ላይ	lˈaj
እና	ʔˈɨna
ውስጥ	wˈɨsɨt`
እንደ	ʔˈɨnɨdə
ወደ	wˈədə
ግን	ɡˈɨn
ወይም	wˈəjɨm
ጊዜ	ɡˈize
ጋር	ɡˈar
በኋላ	bˈəhwala
ነው	nˈəw
ሲሆን	sˈihon
አንድ	ʔˈanɨd
ደግሞ	dˈəɡɨmo
ይህ	jˈɨx
ዘመን	zˈəmən
እስከ	ʔˈɨsɨkə
ብዙ	bˈɨzu
መንግሥት	mˈənɨɡɨsɨt
በዚህ	bˈəziç
ነገር	nˈəɡər
ድረስ	dˈɨrəs
ሰው	sˈəw
ማለት	mˈalət
ስለ	sˈɨlə
ሁሉ	hˈulu
ብቻ	bˈɨt͡ʃa
ዓክልበ	ʔˈakɨlɨβə
ሰዎች	sˈəwot͡ʃ
ልጅ	lˈɨd͡ʒ
ከተማ	kˈətəma
ንጉሥ	nˈɨɡus
ቀን	k`ˈən
ሆኖ	hˈono
ስም	sˈɨm
ቤት	bˈet
ነበር	nˈəβər
ዓመት	ʔˈamət
በላይ	bˈəlaj
ከዚህ	kˈəziç
እንዲሁም	ʔˈɨnɨdihum
ዘንድ	zˈənɨd
አገር	ʔˈaɡər
መካከል	mˈəkakəl
ዋና	wˈana
ሁለት	hˈulət
ዓም	ʔˈam
ታሪክ	tˈarik
ቁጥር	k`ˈut`ɨr
በጣም	bˈət`am
አሁን	ʔˈahun
ያለው	jˈaləw
ዓመታት	ʔˈamətat
ጀምሮ	d͡ʒˈəmɨro
ክፍል	kˈɨfɨl
ሆነ	hˈonə
በ	bˈə
አዲስ	ʔˈadis
ሌላ	lˈela
በፊት	bˈəfit
ምክንያት	mˈɨkɨnɨjat
ቋንቋ	k`wˈanɨk`wa
አንዱ	ʔˈanɨdu
አይነት	ʔˈajɨnət
ፊደል	fˈidəl
ቤተ	bˈetə
የኢትዮጵያ	jˈəʔitɨjop`ɨja
እንጂ	ʔˈɨnɨd͡ʒi
ከፍተኛ	kˈəfɨtəɲa
ብሎ	bˈɨlo
ቦታ	bˈota
ይህን	jˈɨhɨn
ትምህርት	tˈɨmɨhɨrɨt
ምንም	mˈɨnɨm
ሌሎች	lˈelot͡ʃ
ልዩ	lˈɨju
የ	jˈə
ከዚያ	kˈəzija
እንዲህ	ʔˈɨnɨdiç
ስለዚህ	sˈɨləziç
ይህም	jˈɨhɨm
ደረጃ	dˈərəd͡ʒa
ወቅት	wˈək`ɨt
ሆኖም	hˈonom
ቃል	k`ˈal
የተለያዩ	jˈətələjaju
ቅዱስ	k`ˈɨdus
ብለው	bˈɨləw
ጦርነት	t`ˈorɨnət
የሚል	jˈəmil
ያህል	jˈahɨl
ያለ	jˈalə
ኢትዮጵያ	ʔˈitɨjop`ɨja
የሚሰጡዋቸውን	jˈəmisət`uwat͡ʃəwɨn
አካባቢ	ʔˈakaβaβi
እነዚህ	ʔˈɨnəziç
መንገድ	mˈənɨɡəd
አመት	ʔˈamət
ለምሳሌ	lˈəmɨsale
ሁኔታ	hˈuneta
የሆነ	jˈəhonə
ሕዝብ	hˈɨzɨb
በአንድ	bˈəʔanɨd
ክርስቲያን	kˈɨrɨsɨtijan
እጅግ	ʔˈɨd͡ʒɨɡ
ግዛት	ɡˈɨzat
በተለይ	bˈətələj
ተብሎ	tˈəβɨlo
ልጆች	lˈɨd͡ʒot͡ʃ
ከ	kˈə
አለቃ	ʔˈalək`a
ስሙ	sˈɨmu
ቅድሚያ	k`ˈɨdɨmija
ዓለም	ʔˈaləm
ሴት	sˈet
ሥራ	sˈɨra
በሙሉ	bˈəmulu
ክፍለ	kˈɨfɨlə
ወገን	wˈəɡən
ሆነው	hˈonəw
ስራ	sˈɨra
ምን	mˈɨn
አንዳንድ	ʔˈanɨdanɨd
ሳይሆን	sˈajɨhon
ግምገማዎች	ɡˈɨmɨɡəmawot͡ʃ
መጠን	mˈət`ən
በኢትዮጵያ	bˈəʔitɨjop`ɨja
በይፋ	bˈəjɨfa
የሚገኝ	jˈəmiɡəɲ
እንደገና	ʔˈɨnɨdəɡəna
በሌላ	bˈəlela
እንደሆነ	ʔˈɨnɨdəhonə
ቋንቋዎች	k`wˈanɨk`wawot͡ʃ
የነበረው	jˈənəβərəw
የግዕዝ	jˈəɡɨʔɨz
ግድም	ɡˈɨdɨm
ታላቅ	tˈalak`
አበባ	ʔˈaβəβa
መቶ	mˈəto
መጽሐፍ	mˈətsɨhaf
ሜትር	mˈetɨr
ምልክት	mˈɨlɨkɨt
በኩል	bˈəkul
በማለት	bˈəmalət
ትልቅ	tˈɨlɨk`
መሠረት	mˈəsərət
ምናልባት	mˈɨnalɨβat
የሚለው	jˈəmiləw
መሆኑን	mˈəhonun
ጥናት	t`ˈɨnat
የመጀመሪያው	jˈəməd͡ʒəmərijaw
መንግስት	mˈənɨɡɨsɨt
ሦስት	sˈosɨt
አለም	ʔˈaləm
ውጭ	wˈɨt͡ʃ`
ነገሥታት	nˈəɡəsɨtat
በዚሁ	bˈəzihu
ጽሑፍ	tsˈɨhuf
ብዛት	bˈɨzat
ዓይነት	ʔˈajɨnət
ጉዳይ	ɡˈudaj
በአሁኑ	bˈəʔahunu
ናቸው	nˈat͡ʃəw
እኔ	ʔˈɨne
ወይንም	wˈəjɨnɨm
የሰው	jˈəsəw
ሙሉ	mˈulu
ሺህ	ʃˈiç
ክፍሎች	kˈɨfɨlot͡ʃ
ቢሆንም	bˈihonɨm
መጀመርያ	mˈəd͡ʒəmərɨja
መረጃ	mˈərəd͡ʒa
ከዚያም	kˈəzijam
የተባለው	jˈətəβaləw
በመሆን	bˈəməhon
ንጉስ	nˈɨɡus
ኳስ	kwˈas
ያሉ	jˈalu
ያላቸው	jˈalat͡ʃəw
ድል	dˈɨl
ዛሬ	zˈare
በተጨማሪ	bˈətət͡ʃ`əmari
በዚያ	bˈəzija
ኃይል	hˈajɨl
ዙሪያ	zˈurija
ጥንታዊ	t`ˈɨnɨtawi
ጦር	t`ˈor
ኗሪ	nwˈari
እምነት	ʔˈɨmɨnət
ሁሉም	hˈulum
ሊሆን	lˈihon
መሪ	mˈəri
መሬት	mˈəret
አባት	ʔˈaβat
በርካታ	bˈərɨkata
ትርጉም	tˈɨrɨɡum
ዜና	zˈena
በተለያዩ	bˈətələjaju
ሥርወ	sˈɨrɨwə
ስለሆነም	sˈɨləhonəm
ብሔራዊ	bˈɨherawi
ትንሽ	tˈɨnɨʃ
አራት	ʔˈarat
አምላክ	ʔˈamɨlak
አካል	ʔˈakal
የሚባል	jˈəmiβal
እንግዲህ	ʔˈɨnɨɡɨdiç
ጥቅም	t`ˈɨk`ɨm
ስር	sˈɨr
በመባል	bˈəməβal
እጅ	ʔˈɨd͡ʒ
ድርጅት	dˈɨrɨd͡ʒɨt
ሲሆኑ	sˈihonu
ቀለም	k`ˈələm
ዝርዝር	zˈɨrɨzɨr
የተባለ	jˈətəβalə
ሚሊዮን	mˈilijon
ቀለሞች	k`ˈələmot͡ʃ
ጥሩ	t`ˈɨru
ሊቃውንት	lˈik`awɨnɨt
በብዙ	bˈəβɨzu
እስካሁን	ʔˈɨsɨkahun
ራስ	rˈas
ሥነ	sˈɨnə
እንዴት	ʔˈɨnɨdet
የህዝብ	jˈəhɨzɨb
ያለውን	jˈaləwɨn
እግዚአብሔር	ʔˈɨɡɨziʔaβɨher
ዕለት	ʔˈɨlət
ጋራ	ɡˈara
ግንኙነት	ɡˈɨnɨɲunət
ነበሩ	nˈəβəru
አገራት	ʔˈaɡərat
ዘዴ	zˈəde
ሃይማኖት	hˈajɨmanot
መሆኑ	mˈəhonu
ብር	bˈɨr
እንኳን	ʔˈɨnɨkwan
ወንዝ	wˈənɨz
ዘመናዊ	zˈəmənawi
ምድር	mˈɨdɨr
ከሆነ	kˈəhonə
ሥርዓት	sˈɨrɨʔat
ሲል	sˈil
ነገሮች	nˈəɡərot͡ʃ
አቀፍ	ʔˈak`əf
ወር	wˈər
ስለሆነ	sˈɨləhonə
አባላት	ʔˈaβalat
መልኩ	mˈəlɨku
አመታት	ʔˈamətat
እንደነበር	ʔˈɨnɨdənəβər
አገሮች	ʔˈaɡərot͡ʃ
ከላይ	kˈəlaj
ዋጋ	wˈaɡa
ማርያም	mˈarɨjam
ምክንያቱም	mˈɨkɨnɨjatum
በዚህም	bˈəzihɨm
ብርሃን	bˈɨrɨhan
ክርስቶስ	kˈɨrɨsɨtos
ገና	ɡˈəna
መጨረሻ	mˈət͡ʃ`ərəʃa
ሥፍራ	sˈɨfɨra
ባለ	bˈalə
አባል	ʔˈaβal
አዳዲስ	ʔˈadadis
ይልቅ	jˈɨlɨk`
ፊት	fˈit
ህዝብ	hˈɨzɨb
ሠራዊት	sˈərawit
የሙዚቃ	jˈəmuzik`a
መሆን	mˈəhon
ቤቶች	bˈetot͡ʃ
አስቀድሞ	ʔˈasɨk`ədɨmo
አቶ	ʔˈato
የነበሩት	jˈənəβərut
በዓለም	bˈəʔaləm
ስሞች	sˈɨmot͡ʃ
የሆኑ	jˈəhonu
አገልግሎት	ʔˈaɡəlɨɡɨlot
እርሱ	ʔˈɨrɨsu
ሰዓት	sˈəʔat
ተመሳሳይ	tˈəməsasaj
አምስት	ʔˈamɨsɨt
አድርጎ	ʔˈadɨrɨɡo
መጻሕፍት	mˈətsahɨfɨt
እዚህ	ʔˈɨziç
ውጤት	wˈɨt`et
ሁለተኛ	hˈulətəɲa
ቃላት	k`ˈalat
በመሆኑ	bˈəməhonu
ቀጥሎ	k`ˈət`ɨlo
ከአንድ	kˈəʔanɨd
የዓለም	jˈəʔaləm
ድምጽ	dˈɨmɨts
ገጽ	ɡˈəts
ስርዓት	sˈɨrɨʔat
እያንዳንዱ	ʔˈɨjanɨdanɨdu
የዚህ	jˈəziç
እንኳ	ʔˈɨnɨkwa
ውሃ	wˈɨha
የሆነው	jˈəhonəw
የመጀመሪያ	jˈəməd͡ʒəmərija
የሚለውን	jˈəmiləwɨn
ክልል	kˈɨlɨl
ሌላው	lˈelaw
ልክ	lˈɨk
በሚል	bˈəmil
ችግር	t͡ʃˈɨɡɨr
እሱ	ʔˈɨsu
ከፍ	kˈəf
በሽታ	bˈəʃɨta
አየር	ʔˈajər
መሰረት	mˈəsərət
መንግሥታት	mˈənɨɡɨsɨtat
ሴቶች	sˈetot͡ʃ
ቀይ	k`ˈəj
ነጻ	nˈətsa
እግር	ʔˈɨɡɨr
ወረዳ	wˈərəda
የተነሳ	jˈətənəsa
ገንዘብ	ɡˈənɨzəb
ሀገር	hˈaɡər
ለመጀመሪያ	lˈəməd͡ʒəmərija
ቡድን	bˈudɨn
ከሌሎች	kˈəlelot͡ʃ
ደቡብ	dˈəβub
ጠቅላይ	t`ˈək`ɨlaj
ጽሕፈት	tsˈɨhɨfət
በሁለት	bˈəhulət
በተጨማሪም	bˈətət͡ʃ`əmarim
በአንዳንድ	bˈəʔanɨdanɨd
ነጥብ	nˈət`ɨb
ንጉሠ	nˈɨɡusə
እውነት	ʔˈɨwɨnət
ባለው	bˈaləw
የራሱ	jˈərasu
ጥቂት	t`ˈɨk`it
ፊደላት	fˈidəlat
ሁለቱ	hˈulətu
መልክ	mˈəlɨk
እያለ	ʔˈɨjalə
ወንድ	wˈənɨd
ዘር	zˈər
ይዞ	jˈɨzo
በሌሎች	bˈəlelot͡ʃ
ጨምሮ	t͡ʃ`ˈəmɨro
ሕይወት	hˈɨjɨwət
መጠቀም	mˈət`ək`əm
ማለትም	mˈalətɨm
ሥልጣን	sˈɨlɨt`an
ወልደ	wˈəlɨdə
የሚባለው	jˈəmiβaləw
ጥበብ	t`ˈɨβəb
ሥር	sˈɨr
በኋላም	bˈəhwalam
ተራራ	tˈərara
ዘመቻ	zˈəmət͡ʃa
ዘርፍ	zˈərɨf
መጀመሪያ	mˈəd͡ʒəmərija
ምልክቶች	mˈɨlɨkɨtot͡ʃ
ምኒልክ	mˈɨnilɨk
ምንጭ	mˈɨnɨt͡ʃ`
ታዋቂ	tˈawak`i
አስተሳሰብ	ʔˈasɨtəsasəb
ከነዚህ	kˈənəziç
ማዕረግ	mˈaʔɨrəɡ
ቅርጽ	k`ˈɨrɨts
በተለይም	bˈətələjɨm
ኣንድ	ʔˈanɨd
እንዲሆን	ʔˈɨnɨdihon
ውድድር	wˈɨdɨdɨr
የሚኖርበት	jˈəminorɨβət
ግዕዝ	ɡˈɨʔɨz
ሁለተኛው	hˈulətəɲaw
ለዚህ	lˈəziç
ሕግ	hˈɨɡ
መጀመርያው	mˈəd͡ʒəmərɨjaw
ቅርስ	k`ˈɨrɨs
ታሪካዊ	tˈarikawi
እንቅስቃሴ	ʔˈɨnɨk`ɨsɨk`ase
የኤሌክትሪክ	jˈəʔelekɨtɨrik
ያሉት	jˈalut
ለውጥ	lˈəwɨt`
ሜዳ	mˈeda
ርቀት	rˈɨk`ət
ስያሜ	sˈɨjame
በመጠቀም	bˈəmət`ək`əm
ተብለው	tˈəβɨləw
ተጨማሪ	tˈət͡ʃ`əmari
ከተሞች	kˈətəmot͡ʃ
ይህንን	jˈɨhɨnɨn
መስመር	mˈəsɨmər
ምግብ	mˈɨɡɨb
ስምምነት	sˈɨmɨmɨnət
ሶስት	sˈosɨt
ቤተክርስቲያን	bˈetəkɨrɨsɨtijan
ወታደሮች	wˈətadərot͡ʃ
የሕዝብ	jˈəhɨzɨb
የሚገኘው	jˈəmiɡəɲəw
የነበረውን	jˈənəβərəwɨn
የአንድ	jˈəʔanɨd
መርገጫዎች	mˈərɨɡət͡ʃ`awot͡ʃ
በታሪክ	bˈətarik
ኢየሱስ	ʔˈijəsus
ከተማው	kˈətəmaw
ጊዮርጊስ	ɡˈijorɨɡis
መብት	mˈəβɨt
መዋዕል	mˈəwaʔɨl
ስፍራ	sˈɨfɨra
ነጭ	nˈət͡ʃ`
ዝርያ	zˈɨrɨja
ስብስብ	sˈɨβɨsɨb
ብሔር	bˈɨher
ከዚህም	kˈəzihɨm
ለ	lˈə
ምዕራብ	mˈɨʔɨrab
በማድረግ	bˈəmadɨrəɡ
ን	nˈɨ
አስተዳደር	ʔˈasɨtədadər
የጦር	jˈət`or
ማንም	mˈanɨm
ማድረግ	mˈadɨrəɡ
በመጨረሻ	bˈəmət͡ʃ`ərəʃa
በአዲስ	bˈəʔadis
አድርገው	ʔˈadɨrɨɡəw
እናት	ʔˈɨnat
ዘመናት	zˈəmənat
ፍቅር	fˈɨk`ɨr
ለብዙ	lˈəβɨzu
መልስ	mˈəlɨs
በወቅቱ	bˈəwək`ɨtu
ቢሆን	bˈihon
አሁንም	ʔˈahunɨm
እርስ	ʔˈɨrɨs
እንዳለው	ʔˈɨnɨdaləw
ዮሐንስ	jˈohanɨs
ሲባል	sˈiβal
በቀዳሚ	bˈək`ədami
በታች	bˈətat͡ʃ
አልፎ	ʔˈalɨfo
አደጋ	ʔˈadəɡa
እራሱ	ʔˈɨrasu
እኩል	ʔˈɨkul
ይሁን	jˈɨhun
ይሄ	jˈɨhe
ደሴት	dˈəset
ፍጥነት	fˈɨt`ɨnət
ምሳሌ	mˈɨsale
በተባለው	bˈətəβaləw
ከሁሉ	kˈəhulu
ድንጋይ	dˈɨnɨɡaj
ስድስት	sˈɨdɨsɨt
አብዛኛው	ʔˈaβɨzaɲaw
የነበረ	jˈənəβərə
የነበሩ	jˈənəβəru
የከተማው	jˈəkətəmaw
ጎን	ɡˈon
ሚካኤል	mˈikaʔel
ቀናት	k`ˈənat
በር	bˈər
በቀር	bˈək`ər
ባህላዊ	bˈahɨlawi
እንዲሁ	ʔˈɨnɨdihu
ፈርዖን	fˈərɨʔon
ነገሥት	nˈəɡəsɨt
ወዘተ	wˈəzətə
የፖለቲካ	jˈəpolətika
ጉዳት	ɡˈudat
ጥያቄ	t`ˈɨjak`e
ሚኒስትር	mˈinisɨtɨr
ምክር	mˈɨkɨr
በቀላሉ	bˈək`əlalu
ተደርጎ	tˈədərɨɡo
ትውልድ	tˈɨwɨlɨd
ዘመነ	zˈəmənə
ግብጽ	ɡˈɨβɨts
መልካም	mˈəlɨkam
ምንጮች	mˈɨnɨt͡ʃ`ot͡ʃ
ሲሉ	sˈilu
ስለነበር	sˈɨlənəβər
በራሱ	bˈərasu
በአጠቃላይ	bˈəʔat`ək`alaj
በደቡብ	bˈədəβub
ነገሥቱ	nˈəɡəsɨtu
የተፈጥሮ	jˈətəfət`ɨro
ሕዝቦች	hˈɨzɨβot͡ʃ
ስሜት	sˈɨmet
ቀስ	k`ˈəs
በብዛት	bˈəβɨzat
ቤቱ	bˈetu
ኪሎ	kˈilo
የሚገኙ	jˈəmiɡəɲu
ዩኒቨርሲቲ	jˈunivərɨsiti
ገዥ	ɡˈəʒ
ሁለቱም	hˈulətum
መሳሪያ	mˈəsarija
ሙዚቃ	mˈuzik`a
ምርጫ	mˈɨrɨt͡ʃ`a
ሥላሴ	sˈɨlase
በዚያው	bˈəzijaw
ተግባር	tˈəɡɨβar
አይደለም	ʔˈajɨdələm
አጠገብ	ʔˈat`əɡəb
መንፈስ	mˈənɨfəs
መኖር	mˈənor
ሚስት	mˈisɨt
ታሪኮች	tˈarikot͡ʃ
አካላት	ʔˈakalat
የተባለውን	jˈətəβaləwɨn
ደብረ	dˈəβɨrə
ፍርድ	fˈɨrɨd
ልዩነት	lˈɨjunət
መቅደስ	mˈək`ɨdəs
መብቶች	mˈəβɨtot͡ʃ
መኖሪያ	mˈənorija
ሰዎችን	sˈəwot͡ʃɨn
ቀድሞ	k`ˈədɨmo
ቁጥሩም	k`ˈut`ɨrum
ኗሪዎች	nwˈariwot͡ʃ
አቅም	ʔˈak`ɨm
አቅጣጫ	ʔˈak`ɨt`at͡ʃ`a
አጠቃላይ	ʔˈat`ək`alaj
ወራት	wˈərat
ዛፍ	zˈaf
የሆኑት	jˈəhonut
የመሬት	jˈəməret
የአየር	jˈəʔajər
ያ	jˈa
ደብዳቤ	dˈəβɨdaβe
ዶክተሩ	dˈokɨtəru
ጉልበት	ɡˈulɨβət
ጽላት	tsˈɨlat
ፈቃድ	fˈək`ad
ህይወት	hˈɨjɨwət
ሰፊ	sˈəfi
ትኩረት	tˈɨkurət
ኢትዮጵያውያን	ʔˈitɨjop`ɨjawɨjan
የታሪክ	jˈətarik
የእግር	jˈəʔɨɡɨr
ይገናኛሉ	jˈɨɡənaɲalu
ፍላጎት	fˈɨlaɡot
ሰባት	sˈəβat
ሰነድ	sˈənəd
በቀጥታ	bˈək`ət`ɨta
ችሎታ	t͡ʃˈɨlota
አጼ	ʔˈatse
አፈ	ʔˈafə
የውጭ	jˈəwɨt͡ʃ`
ጋዜጣ	ɡˈazet`a
ሞት	mˈot
ሰራዊት	sˈərawit
በቂ	bˈək`i
በተባለ	bˈətəβalə
ቢያንስ	bˈijanɨs
ቦታዎች	bˈotawot͡ʃ
አቶማዊ	ʔˈatomawi
አውራጃ	ʔˈawɨrad͡ʒa
እራሱን	ʔˈɨrasun
ከሁለት	kˈəhulət
ኬሚካዊ	kˈemikawi
የበለጠ	jˈəβələt`ə
የአይርላንድ	jˈəʔajɨrɨlanɨd
ጌታ	ɡˈeta
ልብ	lˈɨb
መሣሪያ	mˈəsarija
መቀመጫ	mˈək`əmət͡ʃ`a
ስለጀመሩ	sˈɨləd͡ʒəməru
ስምንት	sˈɨmɨnɨt
ቀላል	k`ˈəlal
ባለቤት	bˈaləβet
ውክሉ	wˈɨkɨlu
ደም	dˈəm
ጥቁር	t`ˈɨk`ur
ፕሮግራም	pˈɨroɡɨram
ሂደት	hˈidət
ሃሳብ	hˈasab
ለመሆን	lˈəməhon
ለማድረግ	lˈəmadɨrəɡ
ለማግኘት	lˈəmaɡɨɲət
ልደት	lˈɨdət
ልጁ	lˈɨd͡ʒu
ሚና	mˈina
ስዕል	sˈɨʔɨl
በዓል	bˈəʔal
ተራ	tˈəra
ነጻነት	nˈətsanət
ንግሥት	nˈɨɡɨsɨt
አባ	ʔˈaβa
አንጄሎ	ʔˈanɨd͡ʒelo
ዕውቀት	ʔˈɨwɨk`ət
የሚችል	jˈəmit͡ʃɨl
የተነሣ	jˈətənəsa
የአሜሪካ	jˈəʔamerika
ይዘው	jˈɨzəw
ሆይ	hˈoj
ማይክል	mˈajɨkɨl
በጊዜው	bˈəɡizew
ባሕር	bˈahɨr
ቶሎ	tˈolo
አበበ	ʔˈaβəβə
አንጻር	ʔˈanɨtsar
ገብረ	ɡˈəβɨrə
ለአንድ	lˈəʔanɨd
ማኅበር	mˈahɨβər
ሰላም	sˈəlam
በዘመኑ	bˈəzəmənu
ንጉሡ	nˈɨɡusu
እንግሊዝኛ	ʔˈɨnɨɡɨlizɨɲa
እያሉ	ʔˈɨjalu
ኪዳን	kˈidan
ክብር	kˈɨβɨr
የአካባቢውን	jˈəʔakaβaβiwɨn
ገደማ	ɡˈədəma
መዝገቦች	mˈəzɨɡəβot͡ʃ
ሳይንስ	sˈajɨnɨs
ስልጣን	sˈɨlɨt`an
ስሙን	sˈɨmun
ስሜን	sˈɨmen
ስፋት	sˈɨfat
በርስ	bˈərɨs
ትምህርቱን	tˈɨmɨhɨrɨtun
የሚሉ	jˈəmilu
የራሱን	jˈərasun
የተገኘ	jˈətəɡəɲə
የግብጽ	jˈəɡɨβɨts
ጉዞ	ɡˈuzo
ሕገ	hˈɨɡə
ትክክለኛ	tˈɨkɨkɨləɲa
አስተያየት	ʔˈasɨtəjajət
አስፈላጊ	ʔˈasɨfəlaɡi
እንስሳ	ʔˈɨnɨsɨsa
የያዘ	jˈəjazə
ያንጊዜ	jˈanɨɡize
ለምን	lˈəmɨn
መሃል	mˈəhal
ማዕከል	mˈaʔɨkəl
ምዕራፍ	mˈɨʔɨraf
ሥጋ	sˈɨɡa
ሰሜን	sˈəmen
ሽልማት	ʃˈɨlɨmat
ቋሚ	k`wˈami
በነዚህ	bˈənəziç
በከፍተኛ	bˈəkəfɨtəɲa
ተማሪ	tˈəmari
ተከታይ	tˈəkətaj
ተከታዮች	tˈəkətajot͡ʃ
አሥራ	ʔˈasɨra
እኒህ	ʔˈɨniç
ወጣት	wˈət`at
ማን	mˈan
ምስራቅ	mˈɨsɨrak`
ቀደም	k`ˈədəm
ቴዎድሮስ	tˈewodɨros
አላህ	ʔˈalax
አንተ	ʔˈanɨtə
እንስሳት	ʔˈɨnɨsɨsat
እኛ	ʔˈɨɲa
ከባድ	kˈəβad
ዓፄ	ʔˈatse
ዝርያዎች	zˈɨrɨjawot͡ʃ
የትምህርት	jˈətɨmɨhɨrɨt
ይሆናል	jˈɨhonal
ይባል	jˈɨβal
ሃይል	hˈajɨl
መነሻ	mˈənəʃa
በውስጡ	bˈəwɨsɨt`u
ብዬ	bˈɨje
ትዕዛዝ	tˈɨʔɨzaz
ትግል	tˈɨɡɨl
ና	nˈa
አቡነ	ʔˈaβunə
ኢትዮጵያን	ʔˈitɨjop`ɨjan
እሱም	ʔˈɨsum
ከነዚህም	kˈənəzihɨm
ክፍላገር	kˈɨfɨlaɡər
ወረራ	wˈərəra
ዞን	zˈon
የተለየ	jˈətələjə
ፕሬዚደንት	pˈɨrezidənɨt
ልማድ	lˈɨmad
መንግሥቱ	mˈənɨɡɨsɨtu
መኮንን	mˈəkonɨn
ሚኒስቴር	mˈinisɨter
ቅኝ	k`ˈɨɲ
ቅድስት	k`ˈɨdɨsɨt
በሞት	bˈəmot
በአብዛኛው	bˈəʔaβɨzaɲaw
ታላቁ	tˈalak`u
አልጋ	ʔˈalɨɡa
አንድላይ	ʔˈanɨdɨlaj
አይነቶች	ʔˈajɨnətot͡ʃ
ወደፊት	wˈədəfit
የቤተ	jˈəβetə
ገዳም	ɡˈədam
ፍልስፍና	fˈɨlɨsɨfɨna
ሁሉንም	hˈulunɨm
ሌሎችም	lˈelot͡ʃɨm
ምሁራን	mˈɨhuran
ምሥራቅ	mˈɨsɨrak`
ምንጊዜም	mˈɨnɨɡizem
ሰቀል	sˈək`əl
ስትሆን	sˈɨtɨhon
ቀበሮዎች	k`ˈəβərowot͡ʃ
በዚያን	bˈəzijan
ተቃራኒ	tˈək`arani
ነገሮችን	nˈəɡərot͡ʃɨn
አምባ	ʔˈamɨβa
አንዲት	ʔˈanɨdit
አፍሪካ	ʔˈafɨrika
እርዳታ	ʔˈɨrɨdata
እንዲያውም	ʔˈɨnɨdijawɨm
እንዳለ	ʔˈɨnɨdalə
ካሬ	kˈare
ዋናው	wˈanaw
ውል	wˈɨl
ዘ	zˈə
ዙፋን	zˈufan
የላቲን	jˈəlatin
የተለያየ	jˈətələjajə
የንግድ	jˈənɨɡɨd
ያን	jˈan
ጠንካራ	t`ˈənɨkara
ሆኑ	hˈonu
ሥራዎች	sˈɨrawot͡ʃ
ሲጨምር	sˈit͡ʃ`əmɨr
ሺ	ʃˈi
በሆነ	bˈəhonə
በትክክል	bˈətɨkɨkɨl
ቤተሰብ	bˈetəsəb
ተቋም	tˈək`wam
አስተዳዳሪ	ʔˈasɨtədadari
አብረው	ʔˈaβɨrəw
ኢትዮጵያዊ	ʔˈitɨjop`ɨjawi
እሳት	ʔˈɨsat
ወታደራዊ	wˈətadərawi
ዕድሜ	ʔˈɨdɨme
የደም	jˈədəm
ድምፅ	dˈɨmɨts
ጠቃሚ	t`ˈək`ami
ጥረት	t`ˈɨrət
ጭምር	t͡ʃ`ˈɨmɨr
ልሳናት	lˈɨsanat
መደብ	mˈədəb
ማንኛውም	mˈanɨɲawɨm
ራሱን	rˈasun
ሲገመት	sˈiɡəmət
ቀመር	k`ˈəmər
በመጀመሪያ	bˈəməd͡ʒəmərija
በምድር	bˈəmɨdɨr
ታላላቅ	tˈalalak`
ወንድም	wˈənɨdɨm
ወንጌል	wˈənɨɡel
ወገኖች	wˈəɡənot͡ʃ
ያሕል	jˈahɨl
ደራሲ	dˈərasi
ህግ	hˈɨɡ
ማናቸውም	mˈanat͡ʃəwɨm
ማወቅ	mˈawək`
ሳለ	sˈalə
በቅርቡ	bˈək`ɨrɨβu
ባህል	bˈahɨl
ንጉሱ	nˈɨɡusu
አብዛኞቹ	ʔˈaβɨzaɲot͡ʃu
ወዲህ	wˈədiç
ወዲያው	wˈədijaw
የሆነውን	jˈəhonəwɨn
የተመሠረተ	jˈətəməsərətə
የኢትዮጵያን	jˈəʔitɨjop`ɨjan
የዘር	jˈəzər
ይፋዊ	jˈɨfawi
ደስ	dˈəs
ዳር	dˈar
ድንግል	dˈɨnɨɡɨl
ጽሑፎች	tsˈɨhufot͡ʃ
ፍሬ	fˈɨre
ልጁን	lˈɨd͡ʒun
መሰረታዊ	mˈəsərətawi
ማስረጃ	mˈasɨrəd͡ʒa
ሥራዊት	sˈɨrawit
ረገድ	rˈəɡəd
ቴክኖሎጂ	tˈekɨnolod͡ʒi
አለው	ʔˈaləw
አሜሪካ	ʔˈamerika
ወርቅ	wˈərɨk`
ዘውድ	zˈəwɨd
የእጅ	jˈəʔɨd͡ʒ
ደቂቃ	dˈək`ik`a
ድጋፍ	dˈɨɡaf
ገዛ	ɡˈəza
ጉባኤ	ɡˈuβaʔe
ግዛቶች	ɡˈɨzatot͡ʃ
ጸሐፊ	tsˈəhafi
ፓርቲ	pˈarɨti
ሕዝቡ	hˈɨzɨβu
ምህንድስና	mˈɨhɨnɨdɨsɨna
በተደረገው	bˈətədərəɡəw
በደንብ	bˈədənɨb
በግዕዝ	bˈəɡɨʔɨz
ተቋማት	tˈək`wamat
ትክክል	tˈɨkɨkɨl
ነበርና	nˈəβərɨna
ነኝ	nˈəɲ
አረፍተ	ʔˈarəfɨtə
አብያተ	ʔˈaβɨjatə
አንዳንዴ	ʔˈanɨdanɨde
ከክርስቶስ	kˈəkɨrɨsɨtos
ውሸት	wˈɨʃət
የአገሪቱ	jˈəʔaɡəritu
የወርቅ	jˈəwərɨk`
ግልጽ	ɡˈɨlɨts
ግንብ	ɡˈɨnɨb
ጣቢያ	t`ˈaβija
ለማለት	lˈəmalət
መምህር	mˈəmɨhɨr
መደበኛ	mˈədəβəɲa
ስለዚህም	sˈɨləzihɨm
በሰው	bˈəsəw
በአለም	bˈəʔaləm
በጥንት	bˈət`ɨnɨt
ባህርይ	bˈahɨrɨj
ተራሮች	tˈərarot͡ʃ
ተክለ	tˈəkɨlə
ትውፊት	tˈɨwɨfit
ኃይለ	hˈajɨlə
አለቆች	ʔˈalək`ot͡ʃ
እነርሱም	ʔˈɨnərɨsum
እንዳሉት	ʔˈɨnɨdalut
ዓመቱ	ʔˈamətu
የሚታወቀው	jˈəmitawək`əw
የተባሉት	jˈətəβalut
የግል	jˈəɡɨl
ይችላል	jˈɨt͡ʃɨlal
ጉዳዮች	ɡˈudajot͡ʃ
ጋዜጠኛ	ɡˈazet`əɲa
ጠረፍ	t`ˈərəf
ጽሁፍ	tsˈɨhuf
ሃያ	hˈaja
ለረጅም	lˈərəd͡ʒɨm
ለጊዜው	lˈəɡizew
ሌሎቹ	lˈelot͡ʃu
ሰወች	sˈəwət͡ʃ
በመላው	bˈəməlaw
በሚገባ	bˈəmiɡəβa
በሚገኘው	bˈəmiɡəɲəw
በአካባቢው	bˈəʔakaβaβiw
ተቀባይነት	tˈək`əβajɨnət
ትልቁ	tˈɨlɨk`u
ኑሮ	nˈuro
አቆጣጠር	ʔˈak`ot`at`ər
አዲሱ	ʔˈadisu
እነዚህም	ʔˈɨnəzihɨm
ከሌላ	kˈəlela
ከኢትዮጵያ	kˈəʔitɨjop`ɨja
ወይዘሮ	wˈəjɨzəro
ዘመኑ	zˈəmənu
ዘመድ	zˈəməd
የተባሉ	jˈətəβalu
ያለበት	jˈaləβət
ዳግማዊ	dˈaɡɨmawi
ግምገማ	ɡˈɨmɨɡəma
ለማወቅ	lˈəmawək`
መስክ	mˈəsɨk
መጠሪያ	mˈət`ərija
ረጅም	rˈəd͡ʒɨm
ርዝመት	rˈɨzɨmət
በጠቅላላ	bˈət`ək`ɨlala
በጥንታዊ	bˈət`ɨnɨtawi
ተስፋ	tˈəsɨfa
አንድን	ʔˈanɨdɨn
አገሩ	ʔˈaɡəru
እነዚህን	ʔˈɨnəzihɨn
ካለው	kˈaləw
ውኃ	wˈɨha
የመንግሥት	jˈəmənɨɡɨsɨt
የመጀመሪያውን	jˈəməd͡ʒəmərijawɨn
የምግብ	jˈəmɨɡɨb
ያው	jˈaw
ዳሩ	dˈaru
ገብተው	ɡˈəβɨtəw
ግማሽ	ɡˈɨmaʃ
ህዝቦች	hˈɨzɨβot͡ʃ
ሆና	hˈona
ሆኗል	hˈonwal
ለሰው	lˈəsəw
ሊቅ	lˈik`
መሪዎች	mˈəriwot͡ʃ
ሙከራ	mˈukəra
ምስል	mˈɨsɨl
በሰፊ	bˈəsəfi
በዚያም	bˈəzijam
በፍጹም	bˈəfɨtsum
ተማሪዎች	tˈəmariwot͡ʃ
ተናጋሪዎች	tˈənaɡariwot͡ʃ
ንብረት	nˈɨβɨrət
ንግድ	nˈɨɡɨd
አባቱ	ʔˈaβatu
አነስተኛ	ʔˈanəsɨtəɲa
ከመቶ	kˈəməto
ከብዙ	kˈəβɨzu
ዜጎች	zˈeɡot͡ʃ
የዓማርኛ	jˈəʔamarɨɲa
ይሁንና	jˈɨhunɨna
ድርጊት	dˈɨrɨɡit
ገብቶ	ɡˈəβɨto
ጥቃት	t`ˈɨk`at
መቃብር	mˈək`aβɨr
መንደር	mˈənɨdər
መንገዶች	mˈənɨɡədot͡ʃ
ሠፈር	sˈəfər
ቁስ	k`ˈus
ቁጥሮች	k`ˈut`ɨrot͡ʃ
ቅርሶች	k`ˈɨrɨsot͡ʃ
በተፈጥሮ	bˈətəfət`ɨro
ባንድ	bˈanɨd
ተጠቃሚ	tˈət`ək`ami
ነፃ	nˈətsa
ንግግር	nˈɨɡɨɡɨr
አሊ	ʔˈali
ከጥንት	kˈət`ɨnɨt
ክብ	kˈɨb
ወይ	wˈəj
ዓይነቶች	ʔˈajɨnətot͡ʃ
የሥራ	jˈəsɨra
የብርሃን	jˈəβɨrɨhan
የተሰራ	jˈətəsəra
የእንግሊዝ	jˈəʔɨnɨɡɨliz
የፊደል	jˈəfidəl
ግቢ	ɡˈɨβi
ለማሳየት	lˈəmasajət
ስንት	sˈɨnɨt
ቅጠል	k`ˈɨt`əl
በሰፊው	bˈəsəfiw
በስተቀር	bˈəsɨtək`ər
አሉ	ʔˈalu
አልፋቤት	ʔˈalɨfaβet
አመጽ	ʔˈaməts
እናቱ	ʔˈɨnatu
እድገት	ʔˈɨdɨɡət
ከዚሁ	kˈəzihu
ክለብ	kˈɨləb
ያሉትን	jˈalutɨn
ይታያል	jˈɨtajal
ገበያ	ɡˈəβəja
ግድ	ɡˈɨd
ሊባል	lˈiβal
ልዑል	lˈɨʔul
መሪነት	mˈərinət
ቀበሮ	k`ˈəβəro
በቤተ	bˈəβetə
በነበረው	bˈənəβərəw
ቡድኖች	bˈudɨnot͡ʃ
ብላ	bˈɨla
ነውና	nˈəwɨna
ነገሠ	nˈəɡəsə
አማርኛ	ʔˈamarɨɲa
አንደኛው	ʔˈanɨdəɲaw
አጭር	ʔˈat͡ʃ`ɨr
እርሱም	ʔˈɨrɨsum
እንደሆኑ	ʔˈɨnɨdəhonu
ከሚገኙ	kˈəmiɡəɲu
ከርሱ	kˈərɨsu
ወሰን	wˈəsən
ዓመታቸው	ʔˈamətat͡ʃəw
ዝም	zˈɨm
የመጣ	jˈəmət`a
የስራ	jˈəsɨra
የአማርኛ	jˈəʔamarɨɲa
የጋራ	jˈəɡara
ዲግሪ	dˈiɡɨri
ጊዜም	ɡˈizem
ጤና	t`ˈena
ጨዋታ	t͡ʃ`ˈəwata
ጫፍ	t͡ʃ`ˈaf
ጽንሰ	tsˈɨnɨsə
ሊቀ	lˈik`ə
መጻፍ	mˈətsaf
ማተሚያ	mˈatəmija
ማታ	mˈata
ሸዋ	ʃˈəwa
በግብጽ	bˈəɡɨβɨts
ብዙዎች	bˈɨzuwot͡ʃ
ችግሮች	t͡ʃˈɨɡɨrot͡ʃ
አለ	ʔˈalə
አላቸው	ʔˈalat͡ʃəw
ኤርትራ	ʔˈerɨtɨra
እነ	ʔˈɨnə
እናም	ʔˈɨnam
ወጥ	wˈət`
ዉስጥ	wˈusɨt`
ዑደት	ʔˈudət
ዓማርኛ	ʔˈamarɨɲa
የቅዱስ	jˈək`ɨdus
የተወሰነ	jˈətəwəsənə
የውሃ	jˈəwɨha
ያላቸውን	jˈalat͡ʃəwɨn
ደጃዝማች	dˈəd͡ʒazɨmat͡ʃ
ጥበቃ	t`ˈɨβək`a
ሁላቸው	hˈulat͡ʃəw
ሆስፒታል	hˈosɨpital
ለራሱ	lˈərasu
መኪና	mˈəkina
መክተብ	mˈəkɨtəb
ሙያ	mˈuja
ማህበራዊ	mˈahɨβərawi
ሪፐብሊክ	rˈipəβɨlik
ስህተት	sˈɨhɨtət
በልዩ	bˈəlɨju
በመቶ	bˈəməto
በቀስ	bˈək`əs
በእርሱ	bˈəʔɨrɨsu
ባቢሎን	bˈaβilon
ተመልሶ	tˈəməlɨso
ተቃውሞ	tˈək`awɨmo
ትርጉሙ	tˈɨrɨɡumu
ኋላ	hwˈala
ነገዶች	nˈəɡədot͡ʃ
ኖሮ	nˈoro
እምቢ	ʔˈɨmɨβi
እንግዳ	ʔˈɨnɨɡɨda
እውቀት	ʔˈɨwɨk`ət
ከሚለው	kˈəmiləw
ከተለያዩ	kˈətələjaju
ዘጠኝ	zˈət`əɲ
ዝቅ	zˈɨk`
የሚሰራ	jˈəmisəra
የሚኖሩ	jˈəminoru
ድርጅቶች	dˈɨrɨd͡ʒɨtot͡ʃ
ግለሰብ	ɡˈɨləsəb
ጳጳስ	p`ˈap`as
ሀብት	hˈaβɨt
ሊሆኑ	lˈihonu
ልብስ	lˈɨβɨs
መልዕክት	mˈəlɨʔɨkɨt
ማዕከላዊ	mˈaʔɨkəlawi
ሰማያዊ	sˈəmajawi
ሳይቀር	sˈajɨk`ər
በላቲን	bˈəlatin
ባህር	bˈahɨr
ተክል	tˈəkɨl
አማካኝነት	ʔˈamakaɲɨnət
አረንጓዴ	ʔˈarənɨɡwade
አብሮ	ʔˈaβɨro
አብዛኛውን	ʔˈaβɨzaɲawɨn
አካባቢዎች	ʔˈakaβaβiwot͡ʃ
እኔም	ʔˈɨnem
ውድቀት	wˈɨdɨk`ət
ውግያ	wˈɨɡɨja
የሚገኙት	jˈəmiɡəɲut
የቀድሞ	jˈək`ədɨmo
የአለም	jˈəʔaləm
የጽሕፈት	jˈətsɨhɨfət
ይዘት	jˈɨzət
ዴ	dˈe
መታወቂያ	mˈətawək`ija
መጥፎ	mˈət`ɨfo
ሙቀት	mˈuk`ət
ቀዳማዊ	k`ˈədamawi
ቅጣት	k`ˈɨt`at
በመጨረሻም	bˈəmət͡ʃ`ərəʃam
በትምህርት	bˈətɨmɨhɨrɨt
በአሜሪካ	bˈəʔamerika
ባጠቃላይ	bˈat`ək`alaj
ተነስቶ	tˈənəsɨto
ተወላጅ	tˈəwəlad͡ʒ
አንደኛ	ʔˈanɨdəɲa
አዋጅ	ʔˈawad͡ʒ
አያሌ	ʔˈajale
እድሜ	ʔˈɨdɨme
ከሥልጣን	kˈəsɨlɨt`an
ከሰው	kˈəsəw
የተሻለ	jˈətəʃalə
የቻይና	jˈət͡ʃajɨna
የአዲስ	jˈəʔadis
የክብር	jˈəkɨβɨr
ያዕቆብ	jˈaʔɨk`ob
ይሆን	jˈɨhon
ይፋ	jˈɨfa
ዳዊት	dˈawit
ጀርመን	d͡ʒˈərɨmən
ፈርዖኖች	fˈərɨʔonot͡ʃ
መሳፍንት	mˈəsafɨnɨt
መስቀል	mˈəsɨk`əl
ማግኘት	mˈaɡɨɲət
ስለሆኑ	sˈɨləhonu
በሁሉም	bˈəhulum
በሕዝብ	bˈəhɨzɨb
በመሆኑም	bˈəməhonum
በራሳቸው	bˈərasat͡ʃəw
በቅርብ	bˈək`ɨrɨb
በተለምዶ	bˈətələmɨdo
በተግባር	bˈətəɡɨβar
በአንዱ	bˈəʔanɨdu
በዛሬው	bˈəzarew
በየዓመቱ	bˈəjəʔamətu
በጦር	bˈət`or
በጦርነት	bˈət`orɨnət
ቤተሠብ	bˈetəsəb
አስቸጋሪ	ʔˈasɨt͡ʃəɡari
አቡበክር	ʔˈaβuβəkɨr
አንዱን	ʔˈanɨdun
ኣበራ	ʔˈaβəra
ኣንዳንድ	ʔˈanɨdanɨd
እርምጃ	ʔˈɨrɨmɨd͡ʒa
እግዚአብሔርን	ʔˈɨɡɨziʔaβɨherɨn
ከዓለም	kˈəʔaləm
ከዛም	kˈəzam
ካለ	kˈalə
ካውንቲ	kˈawɨnɨti
ወራሽ	wˈəraʃ
ውሳኔ	wˈɨsane
የሚከተሉት	jˈəmikətəlut
የተሰኘው	jˈətəsəɲəw
የከተማ	jˈəkətəma
የደቡብ	jˈədəβub
የግሪክ	jˈəɡɨrik
ግብር	ɡˈɨβɨr
ፈንታ	fˈənɨta
ፊደሉ	fˈidəlu
ሄዶ	hˈedo
ሕግጋት	hˈɨɡɨɡat
መዝገብ	mˈəzɨɡəb
መጥቶ	mˈət`ɨto
ማረፊያ	mˈarəfija
ምክትል	mˈɨkɨtɨl
ሰነዶች	sˈənədot͡ʃ
ስብሰባ	sˈɨβɨsəβa
ቀጥተኛ	k`ˈət`ɨtəɲa
ቅጂ	k`ˈɨd͡ʒi
በመስጠት	bˈəməsɨt`ət
በሽታው	bˈəʃɨtaw
በእንግሊዝኛ	bˈəʔɨnɨɡɨlizɨɲa
በውሃ	bˈəwɨha
በግሪክ	bˈəɡɨrik
ትቶ	tˈɨto
ነበረ	nˈəβərə
ንጥረ	nˈɨt`ɨrə
አሸናፊ	ʔˈaʃənafi
አይ	ʔˈaj
እቴጌ	ʔˈɨteɡe
ከግብጽ	kˈəɡɨβɨts
ወልድ	wˈəlɨd
ዋሻ	wˈaʃa
ዓላማ	ʔˈalama
ዘይት	zˈəjɨt
ዘፈን	zˈəfən
የሚሰጥ	jˈəmisət`
የተመሠረተው	jˈətəməsərətəw
የአፍሪካ	jˈəʔafɨrika
የኤርትራ	jˈəʔerɨtɨra
የእግዚአብሔር	jˈəʔɨɡɨziʔaβɨher
ይሄው	jˈɨhew
ድንበር	dˈɨnɨβər
ግንባር	ɡˈɨnɨβar
ግዕዝን	ɡˈɨʔɨzɨn
ጣኦት	t`ˈaʔot
ጥናቶች	t`ˈɨnatot͡ʃ
ፀሐይ	tsˈəhaj
ሐሳብ	hˈasab
ማየት	mˈajət
ምርት	mˈɨrɨt
ሞገድ	mˈoɡəd
ስልት	sˈɨlɨt
ቀኝ	k`ˈəɲ
ቁጥጥር	k`ˈut`ɨt`ɨr
በመጋቢት	bˈəməɡaβit
በምዕራብ	bˈəmɨʔɨrab
በእግዚአብሔር	bˈəʔɨɡɨziʔaβɨher
በከፊል	bˈəkəfil
ተመልሰው	tˈəməlɨsəw
ነጥቦች	nˈət`ɨβot͡ʃ
ነፍስ	nˈəfɨs
ንቅናቄ	nˈɨk`ɨnak`e
አለቃም	ʔˈalək`am
አነጋገር	ʔˈanəɡaɡər
ኤሌክትሪክ	ʔˈelekɨtɨrik
እነሱ	ʔˈɨnəsu
እንደዚህ	ʔˈɨnɨdəziç
ከእርሱ	kˈəʔɨrɨsu
ከጊዜ	kˈəɡize
ክስተት	kˈɨsɨtət
ወንዞች	wˈənɨzot͡ʃ
ውጪ	wˈɨt͡ʃ`i
ዛሬም	zˈarem
ዞራስተር	zˈorasɨtər
የለም	jˈələm
የሚሆነው	jˈəmihonəw
የምርምር	jˈəmɨrɨmɨr
የምድር	jˈəmɨdɨr
የባቢሎን	jˈəβaβilon
የተገኘው	jˈətəɡəɲəw
የነበሩትን	jˈənəβərutɨn
የእንግሊዝኛ	jˈəʔɨnɨɡɨlizɨɲa
ያንን	jˈanɨn
ያደረገው	jˈadərəɡəw
ግለሰቦች	ɡˈɨləsəβot͡ʃ
ጥፋት	t`ˈɨfat
ፊልም	fˈilɨm
ፕሬዚዳንት	pˈɨrezidanɨt
ፕሬዝዳንት	pˈɨrezɨdanɨt
ሀ	hˈa
ለየት	lˈəjət
መሆናቸውን	mˈəhonat͡ʃəwɨn
መንፈሳዊ	mˈənɨfəsawi
መጋቢት	mˈəɡaβit
ምርምር	mˈɨrɨmɨr
ምክንያቶች	mˈɨkɨnɨjatot͡ʃ
ራሱ	rˈasu
በሦስት	bˈəsosɨt
በሰላም	bˈəsəlam
በቅዱስ	bˈək`ɨdus
በተደጋጋሚ	bˈətədəɡaɡami
በአማርኛ	bˈəʔamarɨɲa
አንድነት	ʔˈanɨdɨnət
ኣንዱ	ʔˈanɨdu
እንደነበሩ	ʔˈɨnɨdənəβəru
እዚያው	ʔˈɨzijaw
እድል	ʔˈɨdɨl
ከጥቂት	kˈət`ɨk`it
ከፍታ	kˈəfɨta
ክርክር	kˈɨrɨkɨr
ወንዶችና	wˈənɨdot͡ʃɨna
ውጊያ	wˈɨɡija
ውጤቶች	wˈɨt`etot͡ʃ
የሃይማኖት	jˈəhajɨmanot
የሚሆን	jˈəmihon
የሚችሉ	jˈəmit͡ʃɨlu
የሚኖር	jˈəminor
የሴት	jˈəset
የተሠራ	jˈətəsəra
ያክል	jˈakɨl
ይህንንም	jˈɨhɨnɨnɨm
ይኖሩ	jˈɨnoru
ደሴቶች	dˈəsetot͡ʃ
ደስታ	dˈəsɨta
ገጽታ	ɡˈətsɨta
ግሪክ	ɡˈɨrik
ጥቃቅን	t`ˈɨk`ak`ɨn
ፊደሎች	fˈidəlot͡ʃ
ሁልጊዜ	hˈulɨɡize
ሃይማኖታዊ	hˈajɨmanotawi
ለመከላከል	lˈəməkəlakəl
ለማየት	lˈəmajət
ልማት	lˈɨmat
ሐውልት	hˈawɨlɨt
መፈንቅለ	mˈəfənɨk`ɨlə
ምርጥ	mˈɨrɨt`
ምትክ	mˈɨtɨk
ሳምንት	sˈamɨnɨt
ስልክ	sˈɨlɨk
ስራው	sˈɨraw
ቅርብ	k`ˈɨrɨb
በመሄድ	bˈəməhed
በሰሜን	bˈəsəmen
በተወለዱ	bˈətəwələdu
በደብረ	bˈədəβɨrə
ባሻገር	bˈaʃaɡər
ብሔሮች	bˈɨherot͡ʃ
ብረት	bˈɨrət
ተከትሎ	tˈəkətɨlo
ነዉ	nˈəwu
አላማ	ʔˈalama
አባባል	ʔˈaβaβal
አብ	ʔˈab
አዝማች	ʔˈazɨmat͡ʃ
እነርሱ	ʔˈɨnərɨsu
እንጨት	ʔˈɨnɨt͡ʃ`ət
ኦርቶዶክስ	ʔˈorɨtodokɨs
ከመሬት	kˈəməret
ክርስቲያናት	kˈɨrɨsɨtijanat
ወታደር	wˈətadər
ወጥቶ	wˈət`ɨto
ውስጥም	wˈɨsɨt`ɨm
ዘርፎች	zˈərɨfot͡ʃ
የቤት	jˈəβet
የተሰኘ	jˈətəsəɲə
ዲ	dˈi
ግዛቱ	ɡˈɨzatu
ግጥም	ɡˈɨt`ɨm
ጥላ	t`ˈɨla
ጽላቶች	tsˈɨlatot͡ʃ
ፈሳሽ	fˈəsaʃ
ፈጣሪ	fˈət`ari
ልጆችን	lˈɨd͡ʒot͡ʃɨn
መስጠት	mˈəsɨt`ət
መድሃኒት	mˈədɨhanit
መጨረሻው	mˈət͡ʃ`ərəʃaw
መጽሐፈ	mˈətsɨhafə
ማህበር	mˈahɨβər
ሰኔ	sˈəne
ሳይንሳዊ	sˈajɨnɨsawi
ስማቸው	sˈɨmat͡ʃəw
ስርጭት	sˈɨrɨt͡ʃ`ɨt
በሚለው	bˈəmiləw
በሚባል	bˈəmiβal
በሚከተለው	bˈəmikətələw
በተረፈ	bˈətərəfə
ባለሙያ	bˈaləmuja
ብቸኛ	bˈɨt͡ʃəɲa
ተወላጆች	tˈəwəlad͡ʒot͡ʃ
ታቦር	tˈaβor
ትእዛዝ	tˈɨʔɨzaz
አማልክት	ʔˈamalɨkɨt
አረመኔ	ʔˈarəməne
አስራ	ʔˈasɨra
አገረ	ʔˈaɡərə
እስር	ʔˈɨsɨr
እስያ	ʔˈɨsɨja
እውነተኛ	ʔˈɨwɨnətəɲa
ከተማውን	kˈətəmawɨn
ከአለት	kˈəʔalət
ካሳ	kˈasa
ክፉ	kˈɨfu
ኮሌጅ	kˈoled͡ʒ
ኮምፕዩተራይዝ	kˈomɨpɨjutərajɨz
ወንጀል	wˈənɨd͡ʒəl
ዕቃ	ʔˈɨk`a
ዝምድና	zˈɨmɨdɨna
ዝናብ	zˈɨnab
የህይወት	jˈəhɨjɨwət
የሕይወት	jˈəhɨjɨwət
የመሳሰሉ	jˈəməsasəlu
የሚታወቅ	jˈəmitawək`
የቀድሞው	jˈək`ədɨmow
የነበር	jˈənəβər
የጀርመን	jˈəd͡ʒərɨmən
ያለምንም	jˈaləmɨnɨm
ጅረት	d͡ʒˈɨrət
ጊዜያዊ	ɡˈizejawi
ጨለማ	t͡ʃ`ˈələma
ጨረር	t͡ʃ`ˈərər
ሀሣብ	hˈasab
ሁለቱን	hˈulətun
ሁሉን	hˈulun
ሃገር	hˈaɡər
ለኢትዮጵያ	lˈəʔitɨjop`ɨja
ልጃቸው	lˈɨd͡ʒat͡ʃəw
መስራች	mˈəsɨrat͡ʃ
መስፍን	mˈəsɨfɨn
መጥተው	mˈət`ɨtəw
ሙሴ	mˈuse
ማንነት	mˈanɨnət
ምክንያቱ	mˈɨkɨnɨjatu
ሦስተኛ	sˈosɨtəɲa
ሦስቱ	sˈosɨtu
ሲሄድ	sˈihed
ሳጥን	sˈat`ɨn
ስራዎችን	sˈɨrawot͡ʃɨn
ስጦታ	sˈɨt`ota
ቅዱሳን	k`ˈɨdusan
በሥነ	bˈəsɨnə
በርግጥ	bˈərɨɡɨt`
በስሜን	bˈəsɨmen
በተለየ	bˈətələjə
በኮምፕዩተር	bˈəkomɨpɨjutər
በየጊዜው	bˈəjəɡizew
ተረት	tˈərət
ተሰማ	tˈəsəma
ታዲያ	tˈadija
ንዑስ	nˈɨʔus
አባቶች	ʔˈaβatot͡ʃ
አብዮት	ʔˈaβɨjot
አጋጣሚ	ʔˈaɡat`ami
ኢብን	ʔˈiβɨn
እራሳቸውን	ʔˈɨrasat͡ʃəwɨn
እቃ	ʔˈɨk`a
እዚያ	ʔˈɨzija
ከቶ	kˈəto
ካሉት	kˈalut
ክርስቲያኖች	kˈɨrɨsɨtijanot͡ʃ
ክርስትና	kˈɨrɨsɨtɨna
ዘለቀ	zˈələk`ə
የሌለው	jˈəleləw
የመጡ	jˈəmət`u
የሚሆኑ	jˈəmihonu
የሚቆጠሩ	jˈəmik`ot`əru
የሚያስችል	jˈəmijasɨt͡ʃɨl
የሥነ	jˈəsɨnə
የራሳቸውን	jˈərasat͡ʃəwɨn
የራስ	jˈəras
የሱመር	jˈəsumər
የቆየ	jˈək`ojə
የቋንቋ	jˈək`wanɨk`wa
የታወቀ	jˈətawək`ə
የእርሱ	jˈəʔɨrɨsu
የጣልያን	jˈət`alɨjan
ዳርቻ	dˈarɨt͡ʃa
ግንዛቤ	ɡˈɨnɨzaβe
ጸሎት	tsˈəlot
ፍጡር	fˈɨt`ur
ሀገራት	hˈaɡərat
ህዋሳት	hˈɨwasat
ለተለያዩ	lˈətələjaju
ለዚህም	lˈəzihɨm
መሆናቸው	mˈəhonat͡ʃəw
መምህሮች	mˈəmɨhɨrot͡ʃ
መረዳት	mˈərədat
መታሰቢያ	mˈətasəβija
መካከለኛ	mˈəkakələɲa
መድረክ	mˈədɨrək
ማቅረብ	mˈak`ɨrəb
ማዕዘን	mˈaʔɨzən
ሠፈሮች	sˈəfərot͡ʃ
ሰውን	sˈəwɨn
ስመ	sˈɨmə
ሸለቆ	ʃˈələk`o
ቅርንጫፍ	k`ˈɨrɨnɨt͡ʃ`af
በሚባለው	bˈəmiβaləw
በማቅረብ	bˈəmak`ɨrəb
በርግጥም	bˈərɨɡɨt`ɨm
በስደት	bˈəsɨdət
በተመለከተ	bˈətəmələkətə
በተካሄደው	bˈətəkahedəw
በነበረበት	bˈənəβərəβət
በአራት	bˈəʔarat
በከተማው	bˈəkətəmaw
በዘመናዊ	bˈəzəmənawi
በጀርመን	bˈəd͡ʒərɨmən
ብዙዎቹ	bˈɨzuwot͡ʃu
ቫይረስ	vˈajɨrəs
ተጠቃሚዎች	tˈət`ək`amiwot͡ʃ
ተጽእኖ	tˈətsɨʔɨno
ትምህርታቸውን	tˈɨmɨhɨrɨtat͡ʃəwɨn
ትርጓሜ	tˈɨrɨɡwame
አማካይነት	ʔˈamakajɨnət
አሥር	ʔˈasɨr
አቋም	ʔˈak`wam
አባይ	ʔˈaβaj
አገሩን	ʔˈaɡərun
እናታቸው	ʔˈɨnatat͡ʃəw
እናንተ	ʔˈɨnanɨtə
ከነበሩት	kˈənəβərut
ክብደት	kˈɨβɨdət
ዋነኛ	wˈanəɲa
ዓመተ	ʔˈamətə
ዕድል	ʔˈɨdɨl
ዙር	zˈur
የመረጃ	jˈəmərəd͡ʒa
የሚባለውን	jˈəmiβaləwɨn
የምትገኝ	jˈəmɨtɨɡəɲ
የሮሜ	jˈərome
የሰውነት	jˈəsəwɨnət
የሳይንስ	jˈəsajɨnɨs
የባህር	jˈəβahɨr
የባሕር	jˈəβahɨr
የኔ	jˈəne
ይችላሉ	jˈɨt͡ʃɨlalu
ይኸው	jˈɨhəw
ዮሴፍ	jˈosef
ድንቅ	dˈɨnɨk`
ጎንደር	ɡˈonɨdər
ጥሬ	t`ˈɨre
ጥር	t`ˈɨr
ጨረቃ	t͡ʃ`ˈərək`a
ጸባይ	tsˈəβaj
ፈላስፋ	fˈəlasɨfa
ሁኔታዎች	hˈunetawot͡ʃ
ለሁለት	lˈəhulət
መረጃዎች	mˈərəd͡ʒawot͡ʃ
መስመሮች	mˈəsɨmərot͡ʃ
መስከረም	mˈəsɨkərəm
መከላከያ	mˈəkəlakəja
መገናኛ	mˈəɡənaɲa
መጠነ	mˈət`ənə
ምስክር	mˈɨsɨkɨr
ሰማይ	sˈəmaj
ሲኖሩ	sˈinoru
ስራዎች	sˈɨrawot͡ʃ
ስጋ	sˈɨɡa
ቀበሌ	k`ˈəβəle
ቀንድ	k`ˈənɨd
በመሬት	bˈəməret
በመጀመርያ	bˈəməd͡ʒəmərɨja
ባለስልጣን	bˈaləsɨlɨt`an
ቴወድሮስ	tˈewədɨros
ትምሕርት	tˈɨmɨhɨrɨt
ኛው	ɲˈaw
አባታቸው	ʔˈaβatat͡ʃəw
አትክልት	ʔˈatɨkɨlɨt
አንዷ	ʔˈanɨdwa
አዳም	ʔˈadam
አጠራር	ʔˈat`ərar
አጻጻፍ	ʔˈatsatsaf
ኣዲስ	ʔˈadis
ኤ	ʔˈe
እየተባለ	ʔˈɨjətəβalə
እጥፍ	ʔˈɨt`ɨf
ኦፍ	ʔˈof
ከእነዚህ	kˈəʔɨnəziç
ክልሎች	kˈɨlɨlot͡ʃ
ወንዶች	wˈənɨdot͡ʃ
ውጤቱ	wˈɨt`etu
ዘበኛ	zˈəβəɲa
ዜማ	zˈema
የመንግስት	jˈəmənɨɡɨsɨt
የመጨረሻው	jˈəmət͡ʃ`ərəʃaw
የሚባሉት	jˈəmiβalut
የብዙ	jˈəβɨzu
የነበራቸው	jˈənəβərat͡ʃəw
የንጉሠ	jˈənɨɡusə
የአሦር	jˈəʔasor
የአርጀንቲና	jˈəʔarɨd͡ʒənɨtina
የአውሮፓ	jˈəʔawɨropa
የአገሩ	jˈəʔaɡəru
የክርስትና	jˈəkɨrɨsɨtɨna
የዓመት	jˈəʔamət
የግንባታ	jˈəɡɨnɨβata
ያገኘው	jˈaɡəɲəw
ይበልጥ	jˈɨβəlɨt`
ይኖር	jˈɨnor
ይገኛል	jˈɨɡəɲal
ደርሶ	dˈərɨso
ድረ	dˈɨrə
ዶላር	dˈolar
ገበታ	ɡˈəβəta
ገዢ	ɡˈəʒi
ገዳማ	ɡˈədama
ጊዜው	ɡˈizew
ግምት	ɡˈɨmɨt
ግራ	ɡˈɨra
ግንቦት	ɡˈɨnɨβot
ጎሣ	ɡˈosa
ጠዋት	t`ˈəwat
ጥልቅ	t`ˈɨlɨk`
ጥገኛ	t`ˈɨɡəɲa
ጳውሎስ	p`ˈawɨlos
ፖሊስ	pˈolis
ሀሳብ	hˈasab
ሀገሮች	hˈaɡərot͡ʃ
ሂሳብ	hˈisab
ለመረዳት	lˈəmərədat
ለወዳጅነት	lˈəwədad͡ʒɨnət
ሌሊት	lˈelit
ልጆቹ	lˈɨd͡ʒot͡ʃu
ሕይወታቸውን	hˈɨjɨwətat͡ʃəwɨn
መሣሪያዎች	mˈəsarijawot͡ʃ
መሰል	mˈəsəl
መስራት	mˈəsɨrat
መቀነስ	mˈək`ənəs
መንግሥቱን	mˈənɨɡɨsɨtun
መዝገበ	mˈəzɨɡəβə
ማለቱ	mˈalətu
ማንኛውንም	mˈanɨɲawɨnɨm
ም	mˈɨ
ሥራው	sˈɨraw
ራሳቸውን	rˈasat͡ʃəwɨn
ራዲዮ	rˈadijo
ርስት	rˈɨsɨt
ሲደርስ	sˈidərɨs
ቆይቶ	k`ˈojɨto
ቆዳ	k`ˈoda
በመቀጠል	bˈəmək`ət`əl
በተለያየ	bˈətələjajə
በአገሪቱ	bˈəʔaɡəritu
በኣንድ	bˈəʔanɨd
በድንገት	bˈədɨnɨɡət
ባለሥልጣናት	bˈaləsɨlɨt`anat
ባርያ	bˈarɨja
ብሔረሰብ	bˈɨherəsəb
ብዙም	bˈɨzum
ተከተል	tˈəkətəl
ተወዳጅ	tˈəwədad͡ʒ
ተገዥ	tˈəɡəʒ
ተጽፎ	tˈətsɨfo
ተፈሪ	tˈəfəri
ትንቢት	tˈɨnɨβit
ነገድ	nˈəɡəd
ናት	nˈat
አስተዋጽኦ	ʔˈasɨtəwatsɨʔo
አንስቶ	ʔˈanɨsɨto
ኣከታተብ	ʔˈakətatəb
እርግጠኛ	ʔˈɨrɨɡɨt`əɲa
ከሌላው	kˈəlelaw
ክምችት	kˈɨmɨt͡ʃɨt
ወለድ	wˈələd
ወይን	wˈəjɨn
ዕውቅና	ʔˈɨwɨk`ɨna
ዝግጅት	zˈɨɡɨd͡ʒɨt
የሁለተኛ	jˈəhulətəɲa
የሚያሳይ	jˈəmijasaj
የቆዳ	jˈək`oda
የተፈጠረ	jˈətəfət`ərə
የአካል	jˈəʔakal
የኢየሱስ	jˈəʔijəsus
የካቲት	jˈəkatit
የጥንታዊ	jˈət`ɨnɨtawi
የጥንት	jˈət`ɨnɨt
የጻፈው	jˈətsafəw
ያልሆኑ	jˈalɨhonu
ዳግመኛ	dˈaɡɨməɲa
ድርሻ	dˈɨrɨʃa
ጊዜያት	ɡˈizejat
ግዕዝኤዲት	ɡˈɨʔɨzɨʔedit
ጸሐፊዎች	tsˈəhafiwot͡ʃ
ፍሬው	fˈɨrew
ለሌሎች	lˈəlelot͡ʃ
ላቲን	lˈatin
መርከብ	mˈərɨkəb
መኳንንት	mˈəkwanɨnɨt
መጠጥ	mˈət`ət`
መፍጠር	mˈəfɨt`ər
ማርች	mˈarɨt͡ʃ
ረቂቅ	rˈək`ik`
ሲሞቱ	sˈimotu
ቆጠራ	k`ˈot`əra
በመሆናቸው	bˈəməhonat͡ʃəw
በጥይት	bˈət`ɨjɨt
ቢሮ	bˈiro
ቢጫ	bˈit͡ʃ`a
ባብዛኛው	bˈaβɨzaɲaw
ብሄራዊ	bˈɨherawi
ተገቢ	tˈəɡəβi
ተጫዋች	tˈət͡ʃ`awat͡ʃ
ትዝታ	tˈɨzɨta
ኅብረት	hˈɨβɨrət
አረቢያ	ʔˈarəβija
አሸንፎ	ʔˈaʃənɨfo
እስራኤል	ʔˈɨsɨraʔel
እንግሊዝ	ʔˈɨnɨɡɨliz
እንግሊዞች	ʔˈɨnɨɡɨlizot͡ʃ
ከሆኑ	kˈəhonu
ከአዲስ	kˈəʔadis
ወንድሙ	wˈənɨdɨmu
ወደብ	wˈədəb
ወጣቶች	wˈət`atot͡ʃ
ዘይቤ	zˈəjɨβe
ዜሮ	zˈero
ዝነኛ	zˈɨnəɲa
የሕግ	jˈəhɨɡ
የመሳሰሉትን	jˈəməsasəlutɨn
የመጣው	jˈəmət`aw
የሚያገለግል	jˈəmijaɡələɡɨl
የተሰጠው	jˈətəsət`əw
የአላህ	jˈəʔalax
የኦሮሞ	jˈəʔoromo
የውስጥ	jˈəwɨsɨt`
የፈረንሳይ	jˈəfərənɨsaj
የፍልስፍና	jˈəfɨlɨsɨfɨna
ይቅርታ	jˈɨk`ɨrɨta
ዴሞክራሲያዊ	dˈemokɨrasijawi
ጀርባ	d͡ʒˈərɨβa
ጋዜጠኞች	ɡˈazet`əɲot͡ʃ
ለጥቂት	lˈət`ɨk`it
ለፊት	lˈəfit
ሐምሌ	hˈamɨle
ሐዋርያት	hˈawarɨjat
መዝሙር	mˈəzɨmur
መድኃኒት	mˈədɨhanit
መግቢያ	mˈəɡɨβija
ሙስሊሞች	mˈusɨlimot͡ʃ
ማሽን	mˈaʃɨn
ምስጋና	mˈɨsɨɡana
ሞላ	mˈola
ሥፍራዎች	sˈɨfɨrawot͡ʃ
ሰላማዊ	sˈəlamawi
ስነ	sˈɨnə
ሻለቃ	ʃˈalək`a
ቀጥሎም	k`ˈət`ɨlom
ቁሶች	k`ˈusot͡ʃ
ቃሉ	k`ˈalu
ቄስ	k`ˈes
ቋንቋው	k`wˈanɨk`waw
በሁለቱ	bˈəhulətu
በመርከብ	bˈəmərɨkəb
በመግባት	bˈəməɡɨβat
በራስ	bˈəras
በአፍሪካ	bˈəʔafɨrika
በእርግጥ	bˈəʔɨrɨɡɨt`
በእሳት	bˈəʔɨsat
በፍጥነት	bˈəfɨt`ɨnət
ባሉት	bˈalut
ባሕል	bˈahɨl
ብሎም	bˈɨlom
ብቃት	bˈɨk`at
ተሳትፎ	tˈəsatɨfo
ተግባራዊ	tˈəɡɨβarawi
ትላልቅ	tˈɨlalɨk`
ትንንሽ	tˈɨnɨnɨʃ
ኅልዮት	hˈɨlɨjot
ነገስታት	nˈəɡəsɨtat
ነጠላ	nˈət`əla
አሉት	ʔˈalut
አስተኔ	ʔˈasɨtəne
አንድም	ʔˈanɨdɨm
እርሻ	ʔˈɨrɨʃa
እሳቸው	ʔˈɨsat͡ʃəw
እንዳሉ	ʔˈɨnɨdalu
እንዴ	ʔˈɨnɨde
እያሱ	ʔˈɨjasu
ከሆኑት	kˈəhonut
ከመሆኑ	kˈəməhonu
ከታች	kˈətat͡ʃ
ከነሱም	kˈənəsum
ከውጭ	kˈəwɨt͡ʃ`
ኮምፕዩተር	kˈomɨpɨjutər
ወረቀት	wˈərək`ət
ዓረፍተ	ʔˈarəfɨtə
ዝርዮች	zˈɨrɨjot͡ʃ
ዝቅተኛ	zˈɨk`ɨtəɲa
የሁለት	jˈəhulət
የመሳሰሉት	jˈəməsasəlut
የሰሜን	jˈəsəmen
የቀረበ	jˈək`ərəβə
የበላይ	jˈəβəlaj
የአካባቢ	jˈəʔakaβaβi
የእስራኤል	jˈəʔɨsɨraʔel
የዱር	jˈədur
የጤና	jˈət`ena
ዩኒቨርስቲ	jˈunivərɨsɨti
ያለበትን	jˈaləβətɨn
ይልቁኑ	jˈɨlɨk`unu
ይታወቅ	jˈɨtawək`
ግዙፍ	ɡˈɨzuf
ግድግዳ	ɡˈɨdɨɡɨda
ግፊት	ɡˈɨfit
ጥቅስ	t`ˈɨk`ɨs
ሃያላት	hˈajalat
ሄደው	hˈedəw
ለመስራት	lˈəməsɨrat
ለመያዝ	lˈəməjaz
ለማመልከት	lˈəmaməlɨkət
ለማከም	lˈəmakəm
ሊቀመንበር	lˈik`əmənɨβər
ሊግ	lˈiɡ
ላይም	lˈajɨm
ሌላውን	lˈelawɨn
መዋቅር	mˈəwak`ɨr
ሙሐመድ	mˈuhaməd
ሚስቱ	mˈisɨtu
ማህበረሰብ	mˈahɨβərəsəb
ማስተማር	mˈasɨtəmar
ምሕረት	mˈɨhɨrət
ምንድን	mˈɨnɨdɨn
ሞክሼዎች	mˈokɨʃewot͡ʃ
ሠላሳ	sˈəlasa
ሠራተኞች	sˈəratəɲot͡ʃ
ሬዲዮ	rˈedijo
ርዕዮተ	rˈɨʔɨjotə
ሳይንቲስቶች	sˈajɨnɨtisɨtot͡ʃ
ስላለው	sˈɨlaləw
በሁሉ	bˈəhulu
በመስራት	bˈəməsɨrat
በማንኛውም	bˈəmanɨɲawɨm
በስተ	bˈəsɨtə
በስፋት	bˈəsɨfat
በተሻለ	bˈətəʃalə
በቻይና	bˈət͡ʃajɨna
በአገሩ	bˈəʔaɡəru
በውጭ	bˈəwɨt͡ʃ`
በዙሪያው	bˈəzurijaw
ተግባራት	tˈəɡɨβarat
ትተው	tˈɨtəw
ነብዩ	nˈəβɨju
ነዋሪዎች	nˈəwariwot͡ʃ
ነገሩ	nˈəɡəru
ንዋይ	nˈɨwaj
አ	ʔˈa
አምልኮ	ʔˈamɨlɨko
አምሥት	ʔˈamɨsɨt
አርባ	ʔˈarɨβa
አባቴ	ʔˈaβate
አካባቢው	ʔˈakaβaβiw
ኣጠቃቀም	ʔˈat`ək`ak`əm
እምነቶች	ʔˈɨmɨnətot͡ʃ
እሱን	ʔˈɨsun
እንቅፋት	ʔˈɨnɨk`ɨfat
እንደሚችል	ʔˈɨnɨdəmit͡ʃɨl
እንዳልሆነ	ʔˈɨnɨdalɨhonə
ከሞላ	kˈəmola
ከነበረው	kˈənəβərəw
ክስተቶች	kˈɨsɨtətot͡ʃ
ኮከብ	kˈokəb
ወለተ	wˈələtə
ወድቆ	wˈədɨk`o
ወጥተው	wˈət`ɨtəw
ዋንጫ	wˈanɨt͡ʃ`a
የሂሳብ	jˈəhisab
የመላእክት	jˈəməlaʔɨkɨt
የሚመራ	jˈəmiməra
የሚከተለውን	jˈəmikətələwɨn
የራዲዮ	jˈəradijo
የሮማ	jˈəroma
የተጀመረው	jˈətəd͡ʒəmərəw
የተፈለፈ	jˈətəfələfə
የት	jˈət
የንጉሥ	jˈənɨɡus
የንጉሱ	jˈənɨɡusu
የአገር	jˈəʔaɡər
የዚህን	jˈəzihɨn
የጣሊያን	jˈət`alijan
የጥንቱ	jˈət`ɨnɨtu
ዩኒኮድ	jˈunikod
ያላት	jˈalat
ይሄውም	jˈɨhewɨm
ደራስያን	dˈərasɨjan
ደርሰው	dˈərɨsəw
ድንጋዮች	dˈɨnɨɡajot͡ʃ
ጀግና	d͡ʒˈəɡɨna
ጆን	d͡ʒˈon
ገነት	ɡˈənət
ጠላት	t`ˈəlat
ጴጥሮስ	p`ˈet`ɨros
ፈረስ	fˈərəs
ፍርስራሽ	fˈɨrɨsɨraʃ
ፖለቲካ	pˈolətika
ህዋስ	hˈɨwas
ለህትመት	lˈəhɨtɨmət
ላዕላይነት	lˈaʔɨlajɨnət
ልውውጥ	lˈɨwɨwɨt`
ልጅና	lˈɨd͡ʒɨna
መለኪያ	mˈələkija
መለየት	mˈələjət
መላኩ	mˈəlaku
መልሶ	mˈəlɨso
መግባት	mˈəɡɨβat
ማንበብ	mˈanɨβəb
ሰአት	sˈəʔat
ሲያገለግሉ	sˈijaɡələɡɨlu
ሲገባ	sˈiɡəβa
ሳሉ	sˈalu
ሳርጎን	sˈarɨɡon
ስለነበረ	sˈɨlənəβərə
ስምዎ	sˈɨmɨwo
ሽግግር	ʃˈɨɡɨɡɨr
ቀኖና	k`ˈənona
ቀዳሚ	k`ˈədami
ቁልፍ	k`ˈulɨf
በሆነው	bˈəhonəw
በመጽሐፈ	bˈəmətsɨhafə
በመጽሐፍ	bˈəmətsɨhaf
በርሱ	bˈərɨsu
በቃ	bˈək`a
በአየር	bˈəʔajər
በእጅ	bˈəʔɨd͡ʒ
በጊዜ	bˈəɡize
በግልጽ	bˈəɡɨlɨts
በጎ	bˈəɡo
ባላቸው	bˈalat͡ʃəw
ብዙውን	bˈɨzuwɨn
ቴአትር	tˈeʔatɨr
አሦር	ʔˈasor
አርበኞች	ʔˈarɨβəɲot͡ʃ
አስረካቢ	ʔˈasɨrəkaβi
አቀማመጥ	ʔˈak`əmamət`
አንስተኛ	ʔˈanɨsɨtəɲa
አንበሳ	ʔˈanɨβəsa
አዘጋጅ	ʔˈazəɡad͡ʒ
አይን	ʔˈajɨn
አዳል	ʔˈadal
አገዛዝ	ʔˈaɡəzaz
አፈር	ʔˈafər
ኣዳዲስ	ʔˈadadis
እናቴ	ʔˈɨnate
እድሜው	ʔˈɨdɨmew
እጁን	ʔˈɨd͡ʒun
ከቤት	kˈəβet
ከተማዋ	kˈətəmawa
ከነዓን	kˈənəʔan
ከአባቱ	kˈəʔaβatu
ከግሪኩ	kˈəɡɨriku
ከጥንታዊ	kˈət`ɨnɨtawi
ካቶሊክ	kˈatolik
ክስ	kˈɨs
ወሬ	wˈəre
ወሳኝ	wˈəsaɲ
ወጣ	wˈət`a
ዠበብ	ʒˈəβəb
የመጨረሻ	jˈəmət͡ʃ`ərəʃa
የሚሉት	jˈəmilut
የተጻፈው	jˈətətsafəw
የተጻፉ	jˈətətsafu
የታዘዘ	jˈətazəzə
የኖረ	jˈənorə
የደረሱ	jˈədərəsu
ያልሆነ	jˈalɨhonə
ይላል	jˈɨlal
ደ	dˈə
ግራኝ	ɡˈɨraɲ
ጣሊያን	t`ˈalijan
ጣልያን	t`ˈalɨjan
ጽዮን	tsˈɨjon
ፈተና	fˈətəna
ፈጽሞ	fˈətsɨmo
ለመሆኑ	lˈəməhonu
ለውጦች	lˈəwɨt`ot͡ʃ
ሌሎችን	lˈelot͡ʃɨn
መላ	mˈəla
መምጣት	mˈəmɨt`at
መሥራት	mˈəsɨrat
መሥራች	mˈəsɨrat͡ʃ
መቸም	mˈət͡ʃəm
መንግስቱ	mˈənɨɡɨsɨtu
መግለጫ	mˈəɡɨlət͡ʃ`a
ሚዲያ	mˈidija
ማቴዎስ	mˈatewos
ምናልባትም	mˈɨnalɨβatɨm
ሞተ	mˈotə
ሥራውን	sˈɨrawɨn
ርዕስ	rˈɨʔɨs
ሰኑስረት	sˈənusɨrət
ሲመለሱ	sˈimələsu
ስማቸውን	sˈɨmat͡ʃəwɨn
ስንኳ	sˈɨnɨkwa
ቅድመ	k`ˈɨdɨmə
በሌላው	bˈəlelaw
በሕይወት	bˈəhɨjɨwət
በረራ	bˈərəra
በታላቅ	bˈətalak`
በውነት	bˈəwɨnət
በዓማርኛ	bˈəʔamarɨɲa
በግፍ	bˈəɡɨf
በጥሩ	bˈət`ɨru
በጥቂት	bˈət`ɨk`it
ቡና	bˈuna
ቢሊዮን	bˈilijon
ባለሙያዎች	bˈaləmujawot͡ʃ
ባሉ	bˈalu
ባል	bˈal
ቤተሰቦች	bˈetəsəβot͡ʃ
ተከታታይ	tˈəkətataj
ተፈጥሮ	tˈəfət`ɨro
ታማኝ	tˈamaɲ
ትርጉሞች	tˈɨrɨɡumot͡ʃ
አምክንዮ	ʔˈamɨkɨnɨjo
አርፎ	ʔˈarɨfo
አስር	ʔˈasɨr
አተር	ʔˈatər
አገልጋይ	ʔˈaɡəlɨɡaj
እስፔሊንግ	ʔˈɨsɨpelinɨɡ
እቅድ	ʔˈɨk`ɨd
እንጅ	ʔˈɨnɨd͡ʒ
እኮ	ʔˈɨko
ከሁሉም	kˈəhulum
ከምድር	kˈəmɨdɨr
ከሞት	kˈəmot
ከብት	kˈəβɨt
ካርታ	kˈarɨta
ክቡር	kˈɨβur
ኮሚቴ	kˈomite
ወሎ	wˈəlo
ወረዳዎች	wˈərədawot͡ʃ
ወፍ	wˈəf
ዓለምን	ʔˈaləmɨn
ዓማርኛውን	ʔˈamarɨɲawɨn
ዘሮች	zˈərot͡ʃ
ዘገባ	zˈəɡəβa
ዘፋኝ	zˈəfaɲ
የለውም	jˈələwɨm
የሌላ	jˈəlela
የሚገኘውን	jˈəmiɡəɲəwɨn
የምዕራብ	jˈəmɨʔɨrab
የተለመደ	jˈətələmədə
የተባበሩት	jˈətəβaβərut
የተገኙት	jˈətəɡəɲut
የተጻፈ	jˈətətsafə
የአካባቢው	jˈəʔakaβaβiw
የአይሁድ	jˈəʔajɨhud
የካቶሊክ	jˈəkatolik
የኮምፕዩተር	jˈəkomɨpɨjutər
የዛሬ	jˈəzare
ደረጃዎች	dˈərəd͡ʒawot͡ʃ
ደጋፊ	dˈəɡafi
ዱቄት	dˈuk`et
ድርድር	dˈɨrɨdɨr
ዶክተር	dˈokɨtər
ግሪኮች	ɡˈɨrikot͡ʃ
ጎደል	ɡˈodəl
ጥርስ	t`ˈɨrɨs
ጫማ	t͡ʃ`ˈama
ሃሳቦች	hˈasaβot͡ʃ
ሃይማኖቶች	hˈajɨmanotot͡ʃ
ህመም	hˈɨməm
ህጎች	hˈɨɡot͡ʃ
ለማጥፋት	lˈəmat`ɨfat
መመልከት	mˈəməlɨkət
መብላት	mˈəβɨlat
መጽሃፍ	mˈətsɨhaf
ማስታወቂያ	mˈasɨtawək`ija
ማክ	mˈak
ሰንሰለት	sˈənɨsələt
ሰውነት	sˈəwɨnət
ሲታይ	sˈitaj
ስርወ	sˈɨrɨwə
ሶፍትዌር	sˈofɨtɨwer
ሸንጎ	ʃˈənɨɡo
ቅጽል	k`ˈɨtsɨl
በህይወት	bˈəhɨjɨwət
በቀን	bˈək`ən
በተደረገ	bˈətədərəɡə
በውኑ	bˈəwɨnu
ቢሆኑም	bˈihonum
ቦምብ	bˈomɨb
ተለይቶ	tˈələjɨto
ተመራማሪ	tˈəməramari
ተቀምጦ	tˈək`əmɨt`o
ተደርገው	tˈədərɨɡəw
ተጽዕኖ	tˈətsɨʔɨno
ቲያትር	tˈijatɨr
ትምህርቶች	tˈɨmɨhɨrɨtot͡ʃ
ትርዒት	tˈɨrɨʔit
ኃላፊነት	hˈalafinət
ኃይለኛ	hˈajɨləɲa
ኅዋ	hˈɨwa
ነበረች	nˈəβərət͡ʃ
ነጋዴዎች	nˈəɡadewot͡ʃ
ነፋስ	nˈəfas
ንጉሰ	nˈɨɡusə
አለበት	ʔˈaləβət
አል	ʔˈal
አስደናቂ	ʔˈasɨdənak`i
አብዛኛዎቹ	ʔˈaβɨzaɲawot͡ʃu
አትሌት	ʔˈatɨlet
አንቺ	ʔˈanɨt͡ʃi
አዛዥ	ʔˈazaʒ
ኣልቦ	ʔˈalɨβo
እማሆይ	ʔˈɨmahoj
እነሱም	ʔˈɨnəsum
እነኚህ	ʔˈɨnəɲiç
እንዳላቸው	ʔˈɨnɨdalat͡ʃəw
እየሱስ	ʔˈɨjəsus
እያደገ	ʔˈɨjadəɡə
እጃቸውን	ʔˈɨd͡ʒat͡ʃəwɨn
ከሕንዳዊ	kˈəhɨnɨdawi
ከሱ	kˈəsu
ከበደ	kˈəβədə
ከጥቅም	kˈət`ɨk`ɨm
ኩባንያ	kˈuβanɨja
ኪሎሜትር	kˈilometɨr
ኮረብታ	kˈorəβɨta
ወደዚህ	wˈədəziç
ውስጣዊ	wˈɨsɨt`awi
ዕለተ	ʔˈɨlətə
ዕብራውያን	ʔˈɨβɨrawɨjan
ዘመናዊው	zˈəmənawiw
የህክምና	jˈəhɨkɨmɨna
የሕዝቡ	jˈəhɨzɨβu
የመሰለ	jˈəməsələ
የመጀመሪያዋ	jˈəməd͡ʒəmərijawa
የመጽሐፍ	jˈəmətsɨhaf
የሚባሉ	jˈəmiβalu
የሚታየው	jˈəmitajəw
የሚኖሩት	jˈəminorut
የሚደርስ	jˈəmidərɨs
የሲቪል	jˈəsivil
የቁጥር	jˈək`ut`ɨr
የቅርብ	jˈək`ɨrɨb
የባህል	jˈəβahɨl
የብር	jˈəβɨr
የተወለደው	jˈətəwələdəw
የተገኙ	jˈətəɡəɲu
የአምላክ	jˈəʔamɨlak
የከነዓን	jˈəkənəʔan
የኬጥያውያን	jˈəket`ɨjawɨjan
የወጣ	jˈəwət`a
የጀመረው	jˈəd͡ʒəmərəw
የገንዘብ	jˈəɡənɨzəb
የፍቅር	jˈəfɨk`ɨr
ይባላል	jˈɨβalal
ይኸውም	jˈɨhəwɨm
ይገኝ	jˈɨɡəɲ
ይግባኝ	jˈɨɡɨβaɲ
ደህና	dˈəhɨna
ደረሰ	dˈərəsə
ደቀ	dˈək`ə
ዳንኤል	dˈanɨʔel
ጌታችን	ɡˈetat͡ʃɨn
ግዴታ	ɡˈɨdeta
ጥሩነሽ	t`ˈɨrunəʃ
ጥቅሞች	t`ˈɨk`ɨmot͡ʃ
ጫና	t͡ʃ`ˈana
ጽኑ	tsˈɨnu
ፈንክሽን	fˈənɨkɨʃɨn
ፍንዳታ	fˈɨnɨdata
ህዝቡ	hˈɨzɨβu
ለማንኛውም	lˈəmanɨɲawɨm
ለራሳቸው	lˈərasat͡ʃəw
ለአጭር	lˈəʔat͡ʃ`ɨr
ለእርሱ	lˈəʔɨrɨsu
ለዓለም	lˈəʔaləm
ሊባኖስ	lˈiβanos
ልምድ	lˈɨmɨd
ሐይቅ	hˈajɨk`
መርሻ	mˈərɨʃa
መስፋፋት	mˈəsɨfafat
መካ	mˈəka
መጣ	mˈət`a
ማስታወሻ	mˈasɨtawəʃa
ምነው	mˈɨnəw
ሠርቶ	sˈərɨto
ሰልፍ	sˈəlɨf
ሲመጣ	sˈimət`a
ቀርቶ	k`ˈərɨto
ቁቤ	k`ˈuβe
ቅጂዎች	k`ˈɨd͡ʒiwot͡ʃ
ቆይተው	k`ˈojɨtəw
ቋንቋን	k`wˈanɨk`wan
ቍጥር	k`wˈɨt`ɨr
ቍጥሮች	k`wˈɨt`ɨrot͡ʃ
በሚገኙ	bˈəmiɡəɲu
በማናቸውም	bˈəmanat͡ʃəwɨm
በምሥራቅ	bˈəmɨsɨrak`
በርሳቸው	bˈərɨsat͡ʃəw
በተመሳሳይ	bˈətəməsasaj
በትንሹ	bˈətɨnɨʃu
በንጉሱ	bˈənɨɡusu
በአንጻሩ	bˈəʔanɨtsaru
በአዲሱ	bˈəʔadisu
በአጭር	bˈəʔat͡ʃ`ɨr
በከነዓን	bˈəkənəʔan
በጥንቱ	bˈət`ɨnɨtu
ቢኖር	bˈinor
ባንክ	bˈanɨk
ባዶ	bˈado
ተብላ	tˈəβɨla
ተወካዮች	tˈəwəkajot͡ʃ
ተወዳዳሪ	tˈəwədadari
ቴሌቪዥን	tˈeleviʒɨn
ትልልቅ	tˈɨlɨlɨk`
ትብብር	tˈɨβɨβɨr
ትንሹ	tˈɨnɨʃu
ትዳር	tˈɨdar
ነበረው	nˈəβərəw
ነገሥቱን	nˈəɡəsɨtun
ነጻነቱን	nˈətsanətun
አልባ	ʔˈalɨβa
አስተማሪ	ʔˈasɨtəmari
አንቀጽ	ʔˈanɨk`əts
አንዳንዴም	ʔˈanɨdanɨdem
አንዴ	ʔˈanɨde
አውሮፕላን	ʔˈawɨropɨlan
አየለ	ʔˈajələ
አይነተኛ	ʔˈajɨnətəɲa
አዳራሽ	ʔˈadaraʃ
አገሪቱን	ʔˈaɡəritun
አገራቸው	ʔˈaɡərat͡ʃəw
አገራቸውን	ʔˈaɡərat͡ʃəwɨn
አጠያያቂ	ʔˈat`əjajak`i
ኣራት	ʔˈarat
ኣኃዞች	ʔˈahazot͡ʃ
እምቅ	ʔˈɨmɨk`
እርግጥኛ	ʔˈɨrɨɡɨt`ɨɲa
እሷ	ʔˈɨswa
እንደራሴ	ʔˈɨnɨdərase
እንደተመነው	ʔˈɨnɨdətəmənəw
እንዲሆኑ	ʔˈɨnɨdihonu
ከቤተ	kˈəβetə
ከኔ	kˈəne
ከደቡብ	kˈədəβub
ከጎን	kˈəɡon
ኪንግ	kˈinɨɡ
ክፍለዘመን	kˈɨfɨləzəmən
ክፍት	kˈɨfɨt
ኸ	hˈə
ወሲባዊ	wˈəsiβawi
ዋነኛው	wˈanəɲaw
ውሻ	wˈɨʃa
ውቤ	wˈɨβe
ዘዴዎች	zˈədewot͡ʃ
ዘፈኖች	zˈəfənot͡ʃ
ዘፍጥረት	zˈəfɨt`ɨrət
የሆነበት	jˈəhonəβət
የልጅ	jˈəlɨd͡ʒ
የመንፈስ	jˈəmənɨfəs
የሚመጣ	jˈəmimət`a
የሚከተለው	jˈəmikətələw
የሰውን	jˈəsəwɨn
የብሔራዊ	jˈəβɨherawi
የተወለዱት	jˈətəwələdut
የተጠቀሰው	jˈətət`ək`əsəw
የአሁኑ	jˈəʔahunu
የአራት	jˈəʔarat
የአጼ	jˈəʔatse
የኣማርኛ	jˈəʔamarɨɲa
የእብድ	jˈəʔɨβɨd
የደረሰው	jˈədərəsəw
የጥናት	jˈət`ɨnat
የጻፉት	jˈətsafut
የፈጠራ	jˈəfət`əra
የፋርስ	jˈəfarɨs
ይሄን	jˈɨhen
ደን	dˈən
ደንብ	dˈənɨb
ዳንጉን	dˈanɨɡun
ድልድይ	dˈɨlɨdɨj
ድምጾች	dˈɨmɨtsot͡ʃ
ድንጋጌ	dˈɨnɨɡaɡe
ድግግሞሽ	dˈɨɡɨɡɨmoʃ
ጀርመናዊ	d͡ʒˈərɨmənawi
ጎጃም	ɡˈod͡ʒam
ጥይት	t`ˈɨjɨt
ጨረራ	t͡ʃ`ˈərəra
ፆታ	tsˈota
ሆን	hˈon
ለመፍጠር	lˈəməfɨt`ər
ለሚለው	lˈəmiləw
ላለፉት	lˈaləfut
ልምምድ	lˈɨmɨmɨd
ሔሩ	hˈeru
መላው	mˈəlaw
መልእክተኛ	mˈəlɨʔɨkɨtəɲa
መምሪያ	mˈəmɨrija
መርከቦች	mˈərɨkəβot͡ʃ
መንገዱ	mˈənɨɡədu
መንግስታት	mˈənɨɡɨsɨtat
ምሁር	mˈɨhur
ምህረት	mˈɨhɨrət
ምሽግ	mˈɨʃɨɡ
ሞክሼ	mˈokɨʃe
ሥልጣኔ	sˈɨlɨt`ane
ሰገድ	sˈəɡəd
ሰፋ	sˈəfa
ሲሞት	sˈimot
ሳንቲ	sˈanɨti
ስራወችን	sˈɨrawət͡ʃɨn
ቀኖች	k`ˈənot͡ʃ
ቀደምት	k`ˈədəmɨt
ቀጥታ	k`ˈət`ɨta
በሌሎቹ	bˈəlelot͡ʃu
በል	bˈəl
በሕንድ	bˈəhɨnɨd
በሮማውያን	bˈəromawɨjan
በሽታዎች	bˈəʃɨtawot͡ʃ
በተነሳ	bˈətənəsa
በተገኙበት	bˈətəɡəɲuβət
በቶሎ	bˈətolo
በኤርትራ	bˈəʔerɨtɨra
በክልሉ	bˈəkɨlɨlu
በክብር	bˈəkɨβɨr
በየቀኑ	bˈəjək`ənu
በድሮ	bˈədɨro
በገዛ	bˈəɡəza
በግል	bˈəɡɨl
በግራ	bˈəɡɨra
በጻፈው	bˈətsafəw
ባሕርይ	bˈahɨrɨj
ብለን	bˈɨlən
ብቅ	bˈɨk`
ተስፋዬ	tˈəsɨfaje
ተባለ	tˈəβalə
ተናጋሪ	tˈənaɡari
ተወስዶ	tˈəwəsɨdo
ተገኘ	tˈəɡəɲə
ታህሳስ	tˈahɨsas
ታሪኩ	tˈariku
ታቦት	tˈaβot
ትርጉሙም	tˈɨrɨɡumum
ቻይና	t͡ʃˈajɨna
ነህ	nˈəx
አህመድ	ʔˈahɨməd
አመራር	ʔˈamərar
አስተዋጾ	ʔˈasɨtəwatso
አንበሶች	ʔˈanɨβəsot͡ʃ
አንዳችም	ʔˈanɨdat͡ʃɨm
ኢኮኖሚ	ʔˈikonomi
ኢያሱ	ʔˈijasu
ኤል	ʔˈel
እኒህን	ʔˈɨnihɨn
እየጨመረ	ʔˈɨjət͡ʃ`əmərə
ከሁለቱ	kˈəhulətu
ከሌሎቹ	kˈəlelot͡ʃu
ከሚገኘው	kˈəmiɡəɲəw
ከስልጣን	kˈəsɨlɨt`an
ካላቸው	kˈalat͡ʃəw
ካረፈ	kˈarəfə
ክብረ	kˈɨβɨrə
ክፍተት	kˈɨfɨtət
ወዳጅ	wˈədad͡ʒ
ዋሚ	wˈami
ውበት	wˈɨβət
ዕድሜው	ʔˈɨdɨmew
ዕድገት	ʔˈɨdɨɡət
ዙፋኑን	zˈufanun
ዜጋ	zˈeɡa
የሁሉም	jˈəhulum
የህግ	jˈəhɨɡ
የሙያ	jˈəmuja
የሚሠራ	jˈəmisəra
የሚከተሉትን	jˈəmikətəlutɨn
የሚደረግ	jˈəmidərəɡ
የሚፈጠር	jˈəmifət`ər
የምህንድስና	jˈəmɨhɨnɨdɨsɨna
የቀይ	jˈək`əj
የቤተክርስቲያን	jˈəβetəkɨrɨsɨtijan
የተሰሩ	jˈətəsəru
የተባሉትን	jˈətəβalutɨn
የታወቀው	jˈətawək`əw
የቻለ	jˈət͡ʃalə
የኖህ	jˈənox
የአባይ	jˈəʔaβaj
የአንዱ	jˈəʔanɨdu
የአንድን	jˈəʔanɨdɨn
የኢኮኖሚ	jˈəʔikonomi
የኣሉ	jˈəʔalu
የእርሻ	jˈəʔɨrɨʃa
የእስልምና	jˈəʔɨsɨlɨmɨna
የዛሬው	jˈəzarew
የጊዜ	jˈəɡize
የግዛት	jˈəɡɨzat
የግድ	jˈəɡɨd
ያለን	jˈalən
ይቅር	jˈɨk`ɨr
ይቻላል	jˈɨt͡ʃalal
ደሞ	dˈəmo
ድርጊቶች	dˈɨrɨɡitot͡ʃ
ጀመረ	d͡ʒˈəmərə
ገበሬ	ɡˈəβəre
ገቢ	ɡˈəβi
ጋብቻ	ɡˈaβɨt͡ʃa
ግድብ	ɡˈɨdɨb
ጠቅላላ	t`ˈək`ɨlala
ጠባቂ	t`ˈəβak`i
ጥቅምት	t`ˈɨk`ɨmɨt
ጥንቃቄ	t`ˈɨnɨk`ak`e
ጨካኝ	t͡ʃ`ˈəkaɲ
ጽሕፈቶች	tsˈɨhɨfətot͡ʃ
ፀሓይ	tsˈəhaj
ፈረንሳይ	fˈərənɨsaj
ፈቃደኛ	fˈək`adəɲa
ፈጠራ	fˈət`əra
ፕሮፌሰር	pˈɨrofesər
ሂክሶስ	hˈikɨsos
ህይወቱ	hˈɨjɨwətu
ለሕዝብ	lˈəhɨzɨb
ለመግለጽ	lˈəməɡɨləts
ለመጻፍ	lˈəmətsaf
ለማረጋገጥ	lˈəmarəɡaɡət`
ለነዚህ	lˈənəziç
ለዘላለም	lˈəzəlaləm
ለዚሁ	lˈəzihu
ሊታወቅ	lˈitawək`
ሊታይ	lˈitaj
ልጇ	lˈɨd͡ʒwa
ሕንድ	hˈɨnɨd
ሕንፃ	hˈɨnɨtsa
መልከ	mˈəlɨkə
መሠረታዊ	mˈəsərətawi
መሥሪያ	mˈəsɨrija
መረጃዎችን	mˈərəd͡ʒawot͡ʃɨn
መርገጫ	mˈərɨɡət͡ʃ`a
መንኮራኩር	mˈənɨkorakur
መንግሥትን	mˈənɨɡɨsɨtɨn
መያዝ	mˈəjaz
መጽሓፍ	mˈətsɨhaf
ሙስሊም	mˈusɨlim
ማረጋገጥ	mˈarəɡaɡət`
ማርቆስ	mˈarɨk`os
ማናቸውንም	mˈanat͡ʃəwɨnɨm
ማዶ	mˈado
ምስሎች	mˈɨsɨlot͡ʃ
ምድርን	mˈɨdɨrɨn
ሦስተኛው	sˈosɨtəɲaw
ሲናገር	sˈinaɡər
ሲኖረው	sˈinorəw
ሲያርፍ	sˈijarɨf
ሲጀምር	sˈid͡ʒəmɨr
ሲገኝ	sˈiɡəɲ
ሲጻፍ	sˈitsaf
ሳቢያ	sˈaβija
ስልኮች	sˈɨlɨkot͡ʃ
ሽብር	ʃˈɨβɨr
ቀለማት	k`ˈələmat
ቀጥ	k`ˈət`
ቁመት	k`ˈumət
ቁም	k`ˈum
ቄሣር	k`ˈesar
ቅርፅ	k`ˈɨrɨts
ቅዱስን	k`ˈɨdusɨn
ቆይታ	k`ˈojɨta
በሀገሪቱ	bˈəhaɡəritu
በሂሳብ	bˈəhisab
በመቀጠልም	bˈəmək`ət`əlɨm
በመንፈስ	bˈəmənɨfəs
በመያዝ	bˈəməjaz
በመጨረሻው	bˈəmət͡ʃ`ərəʃaw
በማሰብ	bˈəmasəb
በማስቀመጥ	bˈəmasɨk`əmət`
በማሸነፍ	bˈəmaʃənəf
በሶርያ	bˈəsorɨja
በቃል	bˈək`al
በንጉሠ	bˈənɨɡusə
በአመጽ	bˈəʔaməts
በአገራችን	bˈəʔaɡərat͡ʃɨn
በኣሁኑ	bˈəʔahunu
በኤሌክትሪክ	bˈəʔelekɨtɨrik
በከተማዋ	bˈəkətəmawa
በዘመናት	bˈəzəmənat
በደስታ	bˈədəsɨta
በግ	bˈəɡ
ባህሪ	bˈahɨri
ባቡር	bˈaβur
ቤቱን	bˈetun
ብዛቱ	bˈɨzatu
ቪ	vˈi
ተለይተው	tˈələjɨtəw
ተመራማሪዎች	tˈəməramariwot͡ʃ
ተዋናይ	tˈəwanaj
ነሽ	nˈəʃ
ንጉሣዊ	nˈɨɡusawi
አልበም	ʔˈalɨβəm
አመለካከት	ʔˈamələkakət
አመቱ	ʔˈamətu
አማካሪ	ʔˈamakari
አራዊት	ʔˈarawit
አቡጊዳ	ʔˈaβuɡida
አባቱን	ʔˈaβatun
አብዮታዊ	ʔˈaβɨjotawi
አንዳንዶቹ	ʔˈanɨdanɨdot͡ʃu
አገሪቱ	ʔˈaɡəritu
አጥቢ	ʔˈat`ɨβi
ኣንድን	ʔˈanɨdɨn
ኤም	ʔˈem
ኤችአይቪ	ʔˈet͡ʃɨʔajɨvi
እስልምና	ʔˈɨsɨlɨmɨna
እስፓንያ	ʔˈɨsɨpanɨja
እንስሶች	ʔˈɨnɨsɨsot͡ʃ
እንዲህም	ʔˈɨnɨdihɨm
እጁ	ʔˈɨd͡ʒu
ከሚገኙት	kˈəmiɡəɲut
ከሦስት	kˈəsosɨt
ኩነት	kˈunət
ኮድ	kˈod
ወላጆች	wˈəlad͡ʒot͡ʃ
ወግ	wˈəɡ
ዋናዎቹ	wˈanawot͡ʃu
ውድ	wˈɨd
ውድድሮችን	wˈɨdɨdɨrot͡ʃɨn
ዝሆን	zˈɨhon
የሌላቸው	jˈəlelat͡ʃəw
የሌሎች	jˈəlelot͡ʃ
የሚመስል	jˈəmiməsɨl
የሚረዳ	jˈəmirəda
የሚሰጠው	jˈəmisət`əw
የሚገልጽ	jˈəmiɡəlɨts
የሳይንስና	jˈəsajɨnɨsɨna
የበሬ	jˈəβəre
የብሔረሰቡ	jˈəβɨherəsəβu
የተሰኙ	jˈətəsəɲu
የተዘጋጀ	jˈətəzəɡad͡ʒə
የቱርክ	jˈəturɨk
የታተመ	jˈətatəmə
የታወቁት	jˈətawək`ut
የአቶ	jˈəʔato
የወጡ	jˈəwət`u
የዓመቱ	jˈəʔamətu
የደረሰ	jˈədərəsə
የድንጋይ	jˈədɨnɨɡaj
የገዛ	jˈəɡəza
የግዴታ	jˈəɡɨdeta
የፆታ	jˈətsota
ያስተምር	jˈasɨtəmɨr
ያደረገ	jˈadərəɡə
ይመስላል	jˈɨməsɨlal
ደማቅ	dˈəmak`
ደብዳቤዎች	dˈəβɨdaβewot͡ʃ
ደንቦች	dˈənɨβot͡ʃ
ደጋፊዎች	dˈəɡafiwot͡ʃ
ዲባባ	dˈiβaβa
ዳኛ	dˈaɲa
ጄኔራል	d͡ʒˈeneral
ገዙ	ɡˈəzu
ግንባታ	ɡˈɨnɨβata
ጠላቶች	t`ˈəlatot͡ʃ
ጣይቱ	t`ˈajɨtu
ጥንካሬ	t`ˈɨnɨkare
ጨዋታዎች	t͡ʃ`ˈəwatawot͡ʃ
ጽሑፎችን	tsˈɨhufot͡ʃɨn
ፈጣን	fˈət`an
ፊታውራሪ	fˈitawɨrari
ፊደሉን	fˈidəlun
ህብረተሰብ	hˈɨβɨrətəsəb
ህንጻ	hˈɨnɨtsa
ለሁለተኛ	lˈəhulətəɲa
ለሁሉም	lˈəhulum
ለሌላ	lˈəlela
ለመቆጣጠር	lˈəmək`ot`at`ər
ለመጠቀም	lˈəmət`ək`əm
ለምግብነት	lˈəmɨɡɨβɨnət
ልዕልት	lˈɨʔɨlɨt
ሐረር	hˈarər
ሕዝቡን	hˈɨzɨβun
ሕጋዊ	hˈɨɡawi
መልአክ	mˈəlɨʔak
መልእክት	mˈəlɨʔɨkɨt
መቀየር	mˈək`əjər
መቼ	mˈət͡ʃe
መንገደኞች	mˈənɨɡədəɲot͡ʃ
መወሰኛ	mˈəwəsəɲa
መጻሕፍትን	mˈətsahɨfɨtɨn
ሙዚየም	mˈuzijəm
ማነስ	mˈanəs
ምላሽ	mˈɨlaʃ
ምርመራ	mˈɨrɨməra
ምስጢር	mˈɨsɨt`ir
ምጣኔ	mˈɨt`ane
ሥርዓተ	sˈɨrɨʔatə
ሩቅ	rˈuk`
ራዕይ	rˈaʔɨj
ሰማዕት	sˈəmaʔɨt
ሰዎችም	sˈəwot͡ʃɨm
ሱዳን	sˈudan
ሳባ	sˈaβa
ሳይመን	sˈajɨmən
ስሌት	sˈɨlet
ስሞቹ	sˈɨmot͡ʃu
ሶርያ	sˈorɨja
ሶቅራጠስ	sˈok`ɨrat`əs
ቀለሞችን	k`ˈələmot͡ʃɨn
ቀውስ	k`ˈəwɨs
ቁርአን	k`ˈurɨʔan
ቅኔ	k`ˈɨne
ቅደም	k`ˈɨdəm
በሀገር	bˈəhaɡər
በሁለተኛ	bˈəhulətəɲa
በሁዋላ	bˈəhuwala
በህዝብ	bˈəhɨzɨb
በመላክ	bˈəməlak
በመጀመሪያው	bˈəməd͡ʒəmərijaw
በመፍጠር	bˈəməfɨt`ər
በምስራቅ	bˈəmɨsɨrak`
በምንም	bˈəmɨnɨm
በሽታውን	bˈəʃɨtawɨn
በበለጠ	bˈəβələt`ə
በባሕር	bˈəβahɨr
በባቢሎን	bˈəβaβilon
በብሔረሰቡ	bˈəβɨherəsəβu
በብዙዎች	bˈəβɨzuwot͡ʃ
በንጉሥ	bˈənɨɡus
በአላህ	bˈəʔalax
በእስራኤል	bˈəʔɨsɨraʔel
በእስር	bˈəʔɨsɨr
በዋናነት	bˈəwananət
በውስጣቸው	bˈəwɨsɨt`at͡ʃəw
በዘፍጥረት	bˈəzəfɨt`ɨrət
በጋራ	bˈəɡara
በግብፅ	bˈəɡɨβɨts
በግንቦት	bˈəɡɨnɨβot
በፈረንሳይ	bˈəfərənɨsaj
ቡናማ	bˈunama
ቢል	bˈil
ባህሎች	bˈahɨlot͡ʃ
ባለፈው	bˈaləfəw
ባንዲራ	bˈanɨdira
ቤታቸው	bˈetat͡ʃəw
ብልት	bˈɨlɨt
ብሔረሰቦች	bˈɨherəsəβot͡ʃ
ብሩስ	bˈɨrus
ብርሃኑ	bˈɨrɨhanu
ቦታው	bˈotaw
ተመልካች	tˈəməlɨkat͡ʃ
ተሠርቶ	tˈəsərɨto
ተራራማ	tˈərarama
ተዋሕዶ	tˈəwahɨdo
ተጫዋቾች	tˈət͡ʃ`awat͡ʃot͡ʃ
ቱትሞስ	tˈutɨmos
ታናሽ	tˈanaʃ
ታደሰ	tˈadəsə
ትምህርትን	tˈɨmɨhɨrɨtɨn
ትውፊቶች	tˈɨwɨfitot͡ʃ
ኃላፊ	hˈalafi
ኃይሎች	hˈajɨlot͡ʃ
ነቢያት	nˈəβijat
ነቢይ	nˈəβij
ነፃነት	nˈətsanət
ንጉሡን	nˈɨɡusun
ንጉሥነቱን	nˈɨɡusɨnətun
ንግስት	nˈɨɡɨsɨt
አህያ	ʔˈahɨja
አልነበረም	ʔˈalɨnəβərəm
አመነምሃት	ʔˈamənəmɨhat
አርቲስት	ʔˈarɨtisɨt
አሳታሚ	ʔˈasatami
አባሎች	ʔˈaβalot͡ʃ
አብጃድ	ʔˈaβɨd͡ʒad
አንጋፋ	ʔˈanɨɡafa
አከባቢ	ʔˈakəβaβi
አዋቂ	ʔˈawak`i
አውጥቶ	ʔˈawɨt`ɨto
አዲሱን	ʔˈadisun
አጠራሩ	ʔˈat`əraru
አጠቃቀም	ʔˈat`ək`ak`əm
አጥር	ʔˈat`ɨr
አጥንት	ʔˈat`ɨnɨt
አፍሪቃ	ʔˈafɨrik`a
ኢየሱስም	ʔˈijəsusɨm
ኤምኔም	ʔˈemɨnem
ኤን	ʔˈen
ኤድስ	ʔˈedɨs
እርሱን	ʔˈɨrɨsun
እርባታ	ʔˈɨrɨβata
እስራኤላውያን	ʔˈɨsɨraʔelawɨjan
እሷም	ʔˈɨswam
እንቅስቃሴዎች	ʔˈɨnɨk`ɨsɨk`asewot͡ʃ
እንዲሄድ	ʔˈɨnɨdihed
እንዳለበት	ʔˈɨnɨdaləβət
እያንዳንዳቸው	ʔˈɨjanɨdanɨdat͡ʃəw
ከባሕር	kˈəβahɨr
ከዛ	kˈəza
ክሮሞሶም	kˈɨromosom
ክፍያ	kˈɨfɨja
ወርረው	wˈərɨrəw
ወስዶ	wˈəsɨdo
ወተት	wˈətət
ወደታች	wˈədətat͡ʃ
ውጫዊ	wˈɨt͡ʃ`awi
ዐዋጅ	ʔˈawad͡ʒ
ዓሣ	ʔˈasa
ዕብራይስጥ	ʔˈɨβɨrajɨsɨt`
ዕውነተኛ	ʔˈɨwɨnətəɲa
ዝና	zˈɨna
የሀገር	jˈəhaɡər
የመንገድ	jˈəmənɨɡəd
የሚሰጡ	jˈəmisət`u
የሚኖረው	jˈəminorəw
የሚያደርግ	jˈəmijadərɨɡ
የሚያገለግሉ	jˈəmijaɡələɡɨlu
የሚጠጉ	jˈəmit`əɡu
የስታትስቲክስ	jˈəsɨtatɨsɨtikɨs
የቀለም	jˈək`ələm
የበሽታ	jˈəβəʃɨta
የተመሰረተ	jˈətəməsərətə
የተሰኘውን	jˈətəsəɲəwɨn
የተያያዘ	jˈətəjajazə
የተፈጠረው	jˈətəfət`ərəw
የነዚህ	jˈənəziç
የአምክንዮ	jˈəʔamɨkɨnɨjo
የአገሪቱን	jˈəʔaɡəritun
የአፈር	jˈəʔafər
የአፍሪቃ	jˈəʔafɨrik`a
የኤርትራን	jˈəʔerɨtɨran
የዓፄ	jˈəʔatse
የድሮ	jˈədɨro
የጋዜጠኝነት	jˈəɡazet`əɲɨnət
የግብፅ	jˈəɡɨβɨts
ዳቦ	dˈaβo
ዴቪድ	dˈevid
ድምር	dˈɨmɨr
ድንገት	dˈɨnɨɡət
ዶሮ	dˈoro
ገለልተኛ	ɡˈələlɨtəɲa
ገብርኤል	ɡˈəβɨrɨʔel
ጉባዔ	ɡˈuβaʔe
ግብ	ɡˈɨb
ጎሳዎች	ɡˈosawot͡ʃ
ጣቢያዎች	t`ˈaβijawot͡ʃ
ጥንት	t`ˈɨnɨt
ጸሐፍት	tsˈəhafɨt
ጽሑፉ	tsˈɨhufu
ፍለጋ	fˈɨləɡa
ፍጥረት	fˈɨt`ɨrət
ፍጹም	fˈɨtsum
ፕሮግራሞች	pˈɨroɡɨramot͡ʃ
ፖለቲካዊ	pˈolətikawi
ሀረም	hˈarəm
ሃሙራቢ	hˈamuraβi
ሃይሉ	hˈajɨlu
ሃይሎች	hˈajɨlot͡ʃ
ሃይቅ	hˈajɨk`
ሄራክሌስ	hˈerakɨles
ህብረት	hˈɨβɨrət
ህጋዊ	hˈɨɡawi
ህግጋት	hˈɨɡɨɡat
ሆነና	hˈonəna
ለመመለስ	lˈəməmələs
ለመስጠት	lˈəməsɨt`ət
ለመጠበቅ	lˈəmət`əβək`
ለቀው	lˈək`əw
ለጎን	lˈəɡon
ለ፫	lˈə
ላሊበላ	lˈaliβəla
ሌሎችንም	lˈelot͡ʃɨnɨm
ልሳነ	lˈɨsanə
ልጇን	lˈɨd͡ʒwan
ሐረግ	hˈarəɡ
ሕዝባዊ	hˈɨzɨβawi
መሄድ	mˈəhed
መሣርያ	mˈəsarɨja
መሰረቶች	mˈəsərətot͡ʃ
መስሪያ	mˈəsɨrija
መስኮች	mˈəsɨkot͡ʃ
መቆጣጠር	mˈək`ot`at`ər
መንግሥትና	mˈənɨɡɨsɨtɨna
መጽሄት	mˈətsɨhet
ማርቲን	mˈarɨtin
ማውጣት	mˈawɨt`at
ማይል	mˈajɨl
ምንትዋብ	mˈɨnɨtɨwab
ምክኒያት	mˈɨkɨnijat
ምዕመናን	mˈɨʔɨmənan
ምድረ	mˈɨdɨrə
ምግባር	mˈɨɡɨβar
ራይሆልት	rˈajɨholɨt
ሰራሽ	sˈəraʃ
ሰብአዊ	sˈəβɨʔawi
ሰንጠረዥ	sˈənɨt`ərəʒ
ሰዉ	sˈəwu
ሰዓታት	sˈəʔatat
ሰፍነጎች	sˈəfɨnəɡot͡ʃ
ሲያደርጉ	sˈijadərɨɡu
ሲጀመር	sˈid͡ʒəmər
ሲገቡ	sˈiɡəβu
ሳዑዲ	sˈaʔudi
ስለሚችል	sˈɨləmit͡ʃɨl
ስርአት	sˈɨrɨʔat
ስጋት	sˈɨɡat
ሹም	ʃˈum
ሻይ	ʃˈaj
ሽማግሌ	ʃˈɨmaɡɨle
ቀረ	k`ˈərə
ቀሪው	k`ˈəriw
ቀጭኔ	k`ˈət͡ʃ`ɨne
ቅሬታ	k`ˈɨreta
ቅርጾች	k`ˈɨrɨtsot͡ʃ
ቆምጬ	k`ˈomɨt͡ʃ`e
በሌሎችም	bˈəlelot͡ʃɨm
በመቃወም	bˈəmək`awəm
በመነሳት	bˈəmənəsat
በመንግሥት	bˈəmənɨɡɨsɨt
በመካከለኛ	bˈəməkakələɲa
በመውጣት	bˈəməwɨt`at
በሚቀጥለው	bˈəmik`ət`ɨləw
በሰዎች	bˈəsəwot͡ʃ
በቀኝ	bˈək`əɲ
በበሽታው	bˈəβəʃɨtaw
በቦታው	bˈəβotaw
በኒህ	bˈəniç
በአሥራ	bˈəʔasɨra
በአገር	bˈəʔaɡər
በእንግሊዝ	bˈəʔɨnɨɡɨliz
በወታደራዊ	bˈəwətadərawi
በዓላት	bˈəʔalat
በዘር	bˈəzər
በዛ	bˈəza
በጣሊያን	bˈət`alijan
ቢቂላ	bˈik`ila
ባሁኑ	bˈahunu
ባህልና	bˈahɨlɨna
ባርነት	bˈarɨnət
ተመሳሳይነት	tˈəməsasajɨnət
ተሟጋቾች	tˈəmwaɡat͡ʃot͡ʃ
ተነስተው	tˈənəsɨtəw
ተንቀሳቃሽ	tˈənɨk`əsak`aʃ
ተክሉ	tˈəkɨlu
ተወለዱ	tˈəwələdu
ተገኝቶ	tˈəɡəɲɨto
ተጠቃሽ	tˈət`ək`aʃ
ትል	tˈɨl
ትዝ	tˈɨz
ቶማስ	tˈomas
ነሐሴ	nˈəhase
ነክ	nˈək
አላት	ʔˈalat
አምባሳደር	ʔˈamɨβasadər
አራተኛ	ʔˈaratəɲa
አበቦች	ʔˈaβəβot͡ʃ
አባታችን	ʔˈaβatat͡ʃɨn
አንፃር	ʔˈanɨtsar
አውሬ	ʔˈawɨre
አይቶ	ʔˈajɨto
አገው	ʔˈaɡəw
አግብቶ	ʔˈaɡɨβɨto
አፄ	ʔˈatse
ኢየሩሳሌም	ʔˈijərusalem
ኤንመርካር	ʔˈenɨmərɨkar
እህል	ʔˈɨhɨl
እንቆቅልሽ	ʔˈɨnɨk`ok`ɨlɨʃ
እንደሚከተለው	ʔˈɨnɨdəmikətələw
እውቅና	ʔˈɨwɨk`ɨna
እየሰራ	ʔˈɨjəsəra
ከመሆኑም	kˈəməhonum
ከራሱ	kˈərasu
ከሴት	kˈəset
ከንቲባ	kˈənɨtiβa
ከአላህ	kˈəʔalax
ከከነዓን	kˈəkənəʔan
ኪም	kˈim
ካህናት	kˈahɨnat
ካሉ	kˈalu
ካልሆነ	kˈalɨhonə
ካም	kˈam
ኬክሮስ	kˈekɨros
ክረምት	kˈɨrəmɨt
ክርስቲያኑ	kˈɨrɨsɨtijanu
ክርስቶስን	kˈɨrɨsɨtosɨn
ክፍላገራት	kˈɨfɨlaɡərat
ኮምፒዩተር	kˈomɨpijutər
ወዲያውም	wˈədijawɨm
ዋስትና	wˈasɨtɨna
ውቅር	wˈɨk`ɨr
ዕረፍት	ʔˈɨrəfɨt
ዛፎች	zˈafot͡ʃ
የሁለቱ	jˈəhulətu
የላቀ	jˈəlak`ə
የሔሩ	jˈəheru
የመኖሪያ	jˈəmənorija
የመከላከያ	jˈəməkəlakəja
የሚመራው	jˈəmiməraw
የሚታወቁት	jˈəmitawək`ut
የሬዲዮ	jˈəredijo
የሰላም	jˈəsəlam
የሸዋ	jˈəʃəwa
የበርካታ	jˈəβərɨkata
የተሠራው	jˈətəsəraw
የተሰኙት	jˈətəsəɲut
የተቃውሞ	jˈətək`awɨmo
የትውልድ	jˈətɨwɨlɨd
የኖሩት	jˈənorut
የኖቤል	jˈənoβel
የኪነ	jˈəkinə
የወረዳው	jˈəwərədaw
የዕውቀት	jˈəʔɨwɨk`ət
የያዘው	jˈəjazəw
የገጠር	jˈəɡət`ər
የግዕዝን	jˈəɡɨʔɨzɨn
የፊልም	jˈəfilɨm
የፖርቱጋል	jˈəporɨtuɡal
ያም	jˈam
ይሉት	jˈɨlut
ይላሉ	jˈɨlalu
ይችል	jˈɨt͡ʃɨl
ይኼ	jˈɨhe
ደቡባዊ	dˈəβuβawi
ደጋማ	dˈəɡama
ድሃ	dˈɨha
ዶ	dˈo
ገባ	ɡˈəβa
ገድሎ	ɡˈədɨlo
ገጾች	ɡˈətsot͡ʃ
ጉድ	ɡˈud
ጊዘ	ɡˈizə
ጊዜውን	ɡˈizewɨn
ግብዣ	ɡˈɨβɨʒa
ግኝት	ɡˈɨɲɨt
ግዝፈት	ɡˈɨzɨfət
ጓደኛ	ɡwˈadəɲa
ጠጅ	t`ˈəd͡ʒ
ጠጠር	t`ˈət`ər
ጣልቃ	t`ˈalɨk`a
ፍጡራን	fˈɨt`uran
ፕሮጀክት	pˈɨrod͡ʒəkɨt
ሁሴን	hˈusen
ሁከት	hˈukət
ሃሪ	hˈari
ሃይለኛ	hˈajɨləɲa
ለህዝብ	lˈəhɨzɨb
ለመሥራት	lˈəməsɨrat
ለመቀነስ	lˈəmək`ənəs
ለመድረስ	lˈəmədɨrəs
ለማጥናት	lˈəmat`ɨnat
ለረዥም	lˈərəʒɨm
ለትምህርት	lˈətɨmɨhɨrɨt
ለንጉሠ	lˈənɨɡusə
ሊባሉ	lˈiβalu
ሊኖሩ	lˈinoru
ሊኖር	lˈinor
ላሉ	lˈalu
ላይኛ	lˈajɨɲa
ልቦለድ	lˈɨβoləd
ልዩነቶች	lˈɨjunətot͡ʃ
ሐሣዊ	hˈasawi
ሕክምና	hˈɨkɨmɨna
መሀል	mˈəhal
መመለስ	mˈəmələs
መሠረተ	mˈəsərətə
መስዋዕት	mˈəsɨwaʔɨt
መነሳት	mˈənəsat
መንደሮች	mˈənɨdərot͡ʃ
መኖርያ	mˈənorɨja
መከራ	mˈəkəra
መኻል	mˈəhal
መደቦች	mˈədəβot͡ʃ
መድኅን	mˈədɨhɨn
መገንዘብ	mˈəɡənɨzəb
መጻፊያ	mˈətsafija
መጽሐፍት	mˈətsɨhafɨt
መፈክር	mˈəfəkɨr
ሚስቶች	mˈisɨtot͡ʃ
ሚካኤልን	mˈikaʔelɨn
ማመን	mˈamən
ማሞ	mˈamo
ማስቀመጥ	mˈasɨk`əmət`
ምርቶች	mˈɨrɨtot͡ʃ
ምት	mˈɨt
ምድብ	mˈɨdɨb
ሥዕል	sˈɨʔɨl
ሥፍራው	sˈɨfɨraw
ረድፍ	rˈədɨf
ሪፑብሊክ	rˈipuβɨlik
ርዕሰ	rˈɨʔɨsə
ሰዐት	sˈəʔat
ሲተረጎም	sˈitərəɡom
ሲኖሩት	sˈinorut
ሲደርሱ	sˈidərɨsu
ሳሙኤል	sˈamuʔel
ሳምንታት	sˈamɨnɨtat
ሳይሆኑ	sˈajɨhonu
ሴቶቹ	sˈetot͡ʃu
ስለዚሁ	sˈɨləzihu
ስሙም	sˈɨmum
ስሟ	sˈɨmwa
ስራወች	sˈɨrawət͡ʃ
ስራውን	sˈɨrawɨn
ስትል	sˈɨtɨl
ስደት	sˈɨdət
ሹመት	ʃˈumət
ቀርቦ	k`ˈərɨβo
ቁመቱ	k`ˈumətu
ቁጥሩ	k`ˈut`ɨru
ቁጥራቸው	k`ˈut`ɨrat͡ʃəw
ቁጭ	k`ˈut͡ʃ`
ቂም	k`ˈim
በሁለተኛው	bˈəhulətəɲaw
በሃይል	bˈəhajɨl
በልጅነቱ	bˈəlɨd͡ʒɨnətu
በሒሳብ	bˈəhisab
በሕግ	bˈəhɨɡ
በመላ	bˈəməla
በመወሰዱ	bˈəməwəsədu
በመጽሐፉ	bˈəmətsɨhafu
በሚከተሉት	bˈəmikətəlut
በማሪ	bˈəmari
በሥራ	bˈəsɨra
በራሂ	bˈərahi
በሮች	bˈərot͡ʃ
በሳይንሳዊ	bˈəsajɨnɨsawi
በስተሰሜን	bˈəsɨtəsəmen
በቀይ	bˈək`əj
በቀድሞ	bˈək`ədɨmo
በቋሚ	bˈək`wami
በቤት	bˈəβet
በቫይረሱ	bˈəvajɨrəsu
በተባሉ	bˈətəβalu
በተወሰነ	bˈətəwəsənə
በተጨባጭ	bˈətət͡ʃ`əβat͡ʃ`
በትንሽ	bˈətɨnɨʃ
በነበሩበት	bˈənəβəruβət
በነፃ	bˈənətsa
በንጉሡ	bˈənɨɡusu
በአውሮጳ	bˈəʔawɨrop`a
በእዚህ	bˈəʔɨziç
በዋና	bˈəwana
በዕብራይስጥ	bˈəʔɨβɨrajɨsɨt`
በዝርዝር	bˈəzɨrɨzɨr
በደረሰበት	bˈədərəsəβət
በዶክተሩ	bˈədokɨtəru
በጦርነቱ	bˈət`orɨnətu
በፋርስ	bˈəfarɨs
በፍቅር	bˈəfɨk`ɨr
ባለቤቱ	bˈaləβetu
ባለፉት	bˈaləfut
ባሕላዊ	bˈahɨlawi
ባሻ	bˈaʃa
ቦይ	bˈoj
ቮልቴጅ	vˈolɨted͡ʒ
ተስማሚ	tˈəsɨmami
ተቃዋሚ	tˈək`awami
ተፈራ	tˈəfəra
ታሪክና	tˈarikɨna
ትርፍ	tˈɨrɨf
ትይዩ	tˈɨjɨju
ቻርጅ	t͡ʃˈarɨd͡ʒ
ኅብረተሠብ	hˈɨβɨrətəsəb
ነቢዩ	nˈəβiju
ናሙና	nˈamuna
ናምሩድ	nˈamɨrud
ንድፍ	nˈɨdɨf
ኖህ	nˈox
አልፋ	ʔˈalɨfa
አሠራር	ʔˈasərar
አሰራር	ʔˈasərar
አስፈላጊነት	ʔˈasɨfəlaɡinət
አብርሃም	ʔˈaβɨrɨham
አናባቢ	ʔˈanaβaβi
አኩሪ	ʔˈakuri
አካላዊ	ʔˈakalawi
አዒሻ	ʔˈaʔiʃa
አደባባይ	ʔˈadəβaβaj
አደገኛ	ʔˈadəɡəɲa
አጋማሽ	ʔˈaɡamaʃ
አጥኝው	ʔˈat`ɨɲɨw
ኢንተርኔት	ʔˈinɨtərɨnet
እህት	ʔˈɨhɨt
እርግጥ	ʔˈɨrɨɡɨt`
እስላማዊ	ʔˈɨsɨlamawi
እስቲ	ʔˈɨsɨti
እስቴትስ	ʔˈɨsɨtetɨs
እስካሁንም	ʔˈɨsɨkahunɨm
እሺ	ʔˈɨʃi
እቃዎች	ʔˈɨk`awot͡ʃ
እኔን	ʔˈɨnen
እንደሚለው	ʔˈɨnɨdəmiləw
እንዲመጣ	ʔˈɨnɨdimət`a
እንዲሠራ	ʔˈɨnɨdisəra
እንድትሆን	ʔˈɨnɨdɨtɨhon
እኚህ	ʔˈɨɲiç
ከሚል	kˈəmil
ከሚባሉት	kˈəmiβalut
ከማንኛውም	kˈəmanɨɲawɨm
ከሥነ	kˈəsɨnə
ከተማዎች	kˈətəmawot͡ʃ
ከአባታቸው	kˈəʔaβatat͡ʃəw
ከእናቱ	kˈəʔɨnatu
ከግዕዙ	kˈəɡɨʔɨzu
ከጥፋት	kˈət`ɨfat
ክንፍ	kˈɨnɨf
ክፍሉ	kˈɨfɨlu
ኮሚሽን	kˈomiʃɨn
ወለል	wˈələl
ወስደው	wˈəsɨdəw
ውይይት	wˈɨjɨjɨt
ውድር	wˈɨdɨr
ዎቹ	wˈot͡ʃu
ዕቅድ	ʔˈɨk`ɨd
ዘመቻዎች	zˈəmət͡ʃawot͡ʃ
ዘመኖች	zˈəmənot͡ʃ
ዘውዴ	zˈəwɨde
ዝርዝሮች	zˈɨrɨzɨrot͡ʃ
የሀገሪቱ	jˈəhaɡəritu
የሙቀት	jˈəmuk`ət
የሚመጡ	jˈəmimət`u
የሚሰሩ	jˈəmisəru
የሚቆጠር	jˈəmik`ot`ər
የሚነገር	jˈəminəɡər
የሚናገር	jˈəminaɡər
የሚኖሩበት	jˈəminoruβət
የሚውሉ	jˈəmiwɨlu
የሚያጠና	jˈəmijat`əna
የሚገኝበት	jˈəmiɡəɲɨβət
የማሪ	jˈəmari
የሴቶች	jˈəsetot͡ʃ
የስብስብ	jˈəsɨβɨsɨb
የቤተሰብ	jˈəβetəsəb
የብረት	jˈəβɨrət
የብሪታንያ	jˈəβɨritanɨja
የተለዩ	jˈətələju
የተነሳው	jˈətənəsaw
የተወለደ	jˈətəwələdə
የተወለዱ	jˈətəwələdu
የተወደደ	jˈətəwədədə
የተገነባ	jˈətəɡənəβa
የነገሥታት	jˈənəɡəsɨtat
የኖረው	jˈənorəw
የአረብ	jˈəʔarəb
የአስተዳደር	jˈəʔasɨtədadər
የአየርላንድ	jˈəʔajərɨlanɨd
የኤላም	jˈəʔelam
የእንስሳት	jˈəʔɨnɨsɨsat
የከተማዋ	jˈəkətəmawa
የከፍተኛ	jˈəkəfɨtəɲa
የኪሽ	jˈəkiʃ
የካልኩለስ	jˈəkalɨkuləs
የዘውድ	jˈəzəwɨd
የዚሁ	jˈəzihu
የዛፍ	jˈəzaf
የደርግ	jˈədərɨɡ
የደብረ	jˈədəβɨrə
የጉዞ	jˈəɡuzo
የጋብቻ	jˈəɡaβɨt͡ʃa
የጠላት	jˈət`əlat
የጠበቀ	jˈət`əβək`ə
የጽሑፍ	jˈətsɨhuf
ዩ	jˈu
ያዘ	jˈazə
ይህች	jˈɨhɨt͡ʃ
ይሙት	jˈɨmut
ይባሉ	jˈɨβalu
ዮሴፉስ	jˈosefus
ደብር	dˈəβɨr
ደጅ	dˈəd͡ʒ
ጃንሆይ	d͡ʒˈanɨhoj
ጆርጅ	d͡ʒˈorɨd͡ʒ
ገላነሽ	ɡˈəlanəʃ
ገመድ	ɡˈəməd
ገዝቶ	ɡˈəzɨto
ገጥመው	ɡˈət`ɨməw
ጉብኝት	ɡˈuβɨɲɨt
ጋዝ	ɡˈaz
ጌታዬ	ɡˈetaje
ግልባጭ	ɡˈɨlɨβat͡ʃ`
ግምብ	ɡˈɨmɨb
ግዛታቸውን	ɡˈɨzatat͡ʃəwɨn
ጎሳ	ɡˈosa
ጠለል	t`ˈələl
ጡት	t`ˈut
ጣልያኖች	t`ˈalɨjanot͡ʃ
ጣና	t`ˈana
ጣኦታት	t`ˈaʔotat
ጥምረት	t`ˈɨmɨrət
ጥራት	t`ˈɨrat
ጥበብን	t`ˈɨβəβɨn
ጥንድ	t`ˈɨnɨd
ጭንቀት	t͡ʃ`ˈɨnɨk`ət
ጳጳሱ	p`ˈap`asu
ጻድቅ	tsˈadɨk`
ጽፎ	tsˈɨfo
ፀሐፊ	tsˈəhafi
ፈልጎ	fˈəlɨɡo
ፋብሪካ	fˈaβɨrika
ፋና	fˈana
ፍሰት	fˈɨsət
ፕሬስ	pˈɨres
ፖሊሲ	pˈolisi
ሀይል	hˈajɨl
ሀገሩ	hˈaɡəru
ሁለተኛውን	hˈulətəɲawɨn
ሄኖክ	hˈenok
ሆድ	hˈod
ለመለየት	lˈəmələjət
ለመማር	lˈəməmar
ለመርዳት	lˈəmərɨdat
ለመኖር	lˈəmənor
ለማስላት	lˈəmasɨlat
ለማስወገድ	lˈəmasɨwəɡəd
ለማዳን	lˈəmadan
ለአንተ	lˈəʔanɨtə
ለገበያ	lˈəɡəβəja
ሉቃስ	lˈuk`as
ሊገኙ	lˈiɡəɲu
ልኮ	lˈɨko
ልጆቻቸው	lˈɨd͡ʒot͡ʃat͡ʃəw
ሐ	hˈa
ሕንጻዎች	hˈɨnɨtsawot͡ʃ
ሕይወታቸው	hˈɨjɨwətat͡ʃəw
መለያ	mˈələja
መላእክት	mˈəlaʔɨkɨt
መሐመድ	mˈəhaməd
መምህራን	mˈəmɨhɨran
መምረጥ	mˈəmɨrət`
መሥዋዕት	mˈəsɨwaʔɨt
መስጊድ	mˈəsɨɡid
መቀበል	mˈək`əβəl
መናገር	mˈənaɡər
መንስኤ	mˈənɨsɨʔe
መክተቢያ	mˈəkɨtəβija
መዓዛ	mˈəʔaza
መገለጫዎ	mˈəɡələt͡ʃ`awo
መጡ	mˈət`u
መጽሀፍ	mˈətsɨhaf
መጽሐፉ	mˈətsɨhafu
መጽሐፋቸው	mˈətsɨhafat͡ʃəw
መፍትሔ	mˈəfɨtɨhe
ሙከራዎች	mˈukərawot͡ʃ
ማህበሩ	mˈahɨβəru
ማኅበረሰብ	mˈahɨβərəsəb
ማእከል	mˈaʔɨkəl
ማዘንጊያ	mˈazənɨɡija
ምሽት	mˈɨʃɨt
ሞገዶች	mˈoɡədot͡ʃ
ሠራሽ	sˈəraʃ
ሥርዓቱ	sˈɨrɨʔatu
ረሃብ	rˈəhab
ሪቻርድ	rˈit͡ʃarɨd
ር	rˈɨ
ሮማ	rˈoma
ሰላማ	sˈəlama
ሰሎሞን	sˈəlomon
ሰባ	sˈəβa
ሰብዓዊ	sˈəβɨʔawi
ሰውም	sˈəwɨm
ሰጥቶ	sˈət`ɨto
ሲወጣ	sˈiwət`a
ሲደረግ	sˈidərəɡ
ሲገኙ	sˈiɡəɲu
ሲጓዝ	sˈiɡwaz
ሳር	sˈar
ሴኔጋል	sˈeneɡal
ስልጣኔ	sˈɨlɨt`ane
ስምንተኛ	sˈɨmɨnɨtəɲa
ስብስቦች	sˈɨβɨsɨβot͡ʃ
ስያሜዎች	sˈɨjamewot͡ʃ
ሶበክሆተፕ	sˈoβəkɨhotəp
ቀይሮ	k`ˈəjɨro
ቁምፊ	k`ˈumɨfi
ቁራጭ	k`ˈurat͡ʃ`
ቁና	k`ˈuna
ቅጠሎች	k`ˈɨt`əlot͡ʃ
ቅጥ	k`ˈɨt`
በሆኑ	bˈəhonu
በመልካም	bˈəməlɨkam
በመካከለኛው	bˈəməkakələɲaw
በመጨመር	bˈəmət͡ʃ`əmər
በሚባሉ	bˈəmiβalu
በሥፍራው	bˈəsɨfɨraw
በራሷ	bˈəraswa
በሬ	bˈəre
በሱ	bˈəsu
በቀላል	bˈək`əlal
በቁርአን	bˈək`urɨʔan
በቁጥጥር	bˈək`ut`ɨt`ɨr
በቋንቋ	bˈək`wanɨk`wa
በበኩሉ	bˈəβəkulu
በባዶ	bˈəβado
በተገኘ	bˈətəɡəɲə
በአይርላንድ	bˈəʔajɨrɨlanɨd
በኩፋሌ	bˈəkufale
በውል	bˈəwɨl
በዓፄ	bˈəʔatse
በዚች	bˈəzit͡ʃ
በደም	bˈədəm
በዳ	bˈəda
በግምት	bˈəɡɨmɨt
በግድ	bˈəɡɨd
በጣልያን	bˈət`alɨjan
በጭራሽ	bˈət͡ʃ`ɨraʃ
በፖለቲካ	bˈəpolətika
ባለበት	bˈaləβət
ባላባት	bˈalaβat
ባደረገው	bˈadərəɡəw
ብቸኛው	bˈɨt͡ʃəɲaw
ብቻውን	bˈɨt͡ʃawɨn
ብዜት	bˈɨzet
ቪዛ	vˈiza
ተለዋዋጭ	tˈələwawat͡ʃ`
ተሰብስበው	tˈəsəβɨsɨβəw
ተሳታፊዎች	tˈəsatafiwot͡ʃ
ተሽከርካሪ	tˈəʃɨkərɨkari
ተቀጥሮ	tˈək`ət`ɨro
ተቋሙ	tˈək`wamu
ተነሥቶ	tˈənəsɨto
ተከራካሪ	tˈəkərakari
ተከታዩ	tˈəkətaju
ተያይዞ	tˈəjajɨzo
ተጓዥ	tˈəɡwaʒ
ተጨባጭ	tˈət͡ʃ`əβat͡ʃ`
ተፈጥሮአዊ	tˈəfət`ɨroʔawi
ትምህርቷን	tˈɨmɨhɨrɨtwan
ትምና	tˈɨmɨna
ትናንሽ	tˈɨnanɨʃ
ትግራይ	tˈɨɡɨraj
ቺ	t͡ʃˈi
ችሎታው	t͡ʃˈɨlotaw
ኃይሉ	hˈajɨlu
ነዋሪ	nˈəwari
ነገስት	nˈəɡəsɨt
ነጻነቷን	nˈətsanətwan
ንጉሥና	nˈɨɡusɨna
ኖረ	nˈorə
አለቃው	ʔˈalək`aw
አሕዛብ	ʔˈahɨzab
አማኞች	ʔˈamaɲot͡ʃ
አሞራውያን	ʔˈamorawɨjan
አርአያ	ʔˈarɨʔaja
አርጎ	ʔˈarɨɡo
አርፈው	ʔˈarɨfəw
አቀራረብ	ʔˈak`ərarəb
አቅራቢያ	ʔˈak`ɨraβija
አቤቱ	ʔˈaβetu
አኒዩስ	ʔˈanijus
አንዳች	ʔˈanɨdat͡ʃ
አከፋፈል	ʔˈakəfafəl
አክልበ	ʔˈakɨlɨβə
አይርላንድ	ʔˈajɨrɨlanɨd
አይጥ	ʔˈajɨt`
አድርጋ	ʔˈadɨrɨɡa
አጫጭር	ʔˈat͡ʃ`at͡ʃ`ɨr
አፍ	ʔˈaf
ኢምንት	ʔˈimɨnɨt
ኢስላም	ʔˈisɨlam
ኢንዱስትሪ	ʔˈinɨdusɨtɨri
ኢጣልያ	ʔˈit`alɨja
ኤልያስ	ʔˈelɨjas
ኤረን	ʔˈerən
ኤች	ʔˈet͡ʃ
እለት	ʔˈɨlət
እርሷ	ʔˈɨrɨswa
እነሆ	ʔˈɨnəho
እንደሆነች	ʔˈɨnɨdəhonət͡ʃ
እንደሚቻል	ʔˈɨnɨdəmit͡ʃal
እንዲኖር	ʔˈɨnɨdinor
እንዲያገኝ	ʔˈɨnɨdijaɡəɲ
እንዳይሆን	ʔˈɨnɨdajɨhon
እኛም	ʔˈɨɲam
እውን	ʔˈɨwɨn
እየሆነ	ʔˈɨjəhonə
ኦሪት	ʔˈorit
ኦሮምኛ	ʔˈoromɨɲa
ኧ	ʔˈə
ከሰማይ	kˈəsəmaj
ከሰሜን	kˈəsəmen
ከተማቸው	kˈətəmat͡ʃəw
ከንጉሠ	kˈənɨɡusə
ከአሥራ	kˈəʔasɨra
ከአራት	kˈəʔarat
ከእስር	kˈəʔɨsɨr
ከእናታቸው	kˈəʔɨnatat͡ʃəw
ከእግዚአብሔር	kˈəʔɨɡɨziʔaβɨher
ከወይዘሮ	kˈəwəjɨzəro
ከዋክብት	kˈəwakɨβɨt
ከዚያው	kˈəzijaw
ክልክል	kˈɨlɨkɨl
ክርስትናን	kˈɨrɨsɨtɨnan
ክብርና	kˈɨβɨrɨna
ኮሎኔል	kˈolonel
ወርቃማ	wˈərɨk`ama
ወንድና	wˈənɨdɨna
ወኪል	wˈəkil
ወደኋላ	wˈədəhwala
ወዲያውኑ	wˈədijawɨnu
ወዴት	wˈədet
ወጪ	wˈət͡ʃ`i
ዋንጫውን	wˈanɨt͡ʃ`awɨn
ውህደት	wˈɨhɨdət
ውሾች	wˈɨʃot͡ʃ
ዕድሜያቸው	ʔˈɨdɨmejat͡ʃəw
ዘውዱን	zˈəwɨdun
የህትመት	jˈəhɨtɨmət
የሌላውን	jˈəlelawɨn
የልማት	jˈəlɨmat
የሒሳብ	jˈəhisab
የመጣውን	jˈəmət`awɨn
የሚታወቁ	jˈəmitawək`u
የሚናገሩ	jˈəminaɡəru
የሚወክል	jˈəmiwəkɨl
የማዕረግ	jˈəmaʔɨrəɡ
የማይክል	jˈəmajɨkɨl
የሞገድ	jˈəmoɡəd
የራሳቸው	jˈərasat͡ʃəw
የርሱ	jˈərɨsu
የስነ	jˈəsɨnə
የቀረበው	jˈək`ərəβəw
የቀርከሃ	jˈək`ərɨkəha
የቆመ	jˈək`omə
የተረፉት	jˈətərəfut
የተባለች	jˈətəβalət͡ʃ
የተወሰደ	jˈətəwəsədə
የታተመው	jˈətatəməw
የቴሌቪዥን	jˈəteleviʒɨn
የቴዎድሮስ	jˈətewodɨros
የትም	jˈətɨm
የትኛው	jˈətɨɲaw
የኑሮ	jˈənuro
የንጉሡ	jˈənɨɡusu
የኛ	jˈəɲa
የአካድ	jˈəʔakad
የአውሮጳ	jˈəʔawɨrop`a
የአገራችን	jˈəʔaɡərat͡ʃɨn
የኢንተርኔት	jˈəʔinɨtərɨnet
የኣሉት	jˈəʔalut
የእሳት	jˈəʔɨsat
የእስፓንያ	jˈəʔɨsɨpanɨja
የወረዱት	jˈəwərədut
የዕብራይስጥና	jˈəʔɨβɨrajɨsɨt`ɨna
የዘመናዊ	jˈəzəmənawi
የዚያን	jˈəzijan
የዛኔ	jˈəzane
የግእዝ	jˈəɡɨʔɨz
የጥቁር	jˈət`ɨk`ur
የፍርድ	jˈəfɨrɨd
ያደረጉት	jˈadərəɡut
ያገኘ	jˈaɡəɲə
ይሄም	jˈɨhem
ደጋ	dˈəɡa
ዲሞክራሲያዊ	dˈimokɨrasijawi
ዳግም	dˈaɡɨm
ድርሰት	dˈɨrɨsət
ድሮ	dˈɨro
ድንጋዩ	dˈɨnɨɡaju
ጆሮ	d͡ʒˈoro
ገብስ	ɡˈəβɨs
ጉልህ	ɡˈulɨx
ጉዳዩ	ɡˈudaju
ጋሜት	ɡˈamet
ግልገል	ɡˈɨlɨɡəl
ግጥሞች	ɡˈɨt`ɨmot͡ʃ
ግጭት	ɡˈɨt͡ʃ`ɨt
ጎርፍ	ɡˈorɨf
ጓደኞቹ	ɡwˈadəɲot͡ʃu
ጠመንጃ	t`ˈəmənɨd͡ʒa
ጠባይ	t`ˈəβaj
ጠፍቶ	t`ˈəfɨto
ጣሊያኖች	t`ˈalijanot͡ʃ
ጣፋጭ	t`ˈafat͡ʃ`
ጥሪ	t`ˈɨri
ጥቅሶች	t`ˈɨk`ɨsot͡ʃ
ጥያቄዎች	t`ˈɨjak`ewot͡ʃ
ጦርነቶች	t`ˈorɨnətot͡ʃ
ጨርቅ	t͡ʃ`ˈərɨk`
ጭራ	t͡ʃ`ˈɨra
ጳጳሳት	p`ˈap`asat
ጼዴቅ	tsˈedek`
ፅንስ	tsˈɨnɨs
ፈላስፎች	fˈəlasɨfot͡ʃ
ፈራጅ	fˈərad͡ʒ
ፈርዖኑ	fˈərɨʔonu
ፊልሞች	fˈilɨmot͡ʃ
ፋሲል	fˈasil
ፍጻሜ	fˈɨtsame
ፎቅ	fˈok`
ፓርላማ	pˈarɨlama
ፓተንቶች	pˈatənɨtot͡ʃ
ፕሬዘዳንት	pˈɨrezədanɨt
ፖል	pˈol
፩ኛ	ɲˈa
፪ኛው	ɲˈaw
ሀብታም	hˈaβɨtam
ሁኖ	hˈuno
ሃይማኖቱን	hˈajɨmanotun
ሄርኩሌስ	hˈerɨkules
ለመላው	lˈəməlaw
ለመቀበል	lˈəmək`əβəl
ለመግዛት	lˈəməɡɨzat
ለመግደል	lˈəməɡɨdəl
ለማምጣት	lˈəmamɨt`at
ለማቅረብ	lˈəmak`ɨrəb
ለማክበር	lˈəmakɨβər
ለማውጣት	lˈəmawɨt`at
ለሞት	lˈəmot
ለቆ	lˈək`o
ለተወሰነ	lˈətəwəsənə
ለንባብ	lˈənɨβab
ለዘመኑ	lˈəzəmənu
ላለው	lˈaləw
ሌላም	lˈelam
ሌላኛው	lˈelaɲaw
ሌባ	lˈeβa
ልማዶች	lˈɨmadot͡ʃ
ልጆቻቸውን	lˈɨd͡ʒot͡ʃat͡ʃəwɨn
ሕጻን	hˈɨtsan
መ	mˈə
መለስ	mˈələs
መልሰው	mˈəlɨsəw
መልዕክቱ	mˈəlɨʔɨkɨtu
መማር	mˈəmar
መሪወች	mˈəriwət͡ʃ
መሰረተ	mˈəsərətə
መቅደላ	mˈək`ɨdəla
መብራት	mˈəβɨrat
መንበር	mˈənɨβər
መንታ	mˈənɨta
መንግሥታቸው	mˈənɨɡɨsɨtat͡ʃəw
መንግሥታዊ	mˈənɨɡɨsɨtawi
መካነ	mˈəkanə
መካከለኛው	mˈəkakələɲaw
መወለድ	mˈəwələd
መውጣት	mˈəwɨt`at
መዲና	mˈədina
መገኘት	mˈəɡəɲət
መጻህፍት	mˈətsahɨfɨt
መጽሔት	mˈətsɨhet
መፅሐፍ	mˈətsɨhaf
ሙቅ	mˈuk`
ሚልዮን	mˈilɨjon
ሚኒስትሩ	mˈinisɨtɨru
ማርያምን	mˈarɨjamɨn
ማሳየት	mˈasajət
ማኅበራዊ	mˈahɨβərawi
ምልክቶችን	mˈɨlɨkɨtot͡ʃɨn
ምሳሌዎች	mˈɨsalewot͡ʃ
ምኒልክም	mˈɨnilɨkɨm
ምድራዊ	mˈɨdɨrawi
ሠራዊቱ	sˈərawitu
ሠው	sˈəw
ሣራ	sˈara
ሥላሴን	sˈɨlasen
ረዥም	rˈəʒɨm
ሰ	sˈə
ሰልፎች	sˈəlɨfot͡ʃ
ሰማንያ	sˈəmanɨja
ሰንደቅ	sˈənɨdək`
ሲስተም	sˈisɨtəm
ሲያልፍ	sˈijalɨf
ሳንቲሞች	sˈanɨtimot͡ʃ
ሴማዊ	sˈemawi
ሴራ	sˈera
ስለሌለ	sˈɨləlelə
ስላሴ	sˈɨlase
ስፍራዎች	sˈɨfɨrawot͡ʃ
ቀረጥ	k`ˈərət`
ቀዳዳ	k`ˈədada
ቁጠራ	k`ˈut`əra
ቃለ	k`ˈalə
ቅነሳ	k`ˈɨnəsa
ቆየ	k`ˈojə
በሀገራችን	bˈəhaɡərat͡ʃɨn
በሆነበት	bˈəhonəβət
በላዩ	bˈəlaju
በሕዝቡ	bˈəhɨzɨβu
በመርታት	bˈəmərɨtat
በመቀየር	bˈəmək`əjər
በመተርጎም	bˈəmətərɨɡom
በመውሰድ	bˈəməwɨsəd
በመጀመርያው	bˈəməd͡ʒəmərɨjaw
በሚገኝ	bˈəmiɡəɲ
በማስተማር	bˈəmasɨtəmar
በምትባል	bˈəmɨtɨβal
በምን	bˈəmɨn
በሮማ	bˈəroma
በሴት	bˈəset
በስራ	bˈəsɨra
በሸንጎ	bˈəʃənɨɡo
በቀድሞው	bˈək`ədɨmow
በብሔራዊ	bˈəβɨherawi
በተለመደው	bˈətələmədəw
በተከታታይ	bˈətəkətataj
በተወለደ	bˈətəwələdə
በተያያዘ	bˈətəjajazə
በታሪካዊ	bˈətarikawi
በኃላ	bˈəhala
በነበሩት	bˈənəβərut
በነጻ	bˈənətsa
በአማራ	bˈəʔamara
በአባቱ	bˈəʔaβatu
በአጼ	bˈəʔatse
በኢየሩሳሌም	bˈəʔijərusalem
በኣንድና	bˈəʔanɨdɨna
በእነዚህ	bˈəʔɨnəziç
በእንግሊዝኛው	bˈəʔɨnɨɡɨlizɨɲaw
በእንግሊዞች	bˈəʔɨnɨɡɨlizot͡ʃ
በእጁ	bˈəʔɨd͡ʒu
በእግር	bˈəʔɨɡɨr
በከንቱ	bˈəkənɨtu
በካፋ	bˈəkafa
በክብ	bˈəkɨb
በዘመናቸው	bˈəzəmənat͡ʃəw
በይበልጥ	bˈəjɨβəlɨt`
በጋዜጠኝነት	bˈəɡazet`əɲɨnət
በግዞት	bˈəɡɨzot
በጠቅላላው	bˈət`ək`ɨlalaw
በጽሑፍ	bˈətsɨhuf
ቢትወደድ	bˈitɨwədəd
ባለስልጣናት	bˈaləsɨlɨt`anat
ባሪያ	bˈarija
ባስሊዮስ	bˈasɨlijos
ባዮች	bˈajot͡ʃ
ቤቴ	bˈete
ብለህ	bˈɨləx
ብላታ	bˈɨlata
ብርቱ	bˈɨrɨtu
ተመራማሪወች	tˈəməramariwət͡ʃ
ተመርቆ	tˈəmərɨk`o
ተመዝግቦ	tˈəməzɨɡɨβo
ተሳታፊ	tˈəsatafi
ተቀብሎ	tˈək`əβɨlo
ተከተለው	tˈəkətələw
ታይ	tˈaj
ታይፕራይተር	tˈajɨpɨrajɨtər
ትራምፕ	tˈɨramɨp
ትንታኔ	tˈɨnɨtane
ነዳጅ	nˈədad͡ʒ
ነገርን	nˈəɡərɨn
ነግሦ	nˈəɡɨso
ኑር	nˈur
ንፋስ	nˈɨfas
አህጉር	ʔˈahɨɡur
አልፈው	ʔˈalɨfəw
አምባገነን	ʔˈamɨβaɡənən
አራተኛው	ʔˈaratəɲaw
አርማ	ʔˈarɨma
አርዕስት	ʔˈarɨʔɨsɨt
አስተዋፅኦ	ʔˈasɨtəwatsɨʔo
አቅድ	ʔˈak`ɨd
አቡ	ʔˈaβu
አባትና	ʔˈaβatɨna
አንስታይን	ʔˈanɨsɨtajɨn
አውሮጳውያን	ʔˈawɨrop`awɨjan
አውሮፓ	ʔˈawɨropa
አዕምሮ	ʔˈaʔɨmɨro
አይሁዶች	ʔˈajɨhudot͡ʃ
አይሆንም	ʔˈajɨhonɨm
አይርላንድን	ʔˈajɨrɨlanɨdɨn
ኢየሱስን	ʔˈijəsusɨn
ኣሥር	ʔˈasɨr
ኣስፈላጊ	ʔˈasɨfəlaɡi
ኤላማውያን	ʔˈelamawɨjan
ኤፍ	ʔˈef
እሳቸውም	ʔˈɨsat͡ʃəwɨm
እስጢፋኖስ	ʔˈɨsɨt`ifanos
እንቁላል	ʔˈɨnɨk`ulal
እንቅልፍ	ʔˈɨnɨk`ɨlɨf
እንዚራን	ʔˈɨnɨziran
እንደሚሆን	ʔˈɨnɨdəmihon
እንደነበረ	ʔˈɨnɨdənəβərə
እንደዚያ	ʔˈɨnɨdəzija
እዚያም	ʔˈɨzijam
እያንዳንዱን	ʔˈɨjanɨdanɨdun
እድሜያቸው	ʔˈɨdɨmejat͡ʃəw
እገዛ	ʔˈɨɡəza
እግሩ	ʔˈɨɡɨru
ኦሮሞ	ʔˈoromo
ከሚባል	kˈəmiβal
ከሞተ	kˈəmotə
ከሰኔ	kˈəsəne
ከስድስት	kˈəsɨdɨsɨt
ከባህር	kˈəβahɨr
ከተማን	kˈətəman
ከተገኙት	kˈətəɡəɲut
ከነበሩ	kˈənəβəru
ከነብዩ	kˈənəβɨju
ከነገሠ	kˈənəɡəsə
ከንጉሥ	kˈənɨɡus
ከአምስት	kˈəʔamɨsɨt
ከአንዳንድ	kˈəʔanɨdanɨd
ከእንግዲህ	kˈəʔɨnɨɡɨdiç
ከእንጨት	kˈəʔɨnɨt͡ʃ`ət
ከግሪክ	kˈəɡɨrik
ካህናቱ	kˈahɨnatu
ካቴድራል	kˈatedɨral
ክህነት	kˈɨhɨnət
ክበብ	kˈɨβəb
ክፍለመደብ	kˈɨfɨləmədəb
ኹኔታ	hˈuneta
ወንበር	wˈənɨβər
ወንድማቸው	wˈənɨdɨmat͡ʃəw
ወገብ	wˈəɡəb
ውሀ	wˈɨha
ውድቅ	wˈɨdɨk`
ውድድሩን	wˈɨdɨdɨrun
ውድድሮች	wˈɨdɨdɨrot͡ʃ
ዕጅግ	ʔˈɨd͡ʒɨɡ
ዙርያ	zˈurɨja
ዜማዎች	zˈemawot͡ʃ
የሀገሩ	jˈəhaɡəru
የሁሉ	jˈəhulu
የሃይል	jˈəhajɨl
የሆኑትን	jˈəhonutɨn
የለሽ	jˈələʃ
የለውጥ	jˈələwɨt`
የላፕላስ	jˈəlapɨlas
የልጆች	jˈəlɨd͡ʒot͡ʃ
የሕንድ	jˈəhɨnɨd
የመላው	jˈəməlaw
የመካከለኛው	jˈəməkakələɲaw
የሚሆኑት	jˈəmihonut
የሚሰራው	jˈəmisəraw
የሚችለው	jˈəmit͡ʃɨləw
የሚጠቀሙ	jˈəmit`ək`əmu
የምትባል	jˈəmɨtɨβal
የሞት	jˈəmot
የሰራው	jˈəsəraw
የሰብዓዊ	jˈəsəβɨʔawi
የብርሃንን	jˈəβɨrɨhanɨn
የተሳሳቱ	jˈətəsasatu
የተስፋፋ	jˈətəsɨfafa
የተወሰኑ	jˈətəwəsənu
የታወቁ	jˈətawək`u
የኖሩ	jˈənoru
የአረመኔ	jˈəʔarəməne
የአባቱን	jˈəʔaβatun
የአገሬው	jˈəʔaɡərew
የኣለው	jˈəʔaləw
የእምነት	jˈəʔɨmɨnət
የእንጨት	jˈəʔɨnɨt͡ʃ`ət
የክርስቶስ	jˈəkɨrɨsɨtos
የወሎ	jˈəwəlo
የወንድ	jˈəwənɨd
የወጣው	jˈəwət`aw
የዘፈን	jˈəzəfən
የዝሆን	jˈəzɨhon
የዶክተሩን	jˈədokɨtərun
የግስበት	jˈəɡɨsɨβət
የጎንደር	jˈəɡonɨdər
የጥበብ	jˈət`ɨβəb
ዩናይትድ	jˈunajɨtɨd
ያካተተ	jˈakatətə
ያደረጉ	jˈadərəɡu
ይሁዳ	jˈɨhuda
ይገኛሉ	jˈɨɡəɲalu
ደካማ	dˈəkama
ደግሞም	dˈəɡɨmom
ዳምጠው	dˈamɨt`əw
ዳይሬክተር	dˈajɨrekɨtər
ድርብ	dˈɨrɨb
ዶክቶር	dˈokɨtor
ገብ	ɡˈəb
ገደብ	ɡˈədəb
ገዳይ	ɡˈədaj
ጉድጓድ	ɡˈudɨɡwad
ጉግል	ɡˈuɡɨl
ጋዜጠኝነት	ɡˈazet`əɲɨnət
ጌታቸው	ɡˈetat͡ʃəw
ግርማ	ɡˈɨrɨma
ግስበት	ɡˈɨsɨβət
ግንድ	ɡˈɨnɨd
ግፍ	ɡˈɨf
ጎበዝ	ɡˈoβəz
ጠቀሜታ	t`ˈək`əmeta
ጠብቆ	t`ˈəβɨk`o
ጣልያንን	t`ˈalɨjanɨn
ጤንነት	t`ˈenɨnət
ጥላቻ	t`ˈɨlat͡ʃa
ጸሐፊው	tsˈəhafiw
ጸጥታ	tsˈət`ɨta
ጾታ	tsˈota
ፈለክ	fˈələk
ፌዴሬሽኑ	fˈedereʃɨnu
ፌዴሬሽን	fˈedereʃɨn
ፍፁም	fˈɨtsum
ፎቶ	fˈoto
ፓተንት	pˈatənɨt
ፓፓ	pˈapa
ሀይሉ	hˈajɨlu
ሀይሮግሊፍ	hˈajɨroɡɨlif
ሁለቱንም	hˈulətunɨm
ሁኔታው	hˈunetaw
ሄክታር	hˈekɨtar
ህዳር	hˈɨdar
ህጻን	hˈɨtsan
ሆቴል	hˈotel
ለመሄድ	lˈəməhed
ለመመሥረት	lˈəməməsɨrət
ለመቀየር	lˈəmək`əjər
ለመናገር	lˈəmənaɡər
ለመክፈል	lˈəməkɨfəl
ለመወሰን	lˈəməwəsən
ለመጥቀስ	lˈəmət`ɨk`əs
ለመፍታት	lˈəməfɨtat
ለማስቀመጥ	lˈəmasɨk`əmət`
ለማስታወስ	lˈəmasɨtawəs
ለማስገባት	lˈəmasɨɡəβat
ለማንበብ	lˈəmanɨβəb
ለርሱ	lˈərɨsu
ለሰዎች	lˈəsəwot͡ʃ
ለብቻው	lˈəβɨt͡ʃaw
ለንጉሱ	lˈənɨɡusu
ለኛ	lˈəɲa
ለእግዚአብሔር	lˈəʔɨɡɨziʔaβɨher
ለውጥን	lˈəwɨt`ɨn
ለይቶ	lˈəjɨto
ለፍርድ	lˈəfɨrɨd
ሊያስከትል	lˈijasɨkətɨl
ላሳናት	lˈasanat
ላባርና	lˈaβarɨna
ሌዊ	lˈewi
ልማዳዊ	lˈɨmadawi
ልዑካን	lˈɨʔukan
ሎሬንዞ	lˈorenɨzo
ሐሙስ	hˈamus
ሐብለ	hˈaβɨlə
ሕመም	hˈɨməm
ሕብረት	hˈɨβɨrət
ሕያው	hˈɨjaw
መላምት	mˈəlamɨt
መመገብ	mˈəməɡəb
መረብ	mˈərəb
መርዛም	mˈərɨzam
መርዝ	mˈərɨz
መሳሪያዎች	mˈəsarijawot͡ʃ
መስኮት	mˈəsɨkot
መቀመጥ	mˈək`əmət`
መተላለፊያ	mˈətəlaləfija
መተካት	mˈətəkat
መንግስቱን	mˈənɨɡɨsɨtun
መኮንኖች	mˈəkonɨnot͡ʃ
መውሰድ	mˈəwɨsəd
መድረስ	mˈədɨrəs
መድፍ	mˈədɨf
መጓዝ	mˈəɡwaz
መጨመር	mˈət͡ʃ`əmər
መጫወት	mˈət͡ʃ`awət
መጽሐፍትን	mˈətsɨhafɨtɨn
ሚናስ	mˈinas
ማህበረሰቦች	mˈahɨβərəsəβot͡ʃ
ማለፍ	mˈaləf
ማረጋገጫ	mˈarəɡaɡət͡ʃ`a
ማርሻል	mˈarɨʃal
ማዕከሉ	mˈaʔɨkəlu
ሜዳሊያ	mˈedalija
ምቹ	mˈɨt͡ʃu
ሠርተው	sˈərɨtəw
ሠንጠረዥ	sˈənɨt`ərəʒ
ሥራቸው	sˈɨrat͡ʃəw
ሥራዎችን	sˈɨrawot͡ʃɨn
ረጃጅም	rˈəd͡ʒad͡ʒɨm
ራሷን	rˈaswan
ርዝመቱ	rˈɨzɨmətu
ሰሌዳ	sˈəleda
ሰሜናዊ	sˈəmenawi
ሰራተኞች	sˈəratəɲot͡ʃ
ሰባቱ	sˈəβatu
ሰንበት	sˈənɨβət
ሰዐወ	sˈəʔawə
ሰፈር	sˈəfər
ሱልጣኔት	sˈulɨt`anet
ሱልጣን	sˈulɨt`an
ሲ	sˈi
ሲሰጥ	sˈisət`
ሲወጡ	sˈiwət`u
ሲጽፉ	sˈitsɨfu
ሲጽፍ	sˈitsɨf
ሳንጃክ	sˈanɨd͡ʒak
ስላለ	sˈɨlalə
ስቴት	sˈɨtet
ስእል	sˈɨʔɨl
ስኬታማ	sˈɨketama
ስኳር	sˈɨkwar
ስያሜው	sˈɨjamew
ስፖርት	sˈɨporɨt
ሸክላ	ʃˈəkɨla
ቀበሌዎች	k`ˈəβəlewot͡ʃ
ቁስል	k`ˈusɨl
ቅሉ	k`ˈɨlu
ቅራኔ	k`ˈɨrane
ቅዳሜ	k`ˈɨdame
ቅጠሉ	k`ˈɨt`əlu
ቅጥር	k`ˈɨt`ɨr
ቆሞ	k`ˈomo
ቆፋሪዎች	k`ˈofariwot͡ʃ
ቋንቋቸው	k`wˈanɨk`wat͡ʃəw
በሁለቱም	bˈəhulətum
በሐዲስ	bˈəhadis
በመሥራት	bˈəməsɨrat
በመተባበር	bˈəmətəβaβər
በመድረክ	bˈəmədɨrək
በሙቀት	bˈəmuk`ət
በማህበራዊ	bˈəmahɨβərawi
በማመን	bˈəmamən
በማቋቋም	bˈəmak`wak`wam
በማተሚያ	bˈəmatəmija
በማየት	bˈəmajət
በማገልገል	bˈəmaɡəlɨɡəl
በማግኘቱ	bˈəmaɡɨɲətu
በማግኘት	bˈəmaɡɨɲət
በረሃ	bˈərəha
በረካ	bˈərəka
በሮማይስጥ	bˈəromajɨsɨt`
በሰብአዊ	bˈəsəβɨʔawi
በሱመር	bˈəsumər
በስሕተት	bˈəsɨhɨtət
በስሙ	bˈəsɨmu
በስማቸው	bˈəsɨmat͡ʃəw
በስም	bˈəsɨm
በሸዋ	bˈəʃəwa
በቅድስት	bˈək`ɨdɨsɨt
በበርካታ	bˈəβərɨkata
በብሉይ	bˈəβɨluj
በተቃራኒ	bˈətək`arani
በተባለች	bˈətəβalət͡ʃ
በተገኘው	bˈətəɡəɲəw
በትጋት	bˈətɨɡat
በእውነት	bˈəʔɨwɨnət
በኦሮምኛ	bˈəʔoromɨɲa
በወረዳው	bˈəwərədaw
በዓመት	bˈəʔamət
በዚያች	bˈəzijat͡ʃ
በዝርዝሩ	bˈəzɨrɨzɨru
በየቦታው	bˈəjəβotaw
በየወሩ	bˈəjəwəru
በዳግማዊ	bˈədaɡɨmawi
በገጠር	bˈəɡət`ər
በጎንደር	bˈəɡonɨdər
በጥንቃቄ	bˈət`ɨnɨk`ak`e
በፖሊስ	bˈəpolis
ቡድንንና	bˈudɨnɨnɨna
ቢላል	bˈilal
ባሉበት	bˈaluβət
ባልታወቀ	bˈalɨtawək`ə
ባሩድ	bˈarud
ባሳተመው	bˈasatəməw
ባቢሎንን	bˈaβilonɨn
ባደረጉት	bˈadərəɡut
ባጭሩ	bˈat͡ʃ`ɨru
ቤከር	bˈekər
ብርሃንና	bˈɨrɨhanɨna
ብርሃንን	bˈɨrɨhanɨn
ብርቱካን	bˈɨrɨtukan
ቦታውን	bˈotawɨn
ቫይረሱ	vˈajɨrəsu
ተልእኮ	tˈəlɨʔɨko
ተማሪወች	tˈəmariwət͡ʃ
ተማሪዎችን	tˈəmariwot͡ʃɨn
ተሸላሚ	tˈəʃəlami
ተሸካሚ	tˈəʃəkami
ተከታዮቹ	tˈəkətajot͡ʃu
ተኩል	tˈəkul
ተክሌ	tˈəkɨle
ተዋህዶ	tˈəwahɨdo
ተይዘው	tˈəjɨzəw
ተይዞ	tˈəjɨzo
ተደጋጋሚ	tˈədəɡaɡami
ተገኙ	tˈəɡəɲu
ተጋድሎ	tˈəɡadɨlo
ተጓዦች	tˈəɡwaʒot͡ʃ
ተፅዕኖ	tˈətsɨʔɨno
ቱቦ	tˈuβo
ታማኝነት	tˈamaɲɨnət
ትርጓሜውም	tˈɨrɨɡwamewɨm
ትክክለኛውን	tˈɨkɨkɨləɲawɨn
ትግርኛ	tˈɨɡɨrɨɲa
ቻርልስ	t͡ʃˈarɨlɨs
ችላ	t͡ʃˈɨla
ኃያል	hˈajal
ኃይሌ	hˈajɨle
ኅልው	hˈɨlɨw
ኋንግ	hwˈanɨɡ
ነበረበት	nˈəβərəβət
ነብይ	nˈəβɨj
ነገሩን	nˈəɡərun
ነጋዴ	nˈəɡade
ነፍሰ	nˈəfɨsə
ኒው	nˈiw
አለባበስ	ʔˈaləβaβəs
አለኝ	ʔˈaləɲ
አመጣጥ	ʔˈamət`at`
አሚና	ʔˈamina
አማራ	ʔˈamara
አሜሪካዊ	ʔˈamerikawi
አምልኮት	ʔˈamɨlɨkot
አምስተኛ	ʔˈamɨsɨtəɲa
አምስተኛው	ʔˈamɨsɨtəɲaw
አሪስጣጣሊስ	ʔˈarisɨt`at`alis
አርበኛ	ʔˈarɨβəɲa
አስተማማኝ	ʔˈasɨtəmamaɲ
አና	ʔˈana
አንተም	ʔˈanɨtəm
አንድያ	ʔˈanɨdɨja
አካውንት	ʔˈakawɨnɨt
አኳያ	ʔˈakwaja
አይተው	ʔˈajɨtəw
አይደል	ʔˈajɨdəl
አደን	ʔˈadən
አዳኝ	ʔˈadaɲ
አድራጎት	ʔˈadɨraɡot
አድርገን	ʔˈadɨrɨɡən
አፈወርቅ	ʔˈafəwərɨk`
ኢናና	ʔˈinana
ኤንድ	ʔˈenɨd
እረኛ	ʔˈɨrəɲa
እረፍት	ʔˈɨrəfɨt
እራሳቸው	ʔˈɨrasat͡ʃəw
እራስን	ʔˈɨrasɨn
እስላም	ʔˈɨsɨlam
እስረኛ	ʔˈɨsɨrəɲa
እስክንድር	ʔˈɨsɨkɨnɨdɨr
እኑስ	ʔˈɨnus
እናታችን	ʔˈɨnatat͡ʃɨn
እንደሚችሉ	ʔˈɨnɨdəmit͡ʃɨlu
እንዲመለስ	ʔˈɨnɨdimələs
እንዲችል	ʔˈɨnɨdit͡ʃɨl
እንዲኖረው	ʔˈɨnɨdinorəw
እንዲያገኙ	ʔˈɨnɨdijaɡəɲu
እንዲገባ	ʔˈɨnɨdiɡəβa
እንዳገኘ	ʔˈɨnɨdaɡəɲə
እኛን	ʔˈɨɲan
ከልጅነቱ	kˈəlɨd͡ʒɨnətu
ከመጽሐፍ	kˈəmətsɨhaf
ከሚባለው	kˈəmiβaləw
ከሩቅ	kˈəruk`
ከራስ	kˈəras
ከቅርብ	kˈək`ɨrɨb
ከባቢ	kˈəβaβi
ከቦታ	kˈəβota
ከተማና	kˈətəmana
ከተባለው	kˈətəβaləw
ከነርሱ	kˈənərɨsu
ከኛ	kˈəɲa
ከአቶ	kˈəʔato
ከኣንድ	kˈəʔanɨd
ከእነዚህም	kˈəʔɨnəzihɨm
ከእዚህ	kˈəʔɨziç
ከገባ	kˈəɡəβa
ከጣልያን	kˈət`alɨjan
ከፈጣሪ	kˈəfət`ari
ኪዳነ	kˈidanə
ካህን	kˈahɨn
ካሣ	kˈasa
ካርል	kˈarɨl
ኬጥያውያን	kˈet`ɨjawɨjan
ክልሉ	kˈɨlɨlu
ክሬዲት	kˈɨredit
ክሮኖስ	kˈɨronos
ክንድ	kˈɨnɨd
ክፉኛ	kˈɨfuɲa
ወላጅ	wˈəlad͡ʒ
ወራሪ	wˈərari
ወርሮ	wˈərɨro
ወንዶቹ	wˈənɨdot͡ʃu
ወዲያ	wˈədija
ወጡ	wˈət`u
ወጣቱ	wˈət`atu
ወፍጮ	wˈəfɨt͡ʃ`o
ዉ	wˈu
ውህድ	wˈɨhɨd
ውስጡ	wˈɨsɨt`u
ውቅያኖስ	wˈɨk`ɨjanos
ዐፄ	ʔˈatse
ዓለቃ	ʔˈalək`a
ዘላቂ	zˈəlak`i
ዘመናቸው	zˈəmənat͡ʃəw
ዘኢትዮጵያ	zˈəʔitɨjop`ɨja
ዘወትር	zˈəwətɨr
ዘፈኖችን	zˈəfənot͡ʃɨn
ዙፋኑ	zˈufanu
ዜማዎችን	zˈemawot͡ʃɨn
ዜግነት	zˈeɡɨnət
ዝርዝሩ	zˈɨrɨzɨru
ዝንባሌ	zˈɨnɨβale
ዞር	zˈor
የሀበሻ	jˈəhaβəʃa
የመሆን	jˈəməhon
የመኪና	jˈəməkina
የሚሆነውን	jˈəmihonəwɨn
የሚለየው	jˈəmiləjəw
የሚቀርብ	jˈəmik`ərɨb
የሚናገረው	jˈəminaɡərəw
የሚውል	jˈəmiwɨl
የሚያመለክት	jˈəmijamələkɨt
የሚያሳየው	jˈəmijasajəw
የሚያሳዩ	jˈəmijasaju
የሚያስተምር	jˈəmijasɨtəmɨr
የሚያደርገው	jˈəmijadərɨɡəw
የሚጠራው	jˈəmit`əraw
የሚጠጋ	jˈəmit`əɡa
የሚጫወቱት	jˈəmit͡ʃ`awətut
የምሥራቅ	jˈəmɨsɨrak`
የሥልጣን	jˈəsɨlɨt`an
የሩሲያ	jˈərusija
የሮማውያን	jˈəromawɨjan
የስልጣን	jˈəsɨlɨt`an
የስሜን	jˈəsɨmen
የስፖርት	jˈəsɨporɨt
የሽግግር	jˈəʃɨɡɨɡɨr
የቀሩት	jˈək`ərut
የቀዳማዊ	jˈək`ədamawi
የቅኝ	jˈək`ɨɲ
የበረራ	jˈəβərəra
የባቡር	jˈəβaβur
የተላከ	jˈətəlakə
የተሞላ	jˈətəmola
የተሰጠ	jˈətəsət`ə
የተሳሳተ	jˈətəsasatə
የተሸፈነ	jˈətəʃəfənə
የተዘጋጀው	jˈətəzəɡad͡ʒəw
የተዘጋጁ	jˈətəzəɡad͡ʒu
የቴአትር	jˈəteʔatɨr
የነገሠው	jˈənəɡəsəw
የአሜሪካን	jˈəʔamerikan
የአንደኛ	jˈəʔanɨdəɲa
የአንድነት	jˈəʔanɨdɨnət
የኤድስ	jˈəʔedɨs
የኮሶ	jˈəkoso
የዝናብ	jˈəzɨnab
የዩናይትድ	jˈəjunajɨtɨd
የድምጽ	jˈədɨmɨts
የገዛው	jˈəɡəzaw
የጌታችን	jˈəɡetat͡ʃɨn
የግጥም	jˈəɡɨt`ɨm
የፈረስ	jˈəfərəs
የፈጠረው	jˈəfət`ərəw
ያለባቸው	jˈaləβat͡ʃəw
ያለውና	jˈaləwɨna
ያሳያል	jˈasajal
ያተኮረ	jˈatəkorə
ይሄንን	jˈɨhenɨn
ይመልከቱ	jˈɨməlɨkətu
ይመስል	jˈɨməsɨl
ይሠራ	jˈɨsəra
ይኖራል	jˈɨnoral
ይዘቱ	jˈɨzətu
ይጠቀሙበት	jˈɨt`ək`əmuβət
ደህንነት	dˈəhɨnɨnət
ደረቅ	dˈərək`
ደረጃውን	dˈərəd͡ʒawɨn
ደራሲው	dˈərasiw
ደብረታቦር	dˈəβɨrətaβor
ዲግሪውን	dˈiɡɨriwɨn
ዳ	dˈa
ዳሪዮስ	dˈarijos
ጀምረው	d͡ʒˈəmɨrəw
ጀኔራል	d͡ʒˈəneral
ጃፓን	d͡ʒˈapan
ጄነራል	d͡ʒˈenəral
ገጸ	ɡˈətsə
ገጹ	ɡˈətsu
ገፅ	ɡˈəts
ጋ	ɡˈa
ግመት	ɡˈɨmət
ግርጌ	ɡˈɨrɨɡe
ግብፅ	ɡˈɨβɨts
ግንቡ	ɡˈɨnɨβu
ጎሣዎች	ɡˈosawot͡ʃ
ጠብ	t`ˈəb
ጠንቅ	t`ˈənɨk`
ጠጣር	t`ˈət`ar
ጣዖት	t`ˈaʔot
ጥልቀት	t`ˈɨlɨk`ət
ጥርጣሬ	t`ˈɨrɨt`are
ጥቅሙ	t`ˈɨk`ɨmu
ጨው	t͡ʃ`ˈəw
ጫካ	t͡ʃ`ˈaka
ፈር	fˈər
ፊልሙ	fˈilɨmu
ፋንታ	fˈanɨta
ፍትሕ	fˈɨtɨx
ፓትርያርክ	pˈatɨrɨjarɨk
ፕላቶ	pˈɨlato
ፖርቱጋል	pˈorɨtuɡal
