a	ɑː
abad	ɑːbɑːd
abecede	ɑːbeːkeːdeː
abelgan	ɑːbelɡɑn
abeodan	ɑːbe͜oːdɑn
aberan	ɑːberɑn
aberendlic	ɑːberendliːt͡ʃ
abidan	ɑːbiːdɑn
abraham	ɑbrɑxɑm
abrastlian	ɑːbrɑstliɑn
abrecan	ɑːbrekɑn
abredwian	ɑːbredwiɑn
abreoþan	ɑːbre͜oːθɑn
abroþen	ɑːbroθen
abroþennes	ɑːbroθennes
abroþennys	ɑːbroθennys
abufan	ɑbuːfɑn
abugan	ɑːbuːɡɑn
ac	ɑk
ac	ɑːk
acan	ɑkɑn
accent	ɑkkent
acennan	ɑːkennɑn
acennedlic	ɑːkennedliːt͡ʃ
acierran	ɑːt͡ʃi͜yrrɑn
acnyssan	ɑːknyssɑn
acol	ɑːkol
acsian	ɑːksiɑn
acsung	ɑːksunɡ
acumendlic	ɑːkumendliːt͡ʃ
acwelan	ɑːkwelɑn
acwelaþ	ɑːkwelɑθ
acwele	ɑːkwele
acwelen	ɑːkwelen
acweorna	ɑːkwe͜ornɑ
acweorran	ɑːkwe͜orrɑn
acweþan	ɑːkweθɑn
acwician	ɑːkwikiɑn
acwilþ	ɑːkwilθ
acwinan	ɑːkwiːnɑn
acwincan	ɑːkwinkɑn
acwolen	ɑːkwolen
acwæl	ɑːkwæl
acwæle	ɑːkwæːle
acwælon	ɑːkwæːlon
acyrran	ɑːt͡ʃyrrɑn
acyrrednes	ɑːt͡ʃyrrednes
ad	ɑːd
adeadian	ɑːdæ͜ɑːdiɑn
adeliht	ɑdelixt
ademan	ɑːdeːmɑn
adesa	ɑdesɑ
adihtan	ɑːdixtɑn
adilegian	ɑːdileɡiɑn
adilgian	ɑːdilɡiɑn
adl	ɑːdl
adlian	ɑːdliɑn
adlieg	ɑːdli͜yːj
adlig	ɑːdlij
adrencan	ɑːdrent͡ʃɑn
adreogan	ɑːdre͜oːɡɑn
adrincan	ɑːdrinkɑn
adustrian	ɑduːstriɑn
adælan	ɑːdæːlɑn
afaran	ɑːfɑrɑn
affrica	ɑffrikɑ
afigen	ɑːfijen
afol	ɑfol
afon	ɑːfoːn
afor	ɑːfor
afremdan	ɑːfremdɑn
afremdung	ɑːfremdunɡ
afulic	ɑfuliːt͡ʃ
afyllan	ɑːfyllɑn
agalan	ɑːɡɑlɑn
agan	ɑːɡɑn
agan	ɑːɡɑːn
agangan	ɑːɡɑnɡɑn
agen	ɑjeːn
agen	ɑːɡen
agend	ɑːɡend
agendfrea	ɑːɡendfræ͜ɑː
agengecyrran	ɑjeːnjet͡ʃyrrɑn
agengehweorfan	ɑjeːnjexwe͜orfɑn
agenslaga	ɑːɡenslɑɡɑ
agenspræc	ɑːɡenspræːt͡ʃ
agenung	ɑːɡenunɡ
agiefan	ɑːji͜yfɑn
agiemeleasian	ɑːji͜yːmelæ͜ɑːsiɑn
agifan	ɑːjifɑn
aglæca	ɑːɡlæːt͡ʃɑ
agnettan	ɑːɡnettɑn
agnian	ɑːɡniɑn
agrapian	ɑːɡrɑːpiɑn
agrisan	ɑːɡriːsɑn
agymeleasian	ɑːjyːmelæ͜ɑːsiɑn
ah	ɑx
ahabban	ɑːxɑbbɑn
ahatan	ɑːxɑːtɑn
aheardian	ɑːxæ͜ɑrdiɑn
aheardung	ɑːxæ͜ɑrdunɡ
aheawan	ɑːxæ͜ɑːwɑn
ahebban	ɑːxebbɑn
ahierdan	ɑːxi͜yrdɑn
ahierding	ɑːxi͜yrdinɡ
ahlehhan	ɑːxlexxɑn
ahleoþrian	ɑːxle͜oːθriɑn
ahliehhan	ɑːxli͜yxxɑn
ahon	ɑːxoːn
ahreran	ɑːxreːrɑn
ahte	ɑːhte
ahweorfan	ɑːxwe͜orfɑn
ahycgan	ɑːxyjjɑn
ahyrdan	ɑːxyrdɑn
al	ɑːl
alan	ɑlɑn
ald	ɑld
alda	ɑldɑ
aldor	ɑldor
aldorleas	ɑldorlæ͜ɑːs
aldwine	ɑldwine
alecgan	ɑːlejjɑn
alegd	ɑːlejd
alfæt	ɑːlfæt
alh	ɑlx
alibban	ɑlibbɑn
alibbend	ɑlibbend
aliefan	ɑːli͜yːfɑn
aliesan	ɑːli͜yːsɑn
alimpan	ɑːlimpɑn
all	ɑll
alles	ɑlles
allic	ɑlliːt͡ʃ
alor	ɑlor
alyfan	ɑːlyːfɑn
alysan	ɑːlyːsɑn
alædan	ɑːlæːdɑn
amarian	ɑːmɑriɑn
amasian	ɑːmɑsiɑn
ambeaht	ɑmbæ͜ɑxt
ambeht	ɑmbext
ambehtan	ɑmbextɑn
amber	ɑmber
ambiht	ɑmbixt
amearcian	ɑːmæ͜ɑrkiɑn
ametan	ɑːmetɑn
ametendlic	ɑːmetendliːt͡ʃ
amierran	ɑːmi͜yrrɑn
amirran	ɑːmirrɑn
amore	ɑmore
ampella	ɑmpellɑ
an	ɑːn
anad	ɑːnɑd
anbugan	ɑnbuːɡɑn
anbyrdnes	ɑnbyrdnes
ancenned	ɑːnkenned
ancleo	ɑnkle͜oː
ancleow	ɑnkle͜oːw
ancor	ɑnkor
ancuman	ɑnkumɑn
and	ɑnd
anda	ɑndɑ
andcweþan	ɑndkweθɑn
andcwiss	ɑndkwiss
andefera	ɑndeferɑ
andefn	ɑndefn
andelbære	ɑndelbæːre
andettan	ɑndettɑn
andfang	ɑndfɑnɡ
andfenge	ɑndfenje
andgiet	ɑndji͜yt
andgiete	ɑndji͜yte
andgietol	ɑndji͜ytol
andgiettacen	ɑndji͜yttɑːken
andgit	ɑndjit
andgitfullice	ɑndjitfulliːt͡ʃe
andhweorfan	ɑndxwe͜orfɑn
andian	ɑndiɑn
andig	ɑndij
andlang	ɑndlɑnɡ
andsaca	ɑndsɑkɑ
andsware	ɑndswɑre
andswarian	ɑndswɑriɑn
andswaru	ɑndswɑru
andswerian	ɑndswerjɑn
andtimber	ɑndtimber
andustrian	ɑnduːstriɑn
andustrigan	ɑnduːstrijɑn
andweard	ɑndwæ͜ɑrd
andweardian	ɑndwæ͜ɑrdiɑn
andweardnes	ɑndwæ͜ɑrdnes
andweorc	ɑndwe͜ork
andwig	ɑndwiːɡ
andwirdan	ɑndwirdɑn
andwis	ɑndwiːs
andwist	ɑndwist
andwlita	ɑndwlitɑ
andwlitan	ɑndwliːtɑn
andwyrdan	ɑndwyrdɑn
andwyrde	ɑndwyrde
aneged	ɑːneːjed
anemnan	ɑːnemnɑn
anes	ɑːnes
anfeald	ɑːnfæ͜ɑld
anfealdlice	ɑːnfæ͜ɑldliːt͡ʃe
anfealdnes	ɑːnfæ͜ɑldnes
anfealdnys	ɑːnfæ͜ɑldnys
anfloga	ɑːnfloɡɑ
anforlætan	ɑːnforlæːtɑn
angbreost	ɑnɡbre͜oːst
ange	ɑnɡe
angelcirice	ɑnɡelt͡ʃirit͡ʃe
angelcynn	ɑnɡelkynn
angenga	ɑːnɡenjɑ
anginn	ɑnjinn
angsum	ɑnɡsum
angsumnes	ɑnɡsumnes
anhaga	ɑːnxɑɡɑ
anhealdan	ɑnxæ͜ɑldɑn
anhende	ɑːnxende
anhorn	ɑːnxorn
aniege	ɑːni͜yːje
anige	ɑːniːje
animan	ɑːnimɑn
anlaf	ɑnlɑf
anlec	ɑnleːt͡ʃ
anlicnes	ɑnliːknes
anliepig	ɑːnli͜yːpij
anlipig	ɑːnliːpij
anlæcan	ɑːnlæːt͡ʃɑn
anlætan	ɑːnlæːtɑn
anmedla	ɑnmedlɑ
annes	ɑːnnes
ansien	ɑnsi͜yːn
ansund	ɑnsund
ansyn	ɑnsyːn
antid	ɑːntiːd
antimber	ɑntimber
anwadan	ɑnwɑdɑn
anweald	ɑnwæ͜ɑld
anwig	ɑːnwiːj
anælan	ɑnæːlɑn
apa	ɑpɑ
apostata	ɑpostɑtɑ
apuldor	ɑpuldor
ar	ɑːr
ara	ɑːrɑ
arabia	ɑrɑbiɑ
arabisc	ɑrɑbiʃ
arcebiscop	ɑrt͡ʃebiʃʃop
arcebiscoprice	ɑrt͡ʃebiʃʃopriːt͡ʃe
ardæde	ɑːrdæːde
are	ɑːre
arfæst	ɑːrfæst
arian	ɑːriɑn
arisan	ɑːriːsɑn
arisaþ	ɑːriːsɑθ
arleas	ɑːrlæ͜ɑːs
arm	ɑrm
arstafas	ɑːrstɑfɑs
arwald	ɑrwɑld
arwe	ɑːrwe
aryþ	ɑːryːθ
arædan	ɑːræːdɑn
aræran	ɑːræːrɑn
asawan	ɑːsɑːwɑn
ascacan	ɑːʃɑkɑn
ascafan	ɑːʃɑfɑn
asceadan	ɑːʃæ͜ɑːdɑn
asceadan	ɑːʃɑːdɑn
asceotan	ɑːʃe͜oːtɑn
ascian	ɑːskiɑn
asciendlic	ɑːskiendliːt͡ʃ
ascieppan	ɑːʃi͜yppɑn
ascinan	ɑːʃiːnɑn
ascirian	ɑːʃirjɑn
ascirigendlic	ɑːʃirijendliːt͡ʃ
ascrencan	ɑːʃrent͡ʃɑn
ascufan	ɑːʃuːfɑn
ascung	ɑːskunɡ
ascunian	ɑːʃuːniɑn
ascuniendlic	ɑːʃuːni͜yndliːt͡ʃ
ascunung	ɑːʃuːnunɡ
asecan	ɑːseːt͡ʃɑn
asecgan	ɑːsejjɑn
asellan	ɑːsellɑn
aseon	ɑːse͜oːn
asettan	ɑːsettɑn
aseþan	ɑːseːθɑn
asittan	ɑːsittɑn
asmeagan	ɑːsmæ͜ɑːjɑn
asprungen	ɑːsprunɡen
asprungennes	ɑːsprunɡennes
astandan	ɑːstɑndɑn
astyrian	ɑːstyrjɑn
asundrian	ɑːsundriɑn
asundrodlic	ɑːsundrodliːt͡ʃ
asweartian	ɑːswæ͜ɑrtiɑn
aswebban	ɑːswebbɑn
asyndrian	ɑːsyndriɑn
asyndrung	ɑːsyndrunɡ
ateon	ɑːte͜oːn
atol	ɑtol
ator	ɑːtor
atorbære	ɑːtorbæːre
atorcoppe	ɑːtorkoppe
atorlic	ɑːtorliːt͡ʃ
atr	ɑːtr
augustus	ɑuɡustus
aulixes	ɑulikses
awacan	ɑːwɑkɑn
aweccan	ɑːwett͡ʃɑn
aweg	ɑːwej
awemman	ɑːwemmɑn
awendan	ɑːwendɑn
aweorpan	ɑːwe͜orpɑn
awiht	ɑːwixt
awlancian	ɑːwlɑnkiɑn
awlencan	ɑːwlent͡ʃɑn
awrecan	ɑːwrekɑn
awuldrian	ɑːwuldriɑn
awyrcan	ɑːwyrt͡ʃɑn
awyrgan	ɑːwyrjɑn
axian	ɑːksiɑn
axigendlic	ɑːksijendliːt͡ʃ
axung	ɑːksunɡ
að	ɑːθ
aþ	ɑːθ
aþecgan	ɑːθejjɑn
aþencan	ɑːθent͡ʃɑn
aþeodan	ɑːθe͜oːdɑn
aþeotan	ɑːθe͜oːtɑn
aþexe	ɑːθekse
aþiedan	ɑːθi͜yːdɑn
aþreotan	ɑːθre͜oːtɑn
aþum	ɑːθum
aþweran	ɑːθwerɑn
babilon	bɑbiloːn
babilonie	bɑbiloːnie
babilonige	bɑbiloːnije
baca	bɑkɑ
bacan	bɑkɑn
bacas	bɑkɑs
bacu	bɑku
bacum	bɑkum
bad	bɑːd
badian	bɑːdiɑn
balca	bɑlkɑ
bald	bɑld
ban	bɑːn
bana	bɑnɑ
banhus	bɑːnxuːs
banleas	bɑːnlæ͜ɑːs
bannan	bɑnnɑn
bar	bɑːr
barum	bɑrum
basnian	bɑːsniɑn
basnung	bɑːsnunɡ
basu	bɑsu
bat	bɑːt
batian	bɑtiɑn
batweard	bɑːtwæ͜ɑrd
baðanceaster	bɑθɑnt͡ʃæ͜ɑster
baðian	bɑθiɑn
baþian	bɑθiɑn
baþu	bɑθu
beacen	bæ͜ɑːken
beacenfyr	bæ͜ɑːkenfyːr
beacenstan	bæ͜ɑːkenstɑːn
beacn	bæ͜ɑːkn
beacnian	bæ͜ɑːkniɑn
beacniendlic	bæ͜ɑːkniendliːt͡ʃ
beacnung	bæ͜ɑːknunɡ
bead	bæːɑ̯d
beado	bæ͜ɑdo
beadu	bæ͜ɑdu
beag	bæ͜ɑːɡ
beagian	bæ͜ɑːɡiɑn
beah	bæ͜ɑːx
beald	bæ͜ɑld
bealdlice	bæ͜ɑldliːt͡ʃe
bealluc	bæ͜ɑlluk
beallucas	bæɑ̯llukɑs
bealo	bæ͜ɑlo
bealocwealm	bæ͜ɑlokwæ͜ɑlm
bealohydig	bæ͜ɑloxyːdij
bealu	bæ͜ɑlu
beam	bæ͜ɑːm
beamweg	bæ͜ɑːmwej
bean	bæ͜ɑːn
beard	bæ͜ɑrd
beardleas	bæ͜ɑrdlæ͜ɑːs
bearg	bæ͜ɑrɡ
bearm	bæ͜ɑrm
bearn	bæ͜ɑrn
bearneacen	bæ͜ɑrnæ͜ɑːken
bearneacnung	bæ͜ɑrnæ͜ɑːknunɡ
beatan	bæ͜ɑːtɑn
beatere	bæ͜ɑːtere
bebaðian	bebɑθiɑn
bebaþian	bebɑθiɑn
bebbe	bebbe
bebeodan	bebe͜oːdɑn
bebindan	bebindɑn
beblawan	beblɑːwɑn
bebod	bebod
bebodræden	bebodræːden
bebrecan	bebrekɑn
bebugan	bebuːɡɑn
bebycgan	bebyjjɑn
bec	beːt͡ʃ
bece	bet͡ʃe
bece	beːt͡ʃe
beceorfan	bet͡ʃe͜orfɑn
becierran	bet͡ʃi͜yrrɑn
beclipian	beklipiɑn
beclyppan	beklyppɑn
beclysan	beklyːsɑn
becnawan	beknɑːwɑn
becnyttan	beknyttɑn
becom	bekom
becrafian	bekrɑfiɑn
becreopan	bekre͜oːpɑn
becuman	bekumɑn
becwelan	bekwelɑn
becweþan	bekweθɑn
becwæl	bekwæl
becyrran	bet͡ʃyrrɑn
bed	bed
bedcleofa	bedkle͜ofɑ
bedclyfa	bedklyfɑ
bedd	bedd
beddrida	beddridɑ
bedecian	bedekiɑn
bedelfan	bedelfɑn
bediernan	bedi͜yrnɑn
bedofen	bedofen
bedon	bedoːn
bedragan	bedrɑɡɑn
bedreda	bedredɑ
bedrifan	bedriːfɑn
bedrincan	bedrinkɑn
bedtid	bedtiːd
bedu	bedu
bedufan	beduːfɑn
bedul	bedul
bedyppan	bedyppɑn
bedælan	bedæːlɑn
befealdan	befæ͜ɑldɑn
befeallan	befæ͜ɑllɑn
befeohtan	befe͜oxtɑn
befeolan	befe͜oːlɑn
befindan	befindɑn
beflean	beflæ͜ɑːn
befleogan	befle͜oːɡɑn
befleon	befle͜oːn
beflowan	befloːwɑn
befon	befoːn
beforan	beforɑn
beforancweþan	beforɑnkweθɑn
befreogan	befre͜oːjɑn
befrignan	befrijnɑn
befylan	befyːlɑn
befæstan	befæstɑn
befæstnian	befæstniɑn
began	beɡɑːn
begang	beɡɑnɡ
begangan	beɡɑnɡɑn
begbeam	bejbæ͜ɑːm
begen	beːjen
begeondan	bejondɑn
begeotan	beje͜oːtɑn
begieman	beji͜yːmɑn
begietan	beji͜ytɑn
beginnan	bejinnɑn
begnagan	beɡnɑɡɑn
begong	beɡonɡ
begrafan	beɡrɑfɑn
begreosan	beɡre͜oːsɑn
begretan	beɡreːtɑn
begripan	beɡriːpɑn
begrætan	beɡræːtɑn
begyman	bejyːmɑn
begyrdan	beɡyrdɑn
behabban	bexɑbbɑn
behat	bexɑːt
behatan	bexɑːtɑn
behatland	bexɑːtlɑnd
beheafdian	bexæ͜ɑːfdiɑn
beheafdung	bexæ͜ɑːfdunɡ
behealdan	bexæ͜ɑldɑn
beheawan	bexæ͜ɑːwɑn
behegian	bexeɡiɑn
behelmian	bexelmiɑn
behindan	bexindɑn
behleapan	bexlæ͜ɑːpɑn
behlehhan	bexlexxɑn
behlidan	bexliːdɑn
behliehhan	bexli͜yxxɑn
behlæstan	bexlæstɑn
behof	bexoːf
behofian	bexoːfiɑn
behon	bexoːn
behreosan	bexre͜oːsɑn
behropan	bexroːpɑn
behweorfan	bexwe͜orfɑn
behycgan	bexyjjɑn
behydan	bexyːdɑn
behæs	bexæːs
beirnan	beirnɑn
beladian	belɑːdiɑn
beladung	belɑːdunɡ
belean	belæ͜ɑːn
belecgan	belejjɑn
belendan	belendɑn
beleogan	bele͜oːɡɑn
belgan	belɡɑn
belicgan	belijjɑn
beliefan	beli͜yːfɑn
belifan	beliːfɑn
belimpan	belimpɑn
bellan	bellɑn
belle	belle
belltacen	belltɑːken
belt	belt
belucan	beluːkɑn
belyfan	belyːfɑn
belyrtan	belyrtɑn
belædan	belæːdɑn
belæfan	belæːfɑn
bemetan	bemetɑn
bemiþan	bemiːθɑn
bemurnan	bemurnɑn
bemænan	bemæːnɑn
ben	ben
ben	beːn
bena	beːnɑ
benc	bent͡ʃ
bendan	bendɑn
benemnan	benemnɑn
beneotan	bene͜oːtɑn
beneoþan	bene͜oθɑn
beniman	benimɑn
benn	benn
bennian	benniɑn
benotian	benotiɑn
bensian	beːnsiɑn
beo	be͜oː
beobread	be͜oːbræ͜ɑːd
beoceorl	be͜oːt͡ʃe͜orl
beocere	be͜oːkere
beod	be͜oːd
beodan	be͜oːdɑn
beodclaþ	be͜oːdklɑːθ
beodern	be͜oːdern
beofor	be͜ofor
beofung	be͜ofunɡ
beogang	be͜oːɡɑnɡ
beogol	be͜oːɡol
beom	beːo̯m
beomodor	be͜oːmoːdor
beon	be͜oːn
beor	be͜oːr
beoran	be͜orɑn
beorcan	be͜orkɑn
beorg	be͜orɡ
beorgan	be͜orjɑn
beorgan	be͜orɡɑn
beorht	be͜orxt
beorhthwil	be͜orxtxwiːl
beorhtian	be͜orxtiɑn
beorhtlice	be͜orxtliːt͡ʃe
beorhtnes	be͜orxtnes
beorma	be͜ormɑ
beorn	be͜orn
beornan	be͜ornɑn
beorsele	be͜oːrsele
beorþegu	be͜oːrθeɡu
beorþorþinen	be͜orθorθiːnen
beot	be͜oːt
beotian	be͜oːtiɑn
beow	be͜oːw
beowulf	be͜oːwulf
beowyrt	be͜oːwyrt
bepæcan	bepæːt͡ʃɑn
bepæcend	bepæːt͡ʃend
bepæcestre	bepæːt͡ʃestre
bepæcung	bepæːt͡ʃunɡ
ber	beːr
bera	berɑ
beran	berɑn
bercan	berkɑn
bere	bere
bereafian	beræ͜ɑːfiɑn
bereofan	bere͜oːfɑn
beridan	beriːdɑn
berige	berije
berstan	berstɑn
berædan	beræːdɑn
besawan	besɑːwɑn
besceadan	beʃæ͜ɑːdɑn
besceadan	beʃɑːdɑn
besceaduwian	beʃɑduwiɑn
bescieran	beʃi͜yrɑn
bescinan	beʃiːnɑn
bescitan	beʃiːtɑn
bescufan	beʃuːfɑn
bescyldian	beʃyldiɑn
bescyldigian	beʃyldiɡiɑn
besecgan	besejjɑn
besellan	besellɑn
besema	besemɑ
besendan	besendɑn
besengan	besenjɑn
beseon	bese͜oːn
besettan	besettɑn
besierwan	besi͜yrwɑn
besig	besij
besincan	besinkɑn
besingan	besinɡɑn
besittan	besittɑn
beslean	beslæ͜ɑːn
beslæpan	beslæːpɑn
besma	besmɑ
besmeagan	besmæ͜ɑːjɑn
besmierwan	besmi͜yrwɑn
besmirwan	besmirwɑn
besniwod	besniːwod
besorgian	besorɡiɑn
besprecan	besprekɑn
bestandan	bestɑndɑn
bestelan	bestelɑn
besteman	besteːmɑn
besteppan	besteppɑn
bestieman	besti͜yːmɑn
bestingan	bestinɡɑn
bestreawian	bestræ͜ɑːwiɑn
bestrican	bestriːkɑn
bestridan	bestriːdɑn
bestyman	bestyːmɑn
bestyrian	bestyrjɑn
beswican	beswiːkɑn
beswincan	beswinkɑn
besyrwan	besyrwɑn
bet	bet
betan	beːtɑn
betellan	betellɑn
beteon	bete͜oːn
beterian	beteriɑn
betredan	betredɑn
betweonan	betwe͜oːnɑn
betweonum	betwe͜oːnum
betweox	betwe͜oːks
betynan	betyːnɑn
betæcan	betæːt͡ʃɑn
bewacian	bewɑkiɑn
bewalwian	bewɑlwiɑn
bewarian	bewɑriɑn
bewealwian	bewæ͜ɑlwiɑn
beweardian	bewæ͜ɑrdiɑn
beweddian	beweddiɑn
bewendan	bewendɑn
beweorpan	bewe͜orpɑn
bewepan	beweːpɑn
bewindan	bewindɑn
bewitan	bewitɑn
bewlatian	bewlɑːtiɑn
bewlitan	bewliːtɑn
bewrecan	bewrekɑn
bewritan	bewriːtɑn
bewyrcan	bewyrt͡ʃɑn
bewægnan	bewæjnɑn
bewæpnian	bewæːpniɑn
beæwnian	beæːwniɑn
beþeccan	beθett͡ʃɑn
beþencan	beθent͡ʃɑn
beþeodan	beθe͜oːdɑn
beþian	beθiɑn
beþiedan	beθi͜yːdɑn
beþrawan	beθrɑːwɑn
beþringan	beθrinɡɑn
bi	biː
biblioþece	bibli͜uθeːke
bicce	bitt͡ʃe
bicnol	biːt͡ʃnol
bicweþan	bikweθɑn
bidan	biːdɑn
bidaþ	biːdɑθ
biddan	biddɑn
bidon	bidon
biecnan	bi͜yːknɑn
bieldan	bi͜yldɑn
bieme	biːeme
biemere	biːeme
biemian	bi͜yːmiɑn
bierce	bi͜yrt͡ʃe
biergan	bi͜yrjɑn
bierhtu	bi͜yrxtu
biernan	bi͜yrnɑn
bifian	bifiɑn
bigenga	biːjenɡɑ
bigspel	bijspel
bihreosan	bixre͜oːsɑn
bil	bil
bilehwit	bilexwiːt
bilewit	bilewit
biliþe	biliθe
billum	billum
binama	biːnɑmɑ
bindan	bindɑn
bineoþan	bine͜oθɑn
binn	binn
binnan	binnɑn
biorn	bi͜urn
birce	birt͡ʃe
birhtu	birxtu
birnan	birnɑn
bisceop	biske͜op
biscop	biʃʃop
biscopdom	biʃʃopdoːm
biscophad	biʃʃopxɑːd
biscoprice	biʃʃopriːt͡ʃe
biscopwyrt	biʃʃopwyrt
bisenian	biseniɑn
bisgian	bisjiɑn
bisig	bisij
bisignes	bisijnes
bisigu	bisiju
bismer	bismer
bismor	bismor
bisnian	bisniɑn
bispel	biːspel
bispell	biːspell
bispellboc	biːspellboːk
bisæc	biːsæk
bisæc	biːsæt͡ʃ
bisæc	biːsæːt͡ʃ
bisæcc	biːsækk
bisæcc	biːsætt͡ʃ
bita	bitɑ
bitan	biːtɑn
bite	bite
biter	biter
biterlice	biterliːt͡ʃe
biternes	biternes
bitor	bitor
bitter	bitter
biword	biːword
biwrecan	biwrekɑn
biþ	biθ
blac	blɑːk
blacern	blɑːkern
blacian	blɑːkiɑn
blanc	blɑnk
blanca	blɑnkɑ
blandan	blɑndɑn
blase	blɑse
blat	blɑːt
blatian	blɑːtiɑn
blaw	blɑːw
blawan	blɑːwɑn
bleat	blæ͜ɑːt
bleaþ	blæ͜ɑːθ
bled	bleːd
bledan	bleːdɑn
bledhwæt	bleːdxwæt
bledsian	bleːdsiɑn
blencan	blent͡ʃɑn
blendan	blendɑn
bleo	ble͜oː
bleoh	ble͜ox
bleoread	ble͜oːræ͜ɑːd
bletsian	bleːtsiɑn
bletsung	bleːtsunɡ
blican	bliːkɑn
blind	blind
blindnes	blindnes
blindnys	blindnys
blinnan	blinnɑn
bliss	bliss
blissian	blissiɑn
bliþe	bliːθe
bliþelice	bliːθeliːt͡ʃe
blod	bloːd
blodgian	bloːdɡiɑn
blodig	bloːdij
blodleas	bloːdlæ͜ɑːs
blodreow	bloːdre͜oːw
blodwite	bloːdwiːte
bloma	bloːmɑ
blondan	blondɑn
blondenfeax	blondenfæ͜ɑks
blostm	bloːstm
blostma	bloːstmɑ
blostmbære	bloːstmbæːre
blostmian	bloːstmiɑn
blot	bloːt
blotan	bloːtɑn
blotmonaþ	bloːtmoːnɑθ
blowan	bloːwɑn
blæc	blæk
blæcan	blæːt͡ʃɑn
blæced	blæːt͡ʃed
blæd	blæd
blæd	blæːd
blædnes	blæːdnes
blæge	blæːje
blæhæwen	blæːxæːwen
blæse	blæse
blæst	blæːst
blætan	blæːtɑn
blæwen	blæːwen
blœdsian	bløːdsiɑn
boc	boːk
boca	boːkɑ
boccræft	boːkkræft
bocere	boːkere
bocgestreon	boːkjestre͜oːn
bochus	boːkxuːs
bocian	boːkiɑn
boclar	boːk
boclic	boːkliːt͡ʃ
bocstæf	boːkstæf
boctreow	boːktre͜oːw
bod	bod
boda	bodɑ
bodan	bodɑn
bodeg	bodej
bodian	bodiɑn
bodig	bodij
bog	boːɡ
boga	boɡɑ
bogan	boɡɑn
bogiht	boɡixt
bolca	bolkɑ
bold	bold
bolde	bolde
bolgenmod	bolɡenmoːd
bolla	bollɑ
bolle	bolle
bolster	bolster
bolt	bolt
bon	boːn
bonda	bondɑ
bora	borɑ
bord	bord
bordclaþ	bordklɑːθ
borg	borɡ
borgian	borɡiɑn
borh	borx
borian	boriɑn
bosig	boːsij
bosm	boːsm
bot	boːt
botettan	boːtettɑn
botian	boːtiɑn
botleas	boːtlæ͜ɑːs
botm	botm
botwierþe	boːtwi͜yrθe
box	boks
boxtreow	bokstre͜oːw
boþen	boθen
brad	brɑːd
brand	brɑnd
brant	brɑnt
brastlian	brɑstliɑn
bread	bræ͜ɑːd
breadru	bræːɑ̯dru
breahtm	bræ͜ɑxtm
breawern	bræ͜ɑːwern
brec	breːt͡ʃ
brecan	brekɑn
brecþ	brekθ
bred	bred
bregdan	brejdɑn
brego	breɡo
breme	breːme
bremel	breːmel
brengan	brenjɑn
breogo	bre͜oɡo
breost	bre͜oːst
breostcearu	bre͜oːstt͡ʃæ͜ɑru
breotan	bre͜oːtɑn
breoton	bre͜oton
breowan	bre͜oːwɑn
breoþan	bre͜oːθɑn
bret	bret
bretland	bretlɑnd
bretwalda	bretwɑldɑ
bridd	bridd
bridel	briːdel
brim	brim
brimliþend	brimliːθend
brine	briːne
bringan	brinɡɑn
briw	briːw
broc	broːk
brocc	brokk
brocen	broken
broga	broːɡɑ
brom	broːm
brord	brord
broþ	broθ
broþor	broːθor
broþorbana	broːθorbɑnɑ
broþorleas	broːθorlæ͜ɑːs
broþorlic	broːθorliːt͡ʃ
broþorræden	broːθorræːden
bru	bruː
brucan	bruːkɑn
brucing	bruːkinɡ
brun	bruːn
bryce	bryt͡ʃe
bryce	bryːt͡ʃe
brycg	bryjj
brycgbot	bryjjboːt
brycgian	bryjjiɑn
bryd	bryːd
brydguma	bryːdɡumɑ
bryne	bryne
bryne	bryːne
bryrdan	bryrdɑn
brysan	bryːsɑn
bryt	bryt
bryten	bryten
brytenlond	brytenlond
brytland	brytlɑnd
brytmælum	brytmæːlum
brytta	bryttɑ
bryttas	bryttɑs
bryþen	bryθen
brædan	bræːdɑn
brædepanne	bræːdepɑnne
brægen	bræjen
brægn	bræjn
bræmbel	bræmbel
bræmel	bræːmel
bræmelberie	bræːmelberie
bræs	bræs
bræsen	bræsen
bræw	bræːw
bræð	bræθ
bræþ	bræːθ
brœme	brøːme
buan	buːɑn
buc	buk
buc	buːk
bucc	bukk
bucc	buːkk
bucca	bukkɑ
budda	buddɑ
buend	buːend
bufan	bufɑn
bugan	buːɡɑn
bugon	buɡon
bur	buːr
burbyrde	buːrbyrde
burg	burɡ
burgræden	burɡræːden
burh	burx
burhbot	burxboːt
burhleod	burxle͜oːd
burhleoda	burxle͜oːdɑ
burna	burnɑ
burne	burne
butan	buːtɑn
butere	butere
buton	buːton
buttorfleoge	buttorfle͜oːɡe
bycgan	byjjɑn
bycgen	byjjen
bydel	bydel
bygan	byːjɑn
byldan	byldɑn
byme	byːme
bymere	byːme
bymian	byːmiɑn
byrde	byrde
byrdling	byrdlinɡ
byre	byre
byre	byːre
byrgan	byrjɑn
byrgen	byrjen
byrgenn	byrjenn
byrla	byrlɑ
byrnan	byrnɑn
byrne	byrne
byrðen	byrθen
byrþen	byrθen
bysen	byːsen
bysenian	byseniɑn
bysig	bysij
bysnian	bysniɑn
bysnigan	bysnijɑn
byþ	byθ
bæc	bæk
bæc	bæt͡ʃ
bæcbord	bækbord
bæcere	bækere
bæcern	bækern
bæcestre	bækestre
bæchus	bækxuːs
bædan	bædɑn
bædan	bæːdɑn
bædaþ	bæːdɑθ
bædde	bæːdde
bæddel	bæddel
bæddon	bæːddon
bædeþ	bæːdeθ
bædling	bædlinɡ
bæl	bæːl
bælfyr	bæːlfyːr
bælg	bælɡ
bænen	bæːnen
bær	bær
bærfot	bærfoːt
bærlic	bærliːt͡ʃ
bærnan	bærnɑn
bærne	bærne
bæron	bæːron
bæst	bæst
bæðhus	bæθxuːs
bæþ	bæθ
bæþhus	bæθxuːs
bœc	bøːk
cac	kɑk
cachus	kɑkxuːs
caf	kɑːf
cafscipe	kɑːfʃipe
calan	kɑlɑn
cald	kɑld
calend	kɑlend
calu	kɑlu
camb	kɑmb
camp	kɑmp
campdom	kɑmpdoːm
campian	kɑmpiɑn
camplic	kɑmpliːt͡ʃ
campræden	kɑmpræːden
campstede	kɑmpstede
campung	kɑmpunɡ
campwisa	kɑmpwiːsɑ
canc	kɑnk
cancer	kɑnker
cancettan	kɑnkettɑn
candel	kɑndel
cann	kɑnn
canne	kɑnne
cantware	kɑntwɑre
capian	kɑpiɑn
carcern	kɑrkern
carful	kɑrful
carfullice	kɑrfulliːt͡ʃe
carian	kɑriɑn
carig	kɑrij
carl	kɑrl
carleas	kɑrlæ͜ɑːs
carleasnes	kɑrlæ͜ɑːsnes
carles	kɑrles
carr	kɑrr
carte	kɑrte
caru	kɑru
carwielm	kɑrwi͜ylm
casere	kɑːsere
caseren	kɑːseren
caserlic	kɑːserliːt͡ʃ
casern	kɑːsern
castel	kɑstel
castenere	kɑstenere
cater	kɑter
catt	kɑtt
catte	kɑtte
cawel	kɑwel
ceac	t͡ʃæ͜ɑːk
ceace	t͡ʃæ͜ɑːke
ceaf	t͡ʃæ͜ɑf
ceafl	t͡ʃæ͜ɑfl
ceafor	t͡ʃæ͜ɑfor
ceahhe	t͡ʃæ͜ɑxxe
ceahhettan	t͡ʃæ͜ɑxxettɑn
cealc	t͡ʃæ͜ɑlk
ceald	t͡ʃæ͜ɑld
cealdheort	t͡ʃæ͜ɑldxe͜ort
cealdian	t͡ʃæ͜ɑldiɑn
cealdnes	t͡ʃæ͜ɑldnes
cealdnys	t͡ʃæ͜ɑldnys
cealf	t͡ʃæ͜ɑlf
ceallian	t͡ʃæ͜ɑlliɑn
ceap	t͡ʃæ͜ɑːp
ceapa	t͡ʃæːɑ̯pɑ
ceapian	t͡ʃæ͜ɑːpiɑn
ceapmann	t͡ʃæ͜ɑːpmɑnn
ceapstow	t͡ʃæ͜ɑːpstoːw
cearful	t͡ʃæ͜ɑrful
cearfullice	t͡ʃæ͜ɑrfulliːt͡ʃe
cearig	t͡ʃæ͜ɑrij
cearseld	kæ͜ɑrseld
cearu	t͡ʃæ͜ɑru
cearwylm	t͡ʃæ͜ɑrwylm
ceas	t͡ʃæ͜ɑːs
ceasnes	t͡ʃæ͜ɑːsnes
ceaster	t͡ʃæ͜ɑster
ceasterleod	t͡ʃæ͜ɑsterle͜oːd
ceaw	t͡ʃæ͜ɑːw
ceder	keder
cederbeam	kederbæ͜ɑːm
cedertreow	kedertre͜oːw
cedrisc	kedriʃ
celde	t͡ʃelde
cele	t͡ʃele
cemban	kembɑn
cempa	kempɑ
cempestre	kempestre
cen	t͡ʃeːn
cene	keːne
cenep	kenep
cenlice	keːnliːt͡ʃe
cennan	kennɑn
cenning	kenninɡ
cenningstow	kenninɡstoːw
cenningtid	kenninɡtiːd
cenrice	keːnriːke
cent	kent
centland	kentlɑnd
cenþu	keːnθu
ceo	t͡ʃe͜oː
ceoce	t͡ʃe͜oːke
ceod	ke͜od
ceol	t͡ʃe͜oːl
ceorfan	t͡ʃe͜orfɑn
ceorfdeor	t͡ʃe͜orfde͜oːr
ceorian	t͡ʃe͜oriɑn
ceorl	t͡ʃe͜orl
ceorla	t͡ʃe͜orlɑ
ceorlas	t͡ʃe͜orlɑs
ceorlboren	t͡ʃe͜orlboren
ceorle	t͡ʃe͜orle
ceorles	t͡ʃe͜orles
ceorlfolc	t͡ʃe͜orlfolk
ceorlian	t͡ʃe͜orliɑn
ceorlisc	t͡ʃe͜orliʃ
ceorliscnes	t͡ʃe͜orliʃnes
ceorlleas	t͡ʃe͜orllæ͜ɑːs
ceorran	t͡ʃe͜orrɑn
ceosan	t͡ʃe͜oːsɑn
ceosel	t͡ʃe͜osel
ceosol	t͡ʃe͜osol
ceosung	t͡ʃe͜oːsunɡ
ceowan	t͡ʃe͜oːwɑn
ceowaþ	t͡ʃe͜oːwɑθ
ceoweþ	t͡ʃe͜oːweθ
cepan	keːpɑn
cerdic	t͡ʃerdit͡ʃ
cerran	t͡ʃerrɑn
cese	t͡ʃeːse
cest	t͡ʃest
cetel	ketel
cicel	kit͡ʃel
cicen	kit͡ʃen
cicen	t͡ʃiken
cidan	t͡ʃiːdɑn
ciefes	t͡ʃi͜yfes
ciefese	t͡ʃi͜yfese
ciegan	t͡ʃi͜yːjɑn
ciele	t͡ʃi͜yle
ciepe	t͡ʃi͜ype
ciern	t͡ʃi͜yrn
cierr	t͡ʃi͜yrr
cierran	t͡ʃi͜yrrɑn
ciese	t͡ʃi͜yːse
cietel	t͡ʃi͜ytel
cigan	t͡ʃiːjɑn
cild	t͡ʃild
cildhad	t͡ʃildxɑːd
cildisc	t͡ʃildiʃ
cildlic	t͡ʃildliːt͡ʃ
cimban	t͡ʃimbɑn
cin	t͡ʃin
cinan	t͡ʃiːnɑn
cinn	kinn
cinn	t͡ʃinn
cipe	t͡ʃipe
cipp	t͡ʃipp
circul	t͡ʃirkul
circuladl	kirkulɑːdl
ciricbelle	t͡ʃirit͡ʃbelle
ciricboc	t͡ʃirit͡ʃboːk
ciricbot	t͡ʃirit͡ʃboːt
ciricbryce	t͡ʃirit͡ʃbryt͡ʃe
ciricbræc	t͡ʃirit͡ʃbræːt͡ʃ
ciricburh	t͡ʃirit͡ʃburx
ciricdor	t͡ʃirit͡ʃdoːr
cirice	t͡ʃirit͡ʃe
ciricend	t͡ʃirit͡ʃend
ciricfriþ	t͡ʃirit͡ʃfriθ
ciricfultum	t͡ʃirit͡ʃfultum
ciricgang	t͡ʃirit͡ʃɡɑnɡ
ciricgemana	t͡ʃirit͡ʃjemɑːnɑ
ciricgeorn	t͡ʃirit͡ʃje͜orn
ciricgeriht	t͡ʃirit͡ʃjerixt
ciricgriþ	t͡ʃirit͡ʃɡriθ
cirichad	t͡ʃirit͡ʃxɑːd
cirichalgung	t͡ʃirit͡ʃxɑːlɡunɡ
cirichata	t͡ʃirit͡ʃxɑtɑ
cirichyll	t͡ʃirit͡ʃxyll
ciricland	t͡ʃirit͡ʃlɑnd
ciriclic	t͡ʃirikliːt͡ʃ
ciricmangung	t͡ʃirit͡ʃmɑnɡunɡ
ciricmitta	t͡ʃirit͡ʃmittɑ
ciricmærsung	t͡ʃirit͡ʃmæːrsunɡ
ciricnytt	t͡ʃirit͡ʃnytt
ciricpæþ	t͡ʃirit͡ʃpæθ
ciricragu	t͡ʃirit͡ʃrɑɡu
ciricran	t͡ʃirit͡ʃrɑːn
ciricsang	t͡ʃirit͡ʃsɑnɡ
ciricsangere	t͡ʃirit͡ʃsɑnɡere
ciricsceatt	t͡ʃirit͡ʃʃæ͜ɑtt
ciricsceattweorc	t͡ʃirit͡ʃʃæ͜ɑttwe͜ork
ciricsocn	t͡ʃirit͡ʃsoːkn
ciricsteall	t͡ʃirit͡ʃstæ͜ɑll
ciricstede	t͡ʃirit͡ʃstede
ciricstig	t͡ʃirit͡ʃstiːj
cirictid	t͡ʃirit͡ʃtiːd
cirictun	t͡ʃiriktuːn
ciricwag	t͡ʃirit͡ʃwɑːɡ
ciricwaru	t͡ʃirit͡ʃwɑru
ciricweard	t͡ʃirit͡ʃwæ͜ɑrd
ciricweg	t͡ʃirit͡ʃwej
ciricwica	t͡ʃirit͡ʃwiːt͡ʃɑ
ciricwæcce	t͡ʃirit͡ʃwætt͡ʃe
ciricwæd	t͡ʃirit͡ʃwæːd
ciricæwe	t͡ʃirit͡ʃæːwe
ciricþegn	t͡ʃirit͡ʃθejn
ciricþegnung	t͡ʃirikθejnunɡ
ciricþing	t͡ʃirit͡ʃθinɡ
ciricþingere	t͡ʃirit͡ʃθinɡere
cirse	t͡ʃirse
cisel	t͡ʃisel
cisil	t͡ʃisil
citelian	t͡ʃiteliɑn
citelung	t͡ʃitelunɡ
ciþ	t͡ʃiːθ
clacu	klɑku
clam	klɑːm
clawan	klɑwɑn
clawan	klɑːwɑn
clawian	klɑwiɑn
clawu	klɑwu
claþ	klɑːθ
claþas	klɑːθɑs
clea	klæ͜ɑː
cleafa	klæ͜ɑːfɑ
cleofan	kle͜oːfɑn
cleopian	kle͜opiɑn
clerc	klerk
cliewen	kli͜yːwen
clif	klif
clifiht	klifixt
clifstan	klifstɑːn
climban	klimbɑn
clingan	klinɡɑn
clipian	klipiɑn
clipiendlic	klipiendliːt͡ʃ
clipigendlic	klipijendliːt͡ʃ
clipol	klipol
clipola	klipolɑ
clipolgefeg	klipoljefeːj
cliwen	kliːwen
cliþa	kliːθɑ
clucge	kluɡɡe
clud	kluːd
clus	kluːs
clut	kluːt
clyccan	klytt͡ʃɑn
clyppan	klyppɑn
clysan	klyːsɑn
clæcleas	klæklæ͜ɑːs
clæg	klæːj
clæman	klæːmɑn
clæna	klæːnɑ
clænan	klæːnɑn
clæne	klæːne
clænes	klæːnes
clænlic	klæːnliːt͡ʃ
clænlice	klæːnliːt͡ʃe
clænne	klæːnne
clænsian	klæːnsiɑn
clænum	klæːnum
clæppan	klæppɑn
clæþ	klæːθ
cnafa	knɑfɑ
cnapa	knɑpɑ
cnawan	knɑːwɑn
cnawe	knɑːwe
cnawelæc	knɑːwelæːt͡ʃ
cnawelæcing	knɑːwelæːt͡ʃinɡ
cnearr	knæ͜ɑrr
cneht	knext
cneo	kne͜oː
cneoht	kne͜oxt
cneordlæcan	kne͜ordlæːt͡ʃɑn
cneorim	kne͜oːriːm
cneoris	kne͜oːris
cneow	kne͜oːw
cnif	kniːf
cniht	knixt
cnihthad	knixtxɑːd
cnihtlic	knixtliːt͡ʃ
cnihtwesende	knixtwesende
cnocian	knokiɑn
cnosl	knoːsl
cnossian	knossiɑn
cnotta	knottɑ
cnucel	knukel
cnyll	knyll
cnyllan	knyllɑn
cnyss	knyss
cnyssan	knyssɑn
cnyssung	knyssunɡ
cnyttan	knyttɑn
cnæwe	knæːwe
coc	kok
coc	koːk
cocc	kokk
cocer	koker
cocnian	koːkniɑn
codd	kodd
cofa	kofɑ
cofgod	koːfɡod
col	kol
col	koːl
colian	koːliɑn
colsweart	kolswæ͜ɑrt
com	koːm
comb	komb
comon	koːmon
copian	kopiɑn
copor	kopor
copp	kopp
corenscipe	korenʃipe
corn	korn
cornbære	kornbæːre
cornweal	kornwæ͜ɑl
corona	koroːnɑ
cos	kos
cosp	kosp
coss	koss
cost	kost
costian	kostiɑn
costnian	kostniɑn
costnung	kostnunɡ
cot	kot
coþu	koθu
crabba	krɑbbɑ
cracian	krɑkiɑn
cradol	krɑdol
crafian	krɑfiɑn
cran	krɑn
cranic	krɑnik
cranicwritere	krɑnikwriːtere
cranoc	krɑnok
crawan	krɑːwɑn
crawe	krɑːwe
crecas	kreːkɑs
crecisc	kreːkiʃ
creopan	kre͜oːpɑn
cribb	kribb
cricc	kritt͡ʃ
crimman	krimmɑn
crincan	krinkɑn
crincgan	krinjɑn
cringan	krinɡɑn
crist	krist
cristen	kristen
cristendom	kristendoːm
cristesmæsse	kristesmæsse
crocca	krokkɑ
cropp	kropp
croppa	kroppɑ
cruc	kruːt͡ʃ
crudan	kruːdɑn
cruma	krumɑ
crycc	krytt͡ʃ
crypel	krypel
cræft	kræft
cræftig	kræftij
cræftiga	kræftiɡɑ
cræftiglice	kræftijliːt͡ʃe
cræftleas	kræftlæ͜ɑːs
cræftlic	kræftliːt͡ʃ
cu	kuː
cudele	kudele
cuhyrde	kuːxyrde
culfre	kulfre
cuma	kumɑ
cuman	kumɑn
cumb	kumb
cumliþe	kumliːθe
cumliþian	kumliːθiɑn
cumliþnes	kumliːθnes
cumpæder	kumpæder
cunnan	kunnɑn
cunnian	kunniɑn
cunnung	kunnunɡ
cuppe	kuppe
cusceote	kuːʃote
cuwearm	kuːwæ͜ɑrm
cuwon	kuwon
cuþ	kuːθ
cuþa	kuːθɑ
cuþe	kuːθe
cuþlice	kuːθliːt͡ʃe
cuþlæcan	kuːθlæːt͡ʃɑn
cwacian	kwɑkiɑn
cwalu	kwɑlu
cwead	kwæ͜ɑːd
cwealm	kwæ͜ɑlm
cwealmbære	kwæ͜ɑlmbæːre
cweartern	kwæ͜ɑrtern
cweccan	kwett͡ʃɑn
cweden	kweden
cwedol	kwedol
cwelan	kwelɑn
cwelaþ	kwelɑθ
cwele	kwele
cwelende	kwelende
cwellan	kwellɑn
cweman	kweːmɑn
cweme	kweːme
cwen	kweːn
cwene	kwene
cwene	kweːne
cwenfugol	kweːnfuɡol
cwenland	kweːnlɑnd
cwenlic	kweːnliːt͡ʃ
cweorn	kwe͜orn
cweornstan	kwe͜ornstɑːn
cweðan	kweθɑn
cweþan	kweθɑn
cweþaþ	kweθɑθ
cweþe	kweθe
cwic	kwik
cwicbeam	kwikbæ͜ɑːm
cwice	kwit͡ʃe
cwician	kwikiɑn
cwicseolfor	kwikse͜olfor
cwictreow	kwiktre͜oːw
cwidboc	kwidboːk
cwide	kwide
cwidræden	kwidræːden
cwiesan	kwi͜yːsɑn
cwild	kwild
cwist	kwist
cwiþ	kwiθ
cwomon	kwoːmon
cwysan	kwyːsɑn
cwæde	kwæːde
cwæden	kwæːden
cwæþ	kwæθ
cwœn	kwøːn
cy	kyː
cycel	kyt͡ʃel
cycen	kyt͡ʃen
cycen	t͡ʃyken
cycen	t͡ʃyːken
cycene	kyt͡ʃene
cyll	kyll
cylu	kylu
cyme	kyme
cyme	kyːme
cymen	kymen
cymlic	kyːmliːt͡ʃ
cynd	kynd
cynde	kynde
cyndelic	kyndeliːt͡ʃ
cynebot	kyneboːt
cyneg	kyneɡ
cynegierd	kyneji͜yrd
cynehelm	kynexelm
cynelic	kyneliːt͡ʃ
cynerice	kyneriːt͡ʃe
cynesetl	kynesetl
cyneþrym	kyneθrym
cynferð	kynferθ
cynferþ	kynferθ
cyng	kynɡ
cynig	kyniɡ
cyning	kyninɡ
cyningdom	kyninɡdoːm
cyninge	kyninɡe
cyningrice	kyninɡriːt͡ʃe
cynn	kynn
cyperen	kyperen
cypren	kypren
cyre	kyre
cyren	t͡ʃyren
cyrf	kyrf
cyrictun	t͡ʃirit͡ʃtuːn
cyrlic	t͡ʃyrlik
cyrnel	kyrnel
cyrr	t͡ʃyrr
cyrran	t͡ʃyrrɑn
cyrtel	kyrtel
cyrtenlæcan	kyrtenlæːt͡ʃɑn
cysa	kysɑ
cysel	t͡ʃysel
cyssan	kyssɑn
cyst	kyst
cystan	kystɑn
cystig	kystij
cywþ	t͡ʃyːwθ
cyþan	kyːθɑn
cyþlæcan	kyːθlæːt͡ʃɑn
cyþþu	kyːθθu
cædmon	kædmon
cæg	kæːj
cægbora	kæːjborɑ
cæggian	kæːɡɡiɑn
cælf	kælf
cærsiht	kærsixt
da	dɑː
dafen	dɑfen
dafenian	dɑfeniɑn
dag	dɑːɡ
dagian	dɑɡiɑn
dagung	dɑɡunɡ
dah	dɑːx
dal	dɑl
daroþ	dɑroθ
daru	dɑru
dead	dæ͜ɑːd
deadlic	dæ͜ɑːdliːt͡ʃ
deadlicnes	dæ͜ɑːdliːknes
deaf	dæ͜ɑːf
deag	dæ͜ɑːɡ
deagol	dæ͜ɑːɡol
deagolnes	dæ͜ɑːɡolnes
deah	dæ͜ɑːx
deaw	dæ͜ɑːw
deaþ	dæ͜ɑːθ
deaþbed	dæ͜ɑːθbed
deaþbedd	dæ͜ɑːθbedd
deaþlic	dæ͜ɑːθliːt͡ʃ
deaþlicnes	dæ͜ɑːθliːt͡ʃnes
deaþlieg	dæ͜ɑːθli͜yːj
deaþscyld	dæ͜ɑːθʃyld
deaþscyldig	dæ͜ɑːθʃyldij
deaþslege	dæ͜ɑːθsleje
deaþwerig	dæ͜ɑːθweːrij
december	dekember
declinian	dekliːniɑn
declinung	dekliːnunɡ
ded	deːd
defe	deːfe
deg	dej
delf	delf
delfan	delfɑn
delu	delu
dema	deːmɑ
deman	deːmɑn
demend	deːmend
dene	dene
denemearc	denemæ͜ɑrk
denisc	deniʃ
denn	denn
denu	denu
deofol	de͜oːfol
deofolcund	de͜oːfolkund
deofolseoc	de͜oːfolse͜oːk
deofolseocnes	de͜oːfolse͜oːknes
deogol	de͜oːɡol
deon	de͜oːn
deop	de͜oːp
deoplic	de͜oːpliːt͡ʃ
deoplice	de͜oːpliːt͡ʃe
deopnes	de͜oːpnes
deor	de͜oːr
deorc	de͜ork
deorcnes	de͜orknes
deorcynn	de͜oːrkynn
deore	de͜oːre
deoren	de͜oːren
deorf	de͜orf
deorfan	de͜orfɑn
deorfellen	de͜oːrfellen
deorlice	de͜oːrliːt͡ʃe
deorling	de͜oːrlinɡ
deorwente	de͜orwente
derian	derjɑn
deriendlic	derjendliːt͡ʃ
diacon	diɑːkon
dic	diːt͡ʃ
diedan	di͜yːdɑn
diepe	di͜yːpe
diere	di͜yːre
diernan	di͜yrnɑn
dierne	di͜yrne
diht	dixt
dihtan	dixtɑn
dihtian	dixtiɑn
dihtnian	dixtniɑn
dilegian	dileɡiɑn
dilgian	dilɡiɑn
dimm	dimm
diofol	di͜uːfol
disc	diʃ
discipul	diskipul
discipul	diʃʃipul
distæf	distæf
docga	doɡɡɑ
dogga	doɡɡɑ
dogor	doːɡor
dohte	dohte
dohtig	doxtij
dohtor	doxtor
dol	dol
dolg	dolɡ
dolh	dolx
dom	doːm
domboc	doːmboːk
domeadig	doːmæ͜ɑːdij
domern	doːmern
domhus	doːmxuːs
domleas	doːmlæ͜ɑːs
don	doːn
donua	donuɑ
dor	doːr
dora	dorɑ
dox	doks
draca	drɑkɑ
dracu	drɑku
dragan	drɑɡɑn
dran	drɑːn
dreah	dræːɑ̯h
dreahtes	dræɑ̯htes
dreahtest	dræɑ̯htest
dream	dræ͜ɑːm
dreamcræft	dræ͜ɑːmkræft
dreamere	dræ͜ɑːmere
dreamleas	dræ͜ɑːmlæ͜ɑːs
dreccan	drett͡ʃɑn
drefan	dreːfɑn
drefednes	dreːfednes
drefend	dreːfend
drefing	dreːfinɡ
drehte	drehte
drehtest	drehtest
dreman	dreːmɑn
drenc	drent͡ʃ
drencan	drent͡ʃɑn
drenccuppe	drenkkuppe
drenccuppe	drent͡ʃkuppe
dreng	drenɡ
dreogan	dre͜oːɡɑn
dreopan	dre͜oːpɑn
dreor	dre͜oːr
dreorig	dre͜oːrij
dreoriglice	dre͜oːrijliːt͡ʃe
dreorignes	dre͜oːrijnes
dreorignys	dre͜oːrijnys
dreosan	dre͜oːsɑn
drepan	drepɑn
drepe	drepe
drieman	dri͜yːmɑn
drifan	driːfɑn
drihten	drixten
drihtenlic	drixtenliːt͡ʃ
drihtenlice	drixtenliːt͡ʃe
drihtlice	drixtliːt͡ʃe
drinc	drink
drincan	drinkɑn
drincere	drinkere
drithen	dritxen
drof	droːf
droflic	droːfliːt͡ʃ
drogen	droɡen
dropa	dropɑ
dropian	dropiɑn
dropmælum	dropmæːlum
drugaþ	druːɡɑθ
drugon	druɡon
druh	drux
druncen	drunken
druncnian	drunkniɑn
drusian	druːsiɑn
dry	dryː
drycræft	dryːkræft
drygan	dryːjɑn
dryge	dryːje
dryht	dryxt
dryhten	dryxten
dryhtguma	dryxtɡumɑ
dryman	dryːmɑn
drync	drynt͡ʃ
drægnet	dræjnet
drægnett	dræjnett
dræn	dræːn
drænc	drænk
duce	duke
duce	duːke
dudda	duddɑ
dufan	duːfɑn
dufenal	dufenɑl
dugan	duɡɑn
duguþ	duɡuθ
dumb	dumb
dumbnes	dumbnes
dun	duːn
dung	dunɡ
dunholm	dunxolm
dunn	dunn
dunstan	dunstɑːn
durran	durrɑn
duru	duru
dust	duːst
dustsceawung	duːstʃæ͜ɑːwunɡ
dwealde	dwæ͜ɑlde
dwelan	dwelɑn
dweleþ	dweleθ
dwelian	dweliɑn
dwellan	dwellɑn
dwelle	dwelle
dweorg	dwe͜orɡ
dwild	dwild
dwimor	dwimor
dwinan	dwiːnɑn
dwola	dwolɑ
dwolcræft	dwolkræft
dwolma	dwolmɑ
dwolmann	dwolmɑnn
dwæs	dwæːs
dwæscan	dwæːʃʃɑn
dydan	dyːdɑn
dyfan	dyːfɑn
dyhtig	dyxtij
dyncge	dynje
dyne	dyne
dynian	dyniɑn
dynnan	dynnɑn
dynt	dynt
dype	dyːpe
dyppan	dyppɑn
dyrne	dyrne
dysig	dysij
dæd	dæːd
dædbana	dæːdbɑnɑ
dædbeta	dæːdbeːtɑ
dædbetan	dæːdbeːtɑn
dædbot	dæːdboːt
dædbotnes	dæːdboːtnes
dædhata	dæːdxɑtɑ
dædlic	dæːdliːt͡ʃ
dæfte	dæfte
dæg	dæj
dæge	dæje
dæge	dæːje
dæges	dæjes
dægfeorm	dæjfe͜orm
dæglang	dæjlɑnɡ
dæglanges	dæjlɑnɡes
dæglic	dæjliːt͡ʃ
dægmæl	dæjmæːl
dægred	dæjreːd
dægsceald	dæjʃæ͜ɑld
dægsteorra	dæjste͜orrɑ
dægweorc	dæjwe͜ork
dæl	dæl
dæl	dæːl
dælan	dæːlɑn
dælde	dæːlde
dælniman	dæːlnimɑn
dœg	døɡ
dœman	døːmɑn
ea	æ͜ɑː
eac	æ͜ɑːk
eaca	æ͜ɑːkɑ
eacan	æ͜ɑːkɑn
eacen	æ͜ɑːken
eacniende	æ͜ɑːkniende
ead	æ͜ɑːd
eadan	æ͜ɑːdɑn
eadbald	æ͜ɑːdbɑld
eadbeald	æ͜ɑːdbæ͜ɑld
eadburh	æ͜ɑdburx
eaden	æ͜ɑːden
eades	æːɑ̯des
eadesa	æ͜ɑdesɑ
eadgar	æ͜ɑːdɡɑːr
eadig	æ͜ɑːdij
eadmund	æ͜ɑːdmund
eadric	æ͜ɑːdriːk
eadweard	æ͜ɑːdwæ͜ɑrd
eadwulf	æ͜ɑːdwulf
eafera	æ͜ɑferɑ
eafora	æ͜ɑforɑ
eafoþ	æ͜ɑfoθ
eagan	æ͜ɑːɡɑn
eagduru	æ͜ɑːɡduru
eage	æ͜ɑːɡe
eagæppel	æ͜ɑːɡæppel
eagþyrel	æ͜ɑːɡθyːrel
eagþyrl	æ͜ɑːɡθyːrl
eahta	æ͜ɑxtɑ
eahtafeald	æ͜ɑxtɑfæ͜ɑld
eahtateoþa	æ͜ɑxtɑte͜oːθɑ
eahtatiene	æ͜ɑxtɑti͜yːne
eahtian	æ͜ɑxtiɑn
eahtoþa	æ͜ɑxtoθɑ
eala	æ͜ɑːlɑː
ealc	æ͜ɑlt͡ʃ
eald	æ͜ɑld
ealdbacen	æ͜ɑldbɑken
ealdfæder	æ͜ɑldfæder
ealdmoder	æ͜ɑldmoːder
ealdmodor	æ͜ɑldmoːdor
ealdnes	æ͜ɑldnes
ealdor	æ͜ɑldor
ealdorleas	æ͜ɑldorlæ͜ɑːs
ealdorlease	æɑ̯ldorlæːɑ̯se
ealdorman	æ͜ɑldormɑn
ealdormann	æ͜ɑldormɑnn
ealdseaxan	æ͜ɑldsæ͜ɑksɑn
ealgian	æ͜ɑlɡiɑn
ealh	æ͜ɑlx
ealhswiþ	æ͜ɑlxswiːθ
eall	æ͜ɑll
ealles	æ͜ɑlles
eallic	æ͜ɑlliːt͡ʃ
eallswa	æ͜ɑllswɑː
ealneg	æ͜ɑlnej
ealswa	æ͜ɑlswɑː
ealu	æ͜ɑlu
ealuhus	æ͜ɑluxuːs
eam	æ͜ɑm
eam	æ͜ɑːm
eanred	æ͜ɑːnred
ear	æ͜ɑːr
earclænsend	æ͜ɑːrklæːnsend
eard	æ͜ɑrd
eardian	æ͜ɑrdiɑn
eardiend	æ͜ɑrdiend
eardiende	æ͜ɑrdiende
eardiendlic	æ͜ɑrdiendliːt͡ʃ
eardung	æ͜ɑrdunɡ
eare	æ͜ɑːre
earendel	æ͜ɑːrendel
earfeþe	æ͜ɑrfeθe
earfoþdæde	æ͜ɑrfoθdæːde
earfoþe	æ͜ɑrfoθe
earfoþhwil	æ͜ɑrfoθxwiːl
earfoþnes	æ͜ɑrfoθnes
earfoþþrag	æ͜ɑrfoθθrɑːɡ
earg	æ͜ɑrɡ
earh	æ͜ɑrx
earhring	æ͜ɑːrxrinɡ
earlæppa	æ͜ɑːrlæppɑ
earm	æ͜ɑrm
earmcearig	æ͜ɑrmt͡ʃæ͜ɑrij
earmhread	æ͜ɑrmxræ͜ɑːd
earn	æ͜ɑrn
earnian	æ͜ɑrniɑn
earnwulf	æ͜ɑrnwulf
ears	æ͜ɑrs
earsþerl	æ͜ɑrsθerl
earsþyrel	æ͜ɑrsθyːrel
earwicga	æ͜ɑːrwiɡɡɑ
east	æ͜ɑːst
eastan	æ͜ɑːstɑn
eastengle	æ͜ɑːstenɡle
eastermonaþ	æ͜ɑːstermoːnɑθ
easterne	æ͜ɑːsterne
eastre	æ͜ɑːstre
eastream	æ͜ɑːstræ͜ɑːm
eastreamyþ	æ͜ɑːstræ͜ɑːmyːθ
eata	æ͜ɑtɑ
eaxel	æ͜ɑksel
eaxl	æ͜ɑksl
eaxlegespann	æ͜ɑkslejespɑnn
eaþ	æ͜ɑːθ
eaþbede	æ͜ɑːθbeːde
eaþbene	æ͜ɑːθbeːne
eaþdæde	æ͜ɑːθdæːde
eaþe	æ͜ɑːθe
eaþmed	æ͜ɑːθmeːd
eaþmedan	æ͜ɑːθmeːdɑn
eaþmod	æ͜ɑːθmoːd
eaþmodheort	æ͜ɑːθmoːdxe͜ort
eaþmodian	æ͜ɑːθmoːdiɑn
eaþmodig	æ͜ɑːθmoːdij
eaþmodlic	æ͜ɑːθmoːdliːt͡ʃ
eaþmodlice	æ͜ɑːθmoːdliːt͡ʃe
eaþmodnes	æ͜ɑːθmoːdnes
ebreisc	ebreːiʃ
ece	et͡ʃe
ece	eːt͡ʃe
ecg	ejj
ecnes	eːknes
edcenning	edkenninɡ
edcierr	edt͡ʃi͜yrr
edcwic	edkwik
edcwician	edkwikiɑn
edcyrr	edt͡ʃyrr
edgeong	edjunɡ
edgild	edjild
edischenn	ediʃxenn
edlesendlic	edlesendliːt͡ʃ
edlæcan	edlæːt͡ʃɑn
edlæcung	edlæːt͡ʃunɡ
edniewan	edni͜yːwɑn
edniewe	edni͜yːwe
edniewian	edni͜yːwiɑn
edniewiend	edni͜yːwiend
edniewinga	edni͜yːwinɡɑ
edniewung	edni͜yːwunɡ
edniwan	edniːwɑn
edniwe	edniːwe
edniwian	edniːwiɑn
edniwigend	edniːwijend
edniwinga	edniːwinɡɑ
edniwung	edniːwunɡ
edor	edor
edstaþelian	edstɑθeliɑn
edstaþeliend	edstɑθeliend
edstaþelig	edstɑθelij
edwendan	edwendɑn
edwenden	edwenden
edwist	edwist
efel	efel
efen	efen
efen	eːfen
efenbyrde	efenbyrde
efencempa	efenkempɑ
efeneardian	efenæ͜ɑrdiɑn
efenhleoþor	efenxle͜oːθor
efenhleoþrian	efenxle͜oːθriɑn
efenhleoþrung	efenxle͜oːθrunɡ
efenhleta	efenxletɑ
efenlic	efenliːt͡ʃ
efenlice	efenliːt͡ʃe
efenlicnes	efenliːknes
efenling	efenlinɡ
efenmetan	efenmetɑn
efenmære	efenmæːre
efenniht	efennixt
efenscyldig	efenʃyldij
efensecgan	efensejjɑn
efenwerod	efenwerod
efenwiht	efenwixt
efenwyrcan	efenwyrt͡ʃɑn
efenwyrcung	efenwyrt͡ʃunɡ
efenwyrhta	efenwyrxtɑ
efes	efes
efesian	efesiɑn
efest	efest
efete	efete
efnan	efnɑn
efnettan	efnettɑn
efor	efor
efstan	efstɑn
eft	eft
eftacenned	eftɑːkenned
eftacennednes	eftɑːkennednes
eftbot	eftboːt
eftcierran	eftt͡ʃi͜yrrɑn
eftcyrran	eftt͡ʃyrrɑn
eftgemyndgian	eftjemyndjiɑn
eftgemyndig	eftjemyndij
eftgian	eftjiɑn
efthweorfan	eftxwe͜orfɑn
eftniewung	eftni͜yːwunɡ
eftniwung	eftniːwunɡ
eg	eːj
ege	eje
ege	eːje
egesa	ejesɑ
egesa	eːɡesɑ
egesian	ejesiɑn
eglan	ejlɑn
egland	eːjlɑnd
egle	ejle
egsian	ejsiɑn
egypte	eɡypte
ehta	extɑ
ehtan	eːxtɑn
ehtend	eːxtend
el	el
elboga	elboɡɑ
elcor	elkor
eldra	eldrɑ
ele	ele
elebeam	elebæ͜ɑːm
eleberge	eleberje
elene	elene
elfen	elfen
elh	elx
ellen	ellen
ellor	ellor
ellærn	ellærn
eln	eln
elnboga	elnboɡɑ
elp	elp
elpenbænen	elpenbæːnen
elpend	elpend
elpendban	elpendbɑːn
elpendbænen	elpendbæːnen
elra	elrɑ
elreord	elre͜ord
elreordig	elre͜ordij
elþeod	elθe͜oːd
elþeodig	elθe͜oːdij
embwlatian	embwlɑːtiɑn
emn	emn
en	ən
encgel	enjel
ende	ende
endedæg	endedæj
endeleas	endelæ͜ɑːs
endeleasnes	endelæ͜ɑːsnes
endesæta	endesæːtɑ
endian	endiɑn
endlefta	endleftɑ
endleofan	endle͜ofɑn
ened	ened
engel	enjel
engellic	enjelliːt͡ʃ
englaland	enɡlɑlɑnd
engle	enɡle
englisc	enɡliʃ
enig	eːnij
enlihtan	enliːxtɑn
ent	ent
entisc	entiʃ
eode	eːo̯de
eodor	e͜odor
eoferwic	e͜oferwiːt͡ʃ
eoferwicscir	e͜oferwiːt͡ʃʃiːr
eofor	e͜ofor
eoforlic	e͜oforliːt͡ʃ
eoforwic	e͜oforwiːt͡ʃ
eoforwicscir	e͜oforwiːt͡ʃʃiːr
eoforþring	e͜oforθrinɡ
eoh	e͜ox
eoh	e͜oːx
eolet	e͜olet
eolh	e͜olx
eolhsand	e͜olxsɑnd
eom	eo̯m
eorclanstan	e͜orklɑnstɑːn
eorcnan	e͜orknɑn
eorcnanstan	e͜orknɑnstɑːn
eored	e͜oːred
eorl	e͜orl
eornost	e͜ornost
eornostlice	e͜ornostliːt͡ʃe
eorp	e͜orp
eorð	e͜orθ
eorðe	e͜orθe
eorþ	e͜orθ
eorþbeofung	e͜orθbe͜ofunɡ
eorþberie	e͜orθberie
eorþberige	e͜orθberije
eorþbifung	e͜orθbifunɡ
eorþcræft	e͜orθkræft
eorþe	e͜orθe
eorþern	e͜orθern
eorþfæt	e͜orθfæt
eorþhnutu	e͜orθxnutu
eorþhus	e͜orθxuːs
eorþlic	e͜orθliːt͡ʃ
eorþling	e͜orθlinɡ
eorþnafela	e͜orθnɑfelɑ
eorþnafola	e͜orθnɑfolɑ
eorþæppel	e͜orθæppel
eosol	e͜osol
eotaland	e͜oːtɑlɑnd
eotan	e͜otɑn
eoten	e͜oten
eotol	e͜otol
eow	e͜oːw
eowan	e͜oːwɑn
eowend	e͜owend
eower	e͜oːwer
eowic	e͜oːwit͡ʃ
eowland	e͜owlɑnd
eowu	e͜oːwu
erce	erke
erian	erjɑn
erschenn	erʃxenn
esa	eːsɑ
esla	eslɑ
esol	esol
essian	essiɑn
est	eːst
etan	etɑn
exanceaster	eksɑnt͡ʃæ͜ɑster
eþel	eːθel
eþelboda	eːθelbodɑ
eþeldream	eːθeldræ͜ɑːm
eþeleard	eːθelæ͜ɑrd
eþelfæsten	eːθelfæsten
eþelland	eːθellɑnd
eþelleas	eːθellæ͜ɑːs
eþelmearc	eːθelmæ͜ɑrk
eþelrice	eːθelriːt͡ʃe
eþelriht	eːθelrixt
eþelstaþol	eːθelstɑθol
eþelstol	eːθelstoːl
eþelstow	eːθelstoːw
eþelturf	eːθelturf
eþelweard	eːθelwæ͜ɑrd
eþelwynn	eːθelwynn
eþelþrym	eːθelθrym
eþian	eːθiɑn
facentacen	fɑːkentɑːken
facian	fɑːkiɑn
facn	fɑːkn
fadian	fɑdiɑn
fagettan	fɑːɡettɑn
fagnian	fɑɡniɑn
fah	fɑːx
fallan	fɑllɑn
fals	fɑls
fam	fɑːm
famblawende	fɑːmblɑːwende
famig	fɑːmij
fana	fɑnɑ
fand	fɑnd
fandian	fɑndiɑn
fang	fɑnɡ
fanu	fɑnu
faran	fɑrɑn
faroþ	fɑroθ
faru	fɑru
fas	fɑs
fatian	fɑtiɑn
faþe	fɑθe
faþu	fɑθu
fealcen	fæ͜ɑlken
feald	fæ͜ɑld
fealdan	fæ͜ɑldɑn
fealg	fæ͜ɑlɡ
fealh	fæ͜ɑlx
feall	fæ͜ɑll
feallan	fæ͜ɑllɑn
fealle	fæ͜ɑlle
fealu	fæ͜ɑlu
fealwian	fæ͜ɑlwiɑn
fearh	fæ͜ɑrx
fearm	fæ͜ɑrm
fearn	fæ͜ɑrn
fearr	fæ͜ɑrr
feasceaft	fæ͜ɑːʃæ͜ɑft
feaw	fæ͜ɑːw
feax	fæ͜ɑks
feaxnett	fæ͜ɑksnett
feccan	fett͡ʃɑn
fedan	feːdɑn
feder	feder
fefor	fefor
fegan	feːjɑn
feh	fex
feht	fext
fehtan	fextɑn
fela	felɑ
felafeald	felɑfæ͜ɑld
felahror	felɑxroːr
felan	feːlɑn
feld	feld
feldbeo	feldbe͜oː
feldielfen	feldi͜ylfen
feldlic	feldliːt͡ʃ
feldmore	feldmore
feldswamm	feldswɑmm
feldwyrt	feldwyrt
feldælfen	feldælfen
fell	fell
fellan	fellɑn
fellen	fellen
felt	felt
feltwurma	feltwurmɑ
feltwyrt	feltwyrt
femne	feːmne
fenester	fenester
fengel	fenɡel
fenix	feːniks
fenlic	fenliːt͡ʃ
fenn	fenn
fennig	fennij
feogan	fe͜oːjɑn
feogean	fe͜oːjɑn
feoh	fe͜ox
feohbot	fe͜oxboːt
feohern	fe͜oxern
feohgift	fe͜oxjift
feoht	fe͜oxt
feohtan	fe͜oxtɑn
feohtlac	fe͜oxtlɑːk
feola	fe͜olɑ
feolan	fe͜oːlɑn
feolo	fe͜olo
feond	fe͜oːnd
feondlic	fe͜oːndliːt͡ʃ
feondræden	fe͜oːndræːden
feondscipe	fe͜oːndʃipe
feor	fe͜or
feorbuend	fe͜orbuːend
feorh	fe͜orx
feorhbealo	fe͜orxbæ͜ɑlo
feorhscyldig	fe͜orxʃyldij
feorhweard	fe͜orxwæ͜ɑrd
feorm	fe͜orm
feormeham	fe͜ormexɑːm
feormere	fe͜ormere
feormian	fe͜ormiɑn
feornes	fe͜ornes
feorr	fe͜orr
feorran	fe͜orrɑn
feorsian	fe͜orsiɑn
feortan	fe͜ortɑn
feorweg	fe͜orwej
feorða	fe͜oːrθɑ
feorþa	fe͜oːrθɑ
feower	fe͜oːwer
feowerfeald	fe͜oːwerfæ͜ɑld
feowerteoþa	fe͜oːwerte͜oːθɑ
feowertiene	fe͜oːwerti͜yːne
feowertig	fe͜oːwertij
feran	feːrɑn
ferdwite	ferdwiːte
ferht	ferxt
ferhþ	ferxθ
ferian	ferjɑn
ferræden	feːrræːden
fers	fers
fersc	ferʃ
ferþ	ferθ
fesian	feːsiɑn
fet	feːt
fetel	fetel
feter	feter
fetian	fetiɑn
feþer	feθer
feþerbære	feθerbæːre
fic	fiːk
fician	fikiɑn
ficol	fikol
fictreow	fiːktre͜oːw
fieldestol	fi͜yldestoːl
fieldstol	fi͜yldstoːl
fiell	fi͜yll
fiellan	fi͜yllɑn
fielleseoc	fi͜yllese͜oːk
fielleseocnes	fi͜yllese͜oːknes
fierd	fi͜yrd
fierdfæreld	fi͜yrdfæreld
fierr	fi͜yrr
fiersn	fi͜yrsn
fierst	fi͜yrst
fif	fiːf
fifealde	fiːfæ͜ɑlde
fifel	fiːfel
fifelcynn	fiːfelkynn
fiffeald	fiːffæ͜ɑld
fiffealde	fiːffæ͜ɑlde
fifta	fiːftɑ
fifteoþa	fiːfte͜oːθɑ
fiftiene	fiːfti͜yːne
fiftig	fiːftij
filmen	filmen
fina	finɑ
finc	fint͡ʃ
findan	findɑn
findaþ	findɑθ
findig	findij
finger	finɡer
fingerdocce	finɡerdokke
fingeræppel	finɡeræppel
finn	finn
finta	fintɑ
finul	finul
firas	fiːrɑs
firen	firen
firendæd	firendæːd
firenfull	firenfull
firengeorn	firenje͜orn
firenhycga	firenxyjjɑ
firenhycge	firenxyjje
firenian	fireniɑn
firenleahtor	firenlust
firenlic	firenliːt͡ʃ
firenlice	firenliːt͡ʃe
firenligerian	firenlijerjɑn
firenlust	firenlust
firensynn	firensynn
firensynnig	firensynnij
firentacen	firentɑːken
firentacnian	firentɑːkniɑn
firenum	firenum
firgen	firɡen
firgengat	firɡenɡɑːt
fisc	fiʃ
fiscere	fiʃʃere
fiscian	fiskiɑn
fisclacu	fiʃlɑku
fiscoþ	fiskoθ
fitt	fitt
fixen	fiksen
fiþerbære	fiθerbæːre
fiþere	fiθere
fiþerfete	fiθerfeːte
fiþerian	fiθeriɑn
fiþerleas	fiθerlæ͜ɑːs
fiþre	fiθre
fiþrian	fiθriɑn
fla	flɑː
flacor	flɑkor
flan	flɑːn
flanhræd	flɑːnxræd
flaniht	flɑːnixt
flanþracu	flɑːnθrɑku
flasce	flɑske
flat	flɑːt
flaxe	flɑkse
fleah	flæ͜ɑːx
fleam	flæ͜ɑːm
flean	flæ͜ɑːn
fleard	flæ͜ɑrd
fleardere	flæ͜ɑrdere
fleax	flæ͜ɑks
fleaxen	flæ͜ɑksen
flegan	fleːɡɑn
fleo	fle͜oː
fleogan	fle͜oːɡɑn
fleoge	fle͜oːɡe
fleogenda	fle͜oːɡendɑ
fleohtan	fle͜oxtɑn
fleon	fle͜oːn
fleos	fle͜oːs
fleotan	fle͜oːtɑn
flering	fleːrinɡ
flet	flet
flet	fleːt
fletgefeoht	fletjefe͜oxt
flett	flett
flewsa	fleːwsɑ
flicorian	flikoriɑn
fliema	fli͜yːmɑ
fliete	fli͜yːte
flitan	fliːtɑn
flitcræft	fliːtkræft
flocc	flokk
floccmælum	flokkmæːlum
flocmælum	flokmæːlum
flod	floːd
flodyþ	floːdyːθ
flor	floːr
florstan	floːrstɑːn
flota	flotɑ
flotian	flotiɑn
flowan	floːwɑn
flugol	fluɡol
flyht	flyxt
flæsc	flæːʃ
flæsclic	flæːʃliːt͡ʃ
flæscmangere	flæːʃmɑnɡere
flæscmete	flæːʃmete
fneosan	fne͜oːsɑn
fnora	fnorɑ
fnæd	fnæd
fnæs	fnæs
fnæst	fnæst
foda	foːdɑ
fodor	foːdor
fola	folɑ
folc	folk
folcgefeoht	folkjefe͜oxt
folcland	folklɑnd
folclar	folklɑːr
folclic	folkliːt͡ʃ
folcræden	folkræːden
folcstede	folkstede
foldbold	foldbold
foldbuend	foldbuːend
folde	folde
folgian	folɡiɑn
folm	folm
fon	foːn
for	for
for	foːr
foran	forɑn
forbeodan	forbe͜oːdɑn
forberan	forberɑn
forberstan	forberstɑn
forbiernan	forbi͜yrnɑn
forbindan	forbindɑn
forbirnan	forbirnɑn
forbitan	forbiːtɑn
forblawan	forblɑːwɑn
forbod	forbod
forboden	forboden
forbrecan	forbrekɑn
forbugan	forbuːɡɑn
forbugennes	forbuːɡennes
forbugennys	forbuːɡennys
forbærnan	forbærnɑn
forca	forkɑ
forcel	forkel
forceorfan	fort͡ʃe͜orfɑn
forcierrednes	fort͡ʃi͜yrrednes
forcippian	fort͡ʃippiɑn
forclingan	forklinɡɑn
forcuman	forkumɑn
forcweþan	forkweθɑn
forcyrran	fort͡ʃyrrɑn
forcyrrednes	fort͡ʃyrrednes
forcyrring	fort͡ʃyrrinɡ
ford	ford
fordeman	fordeːmɑn
fordon	fordoːn
fordragan	fordrɑɡɑn
fordrencan	fordrent͡ʃɑn
fordrifan	fordriːfɑn
fordrincan	fordrinkɑn
fordrugian	fordruːɡiɑn
fordruncnian	fordrunkniɑn
fordwinan	fordwiːnɑn
fordælan	fordæːlɑn
forealdian	foræ͜ɑldiɑn
foreberan	foreberɑn
forebisen	forebiːsen
forebisgian	forebisjiɑn
forebodian	forebodiɑn
foreceorfan	foret͡ʃe͜orfɑn
forecuman	forekumɑn
forecweþan	forekweθɑn
foredeman	foredeːmɑn
forefon	forefoːn
foregan	foreɡɑːn
foregangan	foreɡɑnɡɑn
foregenga	foreɡenjɑ
foregengel	foreɡenjel
forelar	foːrelɑːr
forelocc	forelokk
forelædan	forelæːdɑn
foremearcod	foremæ͜ɑrkod
foremearcung	foremæ͜ɑrkunɡ
forenama	forenɑmɑ
foresceawian	foreʃæ͜ɑːwiɑn
foresceawung	foreʃæ͜ɑːwunɡ
foresecgan	foresejjɑn
foresendan	foresendɑn
foreseon	forese͜oːn
foresetnes	foresetnes
foresettan	foresettɑn
foresmeagan	foresmæ͜ɑːjɑn
forespræc	forespræːt͡ʃ
forestandan	forestɑndɑn
foresteall	forestæ͜ɑll
foresteppan	foresteppɑn
foresægdnes	foresæjdnes
foretacen	foretɑːken
foreward	forewɑrd
forewarnian	forewɑrniɑn
foreweard	forewæ͜ɑrd
forewitan	forewitɑn
forewittig	forewittij
forewritan	forewriːtɑn
foreþencan	foreθent͡ʃɑn
foreþingian	foreθinɡiɑn
forfaran	forfɑrɑn
forfon	forfoːn
forgan	forɡɑːn
forgangan	forɡɑnɡɑn
forgeaf	forjæɑ̯f
forgeald	forjæɑ̯ld
forgengel	forɡenjel
forgiefan	forji͜yfɑn
forgiefendlic	forji͜yfendliːt͡ʃ
forgieldan	forji͜yldɑn
forgieman	forji͜yːmɑn
forgiemeleasian	forji͜yːmelæ͜ɑːsiɑn
forgiemeleasnes	forji͜yːmelæ͜ɑːsnes
forgietan	forji͜ytɑn
forgifendlic	forjifendliːt͡ʃ
forgifnes	forjifnes
forgnagan	forɡnɑɡɑn
forgripan	forɡriːpɑn
forgrowan	forɡroːwɑn
forgyman	forjyːmɑn
forgymeleasian	forjyːmelæ͜ɑːsiɑn
forgymeleasnes	forjyːmelæ͜ɑːsnes
forgyrdan	forɡyrdɑn
forhabban	forxɑbbɑn
forhatan	forxɑːtɑn
forhatena	forxɑːtenɑ
forhealdan	forxæ͜ɑldɑn
forheardian	forxæ͜ɑrdiɑn
forhelan	forxelɑn
forhierdan	forxi͜yrdɑn
forhweorfan	forxwe͜orfɑn
forhycgan	forxyjjɑn
forhydan	forxyːdɑn
forhyrdan	forxyrdɑn
forleosan	forle͜oːsɑn
forlicgan	forliɡɡɑn
forliden	forliden
forlidennes	forlidennes
forliger	forlijer
forligerhus	forlijerxuːs
forliþan	forliːθɑn
forloren	forloren
forlædan	forlæːdɑn
forlæran	forlæːrɑn
forlætan	forlæːtɑn
forma	formɑ
formeltan	formeltɑn
formest	formest
forn	forn
forn	foːrn
forneah	fornæ͜ɑːx
forniman	fornimɑn
forrædan	forræːdɑn
forsacan	forsɑkɑn
forsace	forsɑke
forsacende	forsɑkende
forsceadan	forʃæ͜ɑːdɑn
forsceadan	forʃɑːdɑn
forscieppan	forʃi͜yppɑn
forscrihan	forʃriːxɑn
forscrincan	forʃrinkɑn
forscyldig	forʃyldij
forscyldigian	forʃyldiɡiɑn
forscyttan	forʃyttɑn
forsecan	forseːt͡ʃɑn
forsecgan	forsejjɑn
forsellan	forsellɑn
forsendan	forsendɑn
forseon	forse͜oːn
forseoþan	forse͜oːθɑn
forsettan	forsettɑn
forsewennes	forsewennes
forsittan	forsittɑn
forslawian	forslɑːwiɑn
forslean	forslæ͜ɑːn
forsoc	forsoːk
forsocon	forsoːkon
forspendan	forspendɑn
forspennend	forspennend
forspillan	forspillɑn
forsprecan	forsprekɑn
forst	forst
forstandan	forstɑndɑn
forstelan	forstelɑn
forstes	forstes
forstoppian	forstoppiɑn
forswelgan	forswelɡɑn
forswerian	forswerjɑn
forswiþan	forswiːθɑn
forsæcþ	forsækθ
forteon	forte͜oːn
fortredan	fortredɑn
forweaxan	forwæ͜ɑksɑn
forwemman	forwemmɑn
forwenan	forweːnɑn
forweorpan	forwe͜orpɑn
forweorþan	forwe͜orθɑn
forwlencan	forwlent͡ʃɑn
forwrecan	forwrekɑn
forwundian	forwundiɑn
forwyrcan	forwyrt͡ʃɑn
forð	forθ
forþ	forθ
forþberan	forθberɑn
forþbringan	forθbrinɡɑn
forþcuman	forθkumɑn
forþfaran	forθfɑrɑn
forþferan	forθfeːrɑn
forþferde	forθfeːrde
forþflowan	forθfloːwɑn
forþgan	forθɡɑːn
forþgang	forθɡɑnɡ
forþgangan	forθɡɑnɡɑn
forþgeriman	forθjeriːmɑn
forþgesceaft	forθjeʃæ͜ɑft
forþgestigan	forθjestiːɡɑn
forþgewitan	forθjewiːtɑn
forþgewiten	forθjewiten
forþgewitennes	forθjewitennes
forþlædan	forθlæːdɑn
forþrysmian	forθrysmiɑn
forþscype	forθʃype
forþsendan	forθsendɑn
forþsprecan	forθsprekɑn
forþteon	forθte͜oːn
forþwisian	forθwiːsiɑn
foster	foːster
fostor	foːstor
fot	foːt
fotadl	foːtɑːdl
fotadlig	foːtɑːdlij
fotlic	foːtliːt͡ʃ
fotmælum	foːtmæːlum
fotscamol	foːtʃɑmol
fotsceamol	foːtʃɑmol
fotwielm	foːtwi͜ylm
fox	foks
foxhol	foksxol
fram	frɑm
framacyrran	frɑmɑːt͡ʃyrrɑn
framateon	frɑmɑːte͜oːn
frambugan	frɑmbuːɡɑn
framcierran	frɑmt͡ʃi͜yrrɑn
framcynn	frɑmkynn
framfæreld	frɑmfæreld
framhweorfan	frɑmxwe͜orfɑn
framian	frɑmiɑn
franca	frɑnkɑ
francland	frɑnklɑnd
francrice	frɑnkriːt͡ʃe
frasian	frɑːsiɑn
frasung	frɑːsunɡ
frea	fræ͜ɑː
freadrihten	fræ͜ɑːdrixten
fream	fræːɑ̯m
frean	fræːɑ̯n
freana	fræːɑ̯nɑ
frec	frek
frecen	freːken
frecennes	freːkennes
frecgan	frejjɑn
frecne	freːkne
fredan	freːdɑn
frefran	freːfrɑn
fregen	frejen
fregn	frejn
fregnan	frejnɑn
freht	frext
fremde	fremde
freme	freme
fremede	fremede
fremedlæcan	fremedlæːt͡ʃɑn
fremeþe	fremeθe
fremman	fremmɑn
frencisc	frent͡ʃiʃ
freo	fre͜oː
freod	fre͜oːd
freodom	fre͜oːdoːm
freogan	fre͜oːjɑn
freoh	fre͜oːx
freolac	fre͜oːlɑːk
freolic	fre͜oːliːt͡ʃ
freolice	fre͜oːliːt͡ʃe
freols	fre͜oːls
freolsian	fre͜oːlsiɑn
freolsiend	fre͜oːlsiend
freond	fre͜oːnd
freondlar	fre͜oːndlɑːr
freondlaþu	fre͜oːndlɑθu
freondleas	fre͜oːndlæ͜ɑːs
freondlic	fre͜oːndliːt͡ʃ
freondræden	fre͜oːndræːden
freondscipe	fre͜oːndʃipe
freosan	fre͜oːsɑn
freoþuwebba	fre͜oθuwebbɑ
freslond	freːslond
fretan	fretɑn
fricgan	frijjɑn
frician	frikiɑn
frician	friːkiɑn
friclu	friklu
fricu	friku
friesa	fri͜ysɑ
frig	friːj
frigedæg	friːjedæj
frignan	frijnɑn
frinan	friːnɑn
friþ	friθ
friþ	friːθ
friþhus	friθxuːs
friþian	friθiɑn
friþigend	friθijend
friþleas	friθlæ͜ɑːs
friþlic	friθliːt͡ʃ
friþlice	friθliːt͡ʃe
friþotacen	friθotɑːken
friþowebba	friθowebbɑ
friþsum	friθsum
friþsumian	friθsumiɑn
frocga	froɡɡɑ
frod	froːd
frofor	froːfor
froforgast	froːforɡɑːst
from	from
fromcynn	fromkynn
fromcyrran	fromt͡ʃyrrɑn
fromhweorfan	fromxwe͜orfɑn
frosc	froʃ
frowe	froːwe
frox	froks
fruma	frumɑ
frumcynn	frumkynn
frumcyrr	frumt͡ʃyrr
frumlida	frumlidɑ
frumsceaft	frumʃæ͜ɑft
fryhtu	fryxtu
frymþ	frymθ
frymþu	frymθu
frysa	frysɑ
fræfel	fræfel
frægn	fræjn
frægning	fræjninɡ
frætwe	frætwe
fugelere	fuɡelere
fuglere	fuɡlere
fugol	fuɡol
fuht	fuːxt
ful	ful
ful	fuːl
fuldon	fuldoːn
fulfremed	fulfremed
fulfremednes	fulfremednes
fulgenihtsum	fuljenixtsum
fulian	fuːliɑn
full	full
fullfyllan	fullfyllɑn
fullice	fulliːt͡ʃe
fulnes	fuːlnes
fultum	fultum
fultuman	fultumɑn
fultumian	fultumiɑn
fultumleas	fultumlæ͜ɑːs
fulwian	fulwiɑn
fulwiht	fulwixt
fulwihtan	fulwixtɑn
fulwihtian	fulwixtiɑn
fundian	fundiɑn
furþum	furθum
fus	fuːs
fyhtan	fyːxtɑn
fylan	fyːlɑn
fylgan	fyljɑn
fyllan	fyllɑn
fyllu	fyllu
fylþ	fyːlθ
fylþu	fyːlθu
fyndel	fyndel
fyr	fyr
fyr	fyːr
fyrd	fyrd
fyrdrinc	fyrdrink
fyrdsearu	fyrdsæ͜ɑru
fyrdwite	fyrdwiːte
fyren	fyren
fyren	fyːren
fyrenþearf	fyrenθæ͜ɑrf
fyrest	fyrest
fyrgengat	fyrjenɡɑːt
fyrhtu	fyrxtu
fyrhus	fyːrxuːs
fyrhþ	fyrxθ
fyrhþe	fyrxθe
fyrmest	fyrmest
fyrn	fyrn
fyrst	fyrst
fyrstan	fyːrstɑːn
fyrtorr	fyːrtorr
fyrwet	fyrwet
fyrwit	fyrwit
fysan	fyːsɑn
fysian	fyːsiɑn
fyst	fyːst
fyxen	fyksen
fæc	fæk
fæcele	fækele
fæcne	fæːkne
fæder	fæder
fædera	fæderɑ
fæderen	fæderen
fæderland	fæderlɑnd
fæderleas	fæderlæ͜ɑːs
fæderlic	fæderliːt͡ʃ
fæderrice	fæderriːt͡ʃe
fægan	fæːjɑn
fæge	fæːje
fægen	fæjen
fæger	fæjer
fægernes	fæjernes
fægnian	fæjniɑn
fæhþ	fæːxθ
fæhþbot	fæːxθboːt
fæhþe	fæːhθe
fæhþu	fæːxθu
fæla	fæːlɑ
fæle	fæːle
fælsian	fæːlsiɑn
fæman	fæːmɑn
fæmende	fæːmende
fæmne	fæːmne
fæmnhad	fæːmnxɑːd
fær	fær
fær	fæːr
færbu	færbu
færeld	færeld
færeldboc	færeldboːk
færeldfreols	færeldfre͜oːls
færgripe	fæːrɡripe
færgryre	fæːrɡryre
færinga	fæːrinɡɑ
fæs	fæs
fæsl	fæsl
fæss	fæss
fæst	fæst
fæstan	fæstɑn
fæsten	fæsten
fæstlice	fæstliːt͡ʃe
fæstnes	fæstnes
fæstnian	fæstniɑn
fæstnung	fæstnunɡ
fæt	fæt
fæt	fæːt
fætels	fætels
fætnes	fætnes
fætt	fæːtt
fæx	fæks
fæþm	fæθm
gaast	ɡɑːst
gaderian	ɡɑderiɑn
gaderung	ɡɑderunɡ
gador	ɡɑdor
gadrian	ɡɑdriɑn
gafol	ɡɑfol
gafolrand	ɡɑfolrɑnd
gafolræden	ɡɑfolræːden
gal	ɡɑːl
galan	ɡɑlɑn
galdor	ɡɑldor
galdre	ɡɑldre
galfull	ɡɑːlfull
gamen	ɡɑmen
gamenian	ɡɑmeniɑn
gamnian	ɡɑmniɑn
gamol	ɡɑmol
gan	ɡɑːn
gang	ɡɑnɡ
gangan	ɡɑnɡɑn
gangere	ɡɑnɡere
gangern	ɡɑnɡern
gangweg	ɡɑnɡwej
ganot	ɡɑnot
ganra	ɡɑnrɑ
gar	ɡɑːr
garas	ɡɑːrɑs
gardena	ɡɑːrdenɑ
gardene	ɡɑːrdene
garleac	ɡɑːrlæ͜ɑːk
garsecg	ɡɑːrsejj
gast	ɡɑːst
gastbana	ɡɑːstbɑnɑ
gastberend	ɡɑːstberend
gastcund	ɡɑːstkund
gastgedal	ɡɑːstjedɑːl
gastgifu	ɡɑːstjifu
gastleas	ɡɑːstlæ͜ɑːs
gastlic	ɡɑːstliːt͡ʃ
gastlice	ɡɑːstliːt͡ʃe
gastsunu	ɡɑːstsunu
gat	ɡɑːt
gathierde	ɡɑːtxi͜yrde
gathiorde	ɡɑːtxi͜urde
gathyrde	ɡɑːtxyrde
gatum	ɡɑːtum
ge	je
ge	jeː
gea	jæ͜ɑː
geac	jæ͜ɑːk
geaces	jæ͜ɑːkes
geador	jæ͜ɑdor
geador	ɡæ͜ɑdor
geafon	jæ͜ɑːfon
geagnian	jeɑːɡniɑn
geagniendlic	jɑːɡni͜yndliːt͡ʃ
geagnigendlic	jɑːɡnijendliːt͡ʃ
geahl	jæ͜ɑxl
gealdor	jæ͜ɑldor
gealga	jæ͜ɑlɡɑ
gealla	jæ͜ɑllɑ
gean	jæ͜ɑːn
geancyrr	jæ͜ɑːnt͡ʃyrr
geanhweorfan	jæ͜ɑːnxwe͜orfɑn
geanian	jeɑːniɑn
geanlæcan	jeɑːnlæːt͡ʃɑn
geap	jæ͜ɑːp
gear	jæ͜ɑːr
geara	jɑːrɑ
gearcian	jæ͜ɑrkiɑn
geard	jæ͜ɑrd
geardagas	jæ͜ɑːrdɑɡɑs
geardagum	jæ͜ɑːrdɑɡum
geardum	jæɑrdum
gearlic	jæ͜ɑːrliːt͡ʃ
gearn	jæ͜ɑrn
gearu	jæ͜ɑru
gearwe	jæ͜ɑrwe
gearwian	jæ͜ɑrwiɑn
geascian	jeɑːskiɑn
geat	jæ͜ɑt
geat	jæ͜ɑːt
geatan	jæ͜ɑːtɑn
geatolic	jæ͜ɑtoliːt͡ʃ
geatwa	jæ͜ɑtwɑ
geatwe	jæ͜ɑtwe
gebad	jebɑːd
gebannan	jebɑnnɑn
gebeacnian	jebæ͜ɑːkniɑn
gebeagian	jebæ͜ɑːɡiɑn
gebed	jebed
gebedda	jebeddɑ
gebeodan	jebe͜oːdɑn
gebeor	jebe͜oːr
gebeorc	jebe͜ork
gebeorg	jebe͜orɡ
gebeotian	jebe͜oːtiɑn
geberan	jeberɑn
gebetan	jebeːtɑn
gebeterian	jebeteriɑn
gebetung	jebeːtunɡ
gebicnian	jebiːkniɑn
gebidan	jebiːdɑn
gebiddan	jebiddɑn
gebigednes	jebiːjednes
gebindan	jebindɑn
gebland	jeblɑnd
geblandan	jeblɑndɑn
geblissian	jeblissiɑn
geblowan	jebloːwɑn
gebod	jebod
gebodian	jebodiɑn
gebrecan	jebrekɑn
gebringan	jebrinɡɑn
gebrot	jebrot
gebrucan	jebruːkɑn
gebugan	jebuːɡɑn
gebur	jebuːr
gebygan	jebyːjɑn
gebygednys	jebyːjednys
gebyrd	jebyrd
gebyrddæg	jebyrddæj
gebyrde	jebyrde
gebyrian	jebyrjɑn
gebæc	jebæk
gecanc	jekɑnk
gecennan	ɡekennɑn
geceosan	jet͡ʃe͜oːsɑn
gecid	jet͡ʃiːd
gecidan	jet͡ʃiːdɑn
geciegan	jet͡ʃi͜yːjɑn
geciegendlic	jet͡ʃi͜yːjendliːt͡ʃ
gecierran	jet͡ʃi͜yrrɑn
gecierrednes	jet͡ʃi͜yrrednes
gecigendlic	jet͡ʃiːjendliːt͡ʃ
geclofa	ɡeklofɑ
gecnawan	jeknɑːwɑn
gecneordlæcan	jekne͜ordlæːt͡ʃɑn
gecnos	jeknos
gecnyssan	jeknyssɑn
gecnyttan	jeknyttɑn
gecnæwe	jeknæːwe
gecocnian	jekoːkniɑn
gecocsian	jekoːksiɑn
gecor	jekor
gecorennes	jekorennes
gecorenscipe	jekorenʃipe
gecoronian	jekoroːniɑn
gecuman	jekumɑn
gecweþan	jekweθɑn
gecwician	jekwikiɑn
gecwide	jekwide
gecwidræden	jekwidræːden
gecynd	jekynd
gecyndboc	jekyndboːk
gecynde	jekynde
gecyndelic	jekyndeliːt͡ʃ
gecyndespræc	jekyndespræːt͡ʃ
gecyndlim	jekyndlim
gecyrran	jet͡ʃyrrɑn
gecyrrednes	jet͡ʃyrrednes
gecyrring	jet͡ʃyrrinɡ
gecyþan	jekyːθɑn
gedal	jedɑːl
geddung	jeddunɡ
gedefe	jedeːfe
gediegan	jedi͜yːjɑn
gedigan	jediːjɑn
gediht	jedixt
gedon	jedoːn
gedrefednes	jedreːfednes
gedrefend	jedreːfend
gedrefnes	jedreːfnes
gedreohlice	jedre͜oːxliːt͡ʃe
gedriht	jedrixt
gedritan	jedriːtɑn
gedruncnian	jedrunkniɑn
gedryht	jedryxt
gedwild	jedwild
gedwimor	jedwimor
gedwol	jedwol
gedwola	jedwolɑ
gedwolcræft	jedwolkræft
gedwolgod	jedwolɡod
gedwolmann	jedwolmɑnn
gedwolspræc	jedwolspræːt͡ʃ
gedwolsum	jedwolsum
gedwomer	jedwomer
gedæfte	jedæfte
gedælan	jedæːlɑn
gee	jeː
geeardian	jeæ͜ɑrdiɑn
geeaþmedan	jeæ͜ɑːθmeːdɑn
geeaþmodian	jeæ͜ɑːθmoːdiɑn
geedfreolsian	jeedfre͜oːlsiɑn
geefenlæcan	jeefenlæːt͡ʃɑn
geendian	jeendiɑn
geerian	jeerjɑn
geetan	jeetɑn
gefan	jefɑn
gefangian	jefɑnɡiɑn
gefaran	jefɑrɑn
gefea	jefæ͜ɑː
gefeah	jefæɑx
gefealdan	jefæ͜ɑldɑn
gefeallan	jefæ͜ɑllɑn
gefed	jefeːd
gefegan	jefeːjɑn
gefegnes	jefeːjnes
gefelan	jefeːlɑn
gefeoht	jefe͜oxt
gefeohtan	jefe͜oxtɑn
gefeohtdæg	jefe͜oxtdæj
gefeon	jefe͜oːn
gefer	jefeːr
gefera	jefeːrɑ
gefere	jefeːre
geferlæcan	jefeːrlæːt͡ʃɑn
geferræden	jefeːrræːden
gefic	jefik
gefindan	jefindɑn
geflowan	jefloːwɑn
gefog	jefoːɡ
gefolgian	jefolɡiɑn
gefon	jefoːn
gefrasian	jefrɑːsiɑn
gefredan	jefreːdɑn
gefrignan	jefrijnɑn
gefroren	jefroren
gefrugnon	jefruːjnon
gefrunon	jefruːnon
gefræge	jefræːje
gefrætwian	jefrætwiɑn
gefyllan	jefyllɑn
gefæd	jefæd
gefædera	jefæderɑ
gefær	jefæːr
gefæstnian	jefæstniɑn
gegaderian	jeɡɑderiɑn
gegaderung	jeɡɑderunɡ
gegang	jeɡɑnɡ
gegangan	jeɡɑnɡɑn
gegierwan	jeji͜yrwɑn
gegn	jejn
gegncwide	jejnkwide
gegnum	jejnum
gegrapian	jeɡrɑːpiɑn
gegripan	jeɡriːpɑn
gegripennis	jeɡripennis
gegrundweallian	jeɡrundwæ͜ɑlliɑn
gegræppian	jeɡræppiɑn
gegyrdan	ɡeɡyrdɑn
gegyrwan	jejyrwɑn
gehabban	jexɑbbɑn
gehat	jexɑːt
gehatan	jexɑːtɑn
gehathiertan	jexɑːtxi͜yrtɑn
gehatland	jexɑːtlɑnd
gehealdan	jexæ͜ɑldɑn
gehealdsum	jexæ͜ɑldsum
gehebban	jexebbɑn
gehende	jexende
geherian	jexerjɑn
geherigendlic	jexerijendliːt͡ʃ
gehiegan	jexi͜yːjɑn
gehieran	jexi͜yːrɑn
gehierdan	jexi͜yrdɑn
gehierendlic	jexi͜yːrendliːt͡ʃ
gehiersum	jexi͜yːrsum
gehiersumian	jexi͜yːrsumiɑn
gehiersumnes	jexi͜yːrsumnes
gehiertan	jexi͜yrtɑn
gehiewian	jexi͜yːwiɑn
gehiwcuþlician	jexiːwkuːθliːkiɑn
gehiwian	jexiːwiɑn
gehlow	jexloːw
gehnycned	jehnykned
geholian	jexoliɑn
gehon	jexoːn
gehreran	jexreːrɑn
gehrespan	ɡexrespɑn
gehrinan	jexriːnɑn
gehwa	jexwɑː
gehweorfan	jexwe͜orfɑn
gehwone	jexwone
gehwylc	jexwylt͡ʃ
gehwæde	jexwæːde
gehwædnes	jexwæːdnes
gehwædnis	jexwæːdnis
gehwædnys	jexwæːdnys
gehwær	jexwæːr
gehwære	jexwæːre
gehycgan	jexyjjɑn
gehygd	jexyjd
gehyran	jexyːrɑn
gehyrdan	jexyrdɑn
gehyrde	jehyːrde
gehyrsum	jexyːrsum
gehælan	jexæːlɑn
gehæp	jexæp
gehðu	jexθu
geiecan	jei͜yːt͡ʃɑn
geiecendlic	jei͜yːt͡ʃendliːt͡ʃ
geiewan	jei͜yːwɑn
geimpian	jeimpiɑn
geinlagian	jeinlɑɡiɑn
geinnian	jeinniɑn
gelafian	jelɑfiɑn
gelanda	jelɑndɑ
geldan	jeldɑn
geleafa	jelæ͜ɑːfɑ
geleaffull	jelæ͜ɑːffull
geleaful	jelæ͜ɑːful
gelecgan	jelejjɑn
gelendan	jelendɑn
geleod	jele͜oːd
gelibban	jelibbɑn
gelic	jeliːt͡ʃ
gelica	jeliːkɑ
gelician	jeliːkiɑn
geliclic	jeliːkliːt͡ʃ
gelicnes	jeliːknes
geliefan	jeli͜yːfɑn
geliesan	jeli͜yːsɑn
geliffæstan	jeliːffæstɑn
geliger	jelijer
geligere	jelijere
geligre	jelijre
geliman	jeliːmɑn
gelimpan	jelimpɑn
gelimplic	jelimpliːt͡ʃ
gelimplice	jelimpliːt͡ʃe
geliþan	jeliːθɑn
gelodwyrt	jelodwyrt
gelogian	jeloːɡiɑn
gelom	jeloːm
gelome	jeloːme
gelonda	jelondɑ
gelotendæg	jelotendæj
gelp	jelp
gelpan	jelpɑn
gelyfan	jelyːfɑn
gelysan	jelyːsɑn
gelædan	jelæːdɑn
gelæfan	jelæːfɑn
gelær	jelæːr
gelæran	jelæːrɑn
gelæred	jelæːred
gelæstan	jelæːstɑn
gelæte	jelæːte
gemacian	jemɑkiɑn
gemagian	jemɑɡiɑn
geman	jemɑn
gemana	jemɑːnɑ
gemang	jemɑnɡ
gemangian	jemɑnɡiɑn
gemanian	jemɑniɑn
gemanigfealdian	jemɑnijfæ͜ɑldiɑn
gemanigfieldan	jemɑnijfi͜yldɑn
gemanigfyldan	jemɑnijfyldɑn
gemearcian	jemæ͜ɑrkiɑn
gemearcod	jemæ͜ɑrkod
gemede	jemeːde
gemengan	jemenjɑn
gemet	jemet
gemetan	jemetɑn
gemetan	jemeːtɑn
gemetfæt	jemetvæt
gemimor	jemimor
geminsian	jeminsiɑn
gemittan	jemittɑn
gemot	jemoːt
gemotern	jemoːtern
gemunan	jemunɑn
gemynd	jemynd
gemyndelic	jemyndeliːt͡ʃ
gemyndful	jemyndful
gemyndfull	jemyndfull
gemyndig	jemyndij
gemyndleas	jemyndlæ͜ɑːs
gemyntan	jemyntɑn
gemyþ	jemyːθ
gemyþe	jemyːθe
gemædan	jemæːdɑn
gemæne	jemæːne
gemænelic	jemæːneliːt͡ʃ
gemænscipe	jemæːnʃipe
gemære	jemæːre
gemærsian	jemæːrsiɑn
gemærsung	jemæːrsunɡ
gemætan	jemæːtɑn
gemæte	jemæːte
gemœtan	jemøːtɑn
gen	jeːn
genear	jenæ͜ɑr
geneat	jenæ͜ɑːt
genefa	jenefɑ
genemnan	jenemnɑn
genemnendlic	jenemnendliːt͡ʃ
gener	jener
generian	jenerjɑn
generstede	jenerstede
genesan	jenesɑn
geniedan	jeni͜yːdɑn
genift	jenift
geniht	jenixt
genihtful	jenixtful
genihtlice	jenixtliːt͡ʃe
genihtsum	jenixtsum
genihtsumian	jenixtsumiɑn
genihtsumlice	jenixtsumliːt͡ʃe
genihtsumnes	jenixtsumnes
genihtsumung	jenixtsumunɡ
geniman	jenimɑn
genip	jenip
genog	jenoːɡ
genoh	jenoːx
genugan	jenuɡɑn
genyttian	jenyttiɑn
geo	juː
geoc	je͜oːk
geoc	jok
geofon	je͜ofon
geofonyþ	je͜ofonyːθ
geogolere	je͜oːɡolere
geogoþ	juɡoθ
geoguþ	juɡuθ
geol	je͜oːl
geol	joːl
geola	je͜oːlɑ
geola	joːlɑ
geolo	je͜olo
geoloca	je͜olokɑ
geolu	je͜olu
geoluread	je͜oluræ͜ɑːd
geomor	je͜oːmor
geomor	joːmor
geomrian	joːmriɑn
geon	jon
geond	je͜ond
geondblawan	je͜ondblɑːwɑn
geondbrædan	je͜ondbræːdɑn
geonddrencan	je͜onddrent͡ʃɑn
geondfaran	je͜ondfɑrɑn
geondfeolan	je͜ondfe͜oːlɑn
geondferan	je͜ondfeːrɑn
geondflowan	je͜ondfloːwɑn
geondgangan	je͜ondɡɑnɡɑn
geondgeotan	je͜ondje͜oːtɑn
geondhierdan	je͜ondxi͜yrdɑn
geondhweorfan	je͜ondxwe͜orfɑn
geondhyrdan	je͜ondxyrdɑn
geondlacan	je͜ondlɑːkɑn
geondleccan	je͜ondlett͡ʃɑn
geondleohtend	je͜ondle͜oːxtend
geondlihtan	je͜ondliːxtɑn
geondmengan	je͜ondmenjɑn
geondrecan	je͜ondreːt͡ʃɑn
geondsawan	je͜ondsɑːwɑn
geondsceawian	je͜ondskæ͜ɑːwiɑn
geondscinan	je͜ondskiːnɑn
geondscriþan	je͜ondʃriːθɑn
geondsecan	je͜ondseːt͡ʃɑn
geondsendan	je͜ondsendɑn
geondseon	je͜ondse͜oːn
geondsmeagan	je͜ondsmæ͜ɑːjɑn
geondsprengan	je͜ondsprenjɑn
geondspringan	je͜ondsprinɡɑn
geondspætan	je͜ondspæːtɑn
geondstredan	je͜ondstreːdɑn
geondstregdan	je͜ondstrejdɑn
geondstyrian	je͜ondstyrjɑn
geondswogan	je͜ondswoːɡɑn
geondwadan	je͜ondwɑdɑn
geondwlitan	je͜ondwliːtɑn
geondyrnan	je͜ondyrnɑn
geondþencan	je͜ondθent͡ʃɑn
geong	junɡ
geonga	junɡɑ
geongling	junɡlinɡ
geonre	je͜onre
geonre	jonre
georn	je͜orn
georne	je͜orne
geornlice	je͜ornliːt͡ʃe
georran	je͜orrɑn
geostra	je͜ostrɑ
geostrandæg	je͜ostrɑndæj
geotan	je͜oːtɑn
geposu	jeposu
ger	jeːr
gerad	jerɑːd
gerar	jerɑːr
gerd	jerd
gerec	jerek
gereccan	jerett͡ʃɑn
gereccednyss	jerett͡ʃednyss
gerecednes	jeret͡ʃednes
gerecedness	jeret͡ʃedness
gerecednis	jeret͡ʃednis
gerefa	jereːfɑ
gerene	jereːne
geriht	jerixt
gerihtan	jerixtɑn
gerihte	jerixte
gerim	jeriːm
geriman	jeriːmɑn
gerimboc	jeriːmboːk
gerinnan	jerinnɑn
gerisena	jerisenɑ
gerisene	jerisene
gerum	jeruːm
geryne	jeryːne
geræd	jeræːd
gerædan	jeræːdɑn
geræde	jeræːde
gesacan	jesɑkɑn
gesamnian	jesɑmniɑn
gesamnung	jesɑmnunɡ
gesawan	jesɑːwɑn
gesaweled	jesɑːweled
gescad	jeʃɑːd
gescead	jeʃɑːd
gesceadan	jeʃæ͜ɑːdɑn
gesceadan	jeʃɑːdɑn
gesceadlic	jeʃɑdliːt͡ʃ
gesceadlic	jeʃɑːdliːt͡ʃ
gesceadwis	jeʃɑːdwiːs
gesceaft	jeʃæ͜ɑft
gesceap	jeʃæ͜ɑp
gesceapennes	jeʃæ͜ɑpennes
gesceapennys	jeʃæ͜ɑpennys
gesceaphwil	jeʃæ͜ɑpxwiːl
gesceawian	jeʃæ͜ɑːwiɑn
gesceft	jeʃeft
gesceon	jeʃe͜oːn
gescieppan	jeʃi͜yppɑn
gescierpt	jeʃi͜yrpt
gescildnes	jeʃildnes
gescufan	jeʃuːfɑn
gescæphwil	jeʃæpxwiːl
gese	jeːse
gesealdnis	jesæ͜ɑldnis
gesecan	jeseːt͡ʃɑn
gesegen	jesejen
gesehtlian	jesextliɑn
gesellan	jesellɑn
gesendan	jesendɑn
geseon	jese͜oːn
geset	jeset
gesetednes	jesetednes
gesetnes	jesetnes
gesettan	jesettɑn
gesewenlic	jesewenliːt͡ʃ
geseþan	jeseːθɑn
geseþend	jeseːθend
geseþnes	jeseːθnes
geseþung	jeseːθunɡ
gesieltan	jesi͜yltɑn
gesihþ	jesixθ
gesincan	jesinkɑn
gesittan	jesittɑn
gesiþ	jesiːθ
gesiþscipe	jesiːθʃipe
geslean	jeslæ͜ɑːn
gesliefed	jesli͜yːfed
gesmeag	jesmæ͜ɑːɡ
gesmeagan	jesmæ͜ɑːjɑn
gesmeah	jesmæ͜ɑːx
gesnot	jesnot
gesomnian	jesomniɑn
gesoþian	jesoːθiɑn
gespannan	jespɑnnɑn
gespedan	jespeːdɑn
gespedsumian	jespeːdsumiɑn
gespelia	jespeliɑ
gespowan	jespoːwɑn
gesprecan	jesprekɑn
gespræc	jespræːt͡ʃ
gespyrian	jespyrjɑn
gestandan	jestɑndɑn
gestaþolian	jestɑθoliɑn
gestaþoliend	jestɑθoliend
gestaþolung	jestɑθolunɡ
gestigan	jestiːɡɑn
gestillan	jestillɑn
gestincan	jestinkɑn
gestreon	jestre͜oːn
gestrienendlic	jestri͜yːnendliːt͡ʃ
gesund	jesund
gesundful	jesundful
gesundfull	jesundfull
gesundrian	jesundriɑn
geswencan	jeswent͡ʃɑn
geswencednes	jeswent͡ʃednes
gesweor	jeswe͜oːr
gesweostor	jeswe͜ostor
geswerian	jeswerjɑn
geswican	jeswiːkɑn
geswigra	jeswijrɑ
geswin	jeswin
geswinc	jeswink
geswincan	jeswinkɑn
geswincdæg	jeswinkdæj
geswiþan	jeswiːθɑn
geswutelian	jeswuteliɑn
gesyd	jesyd
gesyndrian	jesyndriɑn
gesælan	jesæːlɑn
getacnian	jetɑːkniɑn
getacniendlic	jetɑːkniendliːt͡ʃ
getacniendlice	jetɑːkniendliːt͡ʃe
getacnigendlic	jetɑːknijendliːt͡ʃ
getacnigendlice	jetɑːknijendliːt͡ʃe
getacnung	jetɑːknunɡ
getaht	jetɑːxt
getalian	jetɑliɑn
getawa	jetɑwɑ
geteal	jetæ͜ɑl
getel	jetel
geteld	ɡeteld
getellan	jetellɑn
geteon	jete͜oːn
geteorian	jete͜oːriɑn
geteorigendlic	jete͜oːrijendliːt͡ʃ
geteorodnes	jete͜oːrodnes
geteorung	jete͜oːrunɡ
getot	jetot
getregian	jetreɡiɑn
getreowe	jetre͜oːwe
getriewe	jetri͜yːwe
getwin	jetwin
getwinn	jetwinn
getwisa	jetwisɑ
getwisan	jetwisɑn
getwæfan	jetwæːfɑn
getæht	jetæːxt
getæl	jetæl
getæsu	jetæːsu
geunderþeodan	jeunderθe͜oːdɑn
geunnan	jeunnɑn
geunsoþian	jeunsoːθiɑn
gewadan	jewɑdɑn
gewanian	jewɑniɑn
gewat	jewɑːt
gewealc	jewæ͜ɑlk
gewealcan	jewæ͜ɑlkɑn
geweald	jewæ͜ɑld
geweaxan	jewæ͜ɑksɑn
gewegan	jeweɡɑn
gewemman	jewemmɑn
gewemmednes	jewemmednes
gewemmednys	jewemmednys
gewemmend	jewemmend
gewemming	jewemminɡ
gewendan	jewendɑn
geweorc	jewe͜ork
geweorpan	jewe͜orpɑn
geweorþan	jewe͜orθɑn
gewican	jewiːkɑn
gewiht	jewixt
gewind	jewind
gewindan	jewindɑn
gewinn	jewinn
gewinnan	jewinnɑn
gewintred	jewintred
gewis	jewis
gewiss	jewiss
gewita	jewitɑ
gewitan	jewitɑn
gewitan	jewiːtɑn
gewitnes	jewitnes
gewitt	jewitt
gewlencan	jewlent͡ʃɑn
geworht	jeworxt
gewrecan	jewrekɑn
gewrit	jewrit
gewritan	jewriːtɑn
gewritere	jewritere
gewritræden	jewritræːden
gewuldorbeagian	jewuldorbæ͜ɑːɡiɑn
gewuldorfullian	jewuldorfulliɑn
gewuldrian	jewuldriɑn
gewundian	jewundiɑn
gewunelic	jewuneliːt͡ʃ
gewunelice	jewuneliːt͡ʃe
gewunian	jewuniɑn
gewyrcan	jewyrt͡ʃɑn
gewyrcean	jewyrt͡ʃæ͜ɑn
gewyrdelice	jewyrdeliːt͡ʃe
gewyrtbox	jewyrtboks
gewyrtian	jewyrtiɑn
gewyscan	jewyːʃʃɑn
gewyscednes	jewyːʃʃednes
gewyscendlic	jewyːʃʃendliːt͡ʃ
gewyscing	jewyːʃʃinɡ
gewæde	jewæːde
gewædian	jewæːdiɑn
gewæpnian	jewæːpniɑn
gewæpnod	jewæːpnod
gewær	jewær
gewærlæcan	jewærlæːt͡ʃɑn
gewæstmbærian	jewæstmbæːriɑn
geywan	jeyːwɑn
geæhtle	jeæxtle
geþanc	jeθɑnk
geþeaht	jeθæ͜ɑxt
geþencan	jeθent͡ʃɑn
geþeodan	jeθe͜oːdɑn
geþeode	jeθe͜oːde
geþeodnes	jeθe͜oːdnes
geþeon	jeθe͜oːn
geþeot	jeθe͜oːt
geþicfieldan	jeθikfi͜yldɑn
geþicgan	jeθiɡɡɑn
geþiedan	jeθi͜yːdɑn
geþing	jeθinɡ
geþingan	jeθinɡɑn
geþinge	jeθinɡe
geþingian	ɡeθinɡiɑn
geþingþu	jeθinɡθu
geþoftræden	jeθoftræːden
geþoftscipe	jeθoftʃipe
geþogen	jeθoɡen
geþoht	jeθoːxt
geþolian	jeθoliɑn
geþrang	jeθrɑnɡ
geþringan	jeθrinɡɑn
geþryccan	jeθrytt͡ʃɑn
geþuxian	jeθuksiɑn
geþweran	jeθwerɑn
geþycfyldan	jeθykfyldɑn
geþyld	jeθyld
geþyldig	jeθyldij
gi	jiː
giccan	jitt͡ʃɑn
gicce	jitt͡ʃe
gicel	jit͡ʃel
giddung	jiddunɡ
gie	ji͜y
gied	ji͜yd
giedd	ji͜ydd
gieddian	ji͜yddiɑn
giedding	ji͜yddinɡ
giefan	ji͜yfɑn
giefu	ji͜yfu
gieldan	ji͜yldɑn
giellan	ji͜yllɑn
gielp	ji͜ylp
gielpan	ji͜ylpɑn
gielpe	jiylpe
gielpword	ji͜ylpword
gieman	ji͜yːmɑn
gieme	ji͜yːme
giemeleas	ji͜yːmelæ͜ɑːs
giemeleasian	ji͜yːmelæ͜ɑːsiɑn
giemeleasnes	ji͜yːmelæ͜ɑːsnes
giemeleast	ji͜yːmelæ͜ɑːst
giemend	ji͜yːmend
giend	ji͜ynd
gierd	ji͜yrd
gierstandæg	ji͜yrstɑndæj
gierwan	ji͜yrwɑn
giese	ji͜yːse
giest	ji͜yst
giestern	ji͜ystern
giestliþe	ji͜ystliːθe
giestran	ji͜ystrɑn
giestrandæg	ji͜ystrɑndæj
giestranniht	ji͜ystrɑnnixt
giestranæfen	ji͜ystrɑnæːfen
giet	ji͜yːt
gietan	jetɑn
gietan	ji͜ytɑn
gif	jif
gifeþe	jifeθe
gifol	jifol
gifre	jiːfre
gifstol	jifstoːl
gift	jift
gifta	jiftɑ
gifu	jifu
gild	jild
gilp	jilp
giltig	ɡiltij
gimm	jimm
gimmwyrhta	jimmwyrxtɑ
gimstan	jimstɑːn
gimwyrhta	jimwyrxtɑ
gingest	jind͡ʒest
gingra	jinɡrɑ
ginian	jiniɑn
girdan	ɡirdɑn
gise	jiːse
gisel	jiːsel
gisl	jiːsl
gislian	jiːsliɑn
git	jit
gitsian	jiːtsiɑn
gitsung	jiːtsunɡ
giwian	jiwiɑn
gleaw	ɡlæ͜ɑːw
gleawceasterscir	ɡlæ͜ɑːwt͡ʃæ͜ɑsterʃiːr
gleawe	ɡlæ͜ɑːwe
gleawlic	ɡlæ͜ɑːwliːt͡ʃ
gleawlice	ɡlæ͜ɑːwliːt͡ʃe
gleawnes	ɡlæ͜ɑːwnes
gleawscipe	ɡlæ͜ɑːwʃipe
gled	ɡleːd
gleng	ɡlenj
gleng	ɡlenɡ
glengan	ɡlenjɑn
gleo	ɡle͜oː
gleobeam	ɡle͜oːbæ͜ɑːm
gleomann	ɡle͜oːmɑnn
gleow	ɡle͜oːw
glida	ɡlidɑ
glidan	ɡliːdɑn
glisnian	ɡlisniɑn
glitnian	ɡlitniɑn
glof	ɡloːf
glom	ɡloːm
glowan	ɡloːwɑn
glæd	ɡlæd
glæde	ɡlæde
glædlice	ɡlædliːt͡ʃe
glædman	ɡlædmɑn
glædmann	ɡlædmɑnn
glæm	ɡlæːm
glær	ɡlær
glær	ɡlæːr
glæs	ɡlæs
glæsen	ɡlæsen
gnagan	ɡnɑɡɑn
gnidan	ɡniːdɑn
gnornian	ɡnorniɑn
gnætt	ɡnætt
god	ɡod
god	ɡoːd
godcund	ɡodkund
godcundnes	ɡodkundnes
godhad	ɡodxɑːd
godleas	ɡoːdlæ͜ɑːs
godlic	ɡodliːt͡ʃ
godlic	ɡoːdliːt͡ʃ
godnes	ɡoːdnes
godscyldig	ɡodʃyldij
godsibb	ɡodsibb
godspel	ɡodspel
godspelboc	ɡodspelboːk
godspelbodung	ɡodspelbodunɡ
godspell	ɡodspell
godspellboc	ɡodspelboːk
godspellbodung	ɡodspelbodunɡ
godspellere	ɡodspellere
godspellian	ɡodspelliɑn
godspellic	ɡoːdspelliːt͡ʃ
godspellisc	ɡoːdspelliʃ
godspelltraht	ɡodspeltrɑxt
godspeltraht	ɡodspeltrɑxt
godwebb	ɡodwebb
godwebben	ɡodwebben
godwrecnes	ɡodwreknes
godþrym	ɡodθrym
gold	ɡold
goldfah	ɡoldfɑːx
goldhord	ɡoldxord
goldmæstling	ɡoldmæstlinɡ
goldsmiþ	ɡoldsmiθ
goldwine	ɡoldwine
goldwrecan	ɡoldwrekɑn
goma	ɡoːmɑ
gombe	ɡombe
gomen	ɡomen
gor	ɡor
gorettan	ɡorettɑn
gorian	ɡoriɑn
gos	ɡoːs
goshafoc	ɡoːsxɑfok
gosheafoc	ɡoːsxæ͜ɑfok
gota	ɡotɑ
grad	ɡrɑd
graf	ɡrɑːf
grafan	ɡrɑfɑn
gram	ɡrɑm
grama	ɡrɑmɑ
grambære	ɡrɑmbæːre
grammatic	ɡrɑmmɑtit͡ʃ
granu	ɡrɑnu
grap	ɡrɑːp
grapian	ɡrɑːpiɑn
grasian	ɡrɑsiɑn
grasu	ɡrɑsu
great	ɡræ͜ɑːt
greatnes	ɡræ͜ɑːtnes
grecland	ɡreːklɑnd
gredig	ɡreːdij
grellan	ɡrellɑn
gremman	ɡremmɑn
grene	ɡreːne
greosan	ɡre͜oːsɑn
greot	ɡre͜oːt
greotan	ɡre͜oːtɑn
gretan	ɡreːtɑn
griellan	ɡri͜yllɑn
grietu	ɡri͜yːtu
grighund	ɡriːjxund
grillan	ɡrillɑn
grim	ɡrim
grima	ɡriːmɑ
grimhelm	ɡriːmxelm
grimm	ɡrimm
grimman	ɡrimmɑn
grin	ɡrin
grindan	ɡrindɑn
grindel	ɡrindel
grindere	ɡrindere
gripan	ɡriːpɑn
gripe	ɡripe
gripe	ɡriːpe
gripend	ɡriːpend
gripennis	ɡripennis
grippan	ɡrippɑn
gripul	ɡripul
grisan	ɡriːsɑn
gristel	ɡristel
griþ	ɡriθ
griþian	ɡriθiɑn
griþleas	ɡriθlæ͜ɑːs
grot	ɡrot
growan	ɡroːwɑn
grund	ɡrund
grundleas	ɡrundlæ͜ɑːs
grundstan	ɡrundstɑːn
grundweall	ɡrundwæ͜ɑll
grunnettan	ɡrunnettɑn
grunnian	ɡrunniɑn
grut	ɡruːt
gryre	ɡryre
grytt	ɡrytt
grædig	ɡræːdij
græf	ɡræf
græg	ɡræːj
græs	ɡræs
græse	ɡræse
græses	ɡræses
grætan	ɡræːtɑn
guma	ɡumɑ
gumcynn	ɡumkynn
gutt	ɡutt
guþ	ɡuːθ
guþbeorn	ɡuːθbe͜orn
guþbord	ɡuːθbord
guþbyrne	ɡuːθbyrne
guþcræft	ɡuːθkræft
guþfremmend	ɡuːθfremmend
guþfruma	ɡuːθfrumɑ
guþfugel	ɡuːθfuɡel
guþgewæde	ɡuːθjewæːde
guþmod	ɡuːθmoːd
guþrof	ɡuːθroːf
guþsele	ɡuːθsele
gyccan	jytt͡ʃɑn
gycce	jytt͡ʃe
gyden	ɡyden
gydig	ɡydij
gyldan	jyldɑn
gylden	ɡylden
gylp	jylp
gylpword	jylpword
gylt	ɡylt
gyltend	ɡyltend
gyltig	ɡyltij
gyman	jyːmɑn
gyme	jyːme
gymeleas	jyːmelæ͜ɑːs
gymeleasian	jyːmelæ͜ɑːsiɑn
gymeleasnys	jyːmelæ͜ɑːsnys
gymeleast	jyːmelæ͜ɑːst
gymend	jyːmend
gyrdan	ɡyrdɑn
gyrdel	ɡyrdel
gyrstandæg	jyrstɑndæj
gyrstanniht	jyrstɑnnixt
gyrwan	jyrwɑn
gystian	jystiɑn
gyte	ɡyte
gæ	jæ
gæd	ɡæd
gædere	ɡædere
gægn	jæjn
gælan	ɡæːlɑn
gælsa	ɡæːlsɑ
gæmnian	ɡæmniɑn
gærs	ɡærs
gærshoppa	ɡærsxoppɑ
gærsstapa	ɡærsstɑpɑ
gærstapa	ɡærstɑpɑ
gærsumas	ɡærsumɑs
gæsne	ɡæːsne
gæst	ɡæːst
gæstan	ɡæːstɑn
gæsthus	ɡæstxuːs
gæt	ɡæːt
gæten	ɡæːten
habban	xɑbbɑn
haca	xɑkɑ
had	xɑːd
hadbot	xɑːdboːt
hafela	xɑfelɑ
hafoc	xɑfok
hafuc	xɑfuk
haga	xɑɡɑ
hagena	xɑɡenɑ
hagosteald	xɑɡostæ͜ɑld
hal	xɑːl
halbære	xɑːlbæːre
haldan	xɑldɑn
haleg	xɑːlej
halga	xɑːlɡɑ
halgian	xɑːlɡiɑn
halgoland	xɑːlɡolɑnd
halh	hɑlx
halig	xɑːlij
haligdom	xɑːlijdoːm
haligern	xɑːlijern
haligmonaþ	xɑːlijmoːnɑθ
halignes	xɑːlijnes
halignis	xɑːlijnis
halignys	xɑːlijnys
halpenige	xɑlpenije
halwende	xɑːlwende
halwœnde	xɑːlwønde
ham	xɑm
ham	xɑːm
hamcyme	xɑːmkyme
hamelian	xɑmeliɑn
hamettan	xɑːmettɑn
hamfæreld	xɑːmfæreld
hamleas	xɑːmlæ͜ɑːs
hamm	xɑmm
hamor	xɑmor
hamsteall	xɑːmstæ͜ɑll
hana	xɑnɑ
hancred	xɑnkreːd
hand	xɑnd
handboc	xɑndboːk
handbred	xɑndbred
handcops	xɑndkops
handcosp	xɑndkosp
handgeweorc	xɑndjewe͜ork
handgewrit	xɑndjewrit
handlian	xɑndliɑn
handscyldig	xɑndʃyldij
handseax	xɑndsæ͜ɑks
handtam	xɑndtɑm
handweorc	xɑndwe͜ork
handworht	xɑndworxt
hangian	xɑnɡiɑn
har	xɑːr
hara	xɑrɑ
has	xɑːs
hasu	xɑsu
haswig	xɑswij
hat	xɑːt
hatan	xɑːtɑn
hatheort	xɑːtxe͜ort
hatheortnes	xɑːtxe͜ortnes
hathiertan	xɑːtxi͜yrtɑn
hatian	xɑtiɑn
hattefagol	xɑttefɑɡol
hawian	xɑːwiɑn
he	xeː
heafdeht	xæ͜ɑːfdext
heafoc	xæ͜ɑfok
heafod	xæ͜ɑːfod
heafodcirice	ɑnɡelt͡ʃirit͡ʃe
heafodclaþ	xæ͜ɑːfodklɑːθ
heafodece	xæ͜ɑːfodet͡ʃe
heafodleas	xæ͜ɑːfodlæ͜ɑːs
heafodlic	xæ͜ɑːfodliːt͡ʃ
heafodling	xæ͜ɑːfodlinɡ
heafodmæg	xæ͜ɑːfodmæːj
heafodpanne	xæ͜ɑːfodpɑnne
heafodstol	xæ͜ɑːfodstoːl
heafodwind	xæ͜ɑːfodwind
heafodwund	xæ͜ɑːfodwund
heafodædre	xæ͜ɑːfodæːdre
heafola	xæ͜ɑfolɑ
heah	xæ͜ɑːx
heahencgel	xæ͜ɑːxenjel
heahengel	xæ͜ɑːxenjel
heahflod	xæ͜ɑːxfloːd
heahfore	xæ͜ɑxfore
heahfæder	xæ͜ɑːxfæder
heahgast	xæ͜ɑːxɡɑːst
heahheall	xæ͜ɑːxxæ͜ɑll
heahlareow	xæ͜ɑːxlɑːre͜oːw
heahstede	xæ͜ɑːxstede
heahweg	xæ͜ɑːxwej
heahþrym	xæ͜ɑːxθrym
heala	xæ͜ɑːlɑ
heald	xæ͜ɑld
healdan	xæ͜ɑldɑn
healdsum	xæ͜ɑldsum
healf	xæ͜ɑlf
healfbrocen	xæ͜ɑlfbroken
healfcwic	xæ͜ɑlfkwik
healfdead	xæ͜ɑlfdæ͜ɑːd
healfscyldig	xæ͜ɑlfʃyldij
healftrendel	xæ͜ɑlftrendel
healfweg	xæ͜ɑlfwej
healh	hæɑlx
healice	xæ͜ɑːliːt͡ʃe
heall	xæ͜ɑll
healm	xæ͜ɑlm
heals	xæ͜ɑls
healsbeag	xæ͜ɑlsbæ͜ɑːɡ
healsfang	xæ͜ɑlsfɑnɡ
healsgebedda	xæ͜ɑlsjebeddɑ
healt	xæ͜ɑlt
hean	xæ͜ɑːn
heap	xæ͜ɑːp
heapmælum	xæ͜ɑːpmæːlum
heard	xæ͜ɑrd
heardheort	xæ͜ɑrdxe͜ort
heardian	xæ͜ɑrdiɑn
hearding	xæ͜ɑrdinɡ
heardlice	xæ͜ɑrdliːt͡ʃe
heardung	xæ͜ɑrdunɡ
hearg	xæ͜ɑrɡ
hearm	xæ͜ɑrm
hearma	xæ͜ɑrmɑ
hearmascinnen	xæ͜ɑrmɑʃinnen
hearmcweþan	xæ͜ɑrmkweθɑn
hearpe	xæ͜ɑrpe
hearpere	xæ͜ɑrpere
hearra	xæ͜ɑrrɑ
heawan	xæ͜ɑːwɑn
heaþolac	xæ͜ɑθolɑːk
heaþorinc	xæ͜ɑθorink
heaþowæd	xæ͜ɑθowæːd
hebban	xebbɑn
hecg	xejj
hedan	xeːdɑn
heddern	xeːddern
heden	xeden
hefig	xefij
hefiglice	xefijliːt͡ʃe
hefignes	xefijnes
hefon	xefon
hege	xeje
hehþ	xeːxθ
hela	xeːlɑ
hela	xeːlɑː
helan	xelɑn
helan	xeːlɑn
hell	xell
hellegeat	xellejæ͜ɑt
hellewite	xellewiːte
hellrun	xellruːn
hellruna	xellruːnɑ
helm	xelm
helma	xelmɑ
helmian	xelmiɑn
help	xelp
helpan	xelpɑn
helruna	xelruːnɑ
helrynegu	xelryːneju
hemeþe	xemeθe
henep	xenep
hengen	xenjen
hengen	xenɡen
hengest	xenjest
hengon	xeːnɡon
hengst	xenkst
hengst	xenɡst
henn	xenn
hentan	xentɑn
heo	xe͜oː
heodæg	xe͜oːdæj
heof	xe͜oːf
heofan	xe͜oːfɑn
heofon	xe͜ofon
heofonisc	xe͜ofoniʃ
heofonlic	xe͜ofonliːt͡ʃ
heofonrice	xe͜ofonriːt͡ʃe
heofonum	heofonum
heofonwuldor	xe͜ofonwuldor
heolca	xe͜olkɑ
heonan	xe͜onɑn
heora	heo̯rɑ
heord	xe͜ord
heore	xe͜oːre
heorot	xe͜orot
heorra	xe͜orrɑ
heort	xe͜ort
heorte	xe͜orte
heortece	xe͜ortet͡ʃe
heortgryre	xe͜ortɡryre
heortleas	xe͜ortlæ͜ɑːs
heoru	xe͜oru
heorþ	xe͜orθ
heorþgeneat	xe͜orθjenæ͜ɑːt
heow	xe͜oːw
her	xeːr
heran	xeːrɑn
here	xere
herebeacen	xerebæ͜ɑːken
herebeorg	xerebe͜orɡ
herebeorgian	xerebe͜orɡiɑn
herefong	xerefonɡ
heregeatwa	xerejæ͜ɑtwɑ
heregrima	xereɡriːmɑ
heremann	xeremɑnn
heretoga	xeretoɡɑ
hereweg	xerewej
hergian	xerɡiɑn
herian	xerjɑn
herigendlic	xerijendliːt͡ʃ
herigendlice	xerijendliːt͡ʃe
hersum	xeːrsum
herung	xerunɡ
herþan	xerθɑn
herþbelig	xerθbelij
het	heːt
hete	xete
heteniþ	xeteniːθ
heterof	xeteroːf
hettan	xettɑn
hetting	xettinɡ
hi	xiː
hicel	xikel
hider	xider
hie	xi͜yː
hieg	xi͜yːj
hielfan	xi͜ylfɑn
hienþu	xi͜yːnθu
hieran	xi͜yːrɑn
hierdan	xi͜yrdɑn
hierde	xi͜yrde
hiere	hiy̯re
hierstan	xi͜yrstɑn
hiersumnes	xi͜yːrsumnes
hiertan	xi͜yrtɑn
hierusalem	jerusɑlem
hiewian	xi͜yːwiɑn
hig	xiːj
higian	xiːɡiɑn
hild	xild
hildebord	xildebord
hildedeor	xildede͜oːr
hilderæs	xilderæːs
hildewæpen	xildewæːpen
him	him
hincian	xinkiɑn
hind	xind
hindan	xindɑn
hindanweard	xindɑnwæ͜ɑrd
hindrian	xindriɑn
hine	hine
hio	xi͜uː
hire	xire
hired	xiːred
hit	xit
hiw	xiːw
hiwcund	xiːwkund
hiwcuþ	xiːwkuːθ
hiwcuþlice	xiːwkuːθliːt͡ʃe
hiwcuþnes	xiːwkuːθnes
hiwen	xiːwen
hiwfæst	xiːwfæst
hiwian	xiːwiɑn
hiwisc	xiːwiʃ
hiwræden	xiːwræːden
hladan	xlɑdɑn
hlaf	xlɑːf
hlafhus	xlɑːfxuːs
hlaford	xlɑːford
hlaforddom	xlɑːforddoːm
hlafordleas	xlɑːfordlæ͜ɑːs
hlafordlic	xlɑːfordliːt͡ʃ
hlafweard	xlɑːfwæ͜ɑrd
hlafæta	xlɑːfæːtɑ
hlagol	xlɑɡol
hland	xlɑnd
hlaw	xlɑːw
hleahtor	xlæ͜ɑxtor
hleapan	xlæ͜ɑːpɑn
hleapere	xlæ͜ɑːpere
hleapestre	xlæ͜ɑːpestre
hlehhan	xlexxɑn
hlemman	xlemmɑn
hlenca	xlent͡ʃɑ
hleo	xle͜oː
hleonian	xle͜oniɑn
hleor	xle͜oːr
hleorberg	xle͜oːrberɡ
hleotan	xle͜oːtɑn
hleoþor	xle͜oːθor
hleoþorcyme	xle͜oːθorkyme
hleoþrere	xle͜oːθrere
hleoþrian	xle͜oːθriɑn
hleoþrung	xle͜oːθrunɡ
hlid	xlid
hliehhan	xli͜yxxɑn
hliep	xli͜yːp
hlifian	xlifiɑn
hlihhan	xlixxɑn
hlimman	xlimmɑn
hlimme	xlimme
hlinc	xlink
hlinian	xliniɑn
hlisa	xliːsɑ
hlisful	xliːsful
hlið	xliθ
hliþ	xliθ
hlose	xloːse
hlosnian	xlosniɑn
hlot	xlot
hlowan	xloːwɑn
hloþ	xloːθ
hloþbot	xloːθboːt
hloþere	xloːθere
hloþian	xloːθiɑn
hlud	xluːd
hlutor	xluːtor
hlyd	xlyːd
hlydan	xlyːdɑn
hlynsian	xlynsiɑn
hlysnan	xlysnɑn
hlyst	xlyst
hlystan	xlystɑn
hlæder	xlæːder
hlæfdige	xlæːfdiːje
hlæne	xlæːne
hlænsian	xlæːnsiɑn
hlæst	xlæst
hlæw	xlæːw
hnah	xnɑːx
hneaw	xnæ͜ɑːw
hnecca	xnekkɑ
hnesce	xneʃʃe
hnigan	xniːɡɑn
hnigian	xniɡiɑn
hnitan	xniːtɑn
hnitu	xnitu
hnocc	xnokk
hnol	xnol
hnoll	xnoll
hnossian	xnossiɑn
hnot	xnot
hnuta	xnutɑ
hnutu	xnutu
hnutum	xnutum
hnyte	xnyte
hnægan	xnæːjɑn
hnægung	xnæːjunɡ
hnæp	xnæp
hnæpf	xnæpf
hnæpp	xnæpp
hobanca	xoːbɑnkɑ
hobbe	xobbe
hoc	xok
hoc	xoːk
hocg	xoɡɡ
hof	xof
hof	xoːf
hofor	xofor
hoga	xoɡɑ
hogg	xoɡɡ
hogode	hoɣode
hol	xol
hol	xoːl
hold	xold
holdræden	xoldræːden
holdscipe	xoldskipe
holegn	xolejn
holen	xolen
holian	xoliɑn
holian	xoːliɑn
holm	xolm
holt	xolt
hon	xoːn
hond	xond
hopa	xopɑ
hopian	xopiɑn
hoppestre	xoppestre
hoppian	xoppiɑn
horcwene	xoːrkwene
hord	xord
hordern	xordern
hore	xoːre
horena	xoːrenɑ
horh	xorx
horhig	xorxij
horig	xorij
horn	xorn
hornblawere	xornblɑːwere
hornbære	xornbæːre
hornreced	xornret͡ʃed
hors	xors
horsc	xorsk
horsc	xorʃ
horscamb	xorskɑmb
horsclice	xorʃliːt͡ʃe
horselene	xorselene
horsern	xorsern
horshwæl	xorsxwæl
horsminte	xorsminte
horu	xoru
hos	xoːs
hosan	xosɑn
hose	xose
hosp	xosp
hoþ	xoːθ
hra	xrɑː
hrafyl	xrɑːfyl
hragra	xrɑːɡrɑ
hramma	xrɑmmɑ
hramsa	xrɑmsɑ
hran	xrɑn
hran	xrɑːn
hranrad	xrɑnrɑːd
hraþe	xrɑθe
hraþor	xrɑθor
hreac	xræ͜ɑːk
hream	xræ͜ɑːm
hreaw	xræ͜ɑːw
hreaðemus	xræ͜ɑːθemuːs
hreaþemus	xræ͜ɑːθemuːs
hreddan	xreddɑn
hreman	xreːmɑn
hremig	xreːmij
hreod	xre͜oːd
hreodan	xre͜oːdɑn
hreosan	xre͜oːsɑn
hreow	xre͜oːw
hreowan	xre͜oːwɑn
hreowcearig	xre͜oːwt͡ʃæ͜ɑrij
hreowlic	xre͜oːwliːt͡ʃ
hreowlice	xre͜oːwliːt͡ʃe
hreppan	xreppɑn
hrepung	xrepunɡ
hreran	xreːrɑn
hreþ	xreːθ
hreþer	xreθer
hreþig	xreːθij
hreþmonaþ	xreːθmoːnɑθ
hrieman	xri͜yːmɑn
hrif	xrif
hrim	xriːm
hriman	xriːmɑn
hrimig	xriːmij
hrinan	xriːnɑn
hrincg	xrinɡɡ
hrindan	xrindɑn
hring	xrinɡ
hringan	xrinjɑn
hringedstefna	xrinɡedstefnɑ
hringfinger	xrinɡfinɡer
hringsetl	xrinɡsetl
hris	xriːs
hrisian	xrisiɑn
hrissan	xrissɑn
hriþ	xriθ
hriþ	xriːθ
hriþer	xriːθer
hriþerhyrde	xriːθerxyrde
hroc	xroːk
hrof	xroːf
hron	xron
hronfisc	xronfiʃ
hronrad	xronrɑːd
hrop	xroːp
hropan	xroːpɑn
hror	xroːr
hrost	xroːst
hrung	xrunɡ
hrurol	xrurol
hruse	xruːse
hrutan	xruːtɑn
hrycg	xryjj
hrycgban	xryjjbɑːn
hryman	xryːmɑn
hryre	xryre
hryscan	xryːʃʃɑn
hryþerhyrde	xryːθerxyrde
hræd	xræd
hrædlice	xrædliːt͡ʃe
hræfn	xræfn
hræfnsweart	xræfnswæ͜ɑrt
hrægl	xræjl
hræn	xræn
hræw	xræːw
hræþ	xræθ
hræþe	xræθe
hu	xuː
hulc	xulk
hulian	xuːliɑn
hunbeorht	xunbe͜orxt
hund	xund
hundeahtatig	xundæ͜ɑxtɑtij
hunden	xunden
hundendleftig	xundendleftij
hundfeald	xundfæ͜ɑld
hundlic	xundliːt͡ʃ
hundnigontig	xundniɡontij
hundred	xundred
hundseofontig	xundse͜ofontij
hundteontig	xundte͜oːntij
hundteontigoþa	xundte͜oːntiɡoθɑ
hundtwelftig	xundtwelftij
hungor	xunɡor
hunig	xunij
hunigbære	xunijbæːre
hunigcamb	xunijkɑmb
hunigsmæc	xunijsmæk
hunigsmæc	xunijsmæt͡ʃ
hunta	xuntɑ
huntian	xuntiɑn
huntoþ	xuntoθ
huru	xuːru
hus	xuːs
husbonda	xuːsbondɑ
husbryce	xuːsbryt͡ʃe
husbryne	xuːsbryne
husc	xuʃ
husel	xuːsel
husian	xuːsiɑn
husl	xuːsl
husræden	xuːsræːden
husul	xuːsul
huuæt	xwæt
huþ	xuːθ
hwa	xwɑː
hwam	xwɑːm
hwamm	xwɑmm
hwamstan	xwɑmstɑːn
hwanon	xwɑnon
hwar	xwɑːr
hwara	xwɑːrɑ
hwealf	xwæ͜ɑlf
hwearfian	xwæ͜ɑrfiɑn
hweg	xweːj
hwelc	xwelt͡ʃ
hwelca	xwelkɑ
hwelcnes	xwelknes
hwelian	xweliɑn
hwelp	xwelp
hwelpian	xwelpiɑn
hweol	xwe͜oːl
hweorfan	xwe͜orfɑn
hwerfan	xwerfɑn
hwergen	xwerjen
hwerhwette	xwerxwette
hwetstan	xwetstɑːn
hwettan	xwettɑn
hwicce	xwitt͡ʃe
hwider	xwider
hwierfan	xwi͜yrfɑn
hwil	xwiːl
hwilc	xwilt͡ʃ
hwilum	xwiːlum
hwilwende	xwiːlwende
hwinan	xwiːnɑn
hwisprian	xwispriɑn
hwistlere	xwistlere
hwistlian	xwistliɑn
hwit	xwiːt
hwitel	xwiːtel
hwitnes	xwiːtnes
hwon	xwon
hwone	xwone
hwopan	xwoːpɑn
hwosan	xwoːsɑn
hwosta	xwoːstɑ
hwy	xwyː
hwylc	xwylt͡ʃ
hwylca	xwylkɑ
hwyrft	xwyrft
hwæder	xwæder
hwæg	xwæːj
hwæl	xwæl
hwælhunta	xwælxuntɑ
hwælhuntoþ	xwælxuntoθ
hwælweg	xwælwej
hwæm	xwæːm
hwæne	xwæne
hwænne	xwænne
hwær	xwæːr
hwærhwugu	xwæːrxwuɡu
hwæs	xwæs
hwæt	xwæt
hwæte	xwæːte
hwæþer	xwæθer
hwæþre	xwæθre
hycgan	xyjjɑn
hyd	xyːd
hydan	xyːdɑn
hyf	xyːf
hyge	xyje
hygerof	xyjeroːf
hygeþrym	xyjeθrym
hyht	xyxt
hyldo	xyldo
hyldræden	xyldræːden
hyldu	xyldu
hyll	xyll
hyllan	xyllɑn
hymele	xymele
hyngran	xynɡrɑn
hyngrian	xynɡriɑn
hynþu	xyːnθu
hype	xype
hyr	xyːr
hyran	xyːrɑn
hyrdan	xyrdɑn
hyrde	xyrde
hyrde	xyːrde
hyrdel	xyrdel
hyrdon	hyːrdon
hyreborg	xyːreborɡ
hyrian	xyrjɑn
hyrling	xyːrlinɡ
hyrmann	xyːrmɑnn
hyrne	xyrne
hyrst	xyrst
hyrstan	xyrstɑn
hyscan	xyʃʃɑn
hyse	xyse
hyþ	xyːθ
hæbbende	hæbbende
hæc	xæt͡ʃ
hæcce	xække
hæf	xæf
hæfde	hæfde
hæfdon	hæfdon
hæfen	xæfen
hæfer	xæfer
hæferblæte	xæferblæːte
hæfern	xæfern
hæft	xæft
hæftan	xæftɑn
hæftling	xæftlinɡ
hæftnung	xæftnunɡ
hægl	xæjl
hægtesse	xæɡtesse
hæl	xæːl
hælan	xæːlɑn
hæle	xæle
hælend	xæːlend
hælendlic	xæːlendliːt͡ʃ
hælettung	xæːlettunɡ
hæleð	xæleθ
hæleþ	xæleθ
hælig	xæːlij
hæling	xæːlinɡ
hælo	xæːlo
hælsung	xæːlsunɡ
hælu	xæːlu
hælþ	xæːlθ
hæman	xæːmɑn
hæmed	xæːmed
hæmedceorl	xæːmedt͡ʃe͜orl
hæmedlac	xæːmedlɑːk
hæmedscipe	xæːmedʃipe
hæmedwif	xæːmedwiːf
hænan	xæːnɑn
hænep	xænep
hær	xæːr
hæren	xæːren
hærenfagol	xæːrenfɑɡol
hærfest	xærfest
hærfestlic	xærfestliːt͡ʃ
hærfestmonaþ	xærfestmoːnɑθ
hæring	xæːrinɡ
hærn	xærn
hærnflota	xærnflotɑ
hæs	xæːs
hæsel	xæsel
hæsl	xæsl
hæst	xæːst
hæt	xæt
hætan	xæːtɑn
hæte	xæːte
hætt	xætt
hæþ	xæːθ
hæþen	xæθen
hæþen	xæːθen
hæþendom	xæːθendoːm
ia	jɑː
ic	it͡ʃ
idel	iːdel
ides	ides
idæges	iːdæjes
iecan	i͜yːt͡ʃɑn
iecend	i͜yːt͡ʃend
ieg	i͜yːj
iegland	i͜yːjlɑnd
iegstream	i͜yːjstræ͜ɑːm
ieldan	i͜yldɑn
ielde	i͜ylde
ielden	i͜ylden
ieldra	iy̯ldrɑ
ieldu	i͜yldu
ielf	i͜ylf
ielfadl	i͜ylfɑːdl
ielfcynn	i͜ylfkynn
ielfen	i͜ylfen
ielfete	i͜ylfete
ielfetu	i͜ylfetu
ielfsciene	i͜ylfʃi͜yːne
ielfsogoþa	i͜ylfsoɡoθɑ
ierfa	i͜yrfɑ
ierfe	i͜yrfe
ierfenuma	i͜yrfenumɑ
iergþ	i͜yrjθ
iergþu	i͜yrjθu
iermþ	i͜yrmθ
iermþu	i͜yrmθu
iernan	i͜yrnɑn
ierre	i͜yrre
iersian	i͜yrsiɑn
ierþling	i͜yrθlinɡ
iewan	i͜yːwɑn
ieþan	i͜yːθɑn
ieþe	i͜yːθe
ifig	iːfij
ifiht	iːfixt
ig	iːj
igeoþ	ijoθ
iggaþ	ijjɑθ
iggoþ	ijjoθ
igil	ijil
igland	iːjlɑnd
igoþ	ijoθ
ih	ix
ilca	ilkɑ
ile	ile
ilfete	ilfete
ilfetu	ilfetu
imbe	imbe
impian	impiɑn
in	in
inblawan	inblɑːwɑn
inbrecan	inbrekɑn
inbringan	inbrinɡɑn
inburh	inburx
inc	ink
inca	inkɑ
incer	inker
inciegan	int͡ʃi͜yːjɑn
inciegung	int͡ʃi͜yːjunɡ
incit	iŋkit
incniht	inknixt
incuman	inkumɑn
incund	inkund
ineardian	inæ͜ɑrdiɑn
ineardiend	inæ͜ɑrdiend
infaran	infɑrɑn
infaru	infɑru
inferan	infeːrɑn
infiht	infixt
infæreld	infæreld
ing	inɡ
ingan	inɡɑːn
ingang	inɡɑnɡ
ingangan	inɡɑnɡɑn
ingefeallan	injefæ͜ɑllɑn
ingefeoht	injefe͜oxt
ingehygd	injexyjd
ingeld	inɡeld
ingeþanc	injeθɑnk
inhold	inxold
inlenda	inlendɑ
inlendisc	inlendiʃ
inlic	inliːt͡ʃ
inlice	inliːt͡ʃe
inlihtan	inliːxtɑn
inlædan	inlæːdɑn
inn	inn
innan	innɑn
innancund	innɑnkund
innanweard	innɑnwæ͜ɑrd
inne	inne
innecund	innekund
innefare	innefɑre
innera	innerɑ
inneweard	innewæ͜ɑrd
innian	inniɑn
innoþ	innoθ
innung	innunɡ
insendan	insendɑn
insiht	insixt
intinga	intinɡɑ
into	intoː
inweard	inwæ͜ɑrd
inylfe	inylfe
iohannes	joxɑnnes
iow	i͜uːw
iraland	iːrɑlɑnd
irland	iːrlɑnd
irnan	irnɑn
is	iːs
isceald	iːst͡ʃæ͜ɑld
isearn	iːsæ͜ɑrn
isenordal	iːsenordɑːl
isern	iːsern
isernsmiþ	iːsernsmiθ
isig	iːsij
isiht	iːsixt
isiþes	iːsiːθes
ispania	ispɑːniɑ
ispanisc	ispɑːniʃ
israhel	isrɑxel
italia	itɑliɑ
iude	iude
iudea	iudæ͜ɑ
iudeisc	juːdeːiʃ
iw	iːw
kyning	kyninɡ
la	lɑː
lac	lɑːk
lacan	lɑːkɑn
lacnestre	lɑːknestre
lacnian	lɑːkniɑn
lacu	lɑku
lad	lɑːd
ladian	lɑːdiɑn
ladmann	lɑːdmɑnn
ladteow	lɑːdte͜oːw
ladung	lɑːdunɡ
laf	lɑːf
lafian	lɑfiɑn
lafor	lɑfor
lage	lɑɡe
lago	lɑɡo
lagu	lɑɡu
lagucræftig	lɑɡukræftij
lagustræt	lɑɡustræːt
lam	lɑːm
lama	lɑmɑ
lamb	lɑmb
lambru	lɑmbru
lamp	lɑmp
land	lɑnd
landbuend	lɑndbuːend
landfeoh	lɑndfe͜ox
landfolc	lɑndfolk
landfruma	lɑndfrumɑ
landhlaford	lɑndxlɑːford
landleas	lɑndlæ͜ɑːs
landleod	lɑndle͜oːd
landmearc	lɑndmæ͜ɑrk
landrest	lɑndrest
landriht	lɑndrixt
landscipe	lɑndʃipe
lang	lɑnɡ
langaland	lɑnɡɑlɑnd
lange	lɑnɡe
langian	lɑnɡiɑn
langoþ	lɑnɡoθ
langsum	lɑnɡsum
langsumlice	lɑnɡsumliːt͡ʃe
langsumnes	lɑnɡsumnes
langtwidig	lɑnɡtwiːdij
lanu	lɑnu
lar	lɑːr
larboc	lɑːrboːk
larbysen	lɑːrbyːsen
larcræft	lɑːrkræft
lareow	lɑːre͜oːw
lareowdom	lɑːre͜oːwdoːm
lareowlic	lɑːre͜oːwliːt͡ʃ
larleast	lɑːrlæ͜ɑːst
larlic	lɑːrliːt͡ʃ
larlyst	lɑːrlyːst
larsmiþ	lɑːrsmiθ
larspell	lɑːrspell
larsum	lɑːrsum
larwita	lɑːrwitɑ
last	lɑːst
late	lɑte
laur	lɑur
laurbeam	lɑurbæ͜ɑːm
laurberige	lɑurberije
laurtreow	lɑurtre͜oːw
lawerce	lɑːwerke
laþ	lɑːθ
laþgeteona	lɑːθjete͜oːnɑ
laþian	lɑθiɑn
laþian	lɑːθiɑn
laþlic	lɑːθliːt͡ʃ
laþu	lɑθu
leac	læ͜ɑːk
lead	læ͜ɑːd
leaf	læ͜ɑːf
leafa	læ͜ɑːfɑ
leafnes	læ͜ɑːfnes
leafnesword	læ͜ɑːfnesword
leah	læ͜ɑːx
lean	læ͜ɑːn
leas	læ͜ɑːs
leasere	læ͜ɑːsere
leaslic	læ͜ɑːsliːt͡ʃ
leassagol	læ͜ɑːssɑɡol
leassceawere	læ͜ɑːsʃæ͜ɑːwere
leax	læ͜ɑks
lec	leːk
leccan	lett͡ʃɑn
lecgan	lejjɑn
lefan	leːfɑn
legen	lejen
leger	lejer
legere	leːɡere
legerstow	lejerstoːw
legerteam	lejertæ͜ɑːm
leget	leːjet
leht	leːxt
lemian	lemiɑn
lencten	lenkten
lenctenadl	lenktenɑːdl
lenctenlic	lenktenliːt͡ʃ
lendan	lendɑn
lenden	lenden
lendenu	lendenu
leng	lenj
lengest	lend͡ʒest
lengþu	lenɡθu
leo	le͜oː
leod	le͜oːd
leoda	le͜oːd
leodan	le͜oːdɑn
leodcyning	le͜oːdkyninɡ
leode	le͜oːde
leoden	le͜oːden
leodgebyrga	le͜oːdjebyrjɑ
leodgeþincþu	le͜oːdjeθinkθu
leodhryre	le͜oːdxryre
leodmearc	le͜oːdmæ͜ɑrk
leodmægen	le͜oːdmæjen
leodriht	le͜oːdrixt
leodræden	le͜oːdræːden
leodscipe	le͜oːdʃipe
leodstefn	le͜oːdstefn
leodweard	le͜oːdwæ͜ɑrd
leodwerod	le͜oːdwerod
leodwita	le͜oːdwitɑ
leodwynn	le͜oːdwynn
leof	le͜oːf
leoflic	le͜oːfliːt͡ʃ
leofwende	le͜oːfwende
leogan	le͜oːɡɑn
leogere	le͜oːɡere
leoht	le͜oːxt
leohtberend	le͜oːxtberend
leohtbrædnes	le͜oːxtbræːdnes
leohtbære	le͜oːxtbæːre
leohtfæt	le͜oːxtfæt
leohtlic	le͜oːxtliːt͡ʃ
leohtlice	le͜oːxtliːt͡ʃe
leohtsawend	le͜oːxtsɑːwend
leoma	le͜oːmɑ
leon	le͜oːn
leoran	le͜oːrɑn
leornian	le͜orniɑn
leorningcild	le͜orninɡt͡ʃild
leornungcniht	le͜ornunɡknixt
leow	le͜oːw
leoþ	le͜oːθ
leoþcræft	le͜oːθkræft
leoþcræftig	le͜oːθkræftij
leoþere	le͜oːθere
leoþgiddung	le͜oːθjiddunɡ
leoþian	le͜oːθiɑn
leoþlic	le͜oːθliːt͡ʃ
leoþorun	le͜oːθoruːn
leoþwise	le͜oːθwiːse
leoþwyrhta	le͜oːθwyrxtɑ
lesan	lesɑn
lettan	lettɑn
leðer	leθer
leþer	leθer
libban	libbɑn
lic	liːt͡ʃ
liccian	likkiɑn
licettan	liːt͡ʃettɑn
licettere	liːt͡ʃettere
licettung	liːt͡ʃettunɡ
licgan	lijjɑn
lichama	liːkxɑmɑ
lichamlic	liːkxɑmliːt͡ʃ
lichamlice	liːkxɑmliːt͡ʃe
lician	liːkiɑn
licnes	liːknes
lictun	liːktuːn
licþeote	liːkθe͜oːte
liefan	li͜yːfɑn
lieg	li͜yːj
liegberende	li͜yːjberende
liegbryne	li͜yːjbryne
liegbære	li͜yːjbæːre
liegcwalu	li͜yːjkwɑlu
liegdraca	li͜yːjdrɑkɑ
liegegesa	li͜yːjejesɑ
liegetu	li͜yːjetu
liegfamblawende	li͜yːjfɑːmblɑːwende
liegfyr	li͜yːjfyːr
liegfæmende	li͜yːjfæːmende
lieglocc	li͜yːjlokk
liegloccod	li͜yːjlokkod
liegnan	li͜yːjnɑn
liegræsc	li͜yːjræʃ
liegræscettung	li͜yːjræʃettunɡ
liegspiwol	li͜yːjspiːwol
liegyþ	li͜yːjyːθ
liegþracu	li͜yːjθrɑku
liehtan	li͜yːxtɑn
liesan	li͜yːsɑn
lif	liːf
lifer	lifer
liffrea	liːffræ͜ɑː
lifgedal	liːfjedɑːl
lifian	lifiɑn
lifleas	liːflæ͜ɑːs
liflic	liːfliːt͡ʃ
liflice	liːfliːt͡ʃe
lig	liːj
ligen	lijen
ligen	liːjen
liget	liːjet
ligetræsc	liːjetræʃ
ligetsliht	liːjetslixt
ligetu	liːjetu
lignan	liːjnɑn
ligyþ	liːjyːθ
lihtan	liːxtɑn
lim	lim
lim	liːm
limmælum	limmæːlum
limpan	limpɑn
lind	lind
linden	linden
lindhæbbend	lindxæbbend
line	liːne
linen	liːnen
linnan	linnɑn
lippa	lippɑ
lira	liːrɑ
lireht	liːrext
list	list
lixan	liːksɑn
liþ	liθ
liþa	liːθɑ
liþan	liːθɑn
liþe	liːθe
lobbe	lobbe
loc	lok
loc	loːk
loca	lokɑ
loca	loːk
locc	lokk
loccian	lokkiɑn
locian	loːkiɑn
loddere	loddere
lodrung	lodrunɡ
lof	lof
lof	loːf
lofdæd	lofdæːd
lofian	lofiɑn
log	loːɡ
loga	loɡɑ
logian	loːɡiɑn
loh	loːx
lome	loːme
long	lonɡ
longe	lonɡe
longsum	lonɡsum
loppe	loppe
loppestre	loppestre
los	los
losian	losiɑn
lox	loks
loþa	loθɑ
lucan	luːkɑn
lucas	lukɑs
lufe	lufe
lufestice	lufestit͡ʃe
lufestre	lufestre
lufian	lufiɑn
lufiend	lufiend
luflic	lufliːt͡ʃ
lufsum	lufsum
luftacen	luftɑːken
lufu	lufu
lumpen	lumpen
lunden	lunden
lundlaga	lundlɑɡɑ
lungen	lunɡen
lus	luːs
lust	lust
lustbære	lustbæːre
lustfullice	lustfulliːt͡ʃe
lutan	luːtɑn
lyb	lyb
lybb	lybb
lybesn	lybesn
lyden	lyːden
lyft	lyft
lyften	lyften
lyge	lyje
lygen	lyjen
lysan	lyːsɑn
lysu	lysu
lyswen	lyswen
lyt	lyːt
lytel	lyːtel
lythwon	lyːtxwoːn
læcan	læːt͡ʃɑn
læccan	lætt͡ʃɑn
læce	læːt͡ʃe
læceboc	læːt͡ʃeboːk
læcecræft	læːt͡ʃekræft
læcedom	læːt͡ʃedoːm
læcehus	læːt͡ʃexuːs
læceseax	læːt͡ʃesæ͜ɑks
lædan	læːdɑn
læden	læːden
lædere	læːdere
læfan	læːfɑn
læn	læːn
lænan	læːnɑn
læppa	læppɑ
læran	læːrɑn
lærestre	læːrestre
læring	læːrinɡ
læringmæden	læːrinɡmæːden
læs	læːs
læsest	læːsest
læssa	læːssɑ
læst	læːst
læstan	læːstɑn
læste	læste
læt	læt
læt	læːt
lætan	læːtɑn
lætsum	lætsum
læwa	læːwɑ
læwan	læːwɑn
læwed	læːwed
læwede	læːwede
ma	mɑː
macian	mɑkiɑn
maga	mɑɡɑ
maga	mɑːɡɑ
magan	mɑɡɑn
magian	mɑɡiɑn
mago	mɑɡo
magon	mɑɣon
magu	mɑɡu
maguþegn	mɑɡuθejn
mal	mɑːl
malscrung	mɑlʃrunɡ
mamera	mɑmerɑ
mamor	mɑmor
mamorian	mɑːmoriɑn
mamrian	mɑːmriɑn
man	mɑn
man	mɑnn
man	mɑːn
manaþ	mɑːnɑːθ
mancynn	mɑnkynn
mand	mɑnd
mandæde	mɑːndæːde
manfordædla	mɑːnfordæːdlɑ
mangere	mɑnɡere
mangian	mɑnɡiɑn
mangung	mɑnɡunɡ
mangunghus	mɑnɡunɡxuːs
manian	mɑniɑn
manig	mɑnij
manigfeald	mɑnijfæ͜ɑld
manigfealdan	mɑnijfæ͜ɑldɑn
manigfealdian	mɑnijfæ͜ɑldiɑn
manigfealdlic	mɑnijfæ͜ɑldliːt͡ʃ
manigfealdlice	mɑnijfæ͜ɑldliːt͡ʃe
manigfealdnes	mɑnijfæ͜ɑldnes
mann	mɑnn
mannbære	mɑnnbæːre
mannleas	mɑnnlæ͜ɑːs
mannlice	mɑnnliːt͡ʃe
manscipe	mɑnskipe
manscyldig	mɑːnʃyldij
manslaga	mɑnslɑɡɑ
manswerian	mɑːnswerjɑn
manu	mɑnu
mapolder	mɑpolder
mapulder	mɑpulder
mapuldor	mɑpuldor
mara	mɑːrɑ
marc	mɑrk
marcus	mɑrkus
mare	mɑre
marmstan	mɑrmstɑːn
masc	mɑʃ
masc	mɑːʃ
mase	mɑːse
matheus	mɑteus
mawan	mɑːwɑn
maþa	mɑθɑ
maþelian	mɑθeliɑn
maþelode	mɑθelode
maþm	mɑːθm
maþum	mɑːθum
me	meː
meaht	mæ͜ɑxt
mealm	mæ͜ɑlm
mealmiht	mæ͜ɑlmixt
mealt	mæ͜ɑlt
mealwe	mæ͜ɑlwe
meara	mæ͜ɑːrɑ
mearc	mæ͜ɑrk
mearcian	mæ͜ɑrkiɑn
mearcung	mæ͜ɑrkunɡ
meare	mæ͜ɑːre
meares	mæ͜ɑːres
mearg	mæ͜ɑrɡ
mearh	mæ͜ɑrx
mearn	mæɑrn
mearum	mæ͜ɑːrum
mearþ	mæ͜ɑrθ
meatte	mæ͜ɑtte
mec	mek
mece	meːt͡ʃe
mecefisc	meːt͡ʃefiʃ
mecgan	mejjɑn
med	meːd
meddern	meːddern
medeme	medeme
medemian	medemiɑn
medern	meːdern
medren	meːdren
medu	medu
medume	medume
medumian	medumiɑn
medusetl	medusetl
medwis	medwiːs
melcan	melkɑn
meldian	meldiɑn
meltan	meltɑn
melu	melu
mencgan	menjɑn
mene	mene
mengan	menjɑn
mengu	menju
menigeo	menijo
menigu	meniju
mennisc	menniʃ
mennisclic	menniʃliːt͡ʃ
mennisclicnes	menniʃliːknes
menniscnes	menniʃnes
menniscu	mennisku
meolc	me͜olk
meolcan	me͜olkɑn
meos	me͜oːs
meotan	me͜otɑn
meowle	me͜oːwle
meox	me͜oks
mere	mere
meredeaþ	meredæ͜ɑːθ
meredeor	merede͜oːr
merefisc	merefiʃ
meregrot	mereɡrot
mereliþend	mereliːθend
mereswin	mereswiːn
merian	merjɑn
merisc	meriʃ
mersc	merʃ
merscig	merʃij
merscmealwe	merʃmæ͜ɑlwe
mesan	meːsɑn
met	met
metan	metɑn
metan	meːtɑn
mete	mete
meteleas	metelæ͜ɑːs
metere	meːtere
metesacca	metesɑkkɑ
meteseax	metesæ͜ɑks
metesocn	metesoːkn
meteswamm	meteswɑmm
metetid	metetiːd
meteþearfende	meteθæ͜ɑrfende
meteþegn	meteθejn
metgian	metɡiɑn
meting	meːtinɡ
metod	metod
meþe	meːθe
micel	mit͡ʃel
micele	mit͡ʃele
micelian	mit͡ʃeliɑn
micellic	mit͡ʃelliːt͡ʃ
micellice	mit͡ʃelliːt͡ʃe
micelmod	mit͡ʃelmoːd
micelnes	mit͡ʃelnes
micelu	mit͡ʃelu
mid	mid
midd	midd
middaneard	middɑnæ͜ɑrd
middangeard	middɑnjæ͜ɑrd
midde	midde
middelfinger	middelfinɡer
middes	middes
middæg	middæj
midniht	midnixt
midsumor	midsumor
midwist	midwist
midþeahtian	midθæ͜ɑxtiɑn
midþolian	midθoliɑn
mierce	mi͜yrt͡ʃe
miercels	mi͜yrt͡ʃels
miere	mi͜yːre
migan	miːɡɑn
migoþa	miɡoθɑ
miht	mixt
mihte	miçte
mihtig	mixtij
mihtleas	mixtlæ͜ɑːs
mihtlic	mixtliːt͡ʃ
mihtlice	mixtliːt͡ʃe
mil	miːl
milde	milde
mildelice	mildeliːt͡ʃe
mildheortlic	mildxe͜ortliːt͡ʃ
mildheortnes	mildxe͜ortnes
milte	milte
miltheortnis	miltxe͜ortnis
milts	milts
miltsian	miltsiɑn
mimming	mimminɡ
mimor	mimor
mimorian	mimoriɑn
min	min
min	miːn
mindom	mindoːm
minlic	minliːt͡ʃ
minsian	minsiɑn
minum	miːnum
mioluc	mi͜uluk
mircels	mirt͡ʃels
mirige	mirije
misbeodan	misbe͜oːdɑn
miscennung	miskennunɡ
miscian	miskiɑn
miscweþan	miskweθɑn
miscyrran	mist͡ʃyrrɑn
misdon	misdoːn
misdæd	misdæːd
misfangen	misfɑnɡen
misfehst	misfeːxst
misfehþ	misfeːxθ
misfeng	misfeːnɡ
misfenge	misfeːnɡe
misfengen	misfeːnɡen
misfengon	misfeːnɡon
misfo	misfoː
misfoh	misfoːx
misfon	misfoːn
misfonde	misfoːnde
misfoþ	misfoːθ
mishieran	misxi͜yːrɑn
mishweorfan	misxwe͜orfɑn
mishyran	misxyːrɑn
mislar	mislɑːr
mislibban	mislibbɑn
mislician	misliːkiɑn
mislædan	mislæːdɑn
misrædan	misræːdɑn
miss	miss
missan	missɑn
misscrydan	misʃryːdɑn
missere	misseːre
misspowan	misspoːwɑn
missprecan	missprekɑn
mist	mist
mistel	mistel
mistæcan	mistæːt͡ʃɑn
miswendan	miswendɑn
miswritan	miswriːtɑn
mið	miθ
miþan	miːθɑn
mod	moːd
modcræft	moːdkræft
modcræftig	moːdkræftij
moder	moːder
modgehygd	moːdjexyjd
modig	moːdij
modiglic	moːdijliːt͡ʃ
modignes	moːdijnes
modor	moːdor
modorleas	moːdorlæ͜ɑːs
modorlic	moːdorliːt͡ʃ
modrige	moːdrije
modsefa	moːdsefɑ
modstaþol	moːdstɑθol
modstaþolnes	moːdstɑθolnes
modþracu	moːdθrɑku
molde	molde
mona	moːnɑ
monandæg	moːnɑndæj
monanniht	moːnɑnnixt
monað	moːnɑθ
monaþ	monɑθ
monaþ	moːnɑθ
monaþblod	moːnɑθbloːd
monaþlic	moːnɑθliːt͡ʃ
monelic	moːneliːt͡ʃ
mor	moːr
moras	moːrɑs
morað	moːrɑθ
moraþ	moːrɑθ
morbeam	moːrbæ͜ɑːm
morberige	moːrberije
more	moːre
morgen	morɡen
morgengiefu	morɡenji͜yfu
morgengifu	morɡenjifu
moru	moru
morþ	morθ
morþbealo	morθbæ͜ɑlo
morþor	morθor
morþorscyldig	morθorʃyldij
morþslaga	morθslɑɡɑ
morþsliht	morθslixt
mos	mos
mos	moːs
mot	moːt
motan	moːtɑn
motern	moːtern
motian	moːtiɑn
motung	moːtunɡ
moþfreten	moθfreten
moþþe	moθθe
muga	muːɡɑ
mul	muːl
munan	munɑn
mund	mund
mundbyrd	mundbyrd
mundgripe	mundɡripe
mundian	mundiɑn
munec	munek
munt	munt
munuc	munuk
murnan	murnɑn
mus	muːs
muscelle	muskelle
musfealle	muːsfæ͜ɑlle
mushafoc	muːsxɑfok
musheafoc	muːsxæ͜ɑfok
muð	muːθ
muþ	muːθ
muþa	muːθɑ
muþleas	muːθlæ͜ɑːs
mycel	myt͡ʃel
mycg	myjj
mycgnett	myjjnett
mylen	mylen
mylenhweol	mylenxwe͜oːl
myln	myln
myltestre	myltestre
mymerian	mymeriɑn
myndgian	myndɡiɑn
myndleas	myndlæ͜ɑːs
myne	myne
mynecenu	mynet͡ʃenu
mynegian	myneɡiɑn
mynelic	myneliːt͡ʃ
mynet	mynet
mynetere	mynetere
mynetian	mynetiɑn
mynetsmiþþe	mynetsmiθθe
myntan	myntɑn
myrge	myrje
myrgen	myrjen
myrgþ	myrjθ
myrige	myrije
myrþra	myrθrɑ
mæce	mæːt͡ʃe
mæcefisc	mæːt͡ʃefiʃ
mæcg	mæjj
mæd	mæːd
mæden	mæːden
mædmonaþ	mæːdmoːnɑθ
mædwe	mæːdwe
mæg	mæj
mæg	mæːj
mægden	mæjden
mægdencild	mæjdent͡ʃild
mægdenhad	mæjdenxɑːd
mægdenlic	mæjdenliːt͡ʃ
mægelan	mæjelɑn
mægen	mæjen
mægencræft	mæjenkræft
mægenwudu	mæjenwudu
mæger	mæjer
mægester	mæjester
mægeþ	mæːjeθ
mæghæmed	mæːjxæːmed
mægn	mæjn
mægðe	mæjθe
mægþ	mæjθ
mægþ	mæːjθ
mægþ	mæːɡθ
mægþblæd	mæjθblæd
mægþe	mæjθe
mægþhad	mæjθxɑːd
mægþhad	mæːjθxɑːd
mæl	mæːl
mælan	mæːlɑn
mænan	mæːnɑn
mæne	mæːne
mænigo	mænijo
mæran	mæːrɑn
mære	mæːre
mærsian	mæːrsiɑn
mærstan	mæːrstɑːn
mærsung	mæːrsunɡ
mærsungtima	mæːrsunɡtiːmɑ
mæscre	mæʃre
mæseren	mæseren
mæsling	mæslinɡ
mæsse	mæsse
mæssedæg	mæssedæj
mæst	mæst
mæst	mæːst
mæstan	mæstɑn
mætan	mæːtɑn
mæw	mæːw
mæþel	mæθel
mæþelern	mæθelern
mæþlan	mæθlɑn
na	nɑː
nabban	nɑbbɑn
naca	nɑkɑ
nacian	nɑkiɑn
nacod	nɑkod
nacodnes	nɑkodnes
nafela	nɑfelɑ
nafogar	nɑfoɡɑːr
nafola	nɑfolɑ
nafu	nɑfu
nagan	nɑːɡɑn
nahwær	nɑːxwæːr
nam	nɑm
nama	nɑmɑ
naman	nɑmɑn
namboc	nɑmboːk
nan	nɑːn
naso	nɑso
nasturcium	nɑsturkium
nasu	nɑsu
nat	nɑːt
nawiht	nɑːwixt
nazarenisc	nɑtsɑreniʃ
nazareth	nɑtsɑret
ne	ne
neah	næ͜ɑːx
neahbuend	næ͜ɑːxbuːend
neahgebur	næ͜ɑːxjebuːr
neahstow	næ͜ɑːxstoːw
neaht	næ͜ɑxt
nealles	næ͜ɑlles
nealæcan	næ͜ɑːlæːt͡ʃɑn
nearanes	næ͜ɑrɑnes
nearo	næ͜ɑro
nearones	næ͜ɑrones
neart	næ͜ɑrt
nearu	næ͜ɑru
nearunes	næ͜ɑrunes
neat	næ͜ɑːt
neawist	næ͜ɑːwist
nebb	nebb
ned	neːd
nefa	nefɑ
nefene	nefene
nefne	nefne
neh	neːx
nemnan	nemnɑn
nemnian	nemniɑn
nemniendlic	nemniendliːt͡ʃ
nemnigendlic	nemnijendliːt͡ʃ
nemning	nemninɡ
neo	ne͜oː
neod	ne͜oːd
neodful	ne͜oːdful
neodian	ne͜oːdiɑn
neodlaþu	ne͜oːdlɑθu
neodlice	ne͜oːdliːt͡ʃe
neol	ne͜oːl
neolnes	ne͜oːlnes
neom	ne͜om
neorxnawang	ne͜orksnɑwɑnɡ
neosian	ne͜oːsiɑn
neotan	ne͜oːtɑn
neowe	ne͜oːwe
neowel	ne͜owel
neowellic	ne͜owelliːt͡ʃ
neowelnes	ne͜owelnes
neowol	ne͜owol
neowollic	ne͜owolliːt͡ʃ
neowolnes	ne͜owolnes
neoðan	ne͜oθɑn
neoþan	ne͜oθɑn
neoþeweard	ne͜oθewæ͜ɑrd
nepflod	neːpfloːd
nerian	nerjɑn
nesan	nesɑn
nese	nese
nest	nest
net	net
neþan	neːθɑn
nibacen	niːbɑken
nic	nit͡ʃ
nicc	nitt͡ʃ
nicenned	niːkenned
nicor	nikor
nied	ni͜yːd
niedhæs	ni͜yːdxæːs
niedwracu	ni͜yːdwrɑku
niehsta	ni͜yːxstɑ
nieht	ni͜yxt
nieten	ni͜yːten
niewan	ni͜yːwɑn
niewe	ni͜yːwe
niewian	ni͜yːwiɑn
niewlice	ni͜yːwliːt͡ʃe
niewnes	ni͜yːwnes
niewung	ni͜yːwunɡ
nifol	nifol
nift	nift
nigon	nijon
nigon	niɡon
nigonfeald	nijonfæ͜ɑld
nigonfeald	niɡonfæ͜ɑld
nigonteoþa	nijonte͜oːθɑ
nigonteoþa	niɡonte͜oːθɑ
nigontiene	nijonti͜yːne
nigontiene	niɡonti͜yːne
nigoþa	nijoθɑ
nigoþa	niɡoθɑ
nihstig	nixstij
niht	nixt
nihtbealo	nixtbæ͜ɑlo
nihtegale	nixteɡɑle
nihtes	nixtes
nihtgenga	nixtɡenjɑ
nihtgenge	nixtɡenje
nihthræfn	nixtxræfn
nihtlic	nixtliːt͡ʃ
nihtscada	nixtʃɑdɑ
nihtsum	nixtsum
nihtsumian	nixtsumiɑn
nihtsumnes	nixtsumnes
nillan	nillɑn
niman	nimɑn
nioðan	ni͜uθɑn
nioþan	ni͜uθɑn
nipan	niːpɑn
nis	nis
niwan	niːwɑn
niwe	niːwe
niwel	niwel
niwellic	niwelliːt͡ʃ
niwelnys	niwelnys
niwian	niːwiɑn
niwlice	niːwliːt͡ʃe
niwnes	niːwnes
niwung	niːwunɡ
niþ	niːθ
niþer	niθer
niþera	niθerɑ
niþerlic	niθerliːt͡ʃ
niþernes	niθernes
niþful	niːθful
niþfull	niːθfull
niþgeteon	niːθjete͜oːn
niþgrimm	niːθɡrimm
niþre	niθre
niþþas	niθθɑs
no	noː
noma	nomɑ
non	non
non	noːn
normandig	normɑndij
normandig	normɑndiːj
norþ	norθ
norþanhymbre	norθɑnxymbre
norþerne	norθerne
norþman	norθmɑn
norþmann	norθmɑnn
norþweg	norθwej
nose	nose
nostle	nostle
nosu	nosu
nosþyrel	nosθyːrel
not	not
notian	notiɑn
notu	notu
nowend	noːwend
nowiht	noːwixt
noþ	noːθ
nu	nuː
numen	numen
nunne	nunne
nyd	nyːd
nydwracu	nyːdwrɑku
nyht	nyxt
nyllan	nyllɑn
nymþe	nymθe
nytan	nytɑn
nyten	nyten
nyten	nyːten
nytennes	nytennes
nytlic	nytliːt͡ʃ
nytlice	nytliːt͡ʃe
nytlicnes	nytliːt͡ʃnes
nytnes	nytnes
nytt	nytt
nyttian	nyttiɑn
nyttol	nyttol
nyttung	nyttunɡ
nytwierþe	nytwi͜yrθe
nytwierþnes	nytwi͜yrθnes
nytwyrþe	nytwyrθe
nytwyrþnes	nytwyrθnes
nyþernes	nyθernes
nædl	næːdl
nædre	næːdre
næfre	næːfre
næft	næft
nægel	næjel
nægl	næjl
næglan	næjlɑn
næglian	næjliɑn
næht	næxt
nænig	næːnij
nære	næːre
næren	næːren
næron	næːron
næs	næs
næse	næse
næster	næster
odissia	odissiɑ
of	of
ofdune	ofduːne
ofer	ofer
ofer	oːfer
oferbidan	oferbiːdɑn
oferbrecan	oferbrekɑn
oferbru	oferbruː
oferbugan	oferbuːɡɑn
ofercierran	ofert͡ʃi͜yrrɑn
oferclimban	oferklimbɑn
ofercuman	oferkumɑn
ofercyrr	ofert͡ʃyrr
ofercyrran	ofert͡ʃyrrɑn
oferdon	oferdoːn
oferdrifan	oferdriːfɑn
oferdrincan	oferdrinkɑn
oferdrincere	oferdrinkere
oferfaran	oferfɑrɑn
oferfeallan	oferfæ͜ɑllɑn
oferflitan	oferfliːtɑn
oferflowan	oferfloːwɑn
oferfylgan	oferfyljɑn
oferfyllan	oferfyllɑn
oferfæreld	oferfæreld
ofergan	oferɡɑːn
ofergang	oferɡɑnɡ
ofergangan	oferɡɑnɡɑn
ofergesawan	oferjesɑːwɑn
oferhabban	oferxɑbbɑn
oferheafod	oferxæ͜ɑːfod
oferhealdan	oferxæ͜ɑldɑn
oferhebban	oferxebbɑn
oferhieran	oferxi͜yːrɑn
oferhleapan	oferxlæ͜ɑːpɑn
oferhleoþor	oferxle͜oːθor
oferhleoþrian	oferxle͜oːθriɑn
oferhycgan	oferxyjjɑn
oferhyran	oferxyːrɑn
oferlecgan	oferlejjɑn
oferlibban	oferlibbɑn
oferlædan	oferlæːdɑn
oferlæfan	oferlæːfɑn
ofermod	ofermoːd
oferreccan	oferrett͡ʃɑn
oferridan	oferriːdɑn
oferrædan	oferræːdɑn
ofersawan	ofersɑːwɑn
ofersceadan	oferʃæ͜ɑːdɑn
ofersceadan	oferʃɑːdɑn
ofersceadwian	oferʃɑdwiɑn
ofersendan	ofersendɑn
oferseon	oferse͜oːn
ofersettan	ofersettɑn
ofersittan	ofersittɑn
ofersprecan	ofersprekɑn
ofersprecol	ofersprekol
ofersprecolnes	ofersprekolnes
oferspræc	oferspræːt͡ʃ
oferspræce	oferspræːt͡ʃe
ofersprædan	oferspræːdɑn
oferstandan	oferstɑndɑn
ofersteppan	ofersteppɑn
oferstigendlic	oferstiːɡendliːt͡ʃ
oferswiþan	oferswiːθɑn
oferswiþness	oferswiːθness
oferswyþan	oferswyːθɑn
oferteon	oferte͜oːn
ofertogennes	ofertoɡennes
oferwadan	oferwɑdɑn
oferweorpan	oferwe͜orpɑn
oferwinnan	oferwinnɑn
oferwintran	oferwintrɑn
oferwrecan	oferwrekɑn
oferwreon	oferwre͜oːn
oferwrigels	oferwriːɡels
oferwyrcan	oferwyrt͡ʃɑn
oferyþ	oferyːθ
ofett	ofett
offestre	offeːstre
offrian	offriɑn
ofgan	ofɡɑːn
ofgangende	ofɡɑnɡende
ofgangendlic	ofɡɑnɡendliːt͡ʃ
ofgiefan	ofji͜yfɑn
ofgifan	ofjifɑn
ofhabban	ofxɑbbɑn
ofhealdan	ofxæ͜ɑldɑn
oflecgan	oflejjɑn
ofmunan	ofmunɑn
ofn	ofn
ofost	ofost
ofsacan	ofsɑkɑn
ofsceadan	ofʃæ͜ɑːdɑn
ofsceadan	ofʃɑːdɑn
ofslean	ofslæ͜ɑːn
ofstandan	ofstɑndɑn
oft	oft
ofteah	oftæ͜ɑːx
ofteon	ofte͜oːn
oftust	oftust
ofweorpan	ofwe͜orpɑn
ofþefian	ofθefiɑn
oht	oːxt
ohthere	oxtxere
olfend	olfend
on	on
onbidan	onbiːdɑn
onbindan	onbindɑn
onbugan	onbuːɡɑn
onbutan	onbuːtɑn
onbæc	onbæk
oncierran	ont͡ʃi͜yrrɑn
oncnyssan	onknyssɑn
oncweþan	onkweθɑn
oncyrran	ont͡ʃyrrɑn
ond	ond
ondfon	ondfoːn
ondon	ondoːn
ondrædan	ondræːdɑn
oneardian	onæ͜ɑrdiɑn
oneardiend	onæ͜ɑrdiend
onerian	onerjɑn
onettan	onettɑn
onfindan	onfindɑn
onfon	onfoːn
onfæreld	onfæreld
ongean	onjæ͜ɑːn
ongeancyrring	onjæ͜ɑːnt͡ʃyrrinɡ
ongeanhweorfan	onjæ͜ɑːnxwe͜orfɑn
ongeat	onjæɑt
ongefeoht	onjefe͜oxt
ongegn	onjejn
ongemang	onjemɑnɡ
ongietan	onji͜ytɑn
onginnan	onjinnɑn
ongitan	onjitɑn
onhabban	onxɑbbɑn
onhatan	onxɑːtɑn
onhierdan	onxi͜yrdɑn
onhreran	onxreːrɑn
onhweorfan	onxwe͜orfɑn
onhycgan	onxyɡɡɑn
onhyrdan	onxyrdɑn
onhyrenes	onxyrenes
onhyrian	onxyrjɑn
onhyriend	onxyrjend
onhyring	onxyrinɡ
onirnan	onirnɑn
onlec	onleːt͡ʃ
onliesan	onli͜yːsɑn
onlihtan	onliːxtɑn
onlucan	onluːkɑn
onlysan	onlyːsɑn
onlædan	onlæːdɑn
onmearcung	onmæ͜ɑrkunɡ
onmiddan	onmiddɑn
onmunan	onmunɑn
onsang	onsɑnɡ
onscogan	onʃoːjɑn
onsendan	onsendɑn
onsendon	onsendon
onsittan	onsittɑn
onsteall	onstæ͜ɑll
onstellan	onstellɑn
onsundrian	onsundriɑn
onteon	onte͜oːn
ontimber	ontimber
ontynan	ontyːnɑn
onwacan	onwɑkɑn
onwadan	onwɑdɑn
onweg	onwej
onwegacyrrednes	onwejɑːt͡ʃyrrednes
onwegfæreld	onwejfæreld
onwendan	onwendɑn
onweorpan	onwe͜orpɑn
onwican	onwiːkɑn
onwoc	onwoːk
onwrecan	onwrekɑn
onwreon	onwre͜oːn
onwæcnan	onwæknɑn
onælan	onæːlɑn
onþracian	onθrɑkiɑn
open	open
openears	openæ͜ɑrs
openian	openiɑn
openlic	openliːt͡ʃ
openlice	openliːt͡ʃe
openung	openunɡ
or	oːr
ora	oːrɑ
orblede	orbleːde
orc	ork
orceard	ort͡ʃæ͜ɑrd
ord	ord
ordal	ordɑːl
ordfruma	ordfrumɑ
ordwulf	ordwulf
ore	ore
oregel	oreɡel
oretmæcg	oːretmæjj
orgel	orɡel
orgello	orɡello
orgol	orɡol
orleahter	orlæ͜ɑxter
orlege	orleje
orleghwil	orlejxwiːl
orlæg	orlæj
ormæte	ormæːte
oroþ	oroθ
orsawle	orsɑːwle
orsorg	orsorɡ
orsorgleas	orsorɡlæ͜ɑːs
orsorglice	orsorɡliːt͡ʃe
orsorgnes	orsorɡnes
orsorgness	orsorɡness
orsorh	orsorx
ortgeard	ortjæ͜ɑrd
ortreowe	ortre͜oːwe
orðanc	orθɑnk
orðonc	orθonk
orþanc	orθɑnk
orþian	orθiɑn
orþonc	orθonk
os	oːs
osle	oːsle
ost	oːst
ostre	ostre
oter	oter
otor	otor
oustrefeld	oustrefeld
owiht	oːwixt
oxa	oksɑ
oxan	oksɑn
oxenaford	oksenɑford
oxnaford	oksnɑford
oððe	oθθe
oþ	oθ
oþcwelan	oθkwelɑn
oþcyrran	oθt͡ʃyrrɑn
oþer	oːθer
oþgripan	oθɡriːpɑn
oþian	oːθiɑn
oþsceotan	oθʃe͜oːtɑn
oþstandan	oθstɑndɑn
oþteon	oθte͜oːn
oþwendan	oːθwendɑn
oþþe	oθθe
oþþeodan	oθθe͜oːdɑn
oþþingian	oθθinɡiɑn
oþþon	oθθon
oþþæt	oθθæt
paddoc	pɑddok
pal	pɑːl
palent	pɑlent
palentlic	pɑlentliːt͡ʃ
palmsunnandæg	pɑlmsunnɑndæj
panne	pɑnne
papa	pɑːpɑ
passion	pɑssi͜un
pawa	pɑːwɑ
paþas	pɑθɑs
paþum	pɑθum
pearroc	pæ͜ɑrrok
pearruc	pæ͜ɑrruk
pehtas	pextɑs
penning	penninɡ
penningmangere	penninɡmɑnɡere
penwihtsteort	penwixtste͜ort
peohtas	pe͜oxtɑs
peorð	pe͜orθ
persoc	persok
persoctreow	persoktre͜oːw
peru	peru
petersilige	petersilije
petrus	petrus
picgbread	piɡɡbræ͜ɑːd
pinca	pinkɑ
pinere	piːnere
pinian	piːniɑn
pinn	pinn
pinne	pinne
pinness	piːnness
pinsian	pinsiɑn
pintel	pintel
pintreow	piːntre͜oːw
pintreowen	piːntre͜oːwen
pintrywen	piːntryːwen
pinung	piːnunɡ
pinungtol	piːnunɡtoːl
pipdream	piːpdræ͜ɑːm
piper	piper
pipor	pipor
piporian	piporiɑn
pirige	pirije
pis	piːs
pislice	piːsliːt͡ʃe
plante	plɑnte
plantian	plɑntiɑn
plantsticca	plɑntstikkɑ
plega	pleɡɑ
plegian	pleɡiɑn
plegol	pleɡol
pleoh	ple͜ox
pleon	ple͜oːn
pliht	plixt
plihtan	plixtɑn
plog	ploːɡ
ploh	ploːx
plume	pluːme
plumtreow	pluːmtre͜oːw
plætt	plætt
plættan	plættɑn
pocca	pokkɑ
pohha	poxxɑ
pol	poːl
popig	popij
port	port
portcwene	portkwene
portesmuða	portesmuːθɑ
portesmuþa	portesmuːθɑ
portgerefa	portjereːfɑ
post	post
potian	potiɑn
predicere	predikere
predician	predikiɑn
predicung	predikunɡ
preost	pre͜oːst
preowthwil	pre͜oːwtxwiːl
prica	prikɑ
prician	prikiɑn
prim	priːm
primsang	priːmsɑnɡ
princ	prink
profian	proːfiɑn
prud	pruːd
pryte	pryːte
prætt	prætt
psealm	psæ͜ɑlm
puca	puːkɑ
pucel	puːkel
pullian	pulliɑn
pund	pund
punian	puːniɑn
purpuren	purpuren
purs	purs
pusa	pusɑ
pyll	pyll
pynca	pynkɑ
pytt	pytt
pæca	pæːt͡ʃɑ
pæcan	pæːt͡ʃɑn
pæcung	pæːt͡ʃunɡ
pægel	pæjel
pæþ	pæθ
pæþe	pæθe
pæþes	pæθes
ra	rɑː
raca	rɑkɑ
racentan	rɑkentɑn
racente	rɑkente
racenteag	rɑkentæ͜ɑːɡ
racenteagian	rɑkentæ͜ɑːɡiɑn
racentum	rɑkentum
racian	rɑkiɑn
racu	rɑku
rad	rɑːd
ragu	rɑɡu
raha	rɑːxɑ
ramm	rɑmm
ran	rɑːn
ranc	rɑnk
rand	rɑnd
randbeag	rɑndbæ͜ɑːɡ
rap	rɑːp
raredumle	rɑːredumle
rarian	rɑːriɑn
rasian	rɑːsiɑn
raþe	rɑθe
read	ræ͜ɑːd
readnes	ræ͜ɑːdnes
readnys	ræ͜ɑːdnys
reaf	ræ͜ɑːf
reafere	ræ͜ɑːfere
reafian	ræ͜ɑːfiɑn
ream	ræ͜ɑːm
rec	reːk
recan	rekɑn
recan	reːt͡ʃɑn
reccan	rett͡ʃɑn
reced	ret͡ʃed
recede	ret͡ʃede
receleas	reːt͡ʃelæ͜ɑːs
recen	ret͡ʃen
recenian	rekeniɑn
red	red
refsan	refsɑn
regn	rejn
regnboga	rejnboɡɑ
regndropa	rejndropɑ
regnian	rejniɑn
regnwyrm	rejnwyrm
regol	reɡol
regolsticca	reɡolstikkɑ
reht	rext
renscur	reːnʃuːr
reoc	re͜oːk
reocan	re͜oːkɑn
reod	re͜oːd
reodan	re͜oːdɑn
reodmuþa	re͜oːdmuːθɑ
reofan	re͜oːfɑn
reohhe	re͜oxxe
reoht	rixt
reoma	re͜omɑ
reon	re͜oːn
reord	re͜ord
reordberend	re͜ordberend
reordian	re͜ordiɑn
reordon	re͜ordon
reotan	re͜oːtɑn
reowon	re͜oːwon
repsan	repsɑn
rest	rest
restan	restɑn
restendæg	restendæj
restleas	restlæ͜ɑːs
reþe	reːθe
reþig	reːθij
reþra	reːθrɑ
ribb	ribb
rice	riːt͡ʃe
ricedom	riːt͡ʃedoːm
ricen	riːt͡ʃen
ricsian	riːksiɑn
ricsiend	riːksiend
ricu	riːku
rida	ridɑ
ridan	riːdɑn
ridda	riddɑ
rift	rift
rignan	rijnɑn
riht	rixt
rihtan	rixtɑn
rihte	rixte
rihtere	rixtere
rihtnes	rixtnes
rihtwis	rixtwiːs
rihtwisnes	rixtwiːsnes
rim	riːm
rima	rimɑ
riman	riːmɑn
rimcræft	riːmkræft
rimere	riːmere
rin	riːn
rinc	rink
rind	rind
rinde	rinde
rinnan	rinnɑn
ripan	riːpɑn
ripaþ	riːpɑθ
ripe	riːpe
ripst	riːpst
ripþ	riːpθ
risan	riːsɑn
risaþ	riːsɑθ
riþ	riːθ
rocc	rokk
roccian	rokkiɑn
rocettan	rot͡ʃettɑn
rod	roːd
rodfæstnian	roːdfæstniɑn
rodor	rodor
rodorlic	rodorliːt͡ʃ
rodorstol	rodorstoːl
rodweorþiend	roːdwe͜orθi͜ynd
rof	roːf
rogian	roːɡiɑn
rom	roːm
romane	roːmɑːne
romanisc	roːmɑːniʃ
romfeoh	roːmfe͜ox
rose	roːse
rosen	roːsen
row	roːw
rowan	roːwɑn
roweþ	roːweθ
roþhund	roθxund
roþor	roːθor
rudduc	rudduk
rudian	rudiɑn
rudig	rudij
ruh	ruːx
ruhha	ruxxɑ
rum	ruːm
run	ruːn
runa	ruːnɑ
rune	ruːne
runian	ruːniɑn
ryge	ryje
ryman	ryːmɑn
ryne	ryne
rynel	rynel
rysel	rysel
ryþþa	ryθθɑ
ræcan	ræːt͡ʃɑn
ræd	ræːd
rædan	ræːdɑn
rædbora	ræːdborɑ
ræde	ræːde
rædels	ræːdels
ræden	ræːden
rædere	ræːdere
rædfæst	ræːdfæst
ræding	ræːdinɡ
rædingboc	ræːdinɡboːk
ræfan	ræːfɑn
ræpan	ræːpɑn
ræpling	ræːplinɡ
ræran	ræːrɑn
ræs	ræːs
ræscettan	ræʃettɑn
ræscettung	ræʃettunɡ
ræswa	ræːswɑ
ræswan	ræːswɑn
ræswian	ræːswiɑn
ræswung	ræːswunɡ
ræt	ræt
rætt	rætt
sacan	sɑkɑn
sacaþ	sɑkɑθ
sacende	sɑkende
sacleas	sɑklæ͜ɑːs
sacu	sɑku
sacum	sɑkum
sadol	sɑdol
sadolian	sɑdoliɑn
saga	sɑɡɑ
sagian	sɑɡiɑn
sagu	sɑɡu
saht	sɑxt
sahtlian	sɑxtliɑn
sal	sɑːl
salig	sɑlij
salnes	sɑːlnes
salor	sɑlor
salu	sɑlu
samcwic	sɑːmkwik
samen	sɑmen
samnian	sɑmniɑn
samnung	sɑmnunɡ
samod	sɑmod
samodeard	sɑmodæ͜ɑrd
samodswegend	sɑmodsweːjend
samodwist	sɑmodwist
samodwunung	sɑmodwununɡ
samodwyrcende	sɑmodwyrt͡ʃende
samræden	sɑmræːden
samwist	sɑmwist
sanct	sɑnkt
sand	sɑnd
sandceosol	sɑndt͡ʃe͜osol
sandcorn	sɑndkorn
sandig	sɑndij
sang	sɑnɡ
sangboc	sɑnɡboːk
sangcræft	sɑnɡkræft
sangere	sɑnɡere
sangestre	sɑnɡestre
sape	sɑːpe
sar	sɑːr
sarig	sɑːrij
sarnes	sɑːrnes
sawal	sɑːwɑl
sawan	sɑːwɑn
sawel	sɑːwel
sawelberend	sɑːwelberend
sawelcund	sɑːwelkund
sawelgedal	sɑːweljedɑːl
sawelhus	sɑːwelxuːs
sawelleas	sɑːwellæ͜ɑːs
sawelsceatt	sɑːwelʃæ͜ɑtt
sawelþearf	sɑːwelθæ͜ɑrf
sawend	sɑːwend
sawere	sɑːwere
sawlian	sɑːwliɑn
sawlung	sɑːwlunɡ
sawol	sɑːwol
sawolcund	sɑːwolkund
scacan	ʃɑkɑn
scadan	ʃɑːdɑn
scafan	ʃɑfɑn
scamfæst	ʃɑmfæst
scamian	ʃɑmiɑn
scamleas	ʃɑmlæ͜ɑːs
scamlic	ʃɑmliːt͡ʃ
scamol	ʃɑmol
scamu	ʃɑmu
scanca	ʃɑnkɑ
scand	ʃɑnd
scandhus	ʃɑndxuːs
scandlic	ʃɑndliːt͡ʃ
sceabb	ʃæ͜ɑbb
sceacga	ʃɑɡɡɑ
sceada	ʃæ͜ɑːdɑ
sceadan	ʃæ͜ɑːdɑn
sceadan	ʃɑːdɑn
sceadian	ʃæ͜ɑdiɑn
sceadu	ʃɑdu
sceaduwe	ʃæ͜ɑduwe
sceadwian	ʃɑdwiɑn
sceaf	ʃæ͜ɑːf
sceafa	ʃæ͜ɑːfɑ
sceafa	ʃɑfɑ
sceafmælum	ʃæ͜ɑfmæːlum
sceaft	ʃæ͜ɑft
sceaga	ʃɑɡɑ
sceal	ʃæɑl
scealfor	ʃæ͜ɑlfor
sceallan	ʃæ͜ɑllɑn
sceamfæst	ʃɑmfæst
sceamfæstness	ʃɑmfæstness
sceamol	ʃɑmol
sceamu	ʃɑmu
sceanca	ʃɑnkɑ
sceap	ʃæ͜ɑːp
sceaphierde	ʃæ͜ɑːpxi͜yrde
sceaphyrde	ʃæ͜ɑːpxyrde
sceapieg	ʃæ͜ɑːpi͜yːj
scear	ʃæ͜ɑr
scear	ʃæ͜ɑːr
sceara	ʃæːɑ̯rɑ
sceard	ʃæ͜ɑrd
scearp	ʃæ͜ɑrp
scearplice	ʃæ͜ɑrpliːt͡ʃe
scearpnes	ʃæ͜ɑrpnes
scearpsiene	ʃæ͜ɑrpsi͜yːne
scearseax	ʃæ͜ɑrsæ͜ɑks
scearu	ʃæ͜ɑru
sceat	ʃæ͜ɑːt
sceatt	ʃæ͜ɑtt
sceawere	ʃæ͜ɑːwere
sceawian	ʃæ͜ɑːwiɑn
sceawung	ʃæ͜ɑːwunɡ
sceaðian	ʃɑθiɑn
sceaþ	ʃæ͜ɑːθ
sceaþa	ʃɑθɑ
sceaþan	ʃæ͜ɑθɑn
sceaþian	ʃɑθiɑn
scedeland	ʃedelɑnd
scedenig	ʃedeniːj
scefing	ʃeːfinɡ
sceld	ʃeld
scelfan	ʃelfɑn
scencan	ʃent͡ʃɑn
scendan	ʃendɑn
scene	ʃeːne
sceo	ʃe͜oː
sceogan	ʃoːjɑn
sceoh	ʃe͜oːx
sceolde	ʃolde
sceolh	ʃe͜olx
sceoliege	ʃe͜oːli͜yːje
sceolu	ʃe͜olu
sceomfull	ʃe͜omfull
sceon	ʃe͜oːn
sceon	ʃoːn
sceonca	ʃonkɑ
sceone	ʃe͜oːne
sceot	ʃot
sceotan	ʃe͜oːtɑn
sceotend	ʃe͜oːtend
sceþþan	ʃeθθɑn
scid	ʃiːd
scield	ʃi͜yld
scieldan	ʃi͜yldɑn
scieldburg	ʃi͜yldburɡ
scieldweall	ʃi͜yldwæ͜ɑll
sciell	ʃell
sciene	ʃi͜yːne
scieppan	ʃi͜yppɑn
scieppian	ʃi͜yppiɑn
scieran	ʃi͜yrɑn
sciete	ʃi͜yːte
scildan	ʃildɑn
scima	ʃiːmɑ
scinan	ʃiːnɑn
scinban	ʃinbɑːn
scinu	ʃinu
scip	ʃip
scipe	ʃipe
scipere	ʃipere
scipfæreld	ʃipfæreld
scipgefeoht	ʃipjefe͜oxt
sciphere	ʃipxere
sciphlaford	ʃipxlɑːford
scipian	ʃipiɑn
scipwyrhta	ʃipwyrxtɑ
scir	ʃiːr
scirgerefa	ʃiːrjereːfɑ
scitan	ʃiːtɑn
scite	ʃiːte
scobl	ʃobl
scofl	ʃofl
scogan	ʃoːjɑn
scoh	ʃoːx
scohwyrhta	ʃoːxwyrxtɑ
scol	skoːl
scola	ʃolɑ
scoldon	ʃoldon
scolere	skoːlere
scolu	ʃolu
scop	ʃop
scoplic	ʃopliːt͡ʃ
scorian	ʃoriɑn
scort	ʃort
scortian	ʃortiɑn
scortlice	ʃortliːt͡ʃe
scot	ʃot
scotfreo	skotfre͜oː
scotland	skotlɑnd
scottisc	skottiʃ
scranc	ʃrɑnk
scread	ʃræ͜ɑːd
screadian	ʃræ͜ɑːdiɑn
screawa	ʃræ͜ɑːwɑ
screncan	ʃrent͡ʃɑn
screon	ʃre͜oːn
scrifan	ʃriːfɑn
scrihan	ʃriːxɑn
scrimman	ʃrimmɑn
scrincan	ʃrinkɑn
scrincaþ	ʃrinkɑθ
scrince	ʃrinke
scriþan	ʃriːθɑn
scriþaþ	ʃriːθɑθ
scrobbesburh	ʃrobbesburx
scrobbesbyrigscir	ʃrobbesbyrijʃiːr
scrud	ʃruːd
scrutnian	ʃruːtniɑn
scrutnung	ʃruːtnunɡ
scrydan	ʃryːdɑn
scræf	ʃræf
scua	ʃuːɑ
scucca	ʃukkɑ
scufan	ʃuːfɑn
sculan	ʃulɑn
sculdra	ʃuldrɑ
scur	ʃuːr
scuwa	ʃuːwɑ
scyan	skyːɑn
scyld	ʃyld
scyldig	ʃyldij
scyldigian	ʃyldiɡiɑn
scyldignes	ʃyldijnes
scylding	ʃyldinɡ
scyldleas	ʃyldlæ͜ɑːs
scyldlæta	ʃyldlæːtɑ
scyldwiga	ʃyldwiɡɑ
scyldwite	ʃyldwiːte
scyndan	ʃyndɑn
scyne	ʃyːne
scyrte	ʃyrte
scyte	ʃyte
scytefinger	ʃytefinɡer
scytelfinger	ʃytelfinɡer
scytta	ʃyttɑ
scyttan	ʃyttɑn
se	seː
sealde	sæɑlde
sealdnes	sæ͜ɑldnes
sealf	sæ͜ɑlf
sealh	sæ͜ɑlx
sealt	sæ͜ɑlt
sealtan	sæ͜ɑltɑn
sealten	sæ͜ɑlten
sealtern	sæ͜ɑltern
sealtian	sæ͜ɑltiɑn
sealtnes	sæ͜ɑltnes
sealtyþ	sæ͜ɑltyːθ
seam	sæ͜ɑːm
seamere	sæ͜ɑːmere
seamestre	sæ͜ɑːmestre
searmonaþ	sæ͜ɑːrmoːnɑθ
searo	sæ͜ɑro
searu	sæ͜ɑru
searuhabbend	sæ͜ɑruxɑbbend
seaw	sæ͜ɑːw
seax	sæ͜ɑks
seaxa	sæ͜ɑksɑ
seaxan	sæ͜ɑksɑn
seaxe	sæ͜ɑkse
seaxisc	sæ͜ɑksiʃ
seaxland	sæ͜ɑkslɑnd
seaxneating	sæ͜ɑksnæ͜ɑːtinɡ
seaþ	sæ͜ɑːθ
sec	seːk
secan	seːt͡ʃɑn
secg	sejj
secgan	sejjɑn
secgaþ	sejjɑθ
secge	sejje
secgsceara	sejjʃɑrɑ
sefa	sefɑ
sefte	seːfte
segel	sejel
segen	sejen
segl	sejl
seglian	sejliɑn
segn	sejn
segnian	sejniɑn
seht	sext
sehtlian	sextliɑn
sel	sel
sel	seːl
seldan	seldɑn
seldcuþ	seldkuːθ
selden	selden
sele	sele
selerædend	seleræːdend
self	self
selfbana	selfbɑnɑ
selfcwala	selfkwɑlɑ
selfcwalu	selfkwɑlu
selflic	selfliːt͡ʃ
selfæta	selfæːtɑ
sellan	sellɑn
sellend	sellend
sellendlic	sellendliːt͡ʃ
sellic	selliːt͡ʃ
sellicre	sellikre
sencan	sent͡ʃɑn
sencgan	senjɑn
sendan	sendɑn
senep	senep
sengan	senjɑn
seo	se͜oː
seoc	se͜oːk
seocnes	se͜oːknes
seod	se͜oːd
seofa	se͜ofɑ
seofon	se͜ofon
seofonfeald	se͜ofonfæ͜ɑld
seofonnihte	se͜ofonnixte
seofonstierre	se͜ofonsti͜yrre
seofonteoþa	se͜ofonte͜oːθɑ
seofontiene	se͜ofonti͜yːne
seofontig	se͜ofontij
seofoða	se͜ofoθɑ
seofoþa	se͜ofoθɑ
seohtre	se͜oxtre
seolc	se͜olk
seolcen	se͜olken
seolcwyrm	se͜olkwyrm
seolf	se͜olf
seolfcwalu	se͜olfkwɑlu
seolfor	se͜olfor
seolh	se͜olx
seolhyþa	se͜olxyːθɑ
seolucen	se͜oluken
seomian	se͜omiɑn
seon	se͜oːn
seonoþ	se͜onoθ
seonoþlic	se͜onoθliːt͡ʃ
seonu	se͜onu
seoslig	se͜oːslij
seox	se͜oks
seoþan	se͜oːθɑn
sepan	seːpɑn
set	set
seted	seted
setl	setl
setlgang	setlɡɑnɡ
setlgangende	setlɡɑnɡende
sett	sett
settan	settɑn
sex	seks
sexred	seksreːd
seþan	seːθɑn
seþend	seːθend
seþung	seːθunɡ
sibb	sibb
sibbegedriht	sibbejedrixt
sibbleger	sibblejer
sibling	siblinɡ
sibræden	sibræːden
sican	siːkɑn
sicerian	sikeriɑn
sicettan	sit͡ʃettɑn
sicol	sikol
sicor	sikor
sicorlice	sikorliːt͡ʃe
sicornes	sikornes
sid	siːd
side	siːde
sidfæþmed	siːdfæθmed
sidu	sidu
sieltan	si͜yltɑn
sien	si͜yːn
sierce	si͜yrt͡ʃe
siex	si͜yks
siexta	si͜ykstɑ
siexteoþa	si͜ykste͜oːθɑ
siextiene	si͜yksti͜yːne
siextig	si͜ykstij
siextigfeald	si͜ykstijfæ͜ɑld
sife	sife
siftan	siftɑn
sigan	siːɡɑn
sige	sije
sigebeam	sijebæ͜ɑːm
sigegefeoht	sijejefe͜oxt
sigehreþig	sijexreːθij
sigelhearwa	sijelxæ͜ɑrwɑ
sigelhweorfa	sijelxwe͜orfɑ
sigelic	sijeliːt͡ʃ
sigetacen	sijetɑːken
siglan	sijlɑn
sigor	siɡor
sigorian	siɡoriɑn
sigortacen	siɡortɑːken
sigorwuldor	siɡorwuldor
sihþ	sixθ
sima	siːmɑ
simbel	simbel
simble	simble
simle	simle
sin	siːn
sinc	sink
sincan	sinkɑn
sinceald	sint͡ʃæ͜ɑld
sincfag	sinkfɑːɡ
sincgiefa	sinkji͜yfɑ
sincgyfa	sinkjyfɑ
sind	sind
sinder	sinder
sinewealt	sinewæ͜ɑlt
sinewealtnes	sinewæ͜ɑltnes
singal	sinɡɑl
singan	sinɡɑn
singrene	sinɡreːne
sinhweorfan	sinxwe͜orfɑn
sinnan	sinnɑn
sinniht	sinnixt
sinu	sinu
sinwealt	sinwæ͜ɑlt
siocol	si͜ukol
sioluc	si͜uluk
siolufr	si͜ulufr
sittan	sittɑn
siwian	siwiɑn
sixfeald	siksfæ͜ɑld
sixtig	sikstij
sixtigfeald	sikstijfæ͜ɑld
siððan	siθθɑn
siþ	siːθ
siþfæt	siːθfæt
siþian	siːθiɑn
siþþan	siθθɑn
slaga	slɑɡɑ
slapan	slɑːpɑn
slapian	slɑːpiɑn
slaw	slɑːw
slawlice	slɑːwliːt͡ʃe
slawyrm	slɑːwyrm
slean	slæ͜ɑːn
slecg	slejj
slege	sleje
slegel	slejel
slepan	sleːpɑn
slidan	sliːdɑn
slief	sli͜yːf
sliefe	sli͜yːfe
sliefescoh	sli͜yːfeʃoːx
sliefleas	sli͜yːflæ͜ɑːs
sliepan	sli͜yːpɑn
sliepescoh	sli͜yːpeʃoːx
slifan	sliːfɑn
sliht	slixt
slincan	slinkɑn
slingan	slinɡɑn
slipor	slipor
slitan	sliːtɑn
sliþe	sliːθe
sloh	sloːx
sluncon	slunkon
slupan	sluːpɑn
slæc	slæk
slæp	slæːp
slæpan	slæːpɑn
slæpern	slæːpern
slæpleas	slæːplæ͜ɑːs
slæpleast	slæːplæ͜ɑːst
slæwþ	slæːwθ
smalan	smɑlɑn
smales	smɑles
smalum	smɑlum
smeag	smæ͜ɑːɡ
smeagan	smæ͜ɑːjɑn
smeage	smæːɑɣe
smeagean	smæ͜ɑːjɑn
smeah	smæ͜ɑːx
smearcian	smæ͜ɑrkiɑn
smeart	smæ͜ɑrt
smelting	smeltinɡ
smeortan	sme͜ortɑn
smeortung	sme͜ortunɡ
smeþe	smeːθe
smeċċan	smekkɑn
smicer	smiker
smicor	smikor
smitan	smiːtɑn
smiðian	smiθiɑn
smiþ	smiθ
smiþian	smiθiɑn
smiþþe	smiθθe
smoca	smokɑ
smocian	smokiɑn
smugan	smuːɡɑn
smæccan	smætt͡ʃɑn
smæl	smæl
snaca	snɑkɑ
snaw	snɑːw
snawig	snɑːwij
snegel	snejel
snican	sniːkɑn
sniwan	sniːwɑn
sniwde	sniːwde
sniweþ	sniːweθ
sniwþ	sniːwθ
sniðan	sniːθɑn
sniþan	sniːθɑn
snoru	snoru
snotingaham	snotinɡɑxɑːm
snotingahamscir	snotinɡɑxɑːmʃiːr
snotor	snotor
snytan	snyːtɑn
snægl	snæjl
socc	sokk
soce	soːke
socen	soːken
socn	soːkn
sodoma	sodom
sodome	sodome
sodomisc	sodomiʃ
sodomitisc	sodomitiʃ
softe	soːfte
sol	sol
sol	soːl
solian	soliɑn
solmonaþ	solmoːnɑθ
solor	solor
solsece	solseke
somnian	somniɑn
son	soːn
sona	soːnɑ
soncræft	soːnkræft
sorg	sorɡ
sorgian	sorɡiɑn
sorh	sorx
sorhful	sorxful
sorhleas	sorxlæ͜ɑːs
sot	soːt
sowhul	soːwxul
soð	soːθ
soþ	soːθ
soþe	soːθe
soþes	soːθes
soþgied	soːθji͜yd
soþgiedd	soːθji͜ydd
soþian	soːθiɑn
soþlic	soːθliːt͡ʃ
soþlice	soːθliːt͡ʃe
soþtacen	soːθtɑːken
spadu	spɑdu
spala	spɑlɑ
spane	spɑne
spann	spɑnn
spannan	spɑnnɑn
spanu	spɑnu
sparian	spɑriɑn
spearca	spæ͜ɑrkɑ
spearlira	spæ͜ɑrlirɑ
spearwa	spæ͜ɑrwɑ
specan	spekɑn
sped	speːd
spedan	speːdɑn
spedig	speːdij
spel	spel
spelc	spelk
spelcan	spelt͡ʃɑn
spelcean	spelt͡ʃɑn
speld	speld
spelian	speliɑn
spell	spell
spellian	spelliɑn
spendan	spendɑn
spendung	spendunɡ
spere	spere
sperehealf	sperexæ͜ɑlf
spic	spit͡ʃ
spicing	spiːkinɡ
spilcan	spilt͡ʃɑn
spildan	spildɑn
spilian	spiliɑn
spillan	spillɑn
spind	spind
spinel	spinel
spinelhealf	spinelxæ͜ɑlf
spinnan	spinnɑn
spirian	spirjɑn
spittan	spittɑn
spitu	spitu
spiwan	spiːwɑn
splott	splott
spor	spor
spornan	spornɑn
spowan	spoːwɑn
sprecan	sprekɑn
sprecol	sprekol
sprecolnes	sprekolnes
sprengan	sprenjɑn
spreot	spre͜oːt
springan	sprinɡɑn
spryttan	spryttɑn
spræc	spræːk
spræc	spræːt͡ʃ
spræcful	spræːt͡ʃful
spræcleas	spræːt͡ʃlæ͜ɑːs
sprædan	spræːdɑn
spurnan	spurnɑn
spyrd	spyrd
spyrian	spyrjɑn
spyrigung	spyrijunɡ
spæc	spæːt͡ʃ
spær	spær
spætan	spæːtɑn
staca	stɑkɑ
stacga	stɑɡɡɑ
stalu	stɑlu
stan	stɑːn
stand	stɑnd
standan	stɑndɑn
stanfah	stɑːnfɑːx
stanig	stɑːnij
staniht	stɑːnixt
stanrocc	stɑːnrokk
stanweall	stɑːnwæ͜ɑll
stanweorc	stɑːnwe͜ork
stapol	stɑpol
starian	stɑriɑn
staþol	stɑθol
staþolfæst	stɑθolfæst
staþolfæstlic	stɑθolfæstliːt͡ʃ
staþolfæstlice	stɑθolfæstliːt͡ʃe
staþolfæstnes	stɑθolfæstnes
staþolfæstnian	stɑθolfæstniɑn
staþolfæstnung	stɑθolfæstnunɡ
staþolian	stɑθoliɑn
staþoliend	stɑθoliend
staþolnes	stɑθolnes
staþolung	stɑθolunɡ
staþolæht	stɑθolæːxt
stealc	stæ͜ɑlk
stealcung	stæ͜ɑlkunɡ
steall	stæ͜ɑll
steam	stæ͜ɑːm
steap	stæ͜ɑːp
stearc	stæ͜ɑrk
stearcmod	stæ͜ɑrkmoːd
steartlian	stæ͜ɑrtliɑn
stede	stede
stedefæst	stedefæst
stedefæstnes	stedefæstnes
stefn	stefn
stelan	stelɑn
stellan	stellɑn
steman	steːmɑn
stemn	stemn
stempan	stempɑn
stenc	stent͡ʃ
steopcild	ste͜oːpt͡ʃild
steopdohtor	ste͜oːpdoxtor
steopfæder	ste͜oːpfæder
steopmodor	ste͜oːpmoːdor
steopsunu	ste͜oːpsunu
steor	ste͜oːr
steoran	ste͜oːrɑn
steore	ste͜oːre
steorend	ste͜oːrend
steorfa	ste͜orfɑ
steorfan	ste͜orfɑn
steorleas	ste͜oːrlæ͜ɑːs
steorn	ste͜orn
steorra	ste͜orrɑ
steort	ste͜ort
steorwiglere	ste͜orwijlere
stepe	stepe
steppan	steppɑn
sticca	stikkɑ
stice	stit͡ʃe
stician	stikiɑn
stiele	sti͜yːle
stielen	sti͜yːlen
stieman	sti͜yːmɑn
stiepel	sti͜yːpel
stieran	sti͜yːrɑn
stif	stiːf
stig	stij
stig	stiːj
stigan	stiːɡɑn
stigel	stijel
stigon	stiɣon
stillan	stillɑn
stille	stille
stilnes	stilnes
stincan	stinkɑn
sting	stinɡ
stingan	stinɡɑn
stiocian	sti͜ukiɑn
stirc	stirk
stirung	stirunɡ
stoc	stok
stocc	stokk
stod	stoːd
stofn	stofn
stol	stoːl
stoppian	stoppiɑn
stor	stoːr
storc	stork
storm	storm
stow	stoːw
stowlic	stoːwliːt͡ʃ
stowlice	stoːwliːt͡ʃe
stracian	strɑːkiɑn
strand	strɑnd
strang	strɑnɡ
strange	strɑnɡe
stream	stræ͜ɑːm
streaw	stræ͜ɑːw
streawberige	stræ͜ɑːwberije
streawian	stræ͜ɑːwiɑn
stredan	streːdɑn
stregdan	strejdɑn
streng	strenɡ
strengest	strend͡ʒest
strengra	strenɡrɑ
strengþo	strenɡθo
strengþu	strenɡθu
strewian	streːwiɑn
strican	striːkɑn
stridan	striːdɑn
striend	stri͜yːnd
strod	stroːd
strudan	struːdɑn
struta	struːtɑ
strynd	stryːnd
stryndan	stryːndɑn
stræc	stræk
stræl	stræːl
stræt	stræːt
stubb	stubb
studu	studu
stulor	stulor
stund	stund
stundmælum	stundmæːlum
stunian	stuniɑn
stunt	stunt
stupian	stuːpiɑn
stybb	stybb
stycce	stytt͡ʃe
styccemælum	stytt͡ʃemæːlum
styntan	styntɑn
styran	styːrɑn
styria	styriɑ
styrian	styrjɑn
styric	styrik
styring	styrinɡ
styrman	styrmɑn
styrung	styrunɡ
stæf	stæf
stæfcræft	stæfkræft
stæfgefeg	stæfjefeːj
stæfleahter	stæflæ͜ɑxter
stæfleahtor	stæflæ͜ɑxtor
stæflic	stæfliːt͡ʃ
stæfn	stæfn
stæfrof	stæfroːf
stæfwis	stæfwiːs
stæfwritere	stæfwriːtere
stæg	stæj
stægel	stæːjel
stæger	stæːjer
stæl	stæl
stælan	stæːlɑn
stælhran	stælxrɑːn
stælwierþe	stæːlwi͜yrθe
stæna	stæːnɑ
stænen	stæːnen
stæpe	stæpe
stæpmælum	stæpmæːlum
stæppan	stæppɑn
stær	stær
stær	stæːr
stærwritere	stæːrwriːtere
su	suː
sucan	suːkɑn
successe	sukkesse
sufel	sufel
sugan	suːɡɑn
sugu	suɡu
sul	suːl
sulh	sulx
sum	sum
sumer	sumer
sumerhus	sumerxuːs
sumerhæte	sumerxæːte
sumerlæcan	sumerlæːt͡ʃɑn
sumor	sumor
sumorhus	sumorxuːs
sumorlic	sumorliːt͡ʃ
sumur	sumur
sunbryne	sunbryne
sund	sund
sunder	sunder
sundor	sundor
sundrian	sundriɑn
sundwudu	sundwudu
sunlic	sunliːt͡ʃ
sunnandæg	sunnɑndæj
sunnanmorgen	sunnɑnmorɡen
sunnanniht	sunnɑnnixt
sunnanæfen	sunnɑnæːfen
sunne	sunne
sunnebeam	sunnebæ͜ɑːm
sunnfolgend	sunnfolɡend
sunnlic	sunnliːt͡ʃ
sunstede	sunstede
sunsunu	sunsunu
sunu	sunu
sunwliteg	sunwlitej
sunwlitig	sunwlitij
suord	sword
sur	suːr
sure	suːre
surian	suːriɑn
surnes	suːrnes
susl	suːsl
suþ	suːθ
suþerne	suːθerne
swa	swɑː
swamm	swɑmm
swan	swɑn
swan	swɑːn
swapan	swɑːpɑn
swaru	swɑru
swat	swɑːt
swatþyrel	swɑːtθyːrel
swaþrian	swɑθriɑn
swealwe	swæ͜ɑlwe
sweard	swæ͜ɑrd
swearm	swæ͜ɑrm
sweart	swæ͜ɑrt
sweartian	swæ͜ɑrtiɑn
sweartnes	swæ͜ɑrtnes
sweartness	swæ͜ɑrtness
swebban	swebbɑn
swefan	swefɑn
swefl	swefl
sweflenum	sweflenum
swefn	swefn
swefniend	swefniend
sweg	sweːj
swegan	sweːjɑn
swegel	swejel
swegelwuldor	swejelwuldor
sweger	swejer
swegl	swejl
swelc	swelt͡ʃ
swelce	swelt͡ʃe
swelgan	swelɡɑn
swellan	swellɑn
sweltan	sweltɑn
sweltaþ	sweltɑθ
swencan	swent͡ʃɑn
sweofot	swe͜ofot
sweoland	swe͜oːlɑnd
sweor	swe͜or
sweor	swe͜oːr
sweora	swe͜oːrɑ
sweoras	swe͜orɑs
sweoras	swe͜oːrɑs
sweorcan	swe͜orkɑn
sweord	swe͜ord
sweore	swe͜ore
sweore	swe͜oːre
sweorfan	swe͜orfɑn
sweorice	swe͜oːriːt͡ʃe
sweoster	swe͜oster
sweostor	swe͜ostor
sweota	swe͜oːtɑ
sweotol	swe͜otol
swerian	swerjɑn
swete	sweːte
swetlice	sweːtliːt͡ʃe
swetnes	sweːtnes
sweþel	sweθel
swic	swik
swica	swikɑ
swican	swiːkɑn
swicdom	swikdoːm
swicol	swikol
swiera	swi͜yːrɑ
swifan	swiːfɑn
swift	swift
swiftlice	swiftliːt͡ʃe
swiftnes	swiftnes
swiftnys	swiftnys
swige	swiːje
swigian	swiːɡiɑn
swilc	swilt͡ʃ
swilce	swilt͡ʃe
swimman	swimmɑn
swin	swiːn
swinc	swink
swincan	swinkɑn
swindan	swindɑn
swingan	swinɡɑn
swinhierde	swiːnxi͜yrde
swinhyrde	swiːnxyrde
swinn	swinn
swinsian	swinsiɑn
swiþ	swiːθ
swiþan	swiːθɑn
swiþe	swiːθe
swiþferhþ	swiːθferxθ
swiþhelm	swiːθxelm
swiþhun	swiːθxuːn
swiþlic	swiːθliːt͡ʃ
swiþness	swiːθness
swiþost	swiːθost
swiþra	swiːθrɑ
swogan	swoːɡɑn
swogen	swoːɡen
sword	sword
swote	swoːte
swurd	swurd
swuster	swuster
swyftlice	swyftliːt͡ʃe
swylc	swylt͡ʃ
swylce	swylt͡ʃe
swynhyrde	swyːnxyrde
swyþ	swyːθ
swyþe	swyːθe
swæcc	swækk
swæfon	swæːfon
swær	swæːr
swæs	swæːs
swæslæcan	swæːslæːt͡ʃɑn
swætan	swæːtɑn
swæþ	swæθ
swæþer	swæθer
syferlic	syːferliːt͡ʃ
syferlice	syːferliːt͡ʃe
syferness	syːferness
syferæte	syːferæːte
syflige	syflije
syfling	syflinɡ
syfre	syːfre
sygor	syɡor
syl	syːl
sylf	sylf
syll	syll
syllic	sylliːt͡ʃ
synbot	synboːt
synder	synder
synderlic	synderliːt͡ʃ
syndrian	syndriɑn
synful	synful
syngian	synɣiɑn
synleas	synlæ͜ɑːs
synn	synn
synnig	synnij
syrce	syrt͡ʃe
syx	syks
syxta	sykstɑ
syþþan	syθθɑn
sæ	sæː
sæbat	sæːbɑːt
sæcc	sætt͡ʃ
sæcgan	sæjjɑn
sæcst	sækst
sæcyrr	sæːt͡ʃyrr
sæcþ	sækθ
sæd	sæd
sæd	sæːd
sædeor	sæːde͜oːr
sæfern	sæfern
sæfernmuþa	sæfernmuːθɑ
sæfæreld	sæːfæreld
sægan	sæːjɑn
sægd	sæjd
sægde	sæjde
sægdon	sæjdon
sægrund	sæːɡrund
sægþ	sæjθ
sæl	sæl
sæl	sæːl
sælac	sæːlɑːk
sælan	sæːlɑn
sælic	sæːliːt͡ʃ
sælig	sæːlij
sæliþend	sæːliːθend
sælþ	sæːlθ
sæmann	sæːmɑnn
sæmest	sæːmest
sæmeþe	sæːmeːθe
sæmra	sæːmrɑ
sæp	sæp
sæpig	sæpij
sæt	sæːt
sæteresdæg	sæteresdæj
sæterndæg	sæterndæj
sæternesdæg	sæternesdæj
sæward	sæːwɑrd
sæweard	sæːwæ͜ɑrd
sæwudu	sæːwudu
sæyþ	sæːyːθ
sæþeof	sæːθe͜oːf
sœcan	søːt͡ʃɑn
ta	tɑː
tacan	tɑkɑn
tacen	tɑːken
tacn	tɑːkn
tacne	tɑːkne
tacnian	tɑːkniɑn
tacnung	tɑːknunɡ
tacor	tɑːkor
taht	tɑːxt
tahte	tɑːxte
tahten	tɑːxten
tahtest	tɑːxtest
tahton	tɑːxton
talente	tɑlente
talian	tɑliɑn
talu	tɑlu
tam	tɑm
tan	tɑːn
tannere	tɑnnere
tannian	tɑnniɑn
tapor	tɑpor
targa	tɑrɡɑ
tawian	tɑwiɑn
taxe	tɑːkse
te	te
teag	tæ͜ɑːɡ
teah	tæːɑx
tealtrian	tæ͜ɑltriɑn
team	tæ͜ɑːm
tear	tæ͜ɑːr
tela	telɑ
teld	teld
telg	telɡ
telga	telɡɑ
tellan	tellɑn
teman	teːmɑn
temesian	temesiɑn
temian	temiɑn
tempel	tempel
templ	templ
temsian	temsiɑn
ten	teːn
tendan	tendɑn
teon	te͜oːn
teond	te͜oːnd
teorian	te͜oːriɑn
teors	te͜ors
teoru	te͜oru
teoþa	te͜oːθɑ
teran	terɑn
termen	termen
teru	teru
ticcen	titt͡ʃen
tid	tiːd
tidlice	tiːdliːt͡ʃe
tiegan	ti͜yːjɑn
tieman	ti͜yːmɑn
tien	ti͜yːn
tienfeald	ti͜yːnfæ͜ɑld
tieran	ti͜yːrɑn
tiergan	ti͜yrjɑn
tife	tife
tigan	tiːjɑn
tigele	tijele
tiger	tiɡer
til	til
tilian	tiliɑn
tima	tiːmɑ
timber	timber
timbrian	timbriɑn
timbrung	timbrunɡ
timlice	tiːmliːt͡ʃe
timpana	timpɑnɑ
tin	tin
tinclian	tinkliɑn
tind	tind
tintregian	tintreɡiɑn
tir	tiːr
tirgan	tirjɑn
titt	titt
tiw	tiːw
tiwesdæg	tiːwesdæj
to	toː
toberstan	toːberstɑn
tobrecan	toːbrekɑn
tocnyssan	toːknyssɑn
tocweþan	toːkweθɑn
tocyme	toːkyme
tocyrran	toːt͡ʃyrrɑn
todreosan	toːdre͜oːsɑn
todrifan	toːdriːfɑn
todæg	toːdæj
todælan	toːdæːlɑn
toeacan	toːæ͜ɑːkɑn
tofaran	toːfɑrɑn
tofeallan	toːfæ͜ɑllɑn
toferan	toːfeːrɑn
toflowan	toːfloːwɑn
togan	toːɡɑːn
togang	toːɡɑnɡ
togean	toːjæ͜ɑːn
togeanes	toːjæ͜ɑːnes
togecorennes	toːjekorennes
togeiecendlic	toːjei͜yːt͡ʃendliːt͡ʃ
togeotan	toːje͜oːtɑn
togesceadan	toːjeʃæ͜ɑːdɑn
togesceadan	toːjeʃɑːdɑn
togian	toɡiɑn
togotennes	toːɡotennes
togædere	toːɡædere
togædre	toːɡædere
toh	toːx
toheawan	toːxæ͜ɑːwɑn
tohladan	toːxlɑdɑn
tohopa	toːxopɑ
tohreran	toːxreːrɑn
tohweorfan	toːxwe͜orfɑn
tohyht	toːxyxt
toiecan	toːi͜yːt͡ʃɑn
toiecnes	toːi͜yːt͡ʃnes
tol	toːl
tolicgan	toːlijjɑn
toliesan	toːli͜yːsɑn
toll	toll
tolucan	toːluːkɑn
tolysan	toːlyːsɑn
tolætan	toːlæːtɑn
tom	toːm
tomearcian	toːmæ͜ɑrkiɑn
tomearcodnes	toːmæ͜ɑrkodnes
tonama	toːnɑmɑ
tonemnan	toːnemnɑn
torfian	torfiɑn
torht	torxt
torn	torn
torr	torr
tosamnian	toːsɑmniɑn
tosawan	toːsɑːwɑn
tosceadan	toːʃæ͜ɑːdɑn
tosceadan	toːʃɑːdɑn
toscriþan	toːʃriːθɑn
tosendan	toːsendɑn
toseþan	toːseːθɑn
toslitan	toːsliːtɑn
tosmeagan	toːsmæ͜ɑːjɑn
tosundrian	toːsundriɑn
tosyndrian	toːsyndriɑn
toteon	toːte͜oːn
totwæman	toːtwæːmɑn
totwæmednes	toːtwæːmednes
toweard	toːwæ͜ɑrd
toweardnes	toːwæ͜ɑrdnes
toweorpan	toːwe͜orpɑn
toweorpendlic	toːwe͜orpendliːt͡ʃ
toworpennes	toːworpennes
towrecan	toːwrekɑn
towritan	toːwriːtɑn
toætiecan	toːæti͜yːt͡ʃɑn
toætiecnes	toːæti͜yːt͡ʃnes
toþ	toːθ
toþgar	toːθɡɑːr
toþleas	toːθlæ͜ɑːs
toþsticca	toːθstikkɑ
traht	trɑxt
trahtian	trɑxtiɑn
trahtnian	trɑxtniɑn
tramet	trɑːmet
tredan	tredɑn
treg	treɡ
treg	treːj
trega	treɡɑ
trendel	trendel
treow	tre͜oːw
treowe	tre͜oːwe
treowlice	tre͜oːwliːt͡ʃe
treowsian	tre͜oːwsiɑn
treowwyrhta	tre͜oːwwyrxtɑ
triewe	tri͜yːwe
triewen	tri͜ywen
trig	trij
triwen	triwen
trog	troɡ
troh	trox
trucian	trukiɑn
trum	trum
truwian	truːwiɑn
trymman	trymmɑn
tu	tuː
tucian	tuːkiɑn
tudor	tuːdor
tulge	tulje
tulge	tulɡe
tumbere	tumbere
tumbian	tumbiɑn
tun	tuːn
tunge	tunɡe
tunggelælle	tunɡjelælle
tunglen	tunɡlen
tunglere	tunɡlere
tungol	tunɡol
tungolbære	tunɡolbæːre
tungolcræft	tunɡolkræft
tungolcræftiga	tunɡolkræftiɡɑ
tunne	tunne
turf	turf
turfum	turfum
turnian	turniɑn
turtle	turtle
tusc	tuːsk
tux	tuːks
tuxas	tuːksɑs
twa	twɑː
twegen	tweːjen
twelf	twelf
twelffeald	twelffæ͜ɑld
twelfta	twelftɑ
twentig	tweːntij
twentigfeald	tweːntijfæ͜ɑld
twentigoþa	tweːntiɡoθɑ
tweo	twe͜oː
tweogan	twe͜oːjɑn
tweowa	twe͜owɑ
twiccian	twikkiɑn
twidælan	twidæːlɑn
twiecge	twiejje
twiefealdnes	twi͜yfæ͜ɑldnes
twifeald	twifæ͜ɑld
twifealdnes	twifæ͜ɑldnes
twifere	twifeːre
twiferlæcan	twifeːrlæːt͡ʃɑn
twifete	twifeːte
twig	twij
twih	twiːx
twihycgan	twixyjjɑn
twin	twin
twinn	twinn
twirædness	twiræːdness
twiscyldig	twiʃyldij
twisla	twislɑ
twyfeald	twyfæ͜ɑld
twyfealdnys	twyfæ͜ɑldnys
twæde	twæːde
twæman	twæːmɑn
twæming	twæːminɡ
tydre	tyːdre
tyge	tyje
tyht	tyxt
tyhtan	tyxtɑn
tyhten	tyxten
tyhtend	tyxtend
tyhtendlic	tyxtendliːt͡ʃ
tyhtere	tyxtere
tyhting	tyxtinɡ
tyhtnes	tyxtnes
tynan	tyːnɑn
tyncen	tynt͡ʃen
tynder	tynder
tyrf	tyrf
tysca	tyʃʃɑ
tæc	tæːt͡ʃ
tæcan	tæːt͡ʃɑn
tæcaþ	tæːt͡ʃɑθ
tæce	tæːt͡ʃe
tæcen	tæːt͡ʃen
tæcende	tæːt͡ʃende
tæcest	tæːt͡ʃest
tæceþ	tæːt͡ʃeθ
tæcing	tæːt͡ʃinɡ
tæcst	tæːkst
tæcung	tæːt͡ʃunɡ
tæcþ	tæːkθ
tægel	tæjel
tægl	tæjl
tæht	tæːxt
tæhte	tæːxte
tæhten	tæːxten
tæhtest	tæːxtest
tæhton	tæːxton
tælan	tæːlɑn
tælg	tælɡ
tælmearc	tælmæ͜ɑrk
tænel	tæːnel
tæppa	tæppɑ
tæppe	tæppe
tæppere	tæppere
tæppestre	tæppestre
tæppian	tæppiɑn
tæsan	tæːsɑn
uder	uːder
ufan	ufɑn
uferian	uferiɑn
uferor	uferor
ufeweard	ufewæ͜ɑrd
ufor	ufor
uht	uːxt
uhta	uːxtɑ
uhtcaru	uːxtkɑru
uhtceare	uːhtt͡ʃæːɑ̯re
uhtcearu	uːxtt͡ʃæ͜ɑru
ulan	uːlɑn
ule	uːle
ultor	ultor
unasundrodlic	unɑːsundrodliːt͡ʃ
unbryce	unbryt͡ʃe
unbryce	unbryːt͡ʃe
unc	unk
uncamprof	unkɑmproːf
uncer	unker
uncit	uŋkit
unclæne	unklæːne
uncnyttan	unknyttɑn
uncumliþe	unkumliːθe
uncumliþnes	unkumliːθnes
uncuþ	unkuːθ
undeadlic	undæ͜ɑːdliːt͡ʃ
undeadlicnes	undæ͜ɑːdliːknes
undeop	unde͜oːp
under	under
underberan	underberɑn
underbugan	underbuːɡɑn
underburg	underburɡ
underbæc	underbæk
undercierran	undert͡ʃi͜yrrɑn
undercyrran	undert͡ʃyrrɑn
underfon	underfoːn
undergan	underɡɑːn
undergangan	underɡɑnɡɑn
underiendlic	underjendliːt͡ʃ
undern	undern
underneoþan	underne͜oθɑn
underniman	undernimɑn
undernmæl	undernmæːl
undersecan	underseːt͡ʃɑn
undersmeagan	undersmæ͜ɑːjɑn
understandan	understɑndɑn
understondan	understondɑn
underwritan	underwriːtɑn
underþeodan	underθe͜oːdɑn
undiere	undi͜yːre
undon	undoːn
undruncen	undrunken
undæd	undæːd
uneaþe	unæ͜ɑːθe
unefen	unefen
unfealdan	unfæ͜ɑldɑn
unforbugendlic	unforbuɡendliːt͡ʃ
unforbugendlice	unforbuɡendliːt͡ʃe
unforesceawod	unforeʃæ͜ɑːwod
unforht	unforxt
unfrod	unfroːd
unfrodnes	unfroːdnes
unfulfremed	unfulfremed
unfulfremednes	unfulfremednes
unfæger	unfæjer
ungeendiendlic	unjeendi͜yndliːt͡ʃ
ungefæd	unjefæd
ungehiersum	unjexi͜yːrsum
ungehiersumnes	unjexi͜yːrsumnes
ungelic	unjeliːt͡ʃ
ungelicnes	unjeliːknes
ungelæred	unjelæːred
ungemæte	unjemæːte
ungenemnendlic	unjenemnendliːt͡ʃ
ungescead	unjeʃɑːd
ungesewenlic	unjesewenliːt͡ʃ
ungeswenced	unjeswent͡ʃed
ungewemmed	unjewemmed
ungewemmednes	unjewemmednes
ungewintred	unjewintred
ungewiss	unjewiss
ungewunelic	unjewuneliːt͡ʃ
ungewæpnod	unjewæːpnod
ungeþyldig	unjeθyldij
ungleaw	unɡlæ͜ɑːw
ungleawlice	unɡlæ͜ɑːwliːt͡ʃe
ungleawnes	unɡlæ͜ɑːwnes
ungleawscipe	unɡlæ͜ɑːwʃipe
ungod	unɡoːd
ungripendlic	unɡriːpendliːt͡ʃ
ungyrdan	unɡyrdɑn
unhal	unxɑːl
unhalig	unxɑːlij
unhiersumnes	unxi͜yːrsumnes
unhlisa	unxliːsɑ
unlar	unlɑːr
unligne	unliːjne
unlucan	unluːkɑn
unlust	unlust
unlyft	unlyft
unlæd	unlæːd
unmann	unmɑnn
unmennisclic	unmenniʃliːt͡ʃ
unmihtig	unmixtij
unmihtlic	unmixtliːt͡ʃ
unmiltsiendlic	unmiltsiendliːt͡ʃ
unmyltsiendlic	unmyltsiendliːt͡ʃ
unmæte	unmæːte
unnan	unnɑn
unnytlic	unnytliːt͡ʃ
unnytlice	unnytliːt͡ʃe
unnytnes	unnytnes
unnytt	unnytt
unnytwierþe	unnytwi͜yrθe
unnytwyrþe	unnytwyrθe
unriht	unrixt
unrihthæmed	unrixtxæːmed
unrihtwif	unrixtwiːf
unrihtwis	unrixtwiːs
unrihtwisnes	unrixtwiːsnes
unripe	unriːpe
unsawen	unsɑːwen
unscrydan	unʃryːdɑn
unscyld	unʃyld
unscyldig	unʃyldij
unseald	unsæ͜ɑld
unsoþ	unsoːθ
unsoþian	unsoːθiɑn
unstaþolfæst	unstɑθolfæst
unstaþolfæstnes	unstɑθolfæstnes
unstæfwis	unstæfwiːs
unsur	unsuːr
unswefn	unswefn
unsyferlic	unsyːferliːt͡ʃ
unsyferness	unsyːferness
unsyfre	unsyːfre
unsælig	unsæːlij
untiegan	unti͜yːjɑn
untigan	untiːjɑn
untime	untiːme
untrum	untrum
untrumian	untrumiɑn
untrumnes	untrumnes
untweolice	untwe͜oːliːt͡ʃe
untwiefeald	untwi͜yfæ͜ɑld
untwifeald	untwifæ͜ɑld
untynan	untyːnɑn
unwealt	unwæ͜ɑlt
unweder	unweder
unwemme	unwemme
unwemming	unwemminɡ
unweorþlic	unwe͜orθliːt͡ʃ
unwindan	unwindɑn
unwis	unwiːs
unwislice	unwiːsliːt͡ʃe
unwitod	unwitod
unwittig	unwittij
unwiþmetendlic	unwiθmetendliːt͡ʃ
unwynsum	unwynsum
unwæstmbære	unwæstmbæːre
unwæterig	unwæterij
unþanc	unθɑnk
unþeaw	unθæ͜ɑːw
up	up
upbregdan	upbrejdɑn
upcuman	upkumɑn
upcund	upkund
upeard	upæ͜ɑrd
upengel	upenjel
upflering	upfleːrinɡ
upfæreld	upfæreld
upgan	upɡɑːn
upgang	upɡɑnɡ
upp	upp
uppe	uppe
upriht	uprixt
uprihte	uprixte
uprodor	uprodor
ur	uːr
ure	uːre
us	uːs
usc	uːsk
user	uːser
usic	uːsit͡ʃ
ut	uːt
utan	uːtɑn
utanlandes	uːtɑnlɑndes
utdragan	uːtdrɑɡɑn
ute	uːte
utera	uːterɑ
uterra	uːterrɑ
utfus	uːtfuːs
utfæreld	uːtfæreld
utgan	uːtɡɑːn
utgang	uːtɡɑnɡ
utgefeoht	uːtjefe͜oxt
utlaga	uːtlɑɡɑ
utlenda	uːtlendɑ
utlendisc	uːtlendiʃ
utlædan	uːtlæːdɑn
utlæs	uːtlæːs
uton	uton
utscyte	uːtʃyte
uu	w
uþmæte	uːθmæːte
uþwita	uːθwitɑ
uþwitegung	uːθwiteɡunɡ
uþwitian	uːθwitiɑn
uþwitlic	uːθwitliːt͡ʃ
wa	wɑː
wac	wɑːk
wacan	wɑkɑn
waccor	wɑkkor
wacian	wɑkiɑn
wacian	wɑːkiɑn
wacnes	wɑːknes
wacol	wɑkol
wacor	wɑkor
wacu	wɑku
wacung	wɑkunɡ
wad	wɑːd
wadan	wɑdɑn
wafian	wɑfiɑn
wafian	wɑːfiɑn
wag	wɑːɡ
wagegan	wɑɡejɑn
wagian	wɑɡiɑn
wagrift	wɑːɡrift
wagþyrel	wɑːɡθyːrel
waldhere	wɑldxere
walhhnutu	wɑlxxnutu
wamb	wɑmb
wambadl	wɑmbɑːdl
wan	wɑn
wancol	wɑnkol
wand	wɑnd
wandeweorpe	wɑndewe͜orpe
wandian	wɑndiɑn
wandrian	wɑndriɑn
wang	wɑnɡ
wange	wɑnɡe
wangteþ	wɑnɡteːθ
wangtoþ	wɑnɡtoːθ
wanian	wɑniɑn
wanian	wɑːniɑn
wann	wɑnn
wansceaft	wɑnʃæ͜ɑft
wansælig	wɑnsæːlij
warian	wɑriɑn
warnian	wɑrniɑn
waroþ	wɑroθ
waru	wɑru
wascan	wɑskɑn
wase	wɑːse
wasend	wɑːsend
wawa	wɑːwɑ
wawan	wɑːwɑn
we	weː
wea	wæ͜ɑː
wealas	wæ͜ɑːlɑs
wealcan	wæ͜ɑlkɑn
wealcian	wæ͜ɑlkiɑn
wealcol	wæ͜ɑlkol
weald	wæ͜ɑld
wealda	wæ͜ɑldɑ
wealdan	wæ͜ɑldɑn
wealdend	wæ͜ɑldend
wealdende	wæ͜ɑldende
wealh	wæ͜ɑlx
wealhhafoc	wæ͜ɑlxxɑfok
wealhheafoc	wæ͜ɑlxxæ͜ɑfok
wealhhnutu	wæ͜ɑlxxnutu
wealhstod	wæ͜ɑlxstod
wealhþeow	wæ͜ɑlxθe͜oːw
weall	wæ͜ɑll
weallan	wæ͜ɑllɑn
weallian	wæ͜ɑlliɑn
wean	wæ͜ɑːn
weana	wæ͜ɑːnɑ
weard	wæ͜ɑrd
weardian	wæ͜ɑrdiɑn
weardsteall	wæ͜ɑrdstæ͜ɑll
wearg	wæ͜ɑrɡ
weargcweþan	wæ͜ɑrɡkweθɑn
wearh	wæ͜ɑrx
wearm	wæ͜ɑrm
wearn	wæ͜ɑrn
wearnian	wæ͜ɑrniɑn
wearp	wæ͜ɑrp
wearr	wæ͜ɑrr
wearriht	wæ͜ɑrrixt
wearte	wæ͜ɑrte
weatacen	wæ͜ɑːtɑːken
weax	wæ͜ɑks
weaxan	wæ͜ɑksɑn
weaxcandel	wæ͜ɑkskɑndel
webb	webb
webba	webbɑ
webbestre	webbestre
weccan	wett͡ʃɑn
wecg	wejj
wecgan	wejjɑn
wedd	wedd
weddian	weddiɑn
weddung	weddunɡ
weden	weːden
weder	weder
wederas	wederɑs
wedertacen	wedertɑːken
wedlac	wedlɑːk
wefan	wefɑn
weg	wej
wegan	weɡɑn
wegleas	wejlæ͜ɑːs
wehha	wexxɑ
wel	wel
wela	welɑ
weland	welɑnd
weler	weler
welisc	weːliʃ
well	well
welund	welund
welwillende	welwillende
welwillendlice	welwillendliːt͡ʃe
welwillendnes	welwillendnes
weman	weːmɑn
wemman	wemmɑn
wemmend	wemmend
wemming	wemminɡ
wen	weːn
wenan	weːnɑn
wendan	wendɑn
wendelsæ	wendelsæː
wenden	wenden
wending	wendinɡ
wendlas	wendlɑs
wendle	wendle
wenian	weniɑn
weninga	weːninɡɑ
wenn	wenn
wennan	wennɑn
wenunga	weːnunɡɑ
weod	we͜oːd
weodian	we͜oːdiɑn
weodmonaþ	we͜oːdmoːnɑθ
weofod	we͜oːfod
weoh	we͜oːx
weohsteall	we͜oːxstæ͜ɑll
weorc	we͜ork
weorcræden	we͜orkræːden
weorcsum	we͜orksum
weornan	we͜ornɑn
weorod	we͜orod
weorold	we͜orold
weoroldræden	we͜oroldræːden
weorpan	we͜orpɑn
weorþ	we͜orθ
weorþan	we͜orθɑn
weorþian	we͜orθiɑn
weorþleas	we͜orθlæ͜ɑːs
weorþlic	we͜orθliːt͡ʃ
weorþmynd	we͜orθmynd
weorþscipe	we͜orθʃipe
weorþung	we͜orθunɡ
wepan	weːpɑn
wer	wer
wera	werɑ
weras	werɑs
werc	werk
werg	werɡ
werian	werjɑn
werig	weːrij
werleas	werlæ͜ɑːs
werlic	werliːt͡ʃ
werod	werod
werwulf	werwulf
wesan	wesɑn
wesan	weːsɑn
wese	weːse
wesend	wesend
wesende	wesende
west	west
westan	weːstɑn
weste	weːste
westen	weːsten
westerne	westerne
westseaxa	westsæ͜ɑksɑ
westseaxan	westsæ͜ɑksɑn
westseaxe	westsæ͜ɑkse
wexan	weksɑn
weðer	weθer
weþe	weːθe
weþer	weθer
wiber	wiber
wic	wiːt͡ʃ
wican	wiːkɑn
wicca	witt͡ʃɑ
wiccan	witt͡ʃɑn
wicce	witt͡ʃe
wiccecræft	witt͡ʃekræft
wiccedom	witt͡ʃedoːm
wiccung	witt͡ʃunɡ
wice	wike
wiceard	wiːt͡ʃæ͜ɑrd
wicg	wijj
wicga	wiɡɡɑ
wicing	wiːkinɡ
wicing	wiːt͡ʃinɡ
wicu	wiku
wid	wiːd
wide	wiːde
widewe	widewe
widherian	wiːdxerjɑn
widmære	wiːdmæːre
widmærsian	wiːdmæːrsiɑn
widmærsung	wiːdmæːrsunɡ
widsiþ	wiːdsiːθ
widuwe	widuwe
wieldan	wi͜yldɑn
wielisc	wi͜yːliʃ
wielm	wi͜ylm
wieltan	wi͜yltɑn
wielwan	wi͜ylwɑn
wierdan	wi͜yrdɑn
wiergan	wi͜yrjɑn
wiergen	wi͜yrjen
wiergnes	wi͜yrjnes
wiergþu	wi͜yrɡθu
wiernan	wi͜yrnɑn
wierrest	wi͜yrrest
wiers	wi͜yrs
wiersa	wi͜yrsɑ
wierþe	wi͜yrθe
wif	wiːf
wifer	wifer
wiffreond	wiːffre͜oːnd
wifgemana	wiːfjemɑːnɑ
wifhad	wiːfxɑːd
wifhand	wiːfxɑnd
wifhired	wiːfxiːred
wifian	wiːfiɑn
wifleas	wiːflæ͜ɑːs
wiflic	wiːfliːt͡ʃ
wifman	wiːfmɑn
wifmann	wiːfmɑnn
wifmenn	wiːfmenn
wig	wiːj
wiga	wiɡɑ
wigan	wiːɡɑn
wigbære	wiːjbæːre
wiges	wiːɡes
wigle	wijle
wiglere	wiɡlere
wiglian	wiɡliɑn
wiglung	wiɡlunɡ
wigsmiþ	wiːjsmiθ
wigweorþung	wiːjwe͜orθunɡ
wih	wiːx
wiht	wixt
wihtland	wixtlɑnd
wihtsæta	wixtsæːtɑ
wihtwara	wixtwɑrɑ
wihtware	wixtwɑre
wil	wil
wilcuma	wilkumɑ
wilddeor	wildde͜oːr
wilde	wilde
wildor	wildor
wilgesiþ	wiljesiːθ
wilian	wiliɑn
wilisc	wiːliʃ
willa	willɑ
willan	willɑn
willian	williɑn
wilnian	wilniɑn
wilnung	wilnunɡ
wilweorþung	wilwe͜orθunɡ
wimpel	wimpel
win	wiːn
winberige	wiːnberije
wincel	wint͡ʃel
wincian	winkiɑn
wind	wind
windan	windɑn
windbære	windbæːre
windig	windij
windruncen	wiːndrunken
windscofl	windʃofl
wine	wine
wineard	wiːnæ͜ɑrd
winemæg	winemæːj
winescipe	wineʃipe
winestra	winestrɑ
wingeard	wiːnjæ͜ɑrd
winhate	wiːnxɑːte
winnan	winnɑn
winstre	winstre
winter	winter
winterbiter	winterbiter
winterburna	winterburnɑ
winterceald	wintert͡ʃæ͜ɑld
wintercearig	wintert͡ʃæ͜ɑrij
winterdun	winterduːn
winterdæg	winterdæj
winterfeorm	winterfe͜orm
winterfylleþ	winterfylleθ
wintergegang	winterjeɡɑnɡ
wintergerim	winterjeriːm
wintergetæl	winterjetæl
wintergeweorp	winterjewe͜orp
wintergewæde	winterjewæːde
winterhus	winterxuːs
winterlic	winterliːt͡ʃ
winterlæcan	winterlæːt͡ʃɑn
winterrim	winterriːm
winterscur	winterʃuːr
winterselde	winterselde
winterset	winterset
wintersetl	wintersetl
wintersufel	wintersufel
wintertid	wintertiːd
winterwylle	winterwylle
wintreow	wiːntre͜oːw
wintrig	wintrij
wiodu	wi͜udu
wipian	wiːpiɑn
wir	wiːr
wis	wiːs
wisa	wiːsɑ
wisdom	wiːsdoːm
wise	wiːse
wisian	wiːsiɑn
wisle	wiːsle
wisleland	wiːslelɑnd
wislemuþa	wiːslemuːθɑ
wislice	wiːsliːt͡ʃe
wisnes	wiːsnes
wist	wist
wiste	wiste
wit	wit
wita	witɑ
witan	witɑn
witan	wiːtɑn
wite	wiːte
witegestre	wiːteɡestre
witena	witenɑ
witleas	witlæ͜ɑːs
witleast	witlæ͜ɑːst
witnes	witnes
witod	witod
witodlic	witodliːt͡ʃ
witodlice	witodliːt͡ʃe
witt	witt
wittig	wittij
wituma	witumɑ
witword	witword
wixlan	wikslɑn
wiðersaca	wiθersɑkɑ
wiðsæcgan	wiθsæjjɑn
wiþ	wiθ
wiþblawan	wiθblɑːwɑn
wiþbregdan	wiθbrejdɑn
wiþceosan	wiθt͡ʃe͜oːsɑn
wiþcostian	wiθkostiɑn
wiþcwedennes	wiθkwedennes
wiþcweþan	wiθkweθɑn
wiþercrist	wiθerkrist
wiþercweþan	wiθerkweθɑn
wiþercyrr	wiθert͡ʃyrr
wiþerhabban	wiθerxɑbbɑn
wiþerhlinian	wiθerxliniɑn
wiþerian	wiθeriɑn
wiþersaca	wiθersɑkɑ
wiþersæc	wiθersæk
wiþerwinna	wiθerwinnɑ
wiþfaran	wiθfɑrɑn
wiþfon	wiθfoːn
wiþgan	wiθɡɑːn
wiþgripan	wiθɡriːpɑn
wiþhabban	wiθxɑbbɑn
wiþheardian	wiθxæ͜ɑrdiɑn
wiþhycgan	wiθxyjjɑn
wiþig	wiːθij
wiþinnan	wiθinnɑn
wiþlædan	wiθlæːdɑn
wiþmetan	wiθmetɑn
wiþmetendlic	wiθmetendliːt͡ʃ
wiþmetenlic	wiθmetenliːt͡ʃ
wiþmetennes	wiθmetennes
wiþsacan	wiθsɑkɑn
wiþsacendlic	wiθsɑkendliːt͡ʃ
wiþsecgan	wiθsejjɑn
wiþsettan	wiθsettɑn
wiþsprecan	wiθsprekɑn
wiþstandan	wiθstɑndɑn
wiþteon	wiθte͜oːn
wiþutan	wiθuːtɑn
wiþweorpan	wiθwe͜orpɑn
wiþþe	wiθθe
wiþþingian	wiθθinɡiɑn
wlacu	wlɑku
wlanc	wlɑnk
wlancian	wlɑnkiɑn
wlatian	wlɑːtiɑn
wlencan	wlent͡ʃɑn
wlencu	wlenku
wlisp	wlisp
wlitan	wliːtɑn
wlite	wlite
wlitebeorht	wlitebe͜orxt
wliteleas	wlitelæ͜ɑːs
wlitig	wlitij
wlæc	wlæk
wlætian	wlæːtiɑn
wocon	woːkon
wod	woːd
woda	woːdɑ
woden	woːden
wodnes	woːdnes
wodnesdæg	woːdnesdæj
wogere	woːɡere
wogian	woːɡiɑn
woh	woːx
wohbogen	woːxboɡen
wohceapung	woːxt͡ʃæ͜ɑːpunɡ
wohdom	woːxdoːm
wohdæd	woːxdæːd
wohfotede	woːxfoːtede
wohfremmende	woːxfremmende
wohful	woːxful
wohfull	woːxfull
wohfulnes	woːxfulnes
wohgeorn	woːxje͜orn
wohgestreon	woːxjestre͜oːn
wohhandede	woːxxɑndede
wohhian	woxxiɑn
wohhæmed	woːxxæːmed
wohhæmende	woːxxæːmende
wohhæmere	woːxxæːmere
wohlic	woːxliːt͡ʃ
wohlice	woːxliːt͡ʃe
wohnes	woːxnes
wohsum	woːxsum
wol	woːl
wolberende	woːlberende
wolberendlic	woːlberendliːt͡ʃ
wolbryne	woːlbryne
wolbærnes	woːlbæːrnes
wolcen	wolken
wolcn	wolkn
wolde	wolde
woldæg	woːldæj
wolgewinn	woːljewinn
wolnes	woːlnes
wom	woːm
woma	woːmɑ
womm	womm
wong	wonɡ
wop	woːp
worc	work
word	word
worda	wordɑ
wordfæst	wordfæst
wordgecwide	wordjekwide
wordhord	wordxord
wordig	wordij
wordlaþu	wordlɑθu
wordmittung	wordmittunɡ
wordpredicung	wordpredikunɡ
wordsawere	wordsɑːwere
worhana	worxɑnɑ
worian	woːriɑn
woriend	woːriend
woriende	woːriende
worn	worn
worold	worold
woroldar	woroldɑːr
woruld	woruld
woruldlic	woruldliːt͡ʃ
worð	worθ
worþ	worθ
wos	woːs
woþ	woːθ
wracu	wrɑku
wrang	wrɑnɡ
wrað	wrɑːθ
wraþ	wrɑːθ
wrecan	wrekɑn
wrecca	wrett͡ʃɑ
wrecend	wrekend
wrecnes	wreknes
wrecscipe	wrekʃipe
wregan	wreːjɑn
wregendlic	wreːjendliːt͡ʃ
wrenc	wrent͡ʃ
wrencan	wrent͡ʃɑn
wrenna	wrennɑ
wreon	wre͜oːn
wrid	wriːd
wrigian	wriːjiɑn
wringan	wrinɡɑn
wrist	wrist
writ	writ
writan	wriːtɑn
writaþ	wriːtɑθ
writere	wriːtere
wrixlan	wrikslɑn
wriþan	wriːθɑn
wroht	wroːxt
wrohtsawere	wroːxtsɑːwere
wrot	wroːt
wrotan	wroːtɑn
wrungon	wrunɡon
wræc	wræk
wræcca	wrætt͡ʃɑ
wræclast	wræklɑːst
wrætlic	wræːtliːt͡ʃ
wrætt	wræːtt
wræþan	wræːθɑn
wræþþo	wræːθθo
wræþþu	wræːθθu
wucu	wuku
wudere	wudere
wudian	wudiɑn
wudig	wudij
wudiht	wudixt
wudu	wudu
wudubora	wuduborɑ
wudubære	wudubæːre
wuducoc	wudukok
wuduculfre	wudukulfre
wudufeoh	wudufe͜ox
wudufugol	wudufuɡol
wudufæsten	wudufæsten
wuduhana	wuduxɑnɑ
wuduielfen	wudui͜ylfen
wuduland	wudulɑnd
wudulic	wuduliːt͡ʃ
wudulæs	wudulæːs
wuduræden	wuduræːden
wudusnite	wudusniːte
wuduwasa	wuduwɑːsɑ
wuduwe	wuduwe
wuduælfen	wuduælfen
wuduþistel	wuduθistel
wuffa	wuffɑ
wuldor	wuldor
wuldorbeag	wuldorbæ͜ɑːɡ
wuldorbeagian	wuldorbæ͜ɑːɡiɑn
wuldorbeah	wuldorbæ͜ɑːx
wuldorcyning	wuldorkyninɡ
wuldordream	wuldordræ͜ɑːm
wuldorfull	wuldorfull
wuldorfullian	wuldorfulliɑn
wuldorfullice	wuldorfulliːt͡ʃe
wuldorfæder	wuldorfæder
wuldorgast	wuldorɡɑːst
wuldorgeflogena	wuldorjefloɡenɑ
wuldorgeweorc	wuldorjewe͜ork
wuldorgifu	wuldorjifu
wuldorgimm	wuldorjimm
wuldorhama	wuldorxɑmɑ
wuldorheap	wuldorxæ͜ɑːp
wuldorhelm	wuldorxelm
wuldorlean	wuldorlæ͜ɑːn
wuldorlic	wuldorliːt͡ʃ
wuldorlice	wuldorliːt͡ʃe
wuldormaga	wuldormɑːɡɑ
wuldornyttung	wuldornyttunɡ
wuldorsang	wuldorsɑnɡ
wuldorsped	wuldorspeːd
wuldorspedig	wuldorspeːdij
wuldorwerod	wuldorwerod
wuldorword	wuldorword
wuldorþrymm	wuldorθrymm
wuldrian	wuldriɑn
wuldrig	wuldrij
wuldrung	wuldrunɡ
wulf	wulf
wulfheort	wulfxe͜ort
wulfstan	wulfstɑːn
wull	wull
wuna	wunɑ
wund	wund
wundian	wundiɑn
wundor	wundor
wundorful	wundorful
wundorlic	wundorliːt͡ʃ
wundorlice	wundorliːt͡ʃe
wundortacen	wundortɑːken
wundrian	wundriɑn
wunian	wuniɑn
wunne	wunne
wunnon	wunnon
wunung	wununɡ
wurde	wurde
wurma	wurmɑ
wurþan	wurθɑn
wusc	wuːsk
wuscbearn	wuːskbæ͜ɑrn
wyda	wydɑ
wylf	wylf
wylfen	wylfen
wyllan	wyllɑn
wyllen	wyllen
wylm	wylm
wynful	wynful
wynfull	wynfull
wynfæst	wynfæst
wynleas	wynlæ͜ɑːs
wynlic	wynliːt͡ʃ
wynn	wynn
wynsum	wynsum
wynsumness	wynsumness
wyrcan	wyrt͡ʃɑn
wyrcean	wyrt͡ʃɑn
wyrcend	wyrt͡ʃend
wyrcung	wyrt͡ʃunɡ
wyrd	wyrd
wyrdan	wyrdɑn
wyrdstæf	wyrdstæf
wyrgan	wyrjɑn
wyrgen	wyrjen
wyrgþu	wyrɡθu
wyrhta	wyrxtɑ
wyrm	wyrm
wyrmcynn	wyrmkynn
wyrmread	wyrmræ͜ɑːd
wyrms	wyrms
wyrnan	wyrnɑn
wyrp	wyrp
wyrrest	wyrrest
wyrs	wyrs
wyrsa	wyrsɑ
wyrst	wyrst
wyrt	wyrt
wyrtian	wyrtiɑn
wyrtruma	wyrtrumɑ
wyrttruma	wyrttrumɑ
wyrttun	wyrttuːn
wyrtweard	wyrtwæ͜ɑrd
wyrþe	wyrθe
wyscan	wyːʃʃɑn
wæccan	wætt͡ʃɑn
wæcce	wætt͡ʃe
wæcnan	wæknɑn
wæd	wæd
wæd	wæːd
wæfersien	wæfersi͜yːn
wæflian	wæfliɑn
wæg	wæj
wæg	wæːj
wæge	we
wæge	wæːje
wægholm	wæːjxolm
wægn	wæjn
wægnwyrhta	wæjnwyrxtɑ
wæl	wæl
wælcyrge	wælkyrje
wælfyllo	wælfyllo
wælhreow	wælxre͜oːw
wælhreowlice	wælxre͜oːwliːt͡ʃe
wælhreownes	wælxre͜oːwnes
wælniþ	wælniːθ
wælreow	wælre͜oːw
wælstow	wælstoːw
wæn	wæːn
wæpen	wæːpen
wæpengetæc	wæːpenjetæk
wæpenhus	wæːpenxuːs
wæpn	wæːpn
wæpnedhand	wæːpnedxɑnd
wæpnedmann	wæːpnedmɑnn
wæpnhus	wæːpnxuːs
wæpnian	wæːpniɑn
wæpnwifestre	wæːpnwiːfestre
wæps	wæps
wær	wær
wær	wæːr
wærc	wært͡ʃ
wære	wæːre
wæringwic	wæːrinɡwiːt͡ʃ
wæringwicscir	wæːrinɡwiːt͡ʃʃiːr
wærloga	wæːrloɡɑ
wærsagol	wærsɑɡol
wærwyrde	wærwyrde
wæs	wæs
wæscan	wæskɑn
wæscern	wæskern
wæsp	wæsp
wæstm	wæstm
wæstmbære	wæstmbæːre
wæstmbærnes	wæstmbæːrnes
wæstmbæru	wæstmbæːru
wæstmian	wæstmiɑn
wæstmleas	wæstmlæ͜ɑːs
wæstmlic	wæstmliːt͡ʃ
wæstmsceatt	wæstmʃæ͜ɑtt
wæt	wæːt
wæter	wæter
wæteradl	wæterɑːdl
wæterflod	wæterfloːd
wætergelæt	wæterjelæːt
wæterian	wæteriɑn
wæterig	wæterij
wæterleas	wæterlæ͜ɑːs
wæterlic	wæterliːt͡ʃ
wæternædre	wæternæːdre
wæterseoc	wæterse͜oːk
wæterseocnes	wæterse͜oːknes
wæteryþ	wæteryːθ
wæx	wæks
xerxis	kserksis
yce	yːt͡ʃe
yfel	yfel
yfela	yfelɑ
yfelcweþan	yfelkweθɑn
yfele	yfele
yfelsian	yfelsiɑn
yfelsung	yfelsunɡ
yfelum	yfelum
yfelwillende	yfelwillende
yfelwillendnes	yfelwillendnes
yfemest	yfemest
yferra	yferrɑ
yld	yld
yldan	yldɑn
ylde	ylde
ylp	ylp
ylpend	ylpend
ymb	ymb
ymbbindan	ymbbindɑn
ymbceorfan	ymbt͡ʃe͜orfɑn
ymbcierran	ymbt͡ʃi͜yrrɑn
ymbcyrr	ymbt͡ʃyrr
ymbcyrran	ymbt͡ʃyrrɑn
ymbe	ymbe
ymbeardian	ymbæ͜ɑrdiɑn
ymbeardiende	ymbæ͜ɑrdiende
ymbfaran	ymbfɑrɑn
ymbfon	ymbfoːn
ymbfær	ymbfær
ymbfæreld	ymbfæreld
ymbgan	ymbɡɑːn
ymbgang	ymbɡɑnɡ
ymbgangan	ymbɡɑnɡɑn
ymbgyrdan	ymbɡyrdɑn
ymbhabban	ymbxɑbbɑn
ymbhealdan	ymbxæ͜ɑldɑn
ymbhon	ymbxoːn
ymbhringan	ymbxrinjɑn
ymbhweorfan	ymbxwe͜orfɑn
ymbhycgan	ymbxyjjɑn
ymblicgan	ymblijjɑn
ymbliþan	ymbliːθɑn
ymblocian	ymbloːkiɑn
ymblyt	ymblyt
ymbsceawian	ymbʃæ͜ɑːwiɑn
ymbscinan	ymbʃiːnɑn
ymbscriþan	ymbʃriːθɑn
ymbsellan	ymbsellɑn
ymbseon	ymbse͜oːn
ymbsettan	ymbsettɑn
ymbsittan	ymbsittɑn
ymbsittend	ymbsittend
ymbsnidennes	ymbsnidennes
ymbsniþan	ymbsniːθɑn
ymbstandan	ymbstɑndɑn
ymbstandend	ymbstɑndend
ymbstandennes	ymbstɑndennes
ymbweorpan	ymbwe͜orpɑn
ymbwlatian	ymbwlɑːtiɑn
ymbþencan	ymbθent͡ʃɑn
ymbþringan	ymbθrinɡɑn
ynneleac	ynnelæ͜ɑːk
yppe	yppe
yr	yːr
yrfe	yrfe
yrfenuma	yrfenumɑ
yrhþo	yrxθo
yrnan	yrnɑn
yst	yːst
ystan	yːstɑn
yþ	yːθ
yþan	yːθɑn
yþbord	yːθbord
yþfaru	yːθfɑru
yþgebland	yːθjeblɑnd
yþgewinn	yːθjewinn
yþhengest	yːθxenjest
yþhof	yːθxof
yþian	yːθiɑn
yþig	yːθij
yþlad	yːθlɑːd
yþlaf	yːθlɑːf
yþlid	yːθlid
yþlida	yːθlidɑ
yþmearh	yːθmæ͜ɑrx
yþmere	yːθmere
yþung	yːθunɡ
yþworian	yːθwoːriɑn
yþworiende	yːθwoːriende
æ	æ
æ	æː
æber	æːbeːr
æboc	æːboːk
æbs	æbs
æbylgan	æːbyljɑn
æcced	ætt͡ʃed
æce	æt͡ʃe
æce	æːt͡ʃe
æced	æt͡ʃed
æcen	æːt͡ʃen
æcer	æker
æcerceorl	ækert͡ʃe͜orl
æcermann	ækermɑnn
æcern	æːkern
æcerweorc	ækerwe͜ork
æcirn	æːkirn
ædre	æːdre
ædreseax	æːdresæ͜ɑks
æf	æf
æfdyne	æfdyːne
æfen	æːfen
æfenglom	æːfenɡloːm
æfensteorra	æːfenste͜orrɑ
æfest	æfest
æfest	æːfest
æfestness	æfestness
æfgrynde	æfɡrynde
æfgælþ	æfɡælθ
æfnan	æfnɑn
æfnian	æːfniɑn
æfre	æːfre
æfter	æfter
æftercweþan	æfterkweθɑn
æfterfolgian	æfterfolɡiɑn
æftergengel	æfterɡenɡel
æfweard	æfwæ͜ɑrd
æfweardnes	æfwæ͜ɑrdnes
æfwela	æfwelɑ
æfwyrdla	æfwyrdlɑ
æfæst	æːfæst
æg	æːj
ægen	æːjen
ægenbald	æːjenbɑld
ægenwulf	æːjenwulf
æghwilc	æːjxwilt͡ʃ
æghwylc	æːjxwylt͡ʃ
æghwylcum	æːjxwylt͡ʃum
æghwær	æːjxwæːr
æghwæþer	æːjxwæθer
æglæca	æːɡlæːt͡ʃɑ
ægra	æːjrɑ
ægre	æːjre
ægres	æːjres
ægru	æːjru
ægrum	æːjrum
ægwyrt	æːjwyrt
æht	æːxt
æhta	æxtɑ
æl	æl
æl	æːl
ælagol	æːlɑɡol
ælan	æːlɑn
ælareow	æːlɑːre͜oːw
ælc	æːlt͡ʃ
æled	æːled
æleputa	æːlepuːtɑ
ælf	ælf
ælfadl	ælfɑːdl
ælfcynn	ælfkynn
ælfen	ælfen
ælfhelm	ælfxelm
ælfsogoþa	ælfsoɡoθɑ
ælle	ælle
ælmesse	ælmesse
ælmiht	ælmixt
ælmihtig	ælmixtij
ælædend	æːlæːdend
æmete	æːmete
æmethwil	æːmetxwiːl
æmethyll	æːmetxyll
æmetta	æːmettɑ
æmette	æːmette
æmtian	æːmtiɑn
æmyrgan	æːmyrjɑn
æmyrge	æːmyrje
æne	æːne
ængel	ænjel
ængle	ænɡle
ænglisc	ænɡliʃ
ænig	æːnij
ænlic	æːnliːt͡ʃ
ænlæcan	æːnlæːt͡ʃɑn
æppel	æppel
æppelbære	æppelbæːre
æppelleaf	æppellæ͜ɑːf
æppelwin	æppelwiːn
ær	æːr
ærcebiscop	ært͡ʃebiʃʃop
ærdæg	æːrdæj
ærende	æːrende
ærendfæst	æːrendfæst
ærendgast	æːrendɡɑːst
ærendgewrit	æːrendjewrit
ærendian	æːrendiɑn
ærendwreca	æːrendwrekɑ
ærendwreccan	æːrendwrett͡ʃɑn
ærest	æːrest
ærgenemned	æːrjenemned
ærgod	æːrɡoːd
ærlice	æːrliːt͡ʃe
ærn	ærn
ærs	ærs
æsc	æʃ
æscas	æʃʃɑs
æsce	æʃʃe
æscen	æʃʃen
æscholt	æʃxolt
æscleah	æʃlæ͜ɑːx
æsctir	æʃtiːr
æsellend	æːsellend
æspe	æspe
æst	æːst
æstel	æːstel
æswician	æːswikiɑn
æt	æt
æt	æːt
ætbeon	ætbe͜oːn
ætberan	ætberɑn
ætbregdendlic	ætbrejdendliːt͡ʃ
ætfleon	ætfle͜oːn
ætfon	ætfoːn
ætgædere	ætɡædere
æthabban	ætxɑbbɑn
æthealdan	ætxæ͜ɑldɑn
æthrinan	ætxriːnɑn
æthweorfan	ætxwe͜orfɑn
ætiecan	æti͜yːt͡ʃɑn
ætiewan	æti͜yːwɑn
ætlædan	ætlæːdɑn
ætren	æːtren
ætrian	æːtriɑn
ætrig	æːtrij
ætsamne	ætsɑmne
ætspringan	ætsprinɡɑn
ætstandan	ætstɑndɑn
ætstandend	ætstɑndend
ætsteall	ætstæ͜ɑll
ættrig	æːttrij
ætwegan	ætweɡɑn
ætwesan	ætwesɑn
ætwindan	ætwindɑn
æwan	æːwɑn
æwbryce	æːwbryt͡ʃe
æwicnes	æːwiknes
æwignes	æːwiɡnes
æwisc	æːwiʃ
æwiscnes	æːwiʃnes
æwita	æːwitɑ
æwlic	æːwliːt͡ʃ
æwlice	æːwliːt͡ʃe
æwnian	æːwniɑn
æwnung	æːwnunɡ
æx	æks
æðelboren	æθelboren
æðelcyning	æθelkyninɡ
æðele	æθele
æðelhere	æθelxere
æðeling	æθelinɡ
æðelred	æθelred
æþel	æːθel
æþelbeorht	æθelbe͜orxt
æþelboren	æθelboren
æþelcund	æθelkund
æþelcyning	æθelkyninɡ
æþele	æθele
æþelhere	æθelxere
æþelian	æθeliɑn
æþeling	æθelinɡ
æþelred	æθelred
æþelu	æθelu
æþelwulf	æθelwulf
æþm	æːθm
æþryttan	æːθryttɑn
ð	θ
ða	θɑː
ðerh	θerx
ðorh	θorx
ðurh	θurx
ðæt	θæt
þ	θ
þa	θɑː
þaccian	θɑkkiɑn
þafian	θɑfiɑn
þafung	θɑfunɡ
þah	θɑːx
þam	θɑːm
þan	θɑːn
þanc	θɑnk
þancian	θɑnkiɑn
þancweorþ	θɑnkwe͜orθ
þanecan	θɑneːkɑn
þanne	θɑnne
þanon	θɑnon
þar	θɑːr
þara	θɑːrɑ
þas	θɑːs
þawian	θɑwiɑn
þe	θe
þe	θeː
þeah	θæ͜ɑːx
þeaht	θæ͜ɑxt
þeahtian	θæ͜ɑxtiɑn
þearf	θæ͜ɑrf
þearle	θæ͜ɑrle
þearm	θæ͜ɑrm
þeaw	θæ͜ɑːw
þeawleas	θæ͜ɑːwlæ͜ɑːs
þec	θek
þeccan	θett͡ʃɑn
þeccean	θett͡ʃɑn
þefel	θefel
þefian	θefiɑn
þegen	θejen
þegenboren	θejenboren
þegn	θejn
þegnian	θejniɑn
þegnung	θejnunɡ
þegon	θeːɣon
þencan	θent͡ʃɑn
þencean	θent͡ʃɑn
þenden	θenden
þenest	θeːnest
þenian	θeniɑn
þenian	θeːniɑn
þennan	θennɑn
þeo	θe͜oː
þeod	θe͜oːd
þeodan	θe͜oːdɑn
þeodcyning	θe͜oːdkyninɡ
þeodcyninga	θeːodkyniŋɡɑ
þeode	θe͜oːde
þeoden	θe͜oːden
þeodenleas	θe͜oːdenlæ͜ɑːs
þeodenstol	θe͜oːdenstoːl
þeodgestreon	θe͜oːdjestre͜oːn
þeodisc	θe͜oːdiʃ
þeodloga	θe͜oːdloɡɑ
þeodwiga	θe͜oːdwiɡɑ
þeodwrecan	θe͜oːdwrekɑn
þeodþrea	θe͜oːdθræ͜ɑː
þeof	θe͜oːf
þeofscyldig	θe͜oːfʃyldij
þeoh	θe͜oːx
þeon	θe͜oːn
þeorf	θe͜orf
þeos	θeːos
þeostrian	θe͜oːstriɑn
þeotan	θe͜oːtɑn
þeote	θe͜oːte
þeow	θe͜oːw
þeowan	θe͜oːwɑn
þeowdom	θe͜oːwdoːm
þeowen	θe͜owen
þeowet	θe͜oːwet
þeowian	θe͜oːwiɑn
þeox	θe͜oks
þer	θeːr
þerh	θerx
þerscan	θerʃɑn
þerscold	θerʃold
þerscweald	θerʃwæ͜ɑld
þerxold	θerksold
þes	θeːs
þicce	θikke
þiccet	θikket
þiccett	θikkett
þicgan	θijjɑn
þicnes	θiknes
þider	θider
þiedan	θi͜yːdɑn
þieder	θi͜yder
þiestre	θi͜yːstre
þiestru	θi͜yːstru
þiewen	θi͜ywen
þignen	θijnen
þille	θille
þin	θiːn
þincg	θinj
þindan	θindɑn
þinen	θiːnen
þing	θinɡ
þingan	θinɡɑn
þingian	θinɡiɑn
þinne	θinne
þis	θis
þisses	θises
þisses	θisses
þissum	θissum
þissum	θisum
þistel	θistel
þoden	θoden
þoft	θoft
þoftræden	θoftræːden
þoftscipe	θoftʃipe
þoht	θoːxt
þol	θol
þolemod	θolemoːd
þolian	θoliɑn
þon	θon
þoncian	θonkiɑn
þone	θone
þonne	θonne
þorfte	θorfte
þorn	θorn
þornig	θornij
þorp	θorp
þost	θost
þrag	θrɑːɡ
þrawan	θrɑːwɑn
þrea	θræ͜ɑː
þreanied	θræ͜ɑːni͜yːd
þreanyd	θræ͜ɑːnyːd
þreapian	θræ͜ɑːpiɑn
þreat	θræ͜ɑːt
þreatian	θræ͜ɑːtiɑn
þreax	θræ͜ɑks
þreo	θre͜oː
þreotan	θre͜oːtɑn
þreotiene	θre͜oːti͜yːne
þreotteoþa	θre͜oːtte͜oːθɑ
þreowa	θre͜owɑ
þrescold	θreʃʃold
þrexwold	θrekswold
þri	θriː
þridda	θriddɑ
þridde	θridde
þrie	θri͜yː
þrifeald	θrifæ͜ɑld
þrimilce	θrimilt͡ʃe
þrines	θriːnes
þringan	θrinɡɑn
þritig	θriːtij
þritigfeald	θriːtijfæ͜ɑld
þroht	θroxt
þrop	θrop
þrostle	θrostle
þrotbolla	θrotbollɑ
þrote	θrote
þrowend	θroːwend
þrowian	θroːwiɑn
þruh	θruːx
þryccan	θrytt͡ʃɑn
þrym	θrym
þrymm	θrymm
þrysman	θrysmɑn
þrysmian	θrysmiɑn
þryþ	θryːθ
þryþswiþ	θryːθswiːθ
þryþswyþ	θryːθswyːθ
þræd	θræːd
þrægan	θræːjɑn
þræl	θræːl
þu	θuː
þufbære	θuːfbæːre
þuhsian	θuxsiɑn
þuma	θuːmɑ
þunor	θunor
þunresdæg	θunresdæj
þunrian	θunriɑn
þunwange	θunwɑnɡe
þurfan	θurfɑn
þurh	θurx
þurhbirnan	θurxbirnɑn
þurhblawan	θurxblɑːwɑn
þurhborian	θurxboriɑn
þurhbrecan	θurxbrekɑn
þurhbregdan	θurxbrejdɑn
þurhbrengan	θurxbrenjɑn
þurhbrucan	θurxbruːkɑn
þurhclænsian	θurxklæːnsiɑn
þurhcreopan	θurxkre͜oːpɑn
þurhdelfan	θurxdelfɑn
þurhdreogan	θurxdre͜oːɡɑn
þurhdrifan	θurxdriːfɑn
þurhdufan	θurxduːfɑn
þurhetan	θurxetɑn
þurhfaran	θurxfɑrɑn
þurhfæstnian	θurxfæstniɑn
þurhgan	θurxɡɑːn
þurhgangan	θurxɡɑnɡɑn
þurhgefeoht	θurxjefe͜oxt
þurhsceotan	θurxʃe͜oːtɑn
þurhscriþan	θurxʃriːθɑn
þurhscyldig	θurxʃyldij
þurhsecan	θurxseːt͡ʃɑn
þurhseon	θurxse͜oːn
þurhsiene	θurxsi͜yːne
þurhsmeagan	θurxsmæ͜ɑːjɑn
þurhsmugan	θurxsmuːɡɑn
þurhteon	θurxte͜oːn
þurhwadan	θurxwɑdɑn
þurhwlitan	θurxwliːtɑn
þurhwrecan	θurxwrekɑn
þurhwunian	θurxwuniɑn
þursdæg	θursdæj
þurst	θurst
þuruh	θurux
þus	θus
þusend	θuːsend
þusendfeald	θuːsendfæ͜ɑld
þwang	θwɑnɡ
þwean	θwæ͜ɑːn
þweorh	θwe͜orx
þweran	θwerɑn
þwirel	θwirel
þwære	θwæːre
þy	θyː
þyld	θyld
þymel	θyːmel
þyncan	θynt͡ʃɑn
þyncþ	θynkθ
þynne	θynne
þyrel	θyːrel
þyrelian	θyːreliɑn
þyrelung	θyːrelunɡ
þyrre	θyrre
þyrs	θyrs
þyrscweald	θyrʃwæ͜ɑld
þyrst	θyrst
þyrstan	θyrstɑn
þystre	θyːstre
þystrian	θyːstriɑn
þystru	θyːstru
þywan	θyːwɑn
þæc	θæk
þæcele	θæt͡ʃele
þæctigele	θæktijele
þæge	θæje
þæm	θæːm
þænne	θænne
þær	θæːr
þære	θæːre
þærmid	θæːrmid
þærtoeacan	θæːrtoːæ͜ɑːkɑn
þærtogeanes	θæːrtoːjæ͜ɑːnes
þærwiþ	θæːrwiθ
þæs	θæs
þæsma	θæːsmɑ
þæt	θæt
ċ	t͡ʃ
œfest	øfest
œle	øle
œþel	øːθel
ƿ	w
