a	a
a	a̝
aba	aβa̝
abada	aβaða̝
abadengo	aβaðeŋɡo̝
abadía	abadia
abafar	aβafaɾ
abafo	aβafo̝
abaixar	aβajʃaɾ
abalar	aβalaɾ
abalo	aβalo̝
abaloucar	aβalowkaɾ
abanar	aβanaɾ
abancar	aβaŋkaɾ
abanicar	aβanikaɾ
abano	aβano̝
abanqueiro	aβaŋkejɾo̝
abastecer	aβasteseɾ
abastecer	aβasteθeɾ
abater	aβateɾ
abeaca	aβeaka̝
abeberar	aβeβeɾaɾ
abeiro	aβejɾo̝
abella	aβeʎa̝
abellariza	aβeʎaɾiθa̝
abelleira	aβeʎejɾa̝
abelleiro	aβeʎejɾo̝
abelurio	aβeluɾio̝
abelá	aβela
abeneiro	aβenejɾo̝
abesouro	aβesowɾo̝
abetar	aβetaɾ
abeto	aβeto̝
abetocar	aβetɔkaɾ
abetouro	aβetowɾo̝
aboar	aβoaɾ
abondar	aβondaɾ
abondo	aβondo̝
abouxar	aβowʃaɾ
abra	aβɾa̝
abranguer	aβɾaŋɡeɾ
abrazar	aβɾasaɾ
abrazar	aβɾaθaɾ
abrente	aβɾɛnte̝
abrigar	aβɾiɣaɾ
abrigo	aβɾiɣo̝
abrir	aβrir
abruñeiro	aβɾuɲejɾo̝
abruño	aβɾuɲo̝
abrótea	aβɾɔte̯a̝
abrótega	aβɾɔte̝ɣa̝
abur	aβuɾ
acabar	akabaɾ
acadar	akaðaɾ
acaer	akaeɾ
acalentar	akalentaɾ
acalentar	akalɛntaɾ
acaroar	akaɾoar
acañar	akaɲaɾ
acea	aθea̝
aceda	aθeða̝
acedo	aseðo̝
acedo	aθeðo̝
aceiro	asθejɾo̝
aceiro	aθejɾo̝
acender	asendeɾ
acender	aθendeɾ
aceno	aθeno̝
acereiro	aθeɾejɾo̝
aceso	aseso̝
aceso	aθeso̝
acevo	aθeβo
acha	at͡ʃa
achaiar	at͡ʃajaɾ
achandar	at͡ʃandaɾ
achantar	at͡ʃantaɾ
achar	at͡ʃaɾ
achegar	at͡ʃeɣaɾ
achorentar	at͡ʃoɾentaɾ
achorentar	at͡ʃoɾɛntaɾ
acibeche	asiβɛt͡ʃe̝
acibeche	aθiβɛt͡ʃe̝
acibecheiro	asiβɛt͡ʃeiɾo̝
acibecheiro	aθiβɛt͡ʃeiɾo̝
acio	aθio̝
acio	aθjo̝
acivro	aθiβɾo̝
aciñeira	aθiɲejɾa̝
acorar	akoɾaɾ
acoro	akoɾo̝
acotío	akotio̝
acougar	akowɣaɾ
acubillar	akuβiʎaɾ
acubillo	akuβiʎo̝
acá	aka
adala	aðala̝
adega	aðɛɣa
adiviñar	aðiβiɲaɾ
adobar	aðoβaɾ
adobe	aðɔβe̝
adobo	aðoβo̝
adoito	aðojto̝
adormentar	aðoɾmentaɾ
adormentar	aðoɾmɛntaɾ
adormiñar	aðoɾmiɲaɾ
adra	aðɾa̝
adrede	aðɾeðe̝
adro	aðɾo̝
aduanada	aðwanaða̝
adubo	aðuβo̝
adurmiñar	aðuɾmiɲaɾ
advento	adbento̝
afagar	afaɣaɾ
afalar	afalaɾ
afastar	afastaɾ
aferretar	aferetaɾ
aferventar	afeɾβentaɾ
afi	afi
afogar	afoɣaɾ
afreitas	afɾejta̝s
afuar	afuaɾ
afumar	afumaɾ
afungar	afuŋɡaɾ
agaitar	aɣajtaɾ
agarimar	aɣaɾimaɾ
agasallar	aɣasaʎaɾ
agatuñar	ɡatuɲaɾ
agochar	aɣot͡ʃaɾ
agoireiro	aɣojɾejɾo̝
agoiro	aɣojɾo̝
agra	aɣɾa̝
agro	aɣɾo̝
agromar	aɣɾomaɾ
agruñeiro	aɣɾuɲejɾo̝
agruño	aɣɾuɲo̝
agua	aɡwa
aguacil	aɡwaθil
aguacil	aɰwasil
agudo	aɣuðo̝
aguia	aɣja̝
aguillada	aɡiʎaða̝
aguillar	aɣiʎaɾ
aguilloar	aɣiʎoaɾ
aguillón	aɡiʎoŋ
aguisar	aɣisaɾ
agulla	aɣuʎa̝
agulletar	aɣuʎetaɾ
aire	ajɾe̝
aixada	ajʃaða̝
aixola	ajʃɔla̝
alabarar	alaβaɾaɾ
alalá	alala
albacora	alβakɔɾa̝
albar	alβaɾ
albarda	alβaɾða̝
albaroque	alβaɾɔke̝
albedro	alβeðɾo̝
albergue	alβɛɾɣe̝
albiscar	alβiskaɾ
alboio	alβojo
alboio	alβɔjo
albor	alβoɾ
albó	alβo̝
alcacén	alkaθɛŋ
alcalde	alkalðe̝
alcanzar	alkansaɾ
alcanzar	alkanθaɾ
alcobre	alkɔβɾe̝
alcouce	alkowθe̝
alcrique	alkɾike̝
alcuñar	alkuɲaɾ
alcácer	alkasɛɾ
aldara	aldaɾa̝
aldea	aldea̝
aldobrén	aldoβɾɛŋ
aldraxe	alðɾaʃe̝
aleixar	alejʃaɾ
alemparte	alɛmpaɾte̝
alfaiate	alfajat̪ɪ
alfar	alfaɾ
alfiestra	alfiɛstɾa̝
algaria	alħaɾja̝
algaria	alɣaɾja̝
algodón	alɣoðoŋ
algunha	alɣuŋa̝
algures	alɡuɾes
alifafe	alifafe
aliviar	aliβjaɾ
allada	aʎaða̝
allariz	aʎaɾiθ
allear	aʎeaɾ
almadraque	almaðɾake̝
almallo	almaʎo̝
almariz	almaɾiθ
almofrei	almofɾej
almorzar	almoɾsaɾ
almorzar	almoɾθaɾ
almorzo	almoɾso̝
almorzo	almoɾθo̝
almucela	almuθɛla̝
alor	alɔɾ
aloumiñar	alowmiɲaɾ
aloumiñeiro	alowmiɲejɾo̝
aloumiño	alowmiɲo̝
alpendre	alpendɾe̝
alpendre	alpɛndɾe̝
alporizar	alpoɾisaɾ
alporizar	alpoɾiθaɾ
alroto	alroto̝
altamira	altamiɾa̝
altar	altaɾ
alto	alto̝
alugar	aluɣaɾ
alugueiro	aluɣejɾo̝
alumear	alumeaɾ
aluscar	aluskaɾ
alustrar	alustɾaɾ
alustro	alustɾo̝
alvariza	alβaɾiθa̝
alverxón	alβ̞eɾʃoŋ
alxofre	alʃofɾe̝
alén	aleŋ
alén	alɛŋ
alí	ali
alínea	alinea
ama	ama̝
amalloar	amaʎoaɾ
amaravallar	amaɾaβaʎaɾ
amarelo	amaɾɛlo̝
amañar	amaɲaɾ
ambos	ambo̝s
ambroesa	ambɾoesa̝
ambroesa	ambɾuesa̝
amecer	ameθeɾ
ameixa	amejʃa̝
ameixeira	amejʃejɾa̝
amencer	amenseɾ
amencer	amenθeɾ
ames	ame̝s
amieiro	amiejɾo̝
amiguiño	amiɣiɲo̝
amizade	amiθaðe̝
amo	amo̝
amoado	amoaðo̝
amodo	amɔðo̝
amolar	amolaɾ
amolecer	amoleseɾ
amolecer	amoleθeɾ
amolegar	amoleɣaɾ
amolentar	amolentaɾ
amora	amɔɾa̝
amorogo	amoɾoɡo̝
amosegar	amoseɣaɾ
amoucar	amowkaɾ
amádego	amaðe̝ɣo̝
améndoa	amendo̯a̝
anaco	anako̝
anafil	anafil
anazar	anaθaɾ
anca	aŋka̝
anciño	anθiɲo̝
ancoradoiro	aŋkoɾaðojɾo̝
andaina	andajna̝
andar	andaɾ
andas	anda̝s
andrade	andɾaðe̝
andré	andɾɛ
anduriña	anduɾiɲa̝
anello	aneʎo̝
anga	aŋka̝
anga	aŋɡa̝
angarela	aŋɡaɾela̝
angarellas	aŋɡaɾeʎa̝s
angazo	aŋɡaθo̝
angueira	aŋɡejɾa̝
angumil	aŋɡumil
anguria	aŋɡuɾja̝
anguía	aŋɡia̝
aninovo	aninɔβo̝
anllar	anʎaɾ
anoxar	anoʃaɾ
ansamonde	ansamonde̝
ansariz	ansaɾiθ
ansemar	ansemaɾ
ansemil	ansemil
ansemonde	ansemonde̝
anseán	anseaŋ
ansimonde	ansimonde̝
ansoar	anso̯aɾ
anta	anta̝
antepeito	antepejto̝
antonte	antɔnte
antroido	antɾojðo̝
antártida	antaɾtiða
anubrar	anuβɾaɾ
anxeriz	anʃeɾiθ
apalpar	apalpaɾ
apancar	apaŋkaɾ
aparcadoiro	apaɾkaðojɾo̝
aparcar	apaɾkaɾ
aparellar	apareʎaɾ
aparello	apaɾeʎo̝
aparelloa	apaɾeʎoa̝
aparvar	apaɾβaɾ
apañar	apaɲaɾ
apeiro	apejɾo̝
apeladoira	apelaðojɾa̝
apio	apjo̝
aplicado	aplikaðo̝
aplicar	aplikaɾ
apocalipse	apokalipse̝
apodrecer	apoðɾeseɾ
apodrecer	apoðɾeθeɾ
apodrentar	apoðɾentaɾ
apostar	apostaɾ
apremer	apɾemeɾ
apupar	apupaɾ
aquel	akel
aquí	aki
arado	aɾaðo̝
arameña	aɾameɲa̝
aramio	aɾamjo̝
arancel	aɾanθel
arando	aɾando̝
arangaño	aɾaŋɡaɲo̝
arangaños	aɾaŋɡaɲo̝s
araña	aɾaɲa̝
arañeira	aɾaɲejɾa̝
arca	arka̝
arciprestado	aɾθipɾɛstaðo̝
arcipreste	aɾθipɾɛste̝
arco	aɾko̝
ardentía	aɾðentia̝
ardora	aɾðoɾa̝
area	aɾea̝
areal	aɾeal
areixa	aɾɛjʃa̝
arfar	aɾfaɾ
argallar	aɾɣaʎaɾ
argana	aɾɣana̝
argola	aɾɣɔla̝
argueiro	aɾɣejɾo̝
ariño	aɾiɲo̝
armadura	aɾmaduɾa
armariz	aɾmaɾiθ
armaría	armaɾia̝
armentío	aɾmentio̝
armiño	aɾmiɲo̝
arna	aɾna̝
arnal	aɾnal
arnal	aɾnaʊ̯
arneiro	aɾnejɾo̝
arnela	aɾnɛla̝
arneste	aɾneste̝
arpeo	aɾpeo̝
arpeo	aɾpeo̯
arqueiro	aɾkejɾo
arquivo	aɾkiβo̝
arranxar	aranʃaɾ
arre	are̝
arrecender	aresendeɾ
arrecender	areθendeɾ
arredar	areðaɾ
arrefecer	arefeseɾ
arrefecer	arefeθeɾ
arrefriar	arefɾiaɾ
arregazar	reɣasaɾ
arregazar	reɣaθaɾ
arremedar	aremeðaɾ
arreo	areo̝
arrepentir	arepentiɾ
arrepiar	arepiaɾ
arrequeixar	arekejʃaɾ
arrigar	ariɣaɾ
arrimar	arimaɾ
arrincar	ariŋkaɾ
arroaz	aroas
arroaz	aroaθ
arrochar	arot͡ʃaɾ
arrocheiro	arot͡ʃo̝
arrocho	arot͡ʃo̝
arroiar	arojaɾ
arroio	arojo̝
arrombar	aromβaɾ
arrombar	arumβaɾ
arrotar	arotaɾ
arroto	aroto̝
arroupar	arowpaɾ
arroutada	arowtaða̝
arroutado	arowtaðo̝
arroz	aros
arrufado	arufaðo̝
arrufar	arufaɾ
arró	arɔ
arrós	aros
arteiro	aɾtejɾo̝
arteixo	aɾtejʃo̝
artello	aɾteʎo̝
artesa	aɾtesa̝
artigo	aɾtiɣo̝
arume	aɾume̝
arxemil	aɾʃemil
arxón	aɾʃoŋ
arzaña	aɾθaɲa̝
arzán	aɾθaŋ
arzón	aɾsoŋ
arzón	aɾθoŋ
asa	asa
asar	asaɾ
asaño	asaɲo̝
ascariz	askaɾiθ
ascarís	askaɾis
ascua	askwa̝
aseitar	asejtaɾ
asemade	asemaðe̝
asenso	asɛnso̝
asexar	aseʃaɾ
asinar	asinaɾ
asma	asma̝
asmo	asmo̝
asmo	aɾmo̝
asoballar	asoβaʎaɾ
asolagar	asolaɡaɾ
asolagar	asulaɡaɾ
asollar	asoʎaɾ
astroso	astɾoso̝
asubiar	asuβiaɾ
asubío	asuβio̝
atafal	atafal
atalaia	atalaja̝
atanguer	ataŋɡeɾ
atar	ataɾ
ateigar	atejɣaɾ
ateán	ateaŋ
atinxir	atiŋʃiɾ
atián	atiaŋ
atoar	atoaɾ
atol	atɔl
atolar	atolaɾ
atopar	atopaɾ
atrapallar	atɾapaʎaɾ
atrás	atɾas
atuar	atuaɾ
atufado	atufaðo̝
aturar	atuɾaɾ
aturuxar	atuɾuʃaɾ
aturuxo	atuɾuʃo̝
atuír	atuiɾ
auga	awɡa
augardente	awɣaɾðɛnte̝
augueiro	awɣejɾo̝
avea	aβea̝
avesada	aβesaða̝
avesar	aβesaɾ
avesedo	aβeseðo̝
aveso	aβɛso̝
avesío	aβesio̝
avia	aβja̝
avinza	aβinθa̝
avoengo	aβoeŋɡo̝
avó	aβo̝
axe	aʃe̝
axear	aʃeaɾ
axirxilar	aʃiɾʃilaɾ
aza	aθa
azo	aso̝
azo	aθo̝
azor	asoɾ
azor	aθoɾ
azougue	asowɣe̝
azougue	aθowɣe̝
azouta	asowta̝
azouta	aθowta̝
azul	asul
azul	aθul
baamonde	bamonde̝
baamonde	baːmonde̝
babuxa	baβuʃa̝
bacelo	baθelo̝
bacelo	baθɛlo̝
bacieiro	basiejɾo̝
bacieiro	baθiejɾo̝
bacinete	baθinete̝
bacorelo	bakoɾɛlo̝
bacoriño	bakoɾiɲo̝
bacía	basia̝
bacía	baθia̝
bacío	basio̝
bacío	baθio̝
badal	baðal
badalada	baðalaða̝
badalar	baðalaɾ
badalo	baðalo̝
badúa	baðua̝
baeta	baeta̝
bafarada	bafaɾaða̝
bafexar	bafeʃaɾ
bafo	bafo̝
bafún	bafuŋ
baga	baɣa̝
bagazo	baɣaso̝
bagazo	baɣaθo̝
bagaña	baɣaɲa̝
bago	baɣo̝
bagulla	baɣuʎa̝
bagullo	baɣuʎʊ
baiona	bajona̝
baiuca	bajuka̝
baixel	bajʃɛl
baladrón	balaðɾo̝n
balandrán	balandɾaŋ
balastrón	balastɾoŋ
balboa	balβoa̝
balcón	balkoŋ
balda	balda̝
baldomar	baldomaɾ
baldomir	baldomiɾ
baldón	baldoŋ
balea	balea̝
baleato	baleato̝
baleeiro	baleejɾo̝
baleeiro	baliejɾo̝
balistrón	balistɾoŋ
baloca	balɔka̝
baloco	balɔko̝
baloncesto	balonθesto
balor	baloɾ
balorento	baloɾento̝
balorento	baloɾɛnto̝
balouco	balowko̝
baltar	baltaɾ
baluga	baluɣa̝
balvís	balβis
bama	bama̝
bamio	bamjo̝
banastra	banastɾa̝
bancal	baŋkal
bance	banse̝
banco	baŋko̝
banda	banda̝
bandeira	bandejɾa̝
bando	bando̝
bandullo	banduʎo̝
banir	baniɾ
banqueta	baŋketa̝
banzado	banθaðo̝
banzo	banso̝
banzo	banθo̝
bao	bao̯
baralla	baɾaʎa̝
barallar	baɾaʎaɾ
barallete	baɾaʎete̝
barallobre	baɾaʎɔβɾe̝
baralloca	baɾaʎɔka̝
baratar	baɾataɾ
barato	baɾato̝
baraza	baɾasa̝
baraza	baɾaθa̝
barazal	baɾaθal
barbanza	baɾβansa̝
barbanza	baɾβanθa̝
barbeito	baɾβejto̝
barbuda	baɾβuðo̝
barbudo	baɾβuðo̝
barca	baɾka̝
barcal	baɾkal
barcia	baɾθja̝
barco	baɾkʊ
barda	baɾða̝
bardanca	baɾðaŋka̝
bardo	baɾðo̝
baril	baɾil
barqueiro	baɾkejɾo̝
barra	bara̝
barreira	barejɾa̝
barreiro	barejɾo̝
barril	baril
barro	baro̝
barullo	baɾuʎo̝
barutar	baɾutaɾ
baruto	baɾuto̝
barón	baɾoŋ
basculla	baskuʎa̝
bascullo	baskuʎo̝
bastar	bastaɾ
bastimento	bastimento̝
bastir	bastiɾ
bastón	bastoŋ
batel	batɛl
bater	bateɾ
batoco	batoko̝
batán	bataŋ
bazar	baθaɾ
bazuncho	baθunt͡ʃo̝
baña	baɲa̝
baño	baɲo̝
beberaxe	beβeɾaʃe̝
beberricar	beβerikaɾ
becerra	besera̝
becerra	beθera̝
becerro	besero̝
becerro	beθero̝
becho	bet͡ʃo̝
bedugo	beðuħo̝
bedugo	beðuɣo̝
bedulo	beðulo̝
beira	bejɾa̝
beirado	bejɾaðo̝
beiramar	bejɾamaɾ
beiril	bejɾil
beizo	bejso̝
beizo	bejθo̝
beizón	bejθoŋ
beladona	bɛladona̝
beldro	beldɾo̝
beldrogo	beldɾoɣo̝
beleguín	beleɣiŋ
beleguín	beleɰiŋ
beleigán	belejɣaŋ
belesar	belesaɾ
beligo	bɪliɣo̝
beliscar	beliskaɾ
belota	belɔta̝
belsar	belsaɾ
belvís	bɛlβis
bemposta	bɛmpɔsta̝
ben	bɛŋ
bendia	bendja̝
bendollo	bendoʎo̝
bendrade	bendɾaðe̝
berberecho	beɾβeɾet͡ʃo̝
berbia	beɾβja̝
berbia	bɛɾβja̝
berce	bɛɾse̝
berce	bɛɾθe̝
beresmo	beɾesmo̝
bergantiños	beɾɣantiɲo̝s
bermui	beɾmuj
bermún	beɾmuŋ
berrar	beraɾ
berro	bɛro̝
bertamil	beɾtamil
bertamiráns	beɾtamiɾaŋs
bertomil	beɾtomil
besta	besta̝
besta	bɛsta̝
besteiro	bɛsteiɾo̝
bestra	bɛstɾa̝
besugo	besuɣo̝
beterraba	beteraba̝
betoque	betɔke̝
bexato	beʃato̝
bicar	bikaɾ
bicha	bit͡ʃa̝
bicho	bit͡ʃo̝
bichoco	bit͡ʃoko̝
bichoco	bit͡ʃɔko̝
bici	biθi
bicudo	bikuðo̝
bidente	biðɛnte̝
bido	biðo̝
bidueiro	biðuejɾo̝
bieiteira	biejtejɾa̝
bieiteiro	biejtejɾo̝
bieito	biejto̝
bigode	biɣɔðe̝
bigornia	biɣɔɾnja̝
bigote	biɣɔtɪ
billa	biʎa̝
billarda	biʎaɾða̝
billardo	biʎaɾðo̝
bilurico	biluɾiko̝
binguelete	biŋɡelete̝
biombo	biombo
biosbardo	biosβaɾðo̝
biqueira	bikejɾa̝
birlo	biɾlo̝
birollo	biɾoʎo̝
birollo	biɾɔʎo̝
birta	biɾta̝
bisbar	bisβaɾ
bisbarra	bisbara̝
biscar	biskaɾ
bo	bo
bocexar	boseʃaɾ
bocexar	boθeʃaɾ
bocha	bɔt͡ʃa̝
boche	bɔt͡ʃe̝
bocoi	bokoj
bode	bɔðe̝
boedo	boeðo̝
boeta	boeta̝
bofe	bofe̝
boga	bɔɣa̝
bogada	boɣaða̝
bogada	buɣaða̝
boh	bɔ
boi	bɔj
boia	bɔja̝
boira	bɔjɾa̝
boirao	bɔjɾao̝
boirao	bɔjɾaw
bola	bola̝
bolboreta	bolβoɾeta
bolo	bolo̝
bolo	bɔlo̝
boneca	bonɛka
bonome	bonɔme̝
boo	bo
boo	boː
boquexar	bokeʃaɾ
bordear	boɾðeaɾ
bordinga	boɾðiŋɡa̝
bordo	boɾðo̝
bordo	bɔɾðo̝
bordón	boɾðoŋ
boroa	boɾoa̝
borra	bora̝
borralla	boraʎa̝
borraxe	boraʃe̝
borrea	borea̝
borreiro	borejɾo̝
borro	boro̝
bortel	boɾtɛl
bortelar	boɾtelaɾ
bosque	bɔske
bosta	bɔsta̝
bota	bota̝
bota	bɔta̝
botafumeiro	botafumejɾo̝
botar	botar
botella	botɛʎɐ
botelo	botɛlo̝
botelo	bʊtɛlo̝
boto	boto̝
boto	bɔto̝
botón	botoŋ
bou	bow
boubeta	bowβeta̝
boubín	bowβiŋ
boullón	bowʎoŋ
bourar	bowɾaɾ
bourear	bowɾeaɾ
bousán	bowsaŋ
bousán	bɔwsaŋ
bouta	bowta̝
boutureira	bowtuɾejɾa̝
bouza	bowsa̝
bouza	bowθa̝
bozo	boso̝
bozo	boθo̝
braceiro	bɾaθejɾo̝
bradar	bɾaðaɾ
braga	bɾaɣa̝
bramar	bɾamaɾ
brancaneves	bɾaŋka̝nɛβe̝s
brancellao	bɾanθeʎao̯
branco	bɾaŋkʊ
brandariz	bɾandaɾis
brandariz	bɾandaɾiθ
brandarís	bɾandaɾis
brandián	bɾandiaŋ
brandufe	bɾandufe̝
brandán	bɾanðaŋ
brandón	bɾanðoŋ
brasa	bɾasa̝
bravo	bɾaβo̝
bravádego	bɾaβaðe̝ɣo̝
braza	bɾasa̝
braza	bɾaθa̝
braña	bɾaɲa̝
brañego	bɾaɲɛɣo̝
brañento	bɾaɲento̝
brañento	bɾaɲɛnto̝
brea	bɾea̝
breixo	bɾejʃo̝
bremar	bɾemaɾ
brenza	bɾensa̝̝
brenza	bɾenθa̝̝
breu	bɾɛw
brexo	bɾɛʃo̝
brica	bɾika̝
brinco	bɾiŋko̝
brindar	bɾindaɾ
bringa	bɾiŋɡa̝
bringuelo	bɾiŋɡɛlo̝
britar	bɾitaɾ
brión	bɾioŋ
broa	bɾoa̝
broca	bɾɔka̝
brocha	bɾɔt͡ʃa̝
broco	bɾɔko̝
brodio	bɾɔðjʊ
broeiro	bɾoejɾo̝
brosa	bɾɔsa̝
brosque	bɾɔske
brouca	bɾɔwka̝
broza	bɾoθa̝
broza	bɾɔθa̝
bruar	bɾuaɾ
bruión	bɾujoŋ
brun	bɾuŋ
bruxaría	bɾuʃaɾia
bréixome	bɾejʃo̝me
brío	bɾio̝
brúa	bɾua̝
brúo	bɾuo̝
bubela	buβɛla̝
buceta	buseta̝
buceta	buθeta̝
bucina	busina̝
bucina	buθina̝
bucio	busjo̝
bucio	buθjo̝
budión	buðioŋ
bufarda	bufaɾða̝
bugallo	buɣaʎo̝
bulicio	bulisjo̝
bulicio	buliθjo̝
buligar	buliɣaɾ
bulir	buliɾ
bullar	βuʎaɾ
bulleiro	buʎejɾo̝
bulleiro	buʎɛjɾo̝
bullo	buʎo̝
bulló	buʎɔ
bulra	bulra̝
buraco	buɾako̝
buraz	buɾas
buraz	buɾaθ
burbulla	buɾβuʎa̝
burbullar	buɾβuʎaɾ
burdiar	buɾðeaɾ
burdiar	buɾðjaɾ
burel	buɾɛl
burela	buɾɛlɐ
burga	buɾɣa̝
burgo	buɾɣo̝
burgueiro	buɾɣejɾo̝
burla	buɾla̝
burlar	buɾlaɾ
buscar	buskaɾ
buso	buso̝
buso	bus̻o̝
busto	busto̝
bustofreán	bustofɾeaŋ
buxa	buʃa̝
buxana	buʃana̝
buxarda	buʃaɾða̝
buxardo	buʃaɾð̝o
buxeo	buʃeo̝
buxeo	buʃeo̯
buxeu	buʃew
buxeu	buʃɛw
buxola	buʃɔla̝
buxón	buʃoŋ
buzaco	busako̝
buzaco	buθako̝
bácoro	bako̝ɾo̝
bálsamo	balsa̝mo̝
bébedo	beβe̝ðo̝
bídalo	biðalo̝
bóveda	bɔβe̝ða̝
búsula	busula̝
caamouco	kamowko̝
cabaleiro	kaβalejɾo̝
cabana	kaβana̝
cabaneiro	kaβanejɾo̝
cabanón	kaβanoŋ
cabaza	kaβasa̝
cabaza	kaβaθa̝
cabazo	kaβaθo̝
cabestro	kaβestɾo̝
cabeza	kaβesa̝
cabeza	kaβeθa̝
cabezada	kaβesaða̝
cabezada	kaβeθaða̝
cabezal	kaβesal
cabezal	kaβeθal
cabido	kaβiðo̝
cable	kaβle̝
cabo	kaβo̝
cabodano	kaβoðano̝
cabra	kaβɾa̝
cabrafigo	kaβɾa̝fiɣo̝
cabrón	kaβɾoŋ
caca	kaka̝
cacarexar	kakaɾeʃaɾ
cacha	kat͡ʃa̝
cachada	kat͡ʃaða̝
cachar	kat͡ʃaɾ
cacharela	kat͡ʃaɾɛla̝
cachaza	kat͡ʃasa̝
cachaza	kat͡ʃaθa̝
cachear	kat͡ʃeaɾ
cacheira	kat͡ʃejɾa̝
cachelo	kat͡ʃɛlo̝
cachena	kat͡ʃena̝
cacho	kat͡ʃo̝
cachola	kat͡ʃɔla̝
cachotaría	kat͡ʃotaɾia
cachote	kat͡ʃɔte̝
cachucha	kat͡ʃut͡ʃa̝
cachón	kat͡ʃoŋ
cadaleito	kaðalejtʊ
cadarnoxo	kaðaɾnoʃo̝
cadea	kaðea̝
cadeado	kaðeaðo̝
cadeirado	kaðejɾaðo
cadela	kaðɛla̝
cadillo	kaðiʎo̝
cadoiro	kaðojɾo̝
cadrar	kaðɾaɾ
cadrifollo	mendɾeʎo̝
cadril	kaðɾil
caeira	kɐɛjɾɐ
caer	kaeɾ
caes	kajs
caetano	kaetano̝
caetano	kae̯tano̝
cafurna	kafuɾna̝
cafúa	kafua̝
cagalla	kaɣaʎa̝
cagalleta	kaɣaʎeta̝
cagallón	kaɣaʎoŋ
cagar	kaɣaɾ
cai	kaj
cailón	kajloŋ
cairo	kajɾo̝
caivanca	kajβaŋka̝
caixa	kajʃa̝
caixón	kajʃoŋ
cal	kal
calacú	kalaku
calafatear	kalafateaɾ
calcar	kalkaɾ
calcañar	kalkaɲaɾ
calcaño	kalkaɲo̝
calda	kalda̝
caldas	kalda̝s
caldeira	kaldejɾa̝
caldeirada	kaldejɾaða̝
caldeireiro	kaldejɾejɾo̝
caldeiro	kaldejɾo̝
caldo	kaldo̝
calella	kaleʎa̝
calixen	kaliʃe̝ŋ
callao	kaʎao̯
callar	kaʎaɾ
callau	kaʎaw
callo	kaʎo̝
callobre	kaʎɔβɾe̝
caloroso	kaloɾoso̝
caluga	kaluɣa̝
calvario	kalβaɾjo̝
calvo	kalβo̝
camariña	kamaɾiɲa̝
camba	kamba̝
cambo	kambo̝
cambota	kambɔta̝
cambra	kambɾa̝
camioneiro	kamjoneɾo
camisa	kamisa̝
camiño	kamiɲo̝
camouco	kamowko̝
campa	kampa
campaza	kampaθa̝
campo	kãmpo̝
camposa	kamposa̝
camposanto	kamposanto̝
campá	kampa
can	kaŋ
cana	kana̝
canada	kanaða̝
canado	kanaðo̝
canafrecha	kanafɾet͡ʃa̝
canal	kanal
canaval	kanaβal
cancela	kansɛla̝
cancela	kanθɛla̝
cancelo	kansɛlo̝
cancelo	kanθɛlo̝
cancil	kansil
cancil	kanθil
canda	kanda̝
candea	kandea̝
candeeiro	kandeejɾo̝̝
candeeiro	kandiejɾo̝
candeloria	kandelɔɾja̝
canedo	kaneðo̝
caneiro	kanejɾo̝
canela	kanɛla̝
canella	kaneʎa̝
canexa	kaneʃa̝
canga	kaŋka̝
canga	kaŋɡa̝
cangalla	kaŋkaʎa̝̝
cangalla	kaŋɡaʎa̝
cangallo	kaŋkaʎo̝̝
cangallo	kaŋɡaʎo̝
cangar	kaŋɡaɾ
cango	kaŋko̝
cango	kaŋɡo̝
canil	kanil
canivete	kaniβete̝
canizo	kaniso̝
canizo	kaniθo̝
canle	kanle̝
cano	kano̝
canteira	kantejɾa̝
canteiro	kantejɾo̝
canterla	kantɛɾla̝
cantil	kantil
canto	kanto̝
cantón	kantoŋ
canudo	kanuðo̝
canzobre	kanθɔbɾe̝
cao	kao̯
capa	kapa̝
capeirote	kapejɾɔte̝̝
capela	kapɛla̝
capelo	kapelo̝
capón	kapoŋ
carabuxa	kaɾaβuʃa̝
carabuña	kaɾaβuɲa̝
carallada	kaɾaʎaða̝
carallo	kaɾaʎo̝
carambelo	kaɾambelo̝
carambelo	kaɾambɛlo̝
carambo	kaɾamβo̝
caramecha	kaɾamet͡ʃa̝
caramuxo	kaɾamuʃo̝
carapucha	kaɾaput͡ʃa̝
carapucho	kaɾaput͡ʃo̝
caravel	kɑɾaβɛl
caravilla	kaɾaβiʎa̝
carazo	kaɾaθo̝
carba	kaɾβa̝
carballa	kaɾβaʎa̝
carballeira	kaɾβaʎejɾa̝
carballo	kaɾβaʎo̝
carbón	kaɾβoŋ
carcán	kaɾkaŋ
carcás	kaɾkas
cardar	kɑɾðaɾ
cardo	kaɾðo̝
careixa	kaɾejʃa̝
carepa	kaɾepa̝
cargar	kaɾɣaɾ
carioca	kaɾjɔka̝
carlou	kaɾlow
carmear	kaɾmeaɾ
carne	kaɾne̝
carneiro	kaɾnejɾo̝
carnocho	kaɾnot͡ʃo̝
carnoedo	kaɾnoeðo̝
carolo	kaɾɔlo̝
carozo	kaɾoso̝
carozo	kaɾoθo̝
carpaza	kaɾpaθa̝
carpear	kaɾpeaɾ
carpinteiro	kaɾpintejɾo̝
carpir	kaɾpiɾ
carqueixa	kaɾkejʃa̝
carrabouxo	karaβowʃo̝
carraca	karaka̝
carracha	karat͡ʃa̝
carracho	karat͡ʃo̝
carranca	karaŋka̝
carrasco	karasko̝
carraxe	karaʃe̝
carreira	karejɾa̝
carreiro	karejɾo̝
carretar	karetaɾ
carreto	kareto̝
carrizo	kariso̝
carrizo	kariθo̝
carro	karo̝
carroucha	karowt͡ʃa̝
carto	kaɾto̝
caruncho	kaɾunt͡ʃo̝
cas	kas
casal	kasal
casanova	kasanɔβa̝
cascabel	kaskaβɛl
cascallo	kaskaʎo̝
cascar	kaskaɾ
casco	kasko̝
cascuda	kaskuða̝
cascón	kaskoŋ
caseiro	kasejɾo̝
casqueiro	kaskejɾo̝
casquete	kaskete̝
casta	kasta̝
castaña	kastaɲa̝
caste	kaste̝
castelo	kastɛlo̝
castelo	kæstɛlo̝
castizal	kastisal
castizal	kastiθal
castizo	kastiθo̝
castrapo	kastɾapo̝
castrexo	kastɾeʃo
castro	kastɾo̝
castromaior	kastɾomajoɾ
castromil	kastɾomil
castrove	kastɾɔβe̝
castrón	kastɾoŋ
casula	kasula̝
catadura	kataðuɾa̝
catar	kataɾ
catasol	katasol
cativo	katiβo̝
catorce	katoɾθɪ
catuxa	katuʃa̝
causela	kawsela̝
causela	kowsela̝
caustra	kawstɾa̝
cavada	kaβaða̝
cavar	kaβaɾ
cavaxe	kaβaʃe̝
cavorco	kaβɔɾko̝
caxigo	kaʃiɣo̝
cazacú	kasaku
cazacú	kaθaku
cazón	kasoŋ
cazón	kaθoŋ
caíño	kaiɲo̝
caña	kaɲa̝
cañoto	kaɲoto̝
cea	sea̝
cea	θea̝
cear	ceaɾ
cear	seaɾ
cear	θeaɾ
ceba	seβa̝
ceba	θeβa̝
cebada	mendɾeʎo̝
cebola	sɛβɔla̝
cebola	θeβola̝
cebrisca	θeβɾiska̝
cebro	θeβɾo̝
cedo	seðo̝
cedo	θeðo̝
cedofeita	θeðofejta̝
cedofeito	seðofejto̝
cego	sɛɣo̝
cego	θɛɣo̝
ceibar	sejβaɾ
ceibar	θejβaɾ
ceibe	sejβe̝
ceibe	θejβe̝
ceibo	sejβo̝
ceibo	θejβo̝
ceifa	sɛjfɐ
ceifa	θɛjfɐ
ceila	θejla̝
cela	θɛla̝
celamín	θelamiŋ
celanova	θelanɔβa̝
celeiro	selejɾo̝
celeiro	θelejɾo̝
celigras	θeliɣɾa̝s
celme	sɛlme̝
celme	θɛlme̝
celtismo	θɛltismo
cenceno	senseno̝
cenceno	θenθeno̝
cendal	θendal
cenlla	senʎa̝
cenlla	θenʎa̝
ceno	aθeno̝
cenrada	senraða̝
cenrada	θenraða̝
centeo	senteo̝
centeo	θenteo̝
centeo	θentew
centola	sentola̝
centola	θentola̝
centulo	θentulo̝
cenza	θɛnθa̝
cenzo	senso̝
cenzo	θenθo̝
cepa	sepa̝
cepa	θepa̝
cepar	θepaɾ
cepo	sepo̝
cepo	θepo̝
cerca	seɾka̝
cerca	θeɾka̝
cercar	seɾkaɾ
cercar	θeɾkaɾ
cerco	seɾko̝
cerco	θeɾko̝
cerdeira	seɾðejɾa̝
cerdeira	θeɾðejɾa̝
cereixa	seɾejʃa̝
cereixa	θeɾejʃa̝
cereixa	θɾɛjʃa̝
cerello	θeɾeʎo̝
cerna	sɛɾna̝
cerna	θɛɾna̝
cernada	θeɾnaða̝s
cerne	sɛɾne̝
cerne	θɛɾne̝
cernella	θeɾneʎa̝
cerollo	θeɾoʎo̝
cerponzóns	seɾponsoŋs
cerponzóns	θeɾponθoŋs
cerqueiro	seɾkejɾo̝
cerqueiro	θeɾkejɾo̝
cerquiño	seɾkiɲo̝
cerquiño	θeɾkiɲo̝
cerrar	sɛraɾ
cerrar	θɛraɾ
cerro	sero̝
cerro	θero̝
cervantes	θeɾβante̝s
cervexa	seɾβeʃa̝
cervexa	θeɾβeʃa̝
cerviña	θɛɾβiɲa̝
cerviño	θɛɾβiɲo̝
cervo	θɛɾβo̝
cervúa	θɛɾβua̝
cervún	θɛɾβuŋ
cesteiro	sestejɾo̝
cesteiro	θestejɾo̝
cezobre	θeθɔbɾe̝
chabola	t͡ʃaβɔla̝
chacina	t͡ʃasina̝
chacina	t͡ʃaθina̝
chafariz	t͡ʃafaɾis
chafariz	t͡ʃafaɾiθ
chaga	t͡ʃaɣa̝
chagorza	t͡ʃaɣɔɾθa̝
chaguazo	t͡ʃaɡwaθo̝
chaira	t͡ʃajɾa̝
chama	t͡ʃama̝
chamador	t͡ʃamaðoɾ
chambergas	t͡ʃambeɾɣa̝s
chamizo	t͡ʃamiso̝
chamizo	t͡ʃamiθo̝
chamorro	t͡ʃamoro̝
chamoso	t͡ʃamoso̝
chamuscar	t͡ʃamuskaɾ
chan	t͡ʃaŋ
chanchar	t͡ʃant͡ʃaɾ
chancho	t͡ʃant͡ʃo̝
chantada	t͡ʃantaða̝
chantar	t͡ʃantaɾ
chantaxe	t͡ʃantaʃe̝
chanto	t͡ʃanto̝
chanzo	t͡ʃanθo̝
chao	t͡ʃao̯
chao	t͡ʃaw
chapa	t͡ʃapa̝
chapacuña	t͡ʃapakuɲa̝
chapapote	t͡ʃapapɔte̝
chapar	t͡ʃapaɾ
chapeu	t͡ʃapew
chapeu	t͡ʃapɛw
charamisca	t͡ʃaɾamiska̝
charamusca	t͡ʃaɾamuska̝
charamuza	t͡ʃaɾamuθa̝
charco	t͡ʃaɾko̝
charro	t͡ʃaro̝
charruar	t͡ʃaruaɾ
charrúa	t͡sarua̝
chasco	t͡ʃasko̝
chata	t͡ʃata̝
chau	t͡ʃaw
chave	t͡ʃaβe̝
chavella	t͡ʃaβeʎa̝
chaíñas	t͡ʃaiɲa̝s
che	t͡ʃe
chea	t͡ʃea̝
cheda	t͡ʃeða̝
chedeiro	t͡ʃeðejɾo̝
chegar	t͡ʃeɣaɾ
cheirar	t͡ʃejɾaɾ
cheirento	t͡ʃejɾento̝
cheirento	t͡ʃejɾɛnto̝
cheiro	t͡ʃejɾo̝
cheiro	t͡ʃɛjɾo̝
chencha	t͡ʃent͡ʃa̝
chencha	t͡ʃɛnt͡ʃa̝
cheo	t͡ʃeo̝
chiar	t͡ʃiaɾ
chicharro	t͡ʃit͡ʃaro̝
chicote	t͡ʃikɔte̝
chifre	t͡ʃifɾe̝
chimpar	t͡ʃimpaɾ
chimpo	t͡ʃimpo̝
chincho	t͡ʃit͡ʃaro̝
chirlar	t͡ʃiɾlaɾ
chisca	t͡ʃiska̝
chiscar	t͡ʃiskaɾ
chisco	t͡ʃisko̝
chisqueiro	t͡ʃiskejɾo̝
choca	t͡ʃoka̝
choca	t͡ʃɔka̝
chocallo	t͡ʃokaʎo̝
choco	t͡ʃoko̝
choco	t͡ʃɔko̝
choer	t͡ʃoeɾ
choia	t͡ʃɔja̝
choiar	t͡ʃɔjaɾ
choio	t͡ʃɔjo̝
chopa	t͡ʃopa̝
chope	t͡ʃɔpe̝
choqueiro	t͡ʃɔkejɾo̝
chor	t͡ʃoɾ
chorar	t͡ʃoɾaɾ
chorida	t͡ʃoɾiða̝
chorima	t͡ʃoɾima̝
chorir	t͡ʃoɾiɾ
choromicas	t͡ʃoɾomika̝s
chorume	t͡ʃoɾume̝
chorón	t͡ʃoɾoŋ
chosco	t͡ʃosko̝
choupana	t͡ʃowpana̝
choupar	t͡ʃowpaɾ
choupelo	t͡ʃowpɛlo̝
chourela	t͡ʃowɾɛla̝
chourizo	t͡ʃowɾiso̝
chourizo	t͡ʃowɾiθo̝
choutar	t͡ʃowtaɾ
chouto	t͡ʃowto̝
chover	t͡ʃoβeɾ
choza	t͡ʃɔsa̝
choza	t͡ʃɔθa̝
chozo	t͡ʃɔso̝
chozo	t͡ʃɔθo̝
chuchamel	t͡ʃut͡ʃamɛl
chuchar	t͡ʃut͡ʃaɾ
chufa	t͡ʃufa̝
chufar	t͡ʃufaɾ
chumaceira	t͡ʃumasejɾa̝
chumaceira	t͡ʃumaθejɾa̝
chumazo	t͡ʃumaso̝
chumazo	t͡ʃumaθo̝
chumbada	t͡ʃumbaða̝
chumbo	t͡ʃumbo̝
chupeta	t͡ʃupeta̝
churrasco	t͡ʃurasko̝
chus	t͡ʃus
chuvasco	t͡ʃuβasko̝
chuvasqueiro	t͡ʃuβaskejɾo̝
chuvia	t͡ʃuβja̝
chá	t͡ʃa
chío	t͡ʃio̝
cicha	sit͡ʃa̝
cicha	θit͡ʃa̝
cichar	sit͡ʃaɾ
cichar	θit͡ʃaɾ
cichote	sit͡ʃɔte̝
cichote	θit͡ʃɔte̝
cichón	sit͡ʃoŋ
cichón	θit͡ʃoŋ
cidreira	siðɾejɾa̝
cidreira	θiðɾejɾa̝
cillobre	siʎɔβɾe̝
cillobre	θiʎɔβɾe̝
cima	sima̝
cima	θima̝
cimbro	θimbɾo̝
cincha	sint͡ʃa̝
cincha	θint͡ʃa̝
cinchar	sint͡ʃaɾ
cinchar	θint͡ʃaɾ
cincho	sint͡ʃo̝
cincho	θint͡ʃo̝
cinguir	siɲiɾ
cinguir	θiŋɡiɾ
cinlla	sinʎa̝
cinlla	θinʎa̝
cinta	sinta̝
cinta	θinta̝
cinto	sinto̝
cinto	θinto̝
cirigaita	siɾiɡajta̝
cirigaita	θiɾiɡajta̝
ciringallo	θiɾiŋɡaʎo̝
cirola	θiɾɔla̝
cirurxián	θiɾuɾʃjaŋ
cisco	sisko̝
cisco	θisko̝
cisma	sisma̝
cisma	ʃiɾma̝
cisma	θisma̝
cismar	sismaɾ
cismar	θismaɾ
cisterna	θistɛɾna̝
claro	klaɾo̝
coar	koaɾ
cobiza	koβisa̝̝
cobiza	koβiθa̝
cobizar	koβisaɾ
cobizar	koβiθaɾ
cobizoso	koβisoso̝
cobizoso	koβiθoso̝
cobra	kɔβɾa̝
cobre	kɔβɾe̝
coca	kɔka̝
cochada	kot͡ʃaða
cocho	kot͡ʃo̝
cocido	kosiðo̝
cocido	koθiðo̝
coco	koko̝
coco	kɔko̝
codeso	koðeso̝
codia	koðia̝
codia	koðja̝
coella	koeʎa̝
coello	koeʎo̝
cofia	kɔfja
coial	kɔjal
coidar	kojðaɾ
coieira	kɔjejɾa̝
coima	kojma
coio	kɔjo̝
coiote	kojɔte
coira	kojɾa̝
coiraza	kojɾaθa̝
coita	kojta̝
coitado	kojtaðo̝
coitelo	kojtɛlo̝
coito	kojto̝
coiñal	kɔiɲal
col	kɔl
cola	kɔla̝
colado	kolaðo̝
colleita	koʎejta̝
colleitar	koʎejtaɾ
colleito	koʎejto̝
coller	koʎeɾ
colludo	koʎuðo̝
collón	koʎoŋ
colmar	kolmaɾ
colmazo	kolmaθo̝
colmea	kolmea̝
colmear	kolmear
colmo	kolmo̝
colmo	kɔlmo̝
colo	kɔlo̝
colorado	koloɾaðo̝
comarca	komaɾka̝
combarro	kombaro̝
combater	kombateɾ
comborza	kombɔɾθa̝
comechón	komet͡ʃoŋ
comechón	komit͡ʃoŋ
comesto	komesto̝
comezo	komeso̝
comezo	komɛθo̝
comida	komiða̝
compaña	kompaɲa̝
composta	kompɔsta̝
compostela	kompostɛla
comprar	kompɾaɾ
compás	kompas
con	ko̝ŋ
con	kɔŋ
cona	kona̝
conda	kɔnda̝
condomiña	kondomiɲa̝
congostra	koŋɡostɾa̝
congro	koŋɡɾo̝̝
consello	konseʎo̝
consonte	konsonte̝
constipado	konstipaðo
conto	konto̝
contía	kontia̝
convidar	kombiðaɾ
convite	kombite̝
conzado	konθaðo̝
cora	kɔɾa̝
coral	koɾal
coraxe	koɾaʃe̝
corazón	koɾasoŋ
corazón	koɾaθoŋ
cordeiro	koɾðejɾo̝
cordeiro	kɔɾðejɾo̝
corenta	kɔrɛnta̝
coresma	korɛsma̝
corgo	kɔɾɣo̝
coriscada	koɾiskaða̝
coriscar	koɾiskaɾ
cornacha	kɔɾnat͡ʃa̝
cornacho	kɔɾnat͡ʃo̝
cornecho	kɔɾnet͡ʃo̝
corneira	kɔɾnejɾa̝
corno	kɔɾno̝
coroa	koɾoa̝
coroa	kɾoa̝
coroar	koɾoaɾ
coroza	koɾoθa̝
coroza	koɾɔθa̝
corpiño	koɾpiɲo̝
corra	kora̝
corrancha	korant͡ʃa̝
corre	kore̝
correa	korea̝
corredoira	koreðojɾa̝
correola	koreɔla̝
corripa	coripa̝
corte	koɾte̝
corte	kɔɾte̝
cortella	koɾteʎa̝
cortello	koɾteʎo̝
cortiza	koɾtisa̝
cortiza	koɾtiθa̝
cortiña	koɾtiɲa̝
coruñés	koɾuɲes
corvo	kɔɾβo̝
cosco	kosko̝
cosmogonía	kosmoɣonia
cospeito	kospejto̝
costa	kɔsta̝
costal	kostal
costeiro	kostejɾo̝
costeiro	kɔstejɾo̝
costela	kostɛla̝
costoia	kostɔja̝
costro	kostɾo̝
costrán	kostɾaŋ
costume	kostume̝
costura	kostuɾa̝
costureiro	kostuɾejɾo̝
cota	kɔta̝
cotarelo	kotaɾɛlo̝
coteiro	kotejɾo̝
coteiro	kɔtejɾo̝
cotián	kɔtjaŋ
coto	koto̝
coto	kɔto̝
cotobelo	kotoβelo̝
cotra	kotɾa̝
couce	kowse
couce	kowθe
couceiro	kowsejɾo̝
couceiro	kowθejɾo̝
cousela	kowsela̝
couselo	kowselo̝
couso	kowso̝
couto	kowto̝
couza	kowθa̝
couzoeira	kowsoejɾa̝
couzoeira	kowθoejɾa̝
couzón	kowsoŋ
couzón	kowθoŋ
cova	kɔβa̝
covo	kɔβo̝
coxa	koʃa̝
coxo	koʃo̝
cozar	kosaɾ
cozar	koθaɾ
cozo	koθo̝
cozo	kɔθo̝
coído	kɔiðo̝
cravo	kɾaβo̝
creba	kɾɛβa̝
crebar	kɾeβaɾ
cregaxe	kɾɛɣaʃe̝
crego	kɾɛɣo̝
crica	kɾika̝
crida	kɾiða̝
crista	kɾista̝
cristal	kɾistal
cristián	kɾistjaŋ
cristo	kɾisto̝
crocante	kɾɔkante̝
croia	kɾɔja̝
croio	kɾɔjo̝
croque	kɾɔke̝
cru	kɾu
cruceiro	kɾusejɾo̝
cruceiro	kɾuθejɾo̝
cruto	kɾuto̝
cruz	kɾus
cruz	kɾuθ
cruzado	kɾusaðo̝
cruzado	kɾuθaðo̝
crás	kɾas
cuada	kuaða̝
cuartillo	kwaɾtiʎo̝
cuarto	kwaɾto̝
cuba	kuβa̝
cubeiro	kuβejɾo̝
cubeta	kuβeta̝
cubo	kuβo̝
cueiro	kuejɾo
cuito	kujto̝
culler	kuʎɛɾ
cume	kume̝
cumial	kumial
cumial	kumjal
cumieira	kumjejɾa̝̝
cumio	kumio̝
cumio	kumjo̝
cumprir	kumpɾiɾ
cunca	kuŋka̝
cuncha	kunt͡ʃa̝
curar	kuɾaɾ
curmá	kuɾma
curmán	kuɾmao̯
curmán	kuɾmaŋ
curota	kuɾɔta̝
curro	kuro̝
curuto	kuɾuto̝
curuto	kɾuto̝
curuxa	kuɾuʃa̝
curuxa	kɾuʃa̝
cuspe	kuspe̝
cuspido	kuspiðo̝
cuspir	kuspiɾ
cádavo	kaða̝βo̝
cálice	kalise
cálice	kaliθe
cális	kalis
cámara	kama̝ɾa̝
cánabo	kana̝βo̝
cántara	kanta̝ɾa̝
cántaro	kanta̝ɾo̝
cárcava	kaɾka̝βa̝
cárcere	kaɾse̝ɾe̝
cárcere	kaɾθe̝ɾe̝
cárdeo	kaɾðeo̝
céltigos	sɛltiɣo̝s
céltigos	θɛltiɣo̝s
cóbado	koβa̝ðo̝
cóengo	koeŋɡo̝
cómaro	koma̝ɾo̝
cós	kɔs
cóxegas	kɔʃe̝ɣa̝s
da	d̪ɐ
dacosta	dakɔsta̝
dala	dala̝
daquela	dakela
daquela	dakɛla
dar	daɾ
das	d̪ɐs̺
debaer	deβaeɾ
debagar	deβaɣaɾ
debandar	deβandaɾ
debullar	deβuʎaɾ
debuxar	deβuʃaɾ
debuxo	deβuʃo̝
decatar	dekataɾ
decepar	deθepaɾ
decotar	dekotaɾ
decote	dekɔte̝
decotío	dekotio̝
degolar	deɣolaɾ
deitar	dejtaɾ
deluvar	deluβaɾ
demarcación	demaɾkaθjoŋ
demarcar	demaɾkaɾ
demo	dɛmo̝
demoucar	demowkaɾ
denegrido	deneɣɾiðo̝
denociña	denosiɲa̝̝
denociña	denoθiɲa̝̝
dentabrún	dentaβɾuŋ
dentabrún	dɛntaβɾuŋ
dentagruño	dentaɣɾuɲo̝
dentagrón	dentaɣɾuŋ
dentexil	denteʃil
dentón	dɛntoŋ
deostar	deɔstaɾ
deosto	deɔsto̝
departir	depaɾtiɾ
depenar	depenaɾ
dependurar	dependuɾaɾ
depenicar	depenikaɾ
depenicar	depinikaɾ
derradeiro	deraðejɾo̝̝
derrafar	derafaɾ
derrear	dereaɾ
derregar	dereɣaɾ
derrego	dereɣo̝
derrego	derɛɣo̝
derrubar	deruβaɾ
des	des
desalgar	desalɣaɾ
desarranxar	desaranʃaɾ
desbotar	desβotaɾ
descascar	deskaskaɾ
deschoer	dest͡ʃoeɾ
desde	desðe̝
desexar	deseʃaɾ
desfeita	desfejta̝
desfeito	desfejto̝
desferrado	desferaðo̝
desferrar	desferaɾ
desleixar	deslejʃaɾ
despeito	despejto̝
despender	despendeɾ
desque	deske̝
desqueixar	deskejʃaɾ
destallar	destaʎaɾ
destripar	destɾipaɾ
deva	deβa̝
devagar	deβaɣaɾ
devalar	deβalaɾ
devasa	deβasa̝
devecer	deβeθeɾ
devesa	deβesa̝
diante	diante̝
diante	djante̝
diaño	diaɲo̝
dicir	diθiɾ
dioivo	diojβo̝
disque	diske̝
disque	diħke̝
distraer	distɾaeɾ
diñeiro	diɲejɾo̝
do	d̪ʊ
doa	doa̝
doado	doaðo̝
doado	duaðo̝
doar	doaɾ
dobar	doβaɾ
dobrar	doβɾaɾ
doca	dɔka̝
doela	doɛla̝
doente	doente̝
doente	doɛnte̝
doente	do̯ente̝
doira	dojɾa̝
doira	dujɾa̝
doiro	dojɾo̝
doiro	dujɾo̝
dona	dona̝
dondio	dondjo̝
dondo	dondo̝
donfreán	doɱfɾeaŋ
donicela	doniθɛla̝
doniña	doniɲa̝
dorna	dɔɾna̝
dos	d̪ʊs̺
dourado	dowɾaðo̝
doutro	dowtɾo
dragón	dɾaɣoŋ
drola	dɾɔla̝
dromedario	dɾomeðaɾjo̝
dubidar	duβiðaɾ
dubra	duβɾa̝
dúbida	duβiða̝
eche	et͡ʃe̝
edificar	eðifikaɾ
edén	ɛðɛŋ
egoa	ɛɣwɐ
egua	ɛɣwɐ
eido	ejðo̝
eira	ejɾa̝
eirado	ejɾaðo̝
eiruga	ejɾuɣa̝
eiré	ejɾe
eis	ejs
eito	ɛjto̝
eiva	ejβa̝
eiva	ɛjβa̝
eivar	ejβaɾ
eixido	ejʃiðo̝
el	el
elefante	ɛlefante̝
elmo	ɛlmʊ
elo	ɛlo̝
embelga	embɛlɣa̝
embora	embɔɾa̝
embude	embuðe̝
empachar	empat͡ʃaɾ
empanada	empanaða̝
empanar	empanaɾ
empecer	empɛθeɾ
empedrar	empeðɾaɾ
empola	empola̝
empoleirar	empolejɾaɾ
empregar	empɾeɣaɾ
emprestar	empɾestaɾ
empurrón	empuroŋ
empuxón	empuʃoŋ
en	eŋ
encaixar	eŋkajʃaɾ
encantamento	eŋkantamɛnto̝
encanto	eŋkanto̝
encartar	eŋkaɾtaɾ
encetar	ensetaɾ
encetar	enθetaɾ
enchenta	ent͡ʃenta̝
enchenta	ent͡ʃɛnta̝
enchenta	int͡ʃɛnta̝
enchoupar	ent͡ʃowpaɾ
encoro	eŋkoro̝
endeita	endejta̝
enfeita	eɱfejta̝
enfeitar	eɱfejtaɾ
enfeitizar	eɱfejtisaɾ
enfeitizar	eɱfejtiθaɾ
enfesta	eɱfɛsta̝
enfesto	eɱfɛsto̝
enfondura	ɪŋfonduɾa̝
enfoscar	enfoskaɾ
enfoscar	enfuskaɾ
engadir	eŋɡaðiɾ
engalar	eŋɡalaɾ
enganido	eŋɡaniðo̝
engastallar	eŋɡastaʎaɾ
engastar	eŋɡastaɾ
engo	ɛŋɡo̝
engorde	eŋɡɔɾðe̝
engoumado	eŋɡowmaðo̝
engra	ɛŋɡɾa̝
engulir	eŋɡuliɾ
enludrar	enluðɾaɾ
enredar	enreðaɾ
enriquecer	enrikeθeɾ
ensanguentar	ensaŋɡentaɾ
ensanguentar	ensaŋɡɛntaɾ
entena	entena̝
entendemento	entendemento̝
entrecinsa	entɾeθinsa̝
entrecocer	entɾekoθeɾ
entrefollo	entɾefoʎo̝
entregar	entɾeɡaɾ
entrego	entɾɛɣo̝
entrillar	entɾiʎaɾ
entroido	antɾojðo̝
entroido	entɾojðo̝
entroido	entɾujðo̝
entrousar	entɾowsaɾ
entrouso	entɾowso̝
entrouxo	entɾowʃo̝
entruido	entɾujðo̝
entullar	entuʎaɾ
entullo	entuʎo̝
entón	entoŋ
envorcallar	emboɾkaʎaɾ
envorcar	embɔɾkaɾ
envorco	embɔɾko̝
envurullar	embuɾuʎaɾ
envurullar	embɾuʎaɾ
enxaugar	enʃawɣaɾ
enxebre	enʃeβɾe̝
enxeitar	enʃejtaɾ
enxerdar	enʃeɾðaɾ
enxerir	enʃeɾiɾ
enxerir	inʃeɾiɾ
enxexar	enʃeʃaɾ
epa	epa̝
epa	ɛpa̝
ergaleirón	eɾɣalejɾoŋ
ergueito	eɾɣejto̝
erguer	eɾɡeɾ
ermida	eɾmiða̝
ermo	ɛɾmo̝
ervella	eɾβeʎa̝
ervellaca	eɾβeʎaka̝
esbardallar	esβaɾðaʎaɾ
esbedro	esβeðɾo̝
esbellar	esβeʎaɾ
esboirar	esβojɾaɾ
esbourar	esβowɾaɾ
esbullar	esβuʎaɾ
esburgar	esβuɾɣaɾ
esca	eska̝
escachar	eskat͡ʃaɾ
escacho	eskat͡ʃo̝
escada	eskaða̝
escairar	eskajɾaɾ
escaldar	eskalðaɾ
escaleira	eskalejɾa̝
escalo	eskalo̝
escambrón	eskambɾoŋ
escandear	eskandeaɾ
escangallar	eskaŋɡaʎaɾ
escano	eskano̝
escarabana	eskaɾaβana̝
escarallar	eskaɾaʎaɾ
escarapote	eskaɾapɔte̝
escaravellar	eskaɾaβeʎaɾ
escaravello	eskaɾaβɛʎo̝
escariz	eskaɾiθ
escarmear	eskaɾmeaɾ
escarochar	eskaɾɔt͡ʃaɾ
escarolar	eskaɾolaɾ
escarpa	eskaɾpa̝
escarpear	eskaɾpeaɾ
escarva	eskaɾβa̝
escarvadentes	eskaɾβaðente̝s
escarvadentes	eskaɾβaðɛnte̝s
escarvar	eskaɾβaɾ
escarís	eskaɾis
escavar	eskaβaɾ
escenario	esenaɾjo
escenario	esθenaɾjo
escochar	eskot͡ʃaɾ
escoda	es̺koð̞ɐ
escofar	eskofaɾ
escoitar	eskojtaɾ
escoitar	eskujtaɾ
escoler	eskɔlɛɾ
escolla	eskoʎa̝
escolleito	eskoʎejto̝
escoller	eskoʎeɾ
escolma	eskɔlma̝
escolmar	eskolmaɾ
escora	eskɔɾa̝
escorar	eskɔɾaɾ
escornabois	eskɔɾnaβojs
escorregar	eskoreɣaɾ
escorrentar	eskorentaɾ
escotar	eskotaɾ
escotar	eskɔtaɾ
escote	eskɔte̝
escoupro	eskowpɾo̝
escoura	eskowɾa̝
escribán	eskɾiβaŋ
escudeiro	eskuðejɾo̝
escudela	eskuðɛla̝
escudriñar	eskuðɾiɲaɾ
esculca	eskulka̝
esculcar	eskulkaɾ
escuma	eskuma̝
escurecer	eskuɾeθeɾ
escusar	eskusaɾ
escuso	eskuso̝
escá	eska
escádea	eskaðe̯a̝
escáncer	eskanθe̝ɾ
escándalo	eskanda̝lo̝
esfamear	esfameaɾ
esfaragullar	esfaɾaɣuʎaɾ
esfarelar	esfaɾelaɾ
esfargallar	esfaɾɣaʎaɾ
esfarrapar	esfarapaɾ
esfolar	esfolaɾ
esfollar	esfoʎaɾ
esfollar	eɾfoʎaɾ
esfrangullar	esfɾaŋɡuʎaɾ
esfregar	esfɾeɣaɾ
esgallar	esɣaʎaɾ
esganar	esɣanaɾ
esgarrar	esɣaraɾ
esgazar	esɣaθaɾ
esgotar	ez̺ɣotaɾ
esgrevio	esɣɾeβjo̝
esguizar	esɣiθaɾ
eslava	eslaβa̝
eslavar	eslaβaɾ
eslañar	eslaɲaɾ
eslumar	eslumaɾ
esmagar	esmaɣaɾ
esmarfallar	esmaɾfaʎaɾ
esmechar	esmet͡ʃaɾ
esmendrellar	esmendɾeʎaɾ
esmeriz	esmeɾiθ
esmigallar	esmiɣaʎaɾ
esmilfallar	esmilfaʎaɾ
esmilfar	esmilfaɾ
esmirrar	esmiraɾ
esmiuzar	esmiusaɾ
esmiuzar	esmiuθaɾ
esmola	esmɔla̝
esmorecer	esmoɾeseɾ
esmorecer	esmoɾeθeɾ
esmorga	esmɔɾɣa̝
esmorgueiro	esmɔɾɣejɾo
esmorir	esmoɾiɾ
esmoriz	esmoɾiθ
esmorís	esmoɾis
esmoucar	esmowkaɾ
esnacar	esnakaɾ
esnafrar	esnafɾaɾ
esnaquizar	esnakisaɾ
esnaquizar	esnakiθaɾ
espadana	espaðana̝
espadela	espaðɛla̝
espadeleiro	espaðelejɾo̝
espadoa	espað̞wa̝
espallar	espaʎaɾ
espaller	espaʎɛɾ
esparexer	espaɾeʃeɾ
esparto	espaɾto̝
espelido	espeliðo̝
espelir	espeliɾ
espeluxar	espeluʃaɾ
espenuca	espenuka̝
espernear	espeɾneaɾ
esperrechar	esperet͡ʃaɾ
espeta	espeta̝
espetada	espeto̝
espetar	espetaɾ
espeteira	espetejɾa̝
espeteira	espitejɾa̝
espeto	espeto̝
espiar	espiaɾ
espichar	espit͡ʃaɾ
espicho	espit͡ʃo̝
espido	espiðo̝
espionaxe	espionaʃe̝
espir	espiɾ
espirrar	espiraɾ
espita	espita̝
espiña	espiɲa̝
espiñaca	espiɲaka̝
espiñazo	espiɲaso̝
espiñazo	espiɲaθo̝
espiño	espiɲo̝
espora	espɔɾa̝
esporón	espoɾoŋ
esposa	esposa̝
esposo	esposo̝
espreitar	espɾejtaɾ
espremer	espɾemeɾ
espulla	espuʎa̝
espádoa	espado̯a
esquecer	eskɛseɾ
esquecer	eskɛθeɾ
esqueira	eskejɾa̝
esqueira	eskɛjɾa̝
esqueiro	eskejɾo̝
esquina	eskina̝
esquipar	eskipaɾ
esquío	eskio̝
estaca	estaka̝
estada	estaða̝
estala	estala̝
estalar	estalaɾ
estampar	estampaɾ
estampinar	estampinaɾ
estantiga	estantiɣa̝
estarrecer	estareseɾ
estarrecer	estareθeɾ
estarricar	estarikaɾ
estatua	estatwa̝
estaño	estaɲo̝
estear	esteaɾ
esteiro	estejɾo̝
estela	estɛla̝
esteo	esteo̝
esteo	esteʊ̯
estercar	esteɾkaɾ
esterco	esteɾko̝
estercoar	esteɾkoaɾ
esterlino	esterlino̝
esterlín	esterliŋ
esterpe	estɛɾpe̝
esterqueira	esteɾkejɾa̝
estevo	esteβo̝
estiar	estiaɾ
estinga	estiŋɡa̝
estirar	estiɾaɾ
estivada	estiβaða̝
estonar	estonaɾ
estopa	estopa̝
estor	estɔʁ
estorbada	estoɾβaða̝
estormento	estoɾmento̝
estornillo	estoɾniɲo̝
estorniño	estoɾniɲo̝
estoupar	estowpaɾ
estourar	estowɾaɾ
estrada	estɾaða̝
estrado	estɾaðo̝
estragar	estɾaɣaɾ
estranxeiro	estɾaŋʃejɾo̝
estrar	estɾaɾ
estraño	estɾaɲo̝
estrema	estɾema̝
estremar	estɾemaɾ
estremo	estɾemo̝
estribeira	estɾiβejɾa̝
estricar	estɾikaɾ
estrinque	estɾiŋke̝
estrinxir	estɾinʃiɾ
estripacontos	estɾipakonto̝s
estripar	estɾipaɾ
estripeiro	estɾipejɾo̝
estro	estɾo̝
estrobo	estɾoβo̝
estronca	estɾoŋka̝
estrondo	estɾondo̝
estruga	estɾuɣa̝
estrullar	estɾuʎaɾ
estrume	estɾume̝
estrumeira	estɾumejɾa̝
estévez	esteβeθ̝
estío	estio̝
esvarar	esβaɾaɾ
esvaír	ez̺β̞ɐiɾ
eu	ew
eu	jew
eu	ɛw
eu	ɪw
faba	faβa̝
fabaca	faβaka̝
faca	faka̝
faceira	fasejɾa̝
faceira	faθejɾa̝
faceiroa	fasejɾoa̝
faceiroa	faθejɾoa̝
facenda	faθenda̝
facha	fat͡ʃa̝
fachenda	fat͡ʃenda̝
facho	fat͡ʃo̝
faia	faja̝
faiado	fajaðo̝
faiar	fajaɾ
faio	fajo̝
faixa	fajʃɐ
fala	fala̝
falabarato	falaβaɾato̝
falangueiro	falaŋɡejɾo̝
falar	falaɾ
falcatruada	falkatɾuaða̝
falcatrueiro	falkatɾuejɾo̝
falcatrúa	falkatɾua̝
falcón	falkoŋ
faldra	faldɾa̝
fallocas	faʎoka̝s
fame	fame̝
famento	famento̝
famento	famɛnto̝
fananco	fanaŋko̝
fanar	fanaɾ
fanega	fanɛɣa̝
faragulla	faɾaɣuʎa̝
farangallo	faɾaŋɡaʎo̝
farangulla	faɾaŋɡuʎa̝
farelo	faɾɛlo̝
farila	faɾila̝
fariña	faɾiɲa̝
faro	faɾo̝
farpar	faɾpaɾ
farrapo	farapo̝
fartar	faɾtaɾ
fartura	faɾtuɾa̝
fastío	fastio̝
fato	fato̝
fatón	fatoŋ
favo	faβo̝
fazula	fasula̝
fazula	faθula̝
feal	feal
feble	fɛβle̝
febra	feβɾa̝
fecha	fet͡ʃa̝
fechadura	fet͡ʃaðuɾa̝
fedellar	feðeʎaɾ
fedello	feðeʎo̝
feder	feðeɾ
feila	fejla̝
feira	fejɾa̝
feiticeiro	fejtiθejɾo̝
feitizo	fejtiθo̝
feito	fejto̝
feito	fɛjto̝
feitío	fejtio̝
feixe	fejʃ
feixe	fejʃe̝
feixón	fejʃoŋ
felga	fɛlɣa̝
felgo	fɛlɣo̝
felmil	felmil
felpa	fɛlpa̝
feltro	fɛltɾo̝
feluxe	feluʃe̝
fenda	fenda̝
fender	fendeɾ
fento	fento̝
fento	fɛnto̝
feo	feo̝
ferir	feɾiɾ
fermento	feɾmento̝
fermento	feɾmɛnto̝
fero	fɛɾo̝
ferra	fɛra̝
ferrada	fɛraða̝
ferrado	feraðo̝
ferrador	feraðoɾ
ferradura	feraðuɾa̝
ferraría	feraɾia̝
ferraxe	feraʃe̝
ferraña	feraɲa̝
ferreiro	ferejɾo̝
ferreiría	ferejɾia̝
ferro	fɛro̝
ferrollo	feroʎo̝
ferros	fɛro̝s
ferruxe	feruʃe̝
ferruxento	feruʃento̝
ferrón	feroŋ
fervellasverzas	feɾβeʎasβeɾθa̝s
fervello	ferβeʎo̝
fervenza	feɾβɛnsa̝
fervenza	feɾβɛnθa̝
ferver	feɾβeɾ
fesga	fesɣa̝
feso	feso̝
fiado	fiaðo̝
fiandón	fiandoŋ
fiar	fiaɾ
fibela	fiβɛla̝
ficar	fikaɾ
fidalgo	fiðalɣo̝
fieito	fiejto̝
fieito	fjejto̝
fiestra	fiɛstɾa̝
figueira	fiɣejɾa̝
figura	fiɣuɾa̝
fillar	fiʎaɾ
fillo	fiʎo̝
filloa	fiʎɔa̝
finamento	finamento̝
finamento	finamɛnto̝
finar	finaɾ
findar	findaɾ
fiollo	fioʎo̝
fionllo	fionʎo̝
fisga	fisɣa̝
fita	fita̝
fitar	fitaɾ
fito	fito̝
fiuncho	fjunt͡ʃo̝
fiúncho	fiunt͡ʃo̝
fiúza	fiuθa̝
florín	floɾiŋ
focha	fot͡ʃa̝
fochanca	fot͡ʃaŋka̝
fochicar	fot͡ʃikaɾ
fociño	fusiɲo̝
fociño	fuθiɲo̝
fodechinchos	foðet͡ʃint͡ʃo̝s
foder	foðeɾ
fogar	foɣaɾ
fogaxe	foɣaʃe̝
fogaza	foɣasa̝
fogaza	foɣaθa̝
fogo	foɣo
fogo	fɔɣo
foia	fɔja̝
fol	fɔl
folello	foleʎo̝
folerpa	folɛɾpa̝
folgueira	folɣejɾa̝
foliada	fɔljaða̝
folión	folioŋ
folía	fɔlia̝
folón	foloŋ
fome	fɔme̝
fondal	fondal
fondo	fondo̝
foraño	foɾaɲo̝
forca	fɔɾka̝
forcada	fɔɾkaða̝
forcado	foɾkaðo̝
forcarei	foɾkaɾej
forma	foɾma̝
formal	foɾmal
formaxe	formaʃe̝
formosende	foɾmosende̝
fornecer	fɔɾnɛseɾ
fornecer	fɔɾnɛθeɾ
forneiro	foɾnejɾo̝
fornello	forneʎo̝
fornir	foɾniɾ
forno	foɾno̝
forqueta	foɾketa̝
forra	fora
forrar	foraɾ
forraxe	foraʃe̝
fortaleza	foɾtaleθa
forte	fɔɾte̝
forxa	fɔɾʃa̝
forxás	foɾʃas
fouce	fowse̝
fouce	fowθe̝
fouciña	fowsiɲa̝
fouciña	fowθiɲa̝
fouciño	fowsiɲo̝
fouciño	fowθiɲo̝
foula	fowla̝
foupa	fowpa̝
foupa	fɔwpa̝
foxo	foʃo̝
foz	fɔs
foz	fɔθ
fozar	fosaɾ
fozar	foθaɾ
fraco	fɾako̝
fradar	fɾaðaɾ
fraga	fɾaɣɐ
fragulla	fɾaɣuʎa̝
fraixolé	fɾajʃʊlɛ
francada	fɾaŋkaða̝
francante	fɾaŋkante̝
franco	fraŋko̝
franco	fɾaŋkʊ
francuín	fɾaŋkuiŋ
francés	fɾanθes
frangulla	fɾaŋɡuʎa̝
franqueza	fɾaŋkeθa̝
franzomil	fɾanθomil
frasca	fɾaska̝
frauga	fɾawɣa̝
freba	fɾeβa̝
fregar	fɾeɣaɾ
freila	fɾejla̝
freire	fɾejɾe̝
freita	fɾejta̝
freixa	fɾejʃa̝
freixedo	fɾejʃeðo̝
freixo	fɾejʃo̝
freixó	fɾejʃɔ
frenxer	frenʃeɾ
freo	fɾeo̝
fresca	fɾeska̝
fresco	fɾesko̝
freta	fɾɛta̝
fretar	fɾetaɾ
frete	fɾɛte̝
freán	fɾeaŋ
freáns	fɾeaŋs
freás	fɾeas
friaxe	fɾiaʃe̝
frieira	fɾiejɾa̝
friosende	fɾiosende̝
fritir	fɾitiɾ
frito	fɾito̝
frixir	fɾiʃiɾ
friúce	fɾiuθe̝
froallo	fɾoaʎo̝
froia	fɾɔja̝
froila	fɾɔjla̝
froita	fɾojta̝
fronza	fɾonsa̝
fronza	fɾonʃa̝
fronza	fɾonθa̝
fros	fɾɔs
frouma	fɾowma̝
frouxo	fɾowʃo̝
froxel	fɾoʃɛl
fruxe	fɾuʃe̝
frágoa	fɾaɣwa̝
fumar	fumaɾ
fume	fume̝
fumegar	fumeɣaɾ
fumeira	fumejɾa̝
fumeiro	fumejɾo̝
fungar	fuŋkaɾ
fungar	fuŋɡaɾ
fungueiro	fuŋɡejɾo̝
funil	funil
fura	fuɾa̝
furabolos	fuɾaβolo̝s
furado	fuɾaðo̝
furancho	fuɾant͡ʃo̝̝
furar	fuɾaɾ
furaño	fuɾaɲo̝
furco	fuɾko̝
furgalla	fuɾɣaʎa̝
furna	fuɾna̝
furrular	furulaɾ
furón	fuɾoŋ
fuste	fuste̝
fuíña	fuiɲa̝
fábrica	faβɾika̝
fía	fia̝
fío	fio̝
fío	fiʊ̯
gabanza	ɡaβanθa̝
gabar	ɡaβaɾ
gabear	ɡaβeaɾ
gabeta	ɡaβeta̝
gabia	ɡaβia̝
gabia	ɡaβja̝
gabido	ɡaβiðo̝
gabita	ɡaβita̝
gacear	ɡaθeaɾ
gadaña	ɡaðaɲa̝
gadoupa	ɡaðowpa̝
gafo	ɡafo̝
gago	ɡaɣo̝
gaio	ɡajo̝
gaiola	ɡajɔla̝
gaita	ɡajta̝
gaiteiro	ɡajtejɾo̝
gaivota	ɡajβɔta̝
galafre	ɡalafɾe̝
galar	ħalaɾ
galar	ɡalaɾ
galardón	ɡalaɾðoŋ
galdaripo	ħaldaɾipʊ
galdaripo	ɡaldaɾipʊ
galdrapa	ɡaldɾapa̝
galega	ħaleħɐ
galega	ɡaleɣɐ
galega	χaleχɐ
galería	ɡaleɾia̝
galeón	ɡaleoŋ
galga	ɡalɣa̝
galgar	ɡalɣaɾ
galicia	ɡalisjɐ
galicia	ɡaliθjɐ
galiza	ɡalisɐ
galiza	ɡaliθɐ
galiña	ɡaliɲa̝
galiñeiro	ɡaliɲejɾo̝
galla	ɡaʎa̝
gallado	ɡaʎaðo̝
galladura	ɡaʎaðuɾa̝
gallar	ħaʎaɾ
gallar	ɡaʎaɾ
gallo	ħaʎʊ
gallo	ɡaʎo̝
galocha	ɡalɔt͡ʃa̝
galopar	ɡalopaɾ
galra	ħalra̝
galra	ɡalra̝
gamela	ɡamɛla̝
gana	ɡana̝
ganapán	ɡanapaŋ
gancho	ɡant͡ʃo̝
gando	ɡando̝
ganduxar	ɡanduʃaɾ
ganir	ɡaniɾ
ganso	ɡanso̝
ganzo	ɡanθo̝
garabato	ɡaɾaβato̝
garabito	ɡaɾaβuʎo̝
garabizo	ɡaɾaβiso̝
garabizo	ɡaɾaβiθo̝
garabullo	ɡaɾaβuʎo̝
garavanzo	ħraβanso̝
garavanzo	ɡaraβanθo̝
gardar	ɡaɾðaɾ
garduña	ɡaɾðuɲa̝
garela	ħaɾɛla̝
garela	ɡaɾɛla̝
garfela	ɡaɾfɛla̝
garfelo	ɡaɾfɛlo̝
garfo	ɡaɾfo̝
gargallada	ɡaɾɣaʎaða̝
gargallar	ɡaɾɣaʎaɾ
garganta	ɡaɾɣanta̝
garimar	ɡaɾimaɾ
garrocha	ɡarɔt͡ʃa̝
garrote	ɡarɔte̝
gaspacho	ɡaspat͡ʃo̝
gaspallo	ɡaspaʎo̝
gaspeto	ɡaspeto̝
gaspeto	ɡaθpeto̝
gastallo	ɡastaʎo̝
gastar	ɡastaɾ
gavela	ɡaβɛla
gañar	ɡaɲaɾ
gobelete	ɡoβelete̝
gobernallo	ɡoβeɾnaʎo̝
godallo	ɡoðaʎo̝
godallo	ɰoðaʎo̝
gola	ɡɔla
goldra	ɡoldɾa̝
golfariz	ɡolfaɾiθ
golfe	ɡɔlfe̝
golfiño	ɡolfiɲo̝
golfón	ɡolfoŋ
golmar	ɡolmaɾ
golpe	ɡɔlpe̝
gomesende	ɡomesende̝
gondollín	ɡondoʎiŋ
gondomar	ɡondomaɾ
gondufe	ɡondufe̝
gondulfe	ɡondulfe̝
gondulfes	ɡondulfe̝s
gontade	ɡontaðe̝
gontar	ɡontaɾ
gonxar	ɡonʃaɾ
gonzar	ɡonθaɾ
gorar	ɡoɾaɾ
gordén	ɡoɾðɛŋ
gorentar	ɡoɾentaɾ
gorentar	ɡoɾɛntaɾ
gorga	ɡɔɾɣa̝
gorgoiro	ɡoɾɣojɾo̝
gorgola	ɡoɾɣola̝
gorgolexar	ɡoɾɣoleʃaɾ
gorgolexo	ɡoɾɣoleʃo̝
gorgolo	ɡoɾɣolo̝
gorgomil	ɡoɾɣomil
gorgozada	ɡoɾɣosaða̝̝
gorgozada	ɡoɾɣoθaða̝
gorgozo	ɡoɾɣoso̝
gorgozo	ɡoɾɣoθo̝
gorgueira	ɡoɾɣejɾa̝
gornecer	ɡoɾneθeɾ
gornir	ɡoɾniɾ
goro	ɡɔɾo̝
gorxa	ɡɔɾʃa̝
gosende	ɡosende̝
gota	ɡota̝
goteira	ɡotejɾa̝
goto	ɡoto̝
graba	ɡɾaβa̝
gradar	ɡɾaðaɾ
grade	ɡɾaðe̝
gralla	ɡɾaʎa̝
grallar	ɡɾaʎaɾ
grama	ɡɾama̝
gramalleira	ɡɾamaʎejɾa̝
gramar	ɡɾamaɾ
grampa	ɡɾampa̝
grampín	ɡɾampiŋ
granxa	ɡɾanʃa̝
graxa	ɡɾaʃa̝
graña	ɡɾaɲa̝
grea	ɡɾea̝
grei	ɡrej
grei	ɡrɛj
grelo	ɡɾelo̝
grelo	ɡɾilo̝
grilanda	ɡrilanda̝
gris	ɡɾis
grixoa	ɡɾiʃɔa̝
grixó	ɡɾiʃɔ
groba	ɡɾɔβa̝
grolo	ɡɾolo̝
gromo	ɡɾomo̝
groria	ɡɾɔɾja̝
groto	ɡɾoto̝
groucho	ɡɾowt͡ʃo̝
gruta	ɡɾuta̝
gueifa	ɡejfa̝
guerra	ɡɛra̝
guerreiro	ɡɛrejɾo̝
guiado	ɡiaðo̝
guiar	ɡiaɾ
guilfonxe	ɡilfonʃe̝
guilfrei	ɡilfɾej
guillade	ɡiʎaðe̝
guillado	ħiʎaðo̝
guillado	ɡiʎaðo̝
guillamil	ɡiʎamil
guillar	ɡiʎaɾ
guillerme	ɡiʎɛɾme
guillo	ɡiʎo̝
guillufe	ɡiʎufe̝
guillurfe	ɡiʎuɾfe̝
guinche	ɡint͡ʃe̝
guincho	ɡint͡ʃo̝
guindar	ɡindaɾ
guindareza	ɡindaɾesɐ
guindareza	ɡindaɾeθɐ
guindastre	ɡindastɾe̝
guisa	ɡisa̝
guisande	ɡisande̝
guisar	ɡisaɾ
guiso	ɡiso̝
guispar	ɡispaɾ
guitiriz	ɡitiɾiθ
guizo	ɡiso̝
guizo	ɡiθo̝
gulapo	ɡulapo̝
guldriz	ɡuldɾiθ
guldrís	ɡuldɾis
gulfar	ɡulfaɾ
gulfariz	ɡulfaɾiθ
gulfián	ɡulfjaŋ
gume	ɡume̝
gundián	ɡundiaŋ
gunxar	ɡunʃaɾ
gurgulla	ɡuɾɣuʎa̝
gurgullar	ɡuɾɣuʎaɾ
gurgullo	ɡuɾɣuʎo̝
gurgullón	ɡuɾɣuʎoŋ
guxeva	ɡuʃeβa̝
gándara	ɡanda̝ɾa̝
habelencia	aβelɛnθja̝
habenza	aβenθa̝
habenza	aβɛnθa̝
halar	alaɾ
han	an
has	as
hedra	ɛðɾa̝
hedreira	ɛðɾejɾa̝
herculino	ɛɾkulino̝
herdade	ɛɾðaðe̝
herdanza	ɛɾðanθa̝
herdar	ɛɾðaɾ
herdeiro	erðejɾo
heree	eɾɛ
hermida	eɾmiða̝
heráldica	eɾalðika̝
ho	ɔ
home	ɔmɪ
homofobia	o̞mo̞fo̞βja̠
horta	ɔɾta̝
hortelá	ɔɾtela
hortelán	ɔɾtelaŋ
hortensa	ɔɾtens̺ɐ
hoste	ɔste̝
hucha	ut͡ʃa̝
humillar	umiʎaɾ
hábito	aβito̝
ichó	it͡ʃɔ
igrexa	iɣɾeʃa̝
illa	iʎa
illar	iʎaɾ
illarga	iʎaɾɣa̝
illargada	iʎaɾɣaða̝
illeu	iʎew
illó	iʎɔ
imitar	imitaɾ
incenso	inθenso̝
incenso	inθɛnso̝
inchar	int͡ʃaɾ
inferno	iɱfɛɾno̝
infondura	ɪŋfonduɾa̝
ingua	iŋɡo̯a̝
ingua	iŋɡwa̝
insua	inswa̝
intención	intenθjoŋ
intre	intɾe̝
intricar	intɾikaɾ
inverno	imbɛɾno̝
invernía	imbɛɾnia̝
inzar	inθaɾ
inzo	inθo̝
irixoa	iɾiʃɔa̝
irmá	iɾma
irmá	iɾmaŋ
irmán	iɾmao̯
irmán	iɾmaŋ
irto	iɾto̝
isca	iska̝
isqueiro	iskejɾo̝
kafkiano	kafkjano
labestro	laβestɾo̝
labrada	laβɾaða̝
labrego	laβɾɛɣo̝
lacazán	lakaθaŋ
laceira	laθɛjɾa̝
lacón	lakoŋ
ladaíña	laðaiɲa
ladeira	laðejɾa̝
laderno	laðɛɾno̝
ladral	laðɾal
ladrar	laðɾaɾ
ladrillo	laðɾiʎo̝
lagar	laɣaɾ
lagareta	laɣaɾetɐ
lagarteiro	laɣaɾtejɾo̝
lagarto	laɣaɾto̝
lago	laɣo
lagoa	laɣoa̝
lagosta	laɣosta̝
laiar	lajaɾ
laido	lajðo̝
lais	lajs
lama	lama̝
lamacento	lamaθɛnto̝
lamazal	lamasal
lamazal	lamaθal
lambecricas	lambekɾika̝s
lambefoula	lambefowla̝
lambetada	lambetaða̝
lambonada	lambonaða̝
lameiro	lamejɾo̝
lamela	lamɛla̝
lamia	lamja̝
lampaza	lampaθa̝
lampo	lampo̝
lamprea	lampɾea̝
landeira	landejɾa̝
landra	landɾa̝
langosta	laŋɡosta̝
langrán	laŋɡɾaŋ
lanza	lanθa̝
lanzoa	lanθoa̝
lapa	lapa̝
lapacaldos	lapakaldo̝s
lapar	lapaɾ
lapo	lapo̝
lar	laɾ
larada	laɾaða̝
laranxa	laɾanʃa̝
laranxeira	laɾanʃejɾa̝
larcha	lart͡ʃa̝
lardo	lardo
laredo	laɾeðo̝
laredo	laɾiðo̝
lareira	laɾejɾa̝
larengo	laɾeŋɡo̝
laretar	laɾetaɾ
lareto	laɾeto̝
larpar	laɾpaɾ
larpeirada	laɾpejɾaða̝
lastra	lastɾa̝
lata	lata̝
latar	lataɾ
latricar	latɾikaɾ
lavacuncas	laβakuŋka̝s
lavadoiro	laβaðojɾo̝
lavadura	laβaðuɾa̝
lavandeira	laβandejɾa̝
laverca	laβɛɾka̝
laverco	laβɛɾko
laxa	laʃa̝
laxe	laʃe̝
lazo	laθo̝
laído	laiðo̝
laña	laɲa̝
lañar	laɲaɾ
laño	laɲo̝
lear	leaɾ
lebre	lɛβɾe̝
lecer	leseɾ
lecer	leθeɾ
ledesma	leðesma̝
ledicia	leðiθja̝
ledo	leðo̝
ledo	lɛðo̝
legua	lɛɣwa̝
legua	lɛɣʊ̯a̝
legume	leɣume̝
legón	leɣoŋ
legón	liħoŋ
lei	lei
leiba	lɛjβa̝
leilán	lejlaŋ
leira	lejɾa̝
leirón	lejɾoŋ
leito	lejto̝
leituga	lejtuɣa̝
leitón	lejtoŋ
leiva	lɛjβa̝
lella	leʎa̝
lello	leʎo̝
lembranza	lembɾanθa̝
lembrar	lembɾaɾ
leme	lɛme̝
lemos	lɛmo̝s
lene	lɛne̝
lenlla	lenʎa̝
lenllo	lenʎo̝
lentella	lenteʎa̝
lento	lento̝
lentura	lentuɾa̝
lenzo	lɛnso̝
lenzo	lɛnθo̝
lenzó	lɛnθɔ
lera	lɛɾa̝
lercha	lɛɾt͡ʃa̝
lercho	lɛɾt͡ʃo̝
leria	lɛɾja̝
leriar	lɛɾiaɾ
lesende	lesende̝
lesma	lesma̝
lesma	lɛsma̝
lesta	lɛsta̝
lestrobe	lestɾɔβe̝
levada	leβaða̝
levar	leβaɾ
leña	leɲa̝
liame	liame̝
liaza	liasa̝
liaza	liaθa̝
librar	liβɾaɾ
libraría	liβɾaɾia̝
libro	liβɾo̝
lidar	liðaɾ
lide	liðe̝
lideira	liðejɾa̝
lighó	liħoŋ
lighó	liħoː
lignito	liɡnito
limacha	limat͡ʃa̝
limaco	limako̝
limiar	limjaɾ
limpar	limpaɾ
limpo	limpo̝
limáchega	limat͡ʃe̝ɣa̝
linde	linde̝
lindeiro	lindejɾo̝
linguaxe	liŋɡwaʃe̝
liorna	liɔɾna̝
liorta	liɔɾta̝
lique	like̝
liscanzo	liskanθo̝
liscar	liskaɾ
lista	lista̝
livián	liβiaŋ
lixo	liʃo̝
liña	liɲa̝
liñar	liɲaɾ
liñaxe	liɲaʃe
liñaza	liɲasa̝
liñaza	liɲaθa̝
liñeiro	liɲejɾo̝
liño	liɲo̝
liñó	liɲɔ
loar	loaɾ
lobato	loβato̝
lobicán	loβikaŋ
lobio	loβjo̝
lobishome	loβisɔme̝
lobo	loβo̝
loderno	loðɛɾno̝
lodo	loðo̝
lodoeiro	loðoejɾo̝
loentia	loɛntja̝
lofa	lofɐ
lois	lojs
loita	lojta̝
loitador	lojtaðoɾ
loitar	lojtaɾ
loitosa	lojtosa̝
lomba	lomba̝
lombo	lombo̝
londra	londɾa̝
longaínza	loŋɡainθa̝
longo	loŋɡo̝
lontra	lontɾɐ
lorbaga	loɾβaɣa̝
lorcho	lɔɾt͡ʃo̝
lorda	lɔɾða̝
loro	loɾo̝
lostregar	lostɾeɣaɾ
lostregar	lustɾiɣaɾ
lote	lɔte̝
louredo	lowɾeðo̝
loureiro	lowɾejɾo̝
lourenzá	lowɾenθa
louro	lowɾo̝
lousa	lowsa̝
lousado	lowsaðo̝
lousar	lowsaɾ
louza	lowsa̝
louza	lowθa̝
louzao	lowθao̯
louzán	lowsaŋ
louzán	lowθao̯
louzán	lowθaŋ
luar	luaɾ
lucenza	luθenθa̝
lucenza	luθɛnθa̝
ludrio	luðɾjo̝
ludro	luðɾo̝
lufiada	lufjaða̝
lugo	luɣo̝
lula	lula̝
lumbrigante	lumbɾiɣante̝
lumieira	lumiejɾa̝
lunada	lunað̞a̝
luns	luŋs
lura	luɾa̝
luscofusco	luskofusko̝
luva	luβ̞ɐ
luvas	luβ̞ɐs̺
lábil	labiːl
lúa	luɐ
maariz	maːɾiθ
maceda	maθɛða̝
maceira	masejɾa̝
maceira	maθejɾa̝
machada	mat͡ʃaða̝
machado	mat͡ʃaðo̝
macheta	mat͡ʃeta̝
machinal	mat͡ʃinal
macho	mat͡ʃo̝
machucar	mat͡ʃukaɾ
macio	maθjo̝
mada	maða̝
madeiro	maðejɾo̝
madeixa	maðejʃa̝
maga	maɣa̝
magoar	maɣoaɾ
magosto	maɣosto̝
magueiro	maɣejɾo̝
magán	maɣaŋ
mainel	majnɛl
maino	majno̝
maio	majo̝
mal	mal
malado	malaðo̝
malataría	malataɾia̝
malato	malato̝
maleta	maleta̝
mallada	maʎaða̝
malladura	maʎaðuɾa̝
mallante	maʎante̝
mallar	maʎaɾ
malle	maʎe̝
malleira	maʎejɾa̝
mallo	maʎo̝
mamada	mamaða
mancha	mant͡ʃa̝
manchea	mant͡ʃea̝
manda	manda̝
mandar	mandaɾ
mandorla	mandɔɾla̝
manicomio	manikɔmjo
maniño	maniɲo̝
manle	manle̝
manlle	manʎe̝
manta	manta̝
manteiga	mantejɣa̝
mantel	mantɛl
mantelo	mantɛlo̝
mantemento	mantemento̝
mantemento	mantemɛnto̝
mantenza	mantɛnsa̝
mantenza	mantɛnθa̝
manter	manteɾ
manto	manto̝
manxadoira	manʃaðojɾa̝
maquía	makia̝
mar	maɾ
maragoto	maɾaɣɔto̝
maravalla	maɾaβaʎa̝
maravallada	maɾaβaʎaða̝
maraña	maɾaɲa̝
marañón	maɾaɲoŋ
marca	maɾka̝
marcar	maɾkaɾ
marcaxe	maɾkaʃe̝
marchar	maɾt͡ʃaɾ
marco	maɾko̝
marea	maɾɛa̝
marear	maɾeaɾ
marfollar	amaɾfoʎaɾ
marfollo	maɾfoʎo̝̝
mariola	maɾjɔla̝
marisco	maɾisko̝
mariz	maɾiθ
mariz	maːɾiθ
mariña	maɾiɲa̝
mariñeiro	maɾiɲejɾo̝
mariño	maɾiɲʊ
marmelo	maɾmɛlo̝
marouba	maɾowβa̝
maroxo	maɾoʃo̝
marra	mara̝
marrar	maraɾ
marrán	maraŋ
marrón	maroŋ
marta	maɾta̝
martabela	maɾtaβɛla̝
martelo	maɾtɛlo̝
martes	maɾte̝s
maruxa	maɾuʃa̝
marxa	maɾʃa̝
marxe	maɾʃe̝
marzapán	marsapaŋ
marzapán	marθapaŋ
marís	maɾis
marís	maːɾis
marón	maɾo̝ŋ
masa	masa̝
mascato	maskato̝
maseira	masejɾa̝
mastro	mastɾo̝
matadoiro	mataðojɾo̝
matanza	matansa̝
matanza	matanθa̝
matar	mataɾ
mato	mato̝
maza	masa̝
maza	maθa̝
mazadura	masaðuɾa̝
mazadura	maθaðuɾa̝
mazar	masaɾ
mazar	maθaɾ
mazarelo	masaɾɛlo̝
mazarelo	maθaɾɛlo̝
mazarico	masaɾiko̝
mazarico	maθaɾiko̝
mazaroca	masaɾɔka̝
mazaroca	maθaɾɔka̝
mazo	maso̝
mazo	maθo̝
mazá	masaː
mazá	maθaː
maínzo	mainθo̝
mañufe	maɲufe̝
mañá	maɲa
meada	meaða̝
mecha	met͡ʃa̝
meda	meða̝
meda	mɛða̝
medeiro	meðejɾo̝
medio	meðio̝
medio	meðjo̝
medorra	meðora̝
medoña	meðoɲa̝
medrar	meðɾaɾ
megálito	meɣalito̝
meiga	mejɣa̝
meigallo	mejɣaʎo̝
meigo	mejɣo̝
meimendro	mejmendɾo̝
meitufe	mejtufe̝
meixela	mejʃɛla̝
meixengra	mejʃeŋɡɾa̝
melandro	melandɾo̝
meleiro	mɛlejɾo̝
melga	mɛlɣa̝
melgacho	mɛlɣat͡ʃo̝
melide	meliðe̝
mellora	meʎoɾa̝
melón	meloŋ
menciña	menθiɲa̝
menciñeiro	menθiɲejɾo̝
mendrello	mendɾeʎo̝
meniño	meniɲo̝
mensaxeiro	mensaʃejɾo̝
menta	menta̝
menta	mɛnta̝
mentir	mentiɾ
mentir	mintiɾ
mentirán	mentiɾaŋ
meogo	meɔɣo̝
mera	mɛɾa̝
mercadoría	meɾkaðoɾia̝
mercar	merkaɾ
merda	mɛɾða̝
merdento	mɛɾðento̝
merdento	mɛɾðɛnto̝
merenda	meɾenda̝
mergullador	meɾɣuʎaðoɾ
mergullar	meɾɣuʎaɾ
mergullo	meɾɣuʎo̝
merlo	mɛɾlo̝
merlán	merlaŋ
mero	mɛɾo̝
mesado	mesaðo̝
mesmo	mihmo̝
mesmo	miɾmo̝
mesmo	mɛsmo̝
mesquita	meskita
mestas	mesta̝s
mesto	mesto̝
mestura	mestuɾa̝
mesturar	mestuɾaɾ
meter	meteɾ
meu	mew
meu	mɛw
mexacán	meʃakaŋ
mexada	meʃaða̝
mexamorno	meʃa̝mɔɾno̝
mexar	meʃaɾ
mexarela	meʃaɾɛla̝
mexeira	meʃejɾa̝
mexer	meʃeɾ
mexericas	meʃeɾika̝s
mexericas	miʃiɾika̝s
mexillón	meʃiʎoŋ
mexillón	miʃiʎoŋ
mexo	meʃo̝
meán	meaŋ
mi	mi
miar	miaɾ
miañar	miaɲaɾ
micáceo	mikaθe̯o̝
miga	miɣa̝
migalla	miɣaʎa̝
migar	miɣaɾ
miguel	miɣɛl
miguez	miɣe̝θ
miguélez	miɣɛle̝θ
miguéns	miɣɛŋs
mil	mil
milagre	milaɣɾe̝
milgranda	milɣɾanda̝
milgrandeira	milɣɾandejɾa̝
milhomes	milɔme̝s
milladoiro	miʎaðojɾo̝
milmanda	milmanda̝
mincha	mint͡ʃa̝
mioca	miɔka̝
mioca	mi̯ɔka̝
miolo	miolo̝
miolo	miɔlo̝
miradoiro	miɾaðojɾo̝
mirar	miɾaɾ
mirfallo	mirfaʎʊ
mirrar	miraɾ
misto	misto̝
miña	miɲa̝
miñato	miɲato̝
miño	miɲo̝
mión	mioŋ
miúl	mioŋ
moa	mɔa̝
moca	mɔka̝
moeche	moet͡ʃe̝
moega	moɛɣa̝
moella	moeʎa̝
moenda	moenda̝
moer	moeɾ
moi	moj
moimendro	mojmendɾo̝
moimenta	mojmenta̝
moina	mɔjna̝
moio	mojo̝
mol	mɔl
molar	molaɾ
molar	mɔlaɾ
molete	molete̝
mollar	moʎaɾ
mollo	moʎo̝
mollo	mɔʎo̝
molo	molo̝
monarquía	monaɾkia
mondariz	mondaɾiθ
moneca	monɛka
monforte	monfɔɾte̝
monicreque	monikɾɛke̝
monifate	monifate̝
monllo	monʎo̝
monllo	mɔnʎo̝
montar	montaɾ
montaña	montaɲa̝
monte	montɪ
montecelo	monteselo̝
montecelo	monteθelo̝
monteira	montejɾa̝
monteiro	montejɾo̝
montellos	monteʎo̝s
monticelo	montiθɛlo̝
monto	monto̝
montouto	montowto̝
montón	montoŋ
morada	moɾaða̝
morado	moɾaðo̝
morar	moɾaɾ
morca	mɔɾka̝
morcego	moɾθɛɣo̝
mordomo	mɔɾðomo̝
mordomádego	moɾðomaðe̝ɣo̝
morea	moɾea̝
moreira	moɾejɾa̝
moreira	mɔɾejɾa̝
mormenta	moɾmenta̝
mornal	moɾnal
morno	moɾno̝
morno	mɔɾno̝
morogo	moɾoɡo̝
morriña	moriɲa
morriña	muriɲa
morriñento	moriɲɛnto̝
morro	moro̝
mortaldade	moɾtaldaðe̝
morte	mɔɾte̝
morteiro	moɾtejɾo̝
mosca	moska̝
moscar	moskaɾ
moscoso	moskoso̝
mosende	mosende̝
mosqueira	moskejɾa̝
mosqueira	mɔskejɾa̝
mosquete	moskete̝
mosteiro	mostejɾo̝
mosteiró	mostejɾɔ
mosteirón	mostejɾɔŋ
mosto	mosto̝
mota	mɔta̝
moucar	mowkaɾ
moucho	mowt͡ʃo̝
mouco	mowko̝
moufa	mowfa̝
moufada	mowfaða̝
mourillón	mowɾiʎoŋ
mouro	mowɾo̝
mourén	mowɾɛŋ
mouta	mowta̝
moxena	moʃena̝
moza	mosa̝
moza	moθa̝
mozo	moso̝
mozo	moθo̝
moído	moiðo̝
muar	muaɾ
mucio	musjo̝
mucio	muθjo̝
mudo	muðo̝
muimenta	mujmenta̝
muiñeira	muiɲejɾa
muiñeiro	muiɲejɾo̝
mulime	mulime̝
muller	muɟɛɾ
muller	muʎɛɾ
mundo	munðo̝
mundo	muðo̝
murador	muɾaðoɾ
murar	muɾar
murcego	muɾθɛɣo̝
murcho	muɾt͡ʃo̝
muricego	muɾiθɛɣo̝
muro	muɾo̝
murta	muɾta̝
murteira	muɾtejɾa̝
muruxa	muɾuʃa̝
muxe	muʃe̝
muxica	muʃika̝
muxir	muʃiɾ
muíña	muiɲa̝
muíño	muiɲo̝
mámoa	mamo̯a
méixamo	mejʃa̝mo̝
mércores	mɛɾko̝ɾe̝s
més	mɛs
míllara	miʎa̝ɾa̝
míllaras	miʎa̝ɾa̝s
nabiza	naβisa̝
nabiza	naβiθa̝
nabo	naβo̝
nadal	naðal
nado	naðo̝
nai	naj
nana	nana̝
nandufe	nandufe̝
nandulfe	nandulfe̝
nantón	nantoŋ
nao	naʊ̯
napia	napja̝
nariz	naɾis
nariz	naɾiθ
nasa	nasa̝
naseiro	nasejɾo̝
nata	nata̝
natura	natura̝
navío	naβio̝
neada	neaða̝
neada	niaða̝
neal	neal
neal	nial
nebra	nɛβɾa̝
neda	neða̝
negrón	neɣɾoŋ
nembargantes	nɛmbaɾɣa̝nte̝s
nena	nena
nendos	nendos̝
neno	nenʊ
nervio	neɾβjo̝
neto	nɛto̝
nial	nial
niallo	niaʎo̝
nifrar	nifɾaɾ
nifroso	nifɾoso̝
nifrón	nifɾoŋ
nimigalla	nimiɣaʎa̝
nin	niŋ
ningunha	niŋɡuŋa̝
ningures	niŋɡuɾe̝s
ningún	niŋɡuŋ
niñeiro	niɲejɾo̝
niño	niɲo̝
nobelo	noβelo̝
nobelo	nuβelo̝
noelo	noɛlo̝
nogueira	noɣejɾa̝
noiro	nojɾo̝
noiteboa	nojteβoa̝
noitebra	nojteβɾa̝
noitiña	nojtiɲa̝
nomeada	nomeaða̝
non	noŋ
non	nʊŋ
nora	nɔɾa̝
nordés	nɔɾðɛs
nortello	noɾteʎo̝
notar	notaɾ
noval	noβal
nove	nɔβe̝
novo	nɔβʊ
noxento	noʃento̝
noxento	noʃɛnto̝
noxo	noʃo̝
noz	nɔs
noz	nɔθ
nubeiro	nuβejɾo
nubrar	nuβɾaɾ
nugalla	nuɣaʎa̝
nugallán	nuɣaʎa̝ŋ
nádega	naðe̝ɣa̝
nébeda	nɛβe̝ða̝
néboa	nɛβo̯a̝
nío	nio
nío	niw
nó	nɔ
o	o̝
oasis	ɔasis
obradoiro	ɔβɾaðojɾo̝
obreiro	oβɾejɾo
obreiro	ɔβɾejɾo
obrigar	oβɾiɣaɾ
obús	ɔβus
ocasión	ɔkasjoŋ
odre	oðɾe̝
ofraxe	ɔfɾaʃe̝
oito	ojto̝
ola	ola̝
ola	ɔla̝
oleiro	olejɾo̝
olfate	ɔlfate̝
olga	ɔlɣa̝
oliva	oliba
oliva	ɔliba
ollar	oʎaɾ
ollar	ɔʎaɾ
ollo	oʎʊ
ollo	ɔʝʊ
ollomol	oʎomɔl
ollomol	ɔʎomɔl
olmo	olmo̝
olveira	olβejɾa̝
ombre	ɔmbɾe̝
onde	onde̝
ons	ɔŋs
onte	ɔnte̝
ontre	ontɾe̝
opa	ɔpa̝
orasme	ɔɾaz̺me̝
orballar	oɾβaʎaɾ
orballo	oɾβaʎo̝
ordenanza	oɾðenanθa̝
orela	oɾɛla̝
orella	oɾeʎa̝
orelleira	oɾeʎejɾa̝
orfo	ɔɾfo̝
orgo	ɔɾɣo̝
orgullo	oɾɣuʎo̝
orgulloso	ɔɾɣuʎoso̝
orizó	oɾisɔ
orizó	oɾiθɔ
orneallo	oɾneaʎo̝
ornear	oɾneaɾ
ornear	ɔɾneaɾ
orneón	oɾneoŋ
ortiga	oɾtiɣa̝
orxo	oɾʃo̝
orxo	ɔɾʃo̝
orzón	oɾsoŋ
orzón	oɾθoŋ
osa	osa̝
osa	ɔsa̝
osca	ɔska̝
osmo	ɔsmo̝
oso	oso̝
ostra	ostɾa̝
oural	owɾal
ouriceira	owɾisejɾa̝
ouriceira	owɾiθejɾa̝
ouriolo	owɾiɔlo̝
ourive	owɾiβe̝
ourizo	owɾiso̝
ourizo	owɾiθo̝
ouro	owɾʊ
outeiro	owtejɾo
outoeira	owtoejɾa̝
outono	owtono̝
outrora	owtɾɔɾa
outón	owtoŋ
ouvear	owβeaɾ
ozca	ɔzka̝
paa	paː
pabea	paβea̝
pabío	paβio̝
padal	paðal
paderne	paðeɾne̝
paderne	paðɛɾne̝
padia	paðia̝
padia	paðja̝
padriño	paðɾiɲo̝
padrón	paðɾoŋ
paes	paes
pagar	paɣaɾ
pago	paɣo̝
pai	paj
pailaroco	pajlaɾoko̝
pailaroco	pajlaɾɔko̝
pailán	pajlaŋ
pailán	pɛjlao̯
paiolo	pajɔlo
pairar	pajɾaɾ
pais	pajs
paixón	pajʃoŋ
palabra	palaβ̞ɾɐ
palla	paʎa̝
pallabarro	paʎaβaro̝
pallaza	paʎaθa̝
palleira	paʎejɾa̝
palleiro	paʎejɾo̝
palleta	paʎeta̝
pallota	paʎɔta̝
pallote	paʎɔte̝
palloza	paʎɔθa̝
palma	palma̝
palmeira	palmeiɾa
palmela	palmɛla̝
palmo	palmo̝
pampillo	pampiʎo̝
pampo	pampo̝
pan	paŋ
panca	paŋka̝
pancada	paŋkaða̝
pandorgada	pandoɾɣaða̝
panduxo	panduʃo̝
panela	panɛla̝
pano	pano
pantasma	pantasma̝
panxoliña	panʃɔliɲa
papa	papa̝
papafigo	papafiɣo̝
papar	papaɾ
papas	papa̝s
papo	papo̝
papoia	papɔja̝
papullo	papuʎo̝
papuxa	papuʃa̝
papuxas	papuʃa̝s
parabéns	paɾaβɛŋs
parada	paɾaða̝
paraugas	paɾawɣɐs̺
paraíso	paɾaiso
paraña	paɾaɲa̝
pardal	paɾðal
pardiña	paɾðiɲa̝
pardiñeiro	paɾðiɲejɾo̝
pardo	paɾðo̝
parede	paɾeðe̝
parladoiro	paɾlaðojɾo̝
parlar	parlar
parola	paɾɔla̝
parolar	parɔlar
parro	paro̝
parrulo	parulo̝
parruma	paruma̝
parrumeira	parumejɾa̝
parte	paɾte̝
partilla	paɾtiʎa̝
partir	paɾtiɾ
parvada	paɾβaða̝
parvo	paɾβo̝
pasada	pasaða̝
pasadoiro	pasaðojɾo̝
pasal	pasal
pasal	pasaʊ̯
pasamento	pasamento̝
pasamento	pasamɛnto̝
pascua	paskwa̝
paspallás	paspaʎas
pasteco	pastɛko̝
pastequeiro	pastɛkejɾo̝
pataca	pataka̝
patarroxa	pataroʃa̝
patela	patɛla̝
patoa	patoa̝
patín	patiŋ
pau	paw
pau	paʊ̯
paz	pas
paz	paθ
pazo	paso̝
pazo	paθo̝
pazó	paθɔ
paínzo	painθo̝
país	pais
paíño	paiɲo̝
pear	peaɾ
peaxe	peaʃe̝
pebida	peβiða̝
pebidal	peβiðal
pechadura	pet͡ʃaðuɾa̝
pecheira	pet͡ʃejɾa̝
pecho	pet͡ʃo̝
pedir	pɨðiɾ
pedrazo	peðɾaso̝
pedrazo	peðɾaθo̝
pedregullo	peðɾeɣuʎo̝
pedreira	peðɾejɾa̝
pedreiro	peðɾejɾo̝
pega	peɣa̝
pegar	peɣaɾ
peideiro	pejðejɾo̝
peido	pejðo̝
peirao	pejɾaʊ
peito	pejto̝
peitoril	pejtoɾil
peixe	pejʃ
peixe	pejʃe̝
pela	pɛla̝
pelame	pelame̝
pelamio	pelamio̝
pelamio	pelamjo̝
peleteiro	peletejɾo̝
pelexa	peleʃa̝
pelexar	peleʃaɾ
pelica	pelika̝
pelica	pɪlika̝
peliqueiro	pelikejro̝
peliqueiro	pɪlikejro̝̝
pelota	pelɔta̝
pelote	pelɔte̝
peluxe	peluʃe̝
pemento	pemento̝
pemento	pemɛnto̝
pena	pena̝
penal	penal
penca	peŋka̝
penca	pɛŋka̝
pendello	pendeʎo̝
pendurar	penduɾaɾ
penedo	peneðo̝
peneira	penejɾa̝
peneirar	penejɾaɾ
peneireiro	penejɾejɾo̝
peneque	penɛke̝
penico	peniko̝
peniz	penis
peniz	peniθ
penuxe	penuʃe̝
pequeneiro	pekenejɾo̝
pequeno	pekeno̝
percebe	peɾseβe̝
percebe	peɾθeβe̝
percebeiro	peɾseβejro̝
percebeiro	peɾθeβejro̝
perda	pɛɾða̝
perdiz	peɾðis
perdiz	peɾðiθ
peregrino	peɾeɣɾino̝
pereira	peɾejɾa̝
perexil	peɾeʃil
perexil	pɾeʃil
perfia	pɛɾfia̝
perfia	pɛɾfja̝
pergameo	peɾɣameo̯
pergamiño	peɾɣamiɲo̝
perixel	peɾiʃɛl
perna	pɛɾna̝
pernil	pɛɾnil
perpiaño	peɾpiaɲo̝
perrencha	peɾent͡ʃa̝
pertencer	peɾtenθeɾ
pescar	peskaɾ
pesco	pesko̝
pescoso	peskoso̝
pescozada	peskosada̝
pescozada	peskoθaða̝
pescozo	peskoso̝
pescozo	peskoθo̝
pescuda	peskuða̝
pescudar	peskuðaɾ
pesqueira	peskejɾa̝
pestana	pestana̝
petar	petaɾ
peteiro	petejɾo̝
peto	peto̝
petouco	petowko̝
petón	petoŋ
pexa	peʃa̝
peza	pɛsa̝
peza	pɛθa̝
pezoia	pesoja̝
pezoia	peθoja̝
pezoña	pesoɲa̝
pezoña	peθoɲa̝
pezuño	pɛsuɲo̝
pezuño	pɛθuɲo̝
peón	peoŋ
piago	piaɣo̝
piar	piaɾ
piarro	pjaro̝
picapau	pikapaw
picapau	pikapaʊ̯
picar	pikaɾ
piche	pit͡ʃe̝
piche	pit͡ʃi
pichel	pit͡ʃɛl
picheleiro	pit͡ʃɛlejɾo̝
pico	piko̝
picota	pikota̝
picota	pikɔta̝
picote	pikɔte̝
pillabán	piʎaβaŋ
pinaza	pinaθa̝
pinchacarneiro	pint͡ʃakaɾnejɾo̝
pinchagato	pint͡ʃaɣato̝
pinchar	pint͡ʃaɾ
pincho	pint͡ʃo̝
pinga	piŋɡa̝
pingar	piŋɡaɾ
pingo	piŋɡo̝
pingueira	piŋɡejɾa̝
pino	pino̝
pintar	pintaɾ
pinto	pinto̝
pintor	pintoɾ
pioga	piɔɣa̝
piolla	pioʎa̝
piollo	pioʎo̝
pior	pɨɔɾ
piorno	pioɾno̝
pipa	pipa̝
piquelo	pikɛlo̝
piringalla	piriŋɡaʎa̝
pirixel	piɾiʃɛl
pirolazo	piɾolaθo
pisar	pisaɾ
pisca	piska̝
piscar	piskaɾ
pispar	pispaɾ
pisón	pisoŋ
pita	pita̝
pitanza	pitanθa̝
pitar	pitaɾ
piteira	pitejɾa̝
piteiro	pitejɾo̝
pitela	pitɛla̝
pitelo	pitɛlo̝
pitiño	pitiɲo̝
pito	pito̝
pitoño	pitoɲo̝
pixa	piʃa̝
piñeiro	piɲejɾo̝
planeta	planeta
planta	planta̝
poalla	poaʎa̝
poallo	poaʎo̝
pobo	pɔβo̝
pobre	pɔβɾe̝
poceiro	posejɾo̝
poceiro	poθejɾo̝
podar	mendɾeʎo̝
podengo	poðeŋɡo̝
podre	poðɾe̝
podrecer	poðɾeseɾ
podrecer	poðɾeθeɾ
podrén	poðɾɛŋ
podón	poðoŋ
poial	pojal
poio	pojo̝
polaina	polajna̝
polbo	pɔlβo̝
poldra	poldɾa̝
poldro	poldɾo̝
poleiro	polejɾo̝
poleiro	pulejɾo̝
policromía	pɔlikɾomia̝
polpa	polpa̝
pomar	pomaɾ
pomba	pɔmba̝
pombal	pɔmbal
pombo	pɔmbo̝
pontella	ponteʎa̝
pontenova	pontenɔβa̝
pontenova	pɔntenɔβa̝
pontevedra	ponteβɛðɾa̝
pontón	pontoŋ
pontón	puntoŋ
porcallada	pɔɾkaʎaða
porcalleiro	pɔɾkaʎejɾo̝
porcallán	poɾkaʎaŋ
porcallán	pɔɾkaʎaŋ
porco	pɔɾko̝
porfía	poɾfia̝
porqueira	pɔɾkeiɾa̝
porro	pɔro
porta	pɔɾta̝
portal	poɾtal
portela	poɾtɛla̝
portela	pɔɾtɛla̝
portelo	poɾtelo̝
portelo	poɾtɛlo̝
portugués	poɾtuɣes
portádego	pɔɾtaðe̝ɣo̝
porén	poɾeŋ
pose	pɔse̝
poseiro	posejɾo̝
posse	pɔse̝
pota	pɔta̝
pote	pɔte̝
pouco	powko̝
poula	powla̝
poupar	powpaɾ
pousa	powsa̝
pousada	powsaða̝
pousadoiro	powsaðojɾo̝
pousafoles	powsafɔles
pousar	powsaɾ
pouta	powta̝
poutada	powtaða̝
poxa	poʃa̝
poxar	poʃaɾ
poza	posa̝
poza	poθa̝
pozo	poso̝
pozo	poθo̝
pra	pɾa
pradairo	pɾaðajɾo̝
prado	pɾaðo̝
pravoa	pɾaβo̯a̝
praza	pɾasa̝
praza	pɾaθa̝
prea	pɾea̝
preada	pɾeaða̝
prebe	pɾɛβe̝
predela	pɾeðɛla
prego	pɾɛɣo̝
pregoeiro	pɾeɣoejɾo̝
preguiceiro	pɾeɣisejɾo̝
preguiceiro	pɾeɣiθejɾo̝
preguiza	pɾeɣisa̝
preguiza	pɾeɣiθa̝
preguizoso	pɾeɣisoso̝
preguizoso	pɾeɣiθoso̝
pregón	pɾeɣoŋ
prema	pɾema̝
premer	pɾemeɾ
presa	pɾesa̝
prestar	pɾestaɾ
presuño	pɾɛsuɲo̝
prezo	pɾeθo̝
primaveras	pɾimaβeɾas
prixel	pɾiʃɛl
probar	pɾoβaɾ
proer	pɾoeɾ
prol	pɾɔl
proveito	pɾoβejto̝
provizo	pɾoβiso̝
provizo	pɾoβiθo̝
proído	pɾoiðo̝
présa	pɾɛsa̝
próximo	pɾɔksimʊ
puga	puɣa̝
pulpillo	pulpiʎo̝
puñal	puɲal
puñar	puɲaɾ
puño	puɲo̝
pá	paː
pádoa	pað̞wa̝
páez	paeθ
pálpebra	palpeβɾa̝
páramo	paɾa̝mo̝
pé	pɛ
péga	pɛɣa̝
pértega	peɾte̝ɣa̝
pértega	pɛɾte̝ɣa̝
pía	pia̝
pígaro	piɣa̝ɾo̝
píllara	piʎa̝ɾa̝
píntega	pinte̝ɣa̝
píntega	pinti̝ɣa̝
póla	pɔla̝
pólvora	pɔlβo̝ɾa̝
quecer	kɛseɾ
quecer	kɛθeɾ
queimada	kejmaða̝
queimadura	kejmaðuɾɐ
queimar	kejmaɾ
queiro	kejɾo̝
queiroa	kejɾɔa̝
queixada	kejʃaða̝
queixar	kejʃaɾ
queixo	kejʃʊ
queixume	kejʃume̝
quella	kɛʎa̝
quenda	kɛnda̝
quenlla	kɛnʎa̝
quenlle	kɛnʎe̝
quer	kɛɾ
querela	keɾela̝
querer	keɾeɾ
quilla	kiʎa̝
quinteiro	kintejɾo̝
quitamerendas	kitameɾenda̝s
quiñón	kiɲoŋ
ra	raː
rabaño	raβaɲo
rabela	raβɛla̝
rabilongo	raβiloŋɡo̝
rabiza	raβisa̝
rabiza	raβiθa̝
rabo	raβo̝
rabuxa	raβuʃa̝
rabuxento	raβuʃɛnto̝
rabuñar	raβuɲaɾ
racha	rat͡ʃa̝
rachar	rat͡ʃaɾ
racho	rat͡ʃo̝
raer	raeɾ
rafa	rafa̝
rafar	rafaɾ
raiar	rajaɾ
raiola	rajɔla̝
rairo	rajɾo̝
ralbar	ralβaɾ
rancio	ransjo̝
rancio	ranθjo̝
rancor	raŋkoɾ
randa	randa̝
randar	randaɾ
randear	randeaɾ
randeeira	randeejɾa̝
randeeira	randeːjɾa̝
randolfe	randolfe̝
randufe	randufe̝
randulfe	randulfe̝
randón	randoŋ
rangua	raŋɡwa̝
ranquear	raŋkeaɾ
rapante	rapante̝
rapar	rapaɾ
rapariga	rapaɾiɣa̝
rapaz	rapas
rapaz	rapaθ
rapaza	rapasa
rapaza	rapaθa
raposo	raposo̝
raro	raɾo̝
raso	raso̝
rastro	rastɾo̝
rato	rato̝
rauto	rawto̝
ravo	raβo̝
raxeira	raʃejɾa̝
raxo	raʃo̝
raíz	rais
raíz	raiθ
raíña	raiɲa̝
raña	raɲa̝
rañar	raɲaɾ
raño	raɲo̝
rebandar	reβandaɾ
rebentar	rebentaɾ
rebento	rebento
rebinxe	reβinʃe̝
rebisaco	rɛβiz̺ako̝
reboira	reβojɾa̝
rebolo	reβolo̝
rebor	reβɔɾ
rebordela	reβoɾðɛla̝
rebordelo	reβoɾðɛlo̝
rebordelos	reβoɾðɛlo̝s
rebordán	reβoɾðaŋ
reboreda	reβoɾeða̝
reboredo	reβoɾeðo̝
reborido	reβoɾiðo̝
rebuldar	reβuldaɾ
rebulir	rebuliɾ
rebumbio	reβumbjo̝
reburdiar	reβuɾðeaɾ
reburdiar	reβuɾðjaɾ
recachar	rekat͡ʃaɾ
recanto	rekanto̝
recear	reseaɾ
recear	reθeaɾ
rechumir	ret͡ʃumiɾ
rechán	ret͡ʃaŋ
recostar	rekostaɾ
recuar	rekuaɾ
recudir	rekuðiɾ
recuncar	rekuŋkaɾ
recuncho	rekunt͡ʃo̝
rede	reðe̝
redondo	reðondo̝
refollo	refoʎo̝
refregar	refɾeɣaɾ
refugallo	refuɣaʎo̝
refugar	refuɣaɾ
refugo	refuɣo̝
refungar	refuŋkaɾ
refungar	refuŋɡaɾ
refusar	refusaɾ
regatear	reɣateaɾ
regateiro	reɣateiɾo̝
regato	reɣato̝
regatón	reɣatoŋ
regazo	reɣaso̝
regazo	reɣaθo̝
rego	reɣo̝
rego	rɛɣo̝
regoldo	reɣɔldo̝
regueifa	reɣejfa̝
regueira	reɣejɾa̝
regueiro	reɣejɾo̝
reguengo	reħɛŋħo̝
reguengo	reɣɛŋɡo̝
reinar	rejnaɾ
reino	rejno̝
reira	rejɾa̝̝
relanzo	relanso̝
relanzo	relanθo̝
relinga	reliŋka̝
relinga	reliŋɡa̝
rella	reʎa̝
rello	reʎo̝
reloxo	relɔ
reloxo	relɔʃo̝
reluscar	reluskaɾ
relusco	relusko̝
relustrar	relistɾaɾ
relustrar	relustɾaɾ
relustro	relistɾo̝
relustro	relustɾo̝
relón	reloŋ
remanecer	remaneseɾ
remanecer	remaneθeɾ
rematar	remataɾ
remela	remɛla̝
remelar	remelaɾ
remexer	remeʃeɾ
remol	remɔl
remollar	remoʎaɾ
remorso	remɔɾso̝
remoucar	remowkaɾ
remuíño	remuiɲo̝
ren	reŋ
renegar	reneɣaɾ
rengo	rɛŋɡo̝
rengue	rɛŋɡe̝
rens	reŋs
renxer	renʃeɾ
reo	reo̝
repelo	repɛlʊ
repenicar	repenikaɾ
repenicar	repinikaɾ
repolo	repolo̝
repugnante	repunante̝
repugnante	repuɡnante̝
requecer	rekɛθeɾ
requeixo	rekejʃo̝
requesende	rekesende̝
requiá	rekia
requián	rekiaŋ
requiás	rekias
res	res
reseso	resɛso̝
reste	rɛste̝
restinga	restiŋɡa̝
restra	rɛstɾa̝
restrelo	restɾelo̝
resío	resio̝
retar	retaɾ
retorto	retɔɾto̝
retrincar	retriŋkaɾ
retrinco	retɾiŋko̝
retriza	retɾisa̝
retriza	retɾiθa̝
retrucar	retɾukaɾ
reuma	rɛwma̝
revellido	reβeʎiðo̝
rever	reβeɾ
revirado	reβiɾaðo̝
revirar	reβiɾaɾ
reviravolta	reβiɾaβɔlta̝
revolta	reβɔlta̝
rexeitamento	reʃejtamento̝
rexeitamento	reʃejtamɛnto̝
rexeitar	reʃejtaɾ
rexelo	reʃɛlo̝
rexión	reʃjoŋ
rexurdir	reʃuɾðiɾ
rial	rial
riazó	riaθɔ
riazón	riaθoŋ
riba	riβa̝
ribada	riβaða̝
ribadavia	riβaðaβja̝
ribeira	riβejɾa̝
ricaz	rikas
ricaz	rikaθ
richar	rit͡ʃaɾ
rico	riko̝
rifa	rifa̝
rifar	rifaɾ
rifón	rifoŋ
ril	ril
rillar	riʎaɾ
rima	rima̝
rinchar	rint͡ʃaɾ
riola	riɔla̝
ripa	ripa̝
ripar	ripaɾ
ripiar	ripa̝
ripo	ripo̝
riqueza	rikesa̝
riqueza	rikeθa̝
riquián	rikiaŋ
risada	risaða̝
riscar	riskaɾ
risco	risko̝
rixo	riʃo̝
riádego	riaðe̝ɣo̝
robaliza	roβalisa̝
robaliza	roβaliθa̝
robalo	roβalo̝
robra	rɔβɾa̝
roca	rɔka̝
rocha	rɔt͡ʃa̝
rocho	rot͡ʃo̝
rocho	rɔt͡ʃo̝
rocín	rosiŋ
rocín	roθiŋ
roda	rɔða̝
rodaballo	roðaβaʎo̝
rodal	roðal
rodeira	roðejɾa̝
rodeira	rɔðejɾa̝
rodeiro	roðejɾo̝
rodela	roðɛla̝
rodo	roðo̝
rodo	rɔðo̝
rodriga	roðɾiɣa̝
rodrigar	roðɾiɣaɾ
rodrigo	rodɾiɣo̝
rodríguez	roðɾiɣe̝s
rodríguez	roðɾiɣe̝θ
roer	roeɾ
roi	roj
roldán	roldaŋ
rolla	roʎa̝
rollo	roʎo̝
rolo	rolo̝
rolo	rɔlo̝
romaría	romaɾia̝
roncón	roŋkoŋ
ronsel	ronsɛl
rosamonde	rosamonde̝
rosca	roska̝
roseira	rosejɾa̝
rosmar	rosmaɾ
rosmar	rɔsmaɾ
rosomil	rosomil
rostro	rostɾo̝
roubar	rowβaɾ
roucear	rowθɛaɾ
rouceo	rowθɛʊ
rouco	rowko̝
rousar	rowsaɾ
roxar	roʃaɾ
roxo	roʃo̝
roxón	roʃoŋ
roza	rosa̝
roza	roθa̝
rozar	rosaɾ
rozar	roθaɾ
rozavales	roθaβale̝s
roñar	roɲaɾ
ruada	ruaða̝
rubio	ruβjo̝
rubir	ruβiɾ
rubién	ruβjɛŋ
rueiro	ruejɾo̝
rusia	rusja
rustrido	rustɾiðo̝
rustrir	rustɾiɾ
ruxido	ruʃiðo̝
ruxidoiro	ruʃiðojɾo̝
ruído	ruiðo̝
ruín	ruiŋ
ruína	ruina̝
sa	sa
sa	saː
saa	saː
saavedra	saːβɛðɾa̝
saba	saβa̝
sabariz	saβaɾiθ
sabarís	saβaɾis
sabela	saβɛla̝
sabelo	saβɛlo̝
sabenla	saβɛŋla̝̝
sabenlo	saβɛnlo̝
saber	saβeɾ
sable	saβle̝̝
saboroso	saβoɾoso̝
sabugueiro	saβuɣejɾo̝
sabuxo	saβuʃo̝
sacar	sakaɾ
sacaúntos	sakaunto̝s
sachar	sat͡ʃo̝
sacho	sat͡ʃo̝
saco	sako̝
saia	saja̝
saibro	sajβɾo̝
salabardo	salaβaɾðo̝
salaiar	salajaɾ
salame	salame
saleiro	salejɾo̝
salgadeira	salɣaðejɾa̝
salgar	salɣaɾ
salgueiro	salɣejɾo̝
salmón	salmoŋ
salnés	salnes
saloucar	salowkaɾ
salto	saltʊ
salvaterra	salβatɛra̝
samesuga	samesuɣa̝
samos	samo̝s
sandar	sandaɾ
sandiás	sandias
sandiás	sandjas
sangano	saŋɡano̝
sangaño	saŋɡaɲo̝
sangiao	sanʃiao̯
sangomiño	saŋɡomiɲo̝
sangue	saŋɡe̝
sanguiño	saŋkiɲo̝
sanguiño	saŋɡiɲo̝
sanjiao	sanʃiao̯
santafollo	santafoʎo̝
sanxenxo	sanʃɛnʃo̝
sapoconcho	sapokont͡ʃo̝
sar	saɾ
saramago	saɾamaɣo̝
sarillo	saɾiʎo̝
sarna	saɾna̝
sarria	sarja̝
sarrio	sarjo̝
sarro	saro̝
sartaña	saɾtaɲa
sartego	saɾtɛɣo̝
sarxar	saɾʃaɾ
saudade	sawðaðɪ
saudades	sawðaðes
sazón	sasoŋ
sazón	saθoŋ
saída	saiða̝
saído	saiðo̝
saín	saiŋ
saña	saɲa̝
seara	seaɾa̝
seareiro	seaɾejɾo̝
seareiro	sjaɾejɾo̝
sebe	seβe̝
sebo	seβo̝
seca	seka̝
secar	sekar
seda	seða
sedela	seðɛla̝
sedeño	seðeɲo̝
sedofeito	seðofejto̝
seeta	sɛɛta̝
segar	seɣaɾ
segorella	seɣoɾeʎa̝
segur	seɣuɾ
seimeira	sejmejɾa̝
seita	sejta̝
seitura	sejtuɾa̝
seixebra	sejʃeβɾa̝
sella	seʎa̝
semellar	semeʎaɾ
sementar	sementaɾ
semente	semɛnte̝
sementeira	sementejɾa
sen	sɛŋ
sendeiro	sendejɾo̝
senlleiro	senʎejɾo̝
senllo	senʎo̝
senllos	senʎo̝s
senra	sɛnra̝
senso	sɛnsʊ
sentir	sentiɾ
seoane	se̯ɔane̝
seoane	sɔane̝
sequeiro	sekejɾo̝
ser	seɾ
serantes	seɾante̝s
serea	seɾea̝
serodio	seɾoðio̝
serodio	seɾoðjo̝
serpe	sɛɾpe̝
serra	sɛra̝
serrapio	serapjo̝
serrón	seroŋ
servente	seɾβente̝
serán	seɾaŋ
seta	sɛta̝
señeiro	seɲejɾo̝
señor	seɲoɾ
sidra	siðɾa̝
silla	siʎa̝
silva	silβa̝
sinal	sinal
singrar	siŋɡɾaɾ
sino	sino̝
sinxelo	sinʃɛlo̝
sisa	sisa̝
siso	siso̝
soar	soaɾ
soarego	soaɾɛɣo̝
soarego	so̯aɾɛɣo̝
soaxe	soaʃe̝
sobexo	soβeʃo̝
sobradar	soβɾaðaɾ
sobrado	soβɾaðo̝
sobreira	soβɾejɾa̝
socalcar	sokalkaɾ
socalco	sokalko̝
sociable	sɔθjable
soer	soeɾ
soio	sojo̝
sola	sɔla̝
solaina	solajna̝
solar	solaɾ
solda	solda̝
solda	sɔlda̝
soldadura	soldaðuɾa̝
soldar	solðaɾ
solla	soʎa̝
sollar	soʎaɾ
solleiro	soʎejɾo̝
sollo	soʎo̝
sollío	sɔʎio̝
solpor	solpoɾ
soltar	soltaɾ
sombra	sombɾa̝
sombreiro	sombɾejɾo̝
somorgullar	somoɾɣuʎaɾ
somorgullo	somoɾɣuʎo̝
somoza	somoθa̝
soneca	sonɛka̝
sopa	sopa̝
sorbeira	soɾβejɾa̝
soro	soɾo̝̝
sorrir	soriɾ
sorte	sɔɾte̝
sortella	soɾteʎa̝
soterrar	soteraɾ
soto	soto̝
souto	sowto̝
soá	soa
soán	soaŋ
subela	suβɛla̝
sucada	sukaða̝
sucar	sukaɾ
sucho	sut͡ʃo̝
sucho	θut͡ʃo̝
suco	suko̝
suor	suoɾ
suorento	suoɾento̝
suorento	suoɾɛnto̝
suspirar	suspiɾaɾ
sámago	sama̝ɣo̝
sé	sɛ
sésamo	sesa̝mo̝
sísamo	sisa̝mo̝
tabardo	taβaɾðo̝
taberna	taβɛɾna̝
taberneiro	taβeɾnejɾo̝
taberneiro	taβɛɾnejɾo̝
taboada	taβo̯aða̝
taboado	taβo̯aðo̝
tabuela	taβuɛla̝
tabán	taβaŋ
tacha	tat͡ʃa̝
tacho	tat͡ʃo
tacoar	takoaɾ
tacón	takoŋ
tafona	tafona̝
taleiga	talejɣa̝
taleigán	talejɣaŋ
talla	taʎa̝
talladeira	taʎaðejɾa̝
tallador	taʎaðoɾ
tallar	taʎaɾ
tallo	taʎo̝
tambo	tambo̝
tamboira	tambojɾa̝
tambor	tamboɾ
tambre	tambɾe̝
tamouca	tamowka̝
tampa	tampa̝
tamuxe	tamuʃe̝
tamén	tamɛŋ
tanguer	taŋɡeɾ
tanza	tansa
tanza	tanθa
tapada	tapaða̝
tapar	tapaɾ
tarabela	taɾaβɛla̝
tardiña	taɾðiɲa̝
targa	taɾɣa̝
taro	taɾo̝
tasca	taska̝
tascar	taskaɾ
tasco	tasko̝
tascón	taskoŋ
tato	tato̝
tauromaquia	tauɾomakja
taxa	taʃa̝
tea	tea̝
tear	teaɾ
teaz	teaθ
tebras	tɛβɾa̝s
tecelán	teselaŋ
tecelán	teθelaŋ
tecer	teseɾ
tecer	teθeɾ
tega	tɛɣa̝
teiga	tɛjɣa̝
teima	tejma̝
teimado	tejmaðo̝
teimudo	tejmuðo̝
teiroa	tejɾɔa̝
teitar	tejtaɾ
teito	tejto̝
teixelo	tejʃelo̝
teixo	tejʃo̝
teixugo	tejʃuɣo̝
teixón	tejʃoŋ
telefonía	telefonia
tella	teʎa̝
tellado	teʎaðo̝
tellar	teʎaɾ
tello	teʎo̝
temer	temeɾ
tempas	t̪ɛmpɐs̻
tempestade	tempɛsta
tempestade	tempɛstaðe̝
templo	templo
temporal	tɛmpoɾal
temón	temoŋ
tenca	teŋka̝
tenda	tenda̝
tenda	tɛnda̝
tendal	tendal
tento	tento̝
tento	tɛnto̝
tenza	tensa̝̝
tenza	tenθa̝̝
teor	teoɾ
termar	teɾmaɾ
terra	tɛra̝
terreo	tɛreo̝
terroeira	teroejɾa
terrón	teroŋ
terzo	teɾso̝
terzo	teɾθo̝
teso	teso̝
tesoira	tesojɾa̝
tesoiras	tesojɾa̝
tesouro	tesowɾo̝
testa	testa̝
testa	tɛsta̝
testar	testaɾ
testar	tɛstaɾ
testeira	tɛstejɾa̝
testeiro	tɛstejɾo̝
testo	testo̝
testo	tɛsto̝
teta	teta̝
ti	ti
tieira	tiejɾa̝
tilla	tiʎa̝
tillado	tiʎaðo̝
tillar	tiʎaɾ
tina	tina̝
tinalla	tinaʎa̝
tinguir	tiŋɡiɾ
tinta	tinta̝
tinto	tinto̝
tira	tiɾa̝
tiraboleiro	tiɾaβolejɾo̝
tirador	tiɾaðoɾ
tirar	tiɾaɾ
tirizó	tiɾiθɔ
tiro	tiɾo̝
titor	titoɾ
tixela	tiʃɛlɐ
tixoa	tiʃɔa̝
tixola	tiʃɔla̝
toa	toa̝
toalla	toaʎa̝
toar	toaɾ
tobo	toβo̝
toco	toko̝
toco	tɔko̝
toelo	toelo̝
toiberde	tujβeɾðe̝
toimil	tojmil
toimil	tɔjmil
toiriz	tojɾiθ
tol	tɔl
tola	tɔla
toleiro	tolejɾo̝
toleiro	tɔlejɾo̝
tolete	tolete̝
tolleito	toʎejto̝
tollemerendas	toʎemeɾenda̝s
toller	toʎeɾ
tolo	tolo̝
tolosa	tolosa
tolosano	tolosano
tomada	tomaða̝
tomar	tomaɾ
tombo	tombo̝
tomentelo	tomentɛlo̝
tomiño	tomiɲo̝
tomé	tomɛ
tona	tona̝
tonel	tonɛl
toneleiro	tonelejɾo̝
topar	topaɾ
topete	topɛte̝
torco	tɔɾko̝
tordo	toɾðo̝
torga	tɔɾɣa̝
torgallo	toɾɣaʎo̝
torgo	tɔɾɣo̝
tormenta	toɾmenta̝
tormenta	toɾmɛnta̝
tormentelo	toɾmentɛlo̝
tormento	toɾmento̝
tornar	toɾnaɾ
tornarratos	tɔɾnarato̝s
tornasol	toɾnasol
tornecelo	toɾneselo̝
tornecelo	toɾneθelo̝
torneira	toɾnejɾa̝
torno	tɔɾno̝
tornés	toɾnes
toro	toɾo̝
torque	tɔɾke̝
torrada	toraða̝
torrar	toraɾ
torre	tore̝
torrente	torente̝
torrente	torɛnte̝
torrontés	torontes
tortilla	toɾtiʎa
torto	tɔɾto̝
tosca	toska̝
tose	tɔsɪ
tosquiar	toskiaɾ
touca	towka̝
touceira	towθejɾa̝
touciño	towsiɲo̝
touciño	towθiɲo̝
toupa	towpa̝
touriñán	towɾiɲaŋ
tourón	towɾoŋ
touta	towta̝
toutelo	towtɛlo̝
touticeira	towtiθejɾa̝
toutizo	towtiso̝
toutizo	towtiθo̝
toutón	towtoŋ
touza	towsa̝
touza	towθa̝
touzo	towso̝
touzo	towθo̝
toxal	toʃal
toxo	toʃo̝
trabada	tɾaβaða
trabalinguas	tɾaβaliŋɡwa̝s
traballar	tɾaβaʎaɾ
traballo	tɾaβaʎo̝
trabanco	tɾaβaŋko̝
trabar	tɾaβaɾ
trabe	tɾaβe̝
trabucar	tɾaβukaɾ
trabuco	tɾaβuko̝
trade	tɾaðe̝
tragar	tɾaɣaɾ
tragove	tɾaɣɔβe̝
tralla	tɾaʎa̝
trallar	tɾaʎaɾ
tranca	tɾaŋka̝
tranga	tɾaŋɡa̝
trangallada	tɾaŋɡaʎaða̝
trangallo	tɾaŋɡaʎo̝
trapa	tɾapa̝
trapallada	tɾapaʎaða̝
trapallo	tɾapaʎo̝
trapela	tɾapɛla̝
trapo	tɾapo̝
trasavó	tɾas̺ɐvɔ
trasnada	tɾasnaða̝
trasnoitar	tɾasnojtaɾ
trasvirar	tɾasbiɾaɾ
travesa	tɾaβɛsa̝
traveseiro	tɾaβesejɾ̝o
traxe	tɾaʃe̝
traíña	tɾaiɲa̝
trebellar	tɾeβeʎaɾ
trebello	tɾeβeʎo̝
treboada	tɾeβoaða̝
trebón	tɾeβoŋ
tregua	tɾɛɣwa̝
treina	trejna̝
treito	tɾejto̝
treitoira	tɾejtojɾa̝
trela	tɾɛla̝
trello	tɾeʎo̝
trelo	tɾɛlo̝
trema	tɾema̝
tremer	tɾemeɾ
tremo	tɾemo̝
tremor	tɾemoɾ
tren	tɾɛŋ
trenla	tɾɛnla̝
trepar	tɾepaɾ
trepia	tɾepja̝
trespés	tɾespɛs
treu	tɾɛw
trevo	tɾeβo̝
triabá	tɾiaβa
triacastela	tɾiakastɛla̝
trigar	tɾiɣaɾ
trigo	tɾiɣo̝
trilla	tɾiʎa̝
trillar	tɾiʎaɾ
trinca	tɾiŋka̝
trincado	tɾiŋkaðo̝
trincar	triŋkaɾ
trincheira	tɾint͡ʃaɾ
trinque	triŋke̝
trinta	trinta̝
tripa	tɾipa̝
tripar	tɾipaɾ
triscar	tɾiskaɾ
trisco	tɾisko̝
trives	tɾiβe̝s
troba	tɾɔβa̝
trobe	tɾɔβe̝
trocar	tɾokaɾ
troita	tɾojta̝
troita	tɾujta̝
troita	tɾuta̝
troita	tɾutja̝
troitosende	tɾojtosende̝
trola	tɾɔla̝
trollo	tɾoʎo̝
tromentelo	tɾomentɛlo̝
trompa	tɾompa
tronada	tɾonaða̝
tronco	tɾoŋko̝
trono	tɾono̝
trono	tɾɔno̝
tronzar	tɾonsaɾ
tronzar	tɾonθaɾ
trosma	tɾɔsma̝
trotar	tɾɔtaɾ
troula	tɾowla̝
troulear	tɾowleaɾ
trousa	tɾowsa
trousar	tɾowsaɾ
trouso	tɾowso̝
trouzo	tɾowso̝
trouzo	tɾowθo̝
trucar	tɾukaɾ
trueiro	tɾuejɾo̝
truel	tɾuɛl
trémbora	tɾembo̝ɾa̝
tríscele	tɾisθe̝le̝
tufeira	tufejɾa̝
tufo	tufo̝
tuimil	tujmil
tulla	tuʎa̝
turuleque	turulɛke̝
tusir	tusiɾ
táboa	taβo̯a̝
támboga	tambo̝ɣa̝
támega	tame̝ɣa̝
támoga	tamo̝ɣa̝
tósego	tos̺eħo̝
tósego	tos̺eɣo̝
túzaro	tusa̝ɾo̝
túzaro	tuθa̝ɾo̝
u	u
uceira	usejɾa̝
uceira	uθejɾa̝
ulido	ulið̞o̝
ulla	uʎa̝
ulloa	uʎoa̝
un	uŋ
unha	uŋa̝
unlla	unʎa̝
unto	unto̝
unxir	unʃiɾ
uz	us
uz	uθ
uzal	uθal
uña	uɲa̝
vaca	baka̝
vacaloura	bakalowɾa̝
vacina	basina̝
vacina	baθina̝
vagalume	baɣalume̝
vaira	bajɾa̝
val	bal
valado	balaðo̝
valar	balaɾ
valdeorras	baldeora̝s
valella	baleʎa̝
valente	balɛnte̝
valgada	balɣaða̝
valigoto	baliɣoto̝
valo	balo̝
valume	balume̝
vao	bao̯
vara	baɾa̝
varar	baɾaɾ
varcia	baɾsja̝
varcia	baɾθja̝
vareixa	baɾɛjʃa̝
varela	baɾɛla̝
varenga	baɾɛŋɡa̝
varga	baɾɣa̝
varganzo	baɾɣanθo̝
vargo	baɾɣo̝
varón	baɾoŋ
vasalo	basalo̝
vasca	baska̝
vascullo	baskuʎo̝
vaxina	baʃina
vaíña	baiɲa̝
vea	bea̝
veciño	beθiɲo̝
veciño	bisiɲo̝
veciño	biθiɲo̝
vedizo	bɛːðiθo̝
vedraño	beðɾaɲo̝
vedro	bɛðɾo̝
vegada	beɣaða̝
veiga	bejɣa̝
veitureira	bejtuɾejɾa̝
vello	bɛʎo̝
vencello	benseʎo̝
vencello	benθeʎo̝
venda	benda̝
vendaval	bendaβal
vendima	bendima̝
vendimar	bendimaɾ
venres	bɛnre̝s
ventar	bentaɾ
ventas	ventas
vento	bento̝
vento	bɛnto̝
ventrecha	bentɾet͡ʃa̝
ventureira	bentuɾejɾa̝
ventureiro	bentuɾejɾo̝
veo	beo̝
veo	beʊ̯
verba	berβa̝
verde	beɾðe̝
verdello	beɾðeʎo̝
verea	beɾea̝
verea	bɾea̝
verga	beɾɣa̝
verga	bɛɾɣa̝
veriño	beɾiɲo̝
veriño	bɾiɲo̝
verme	bɛɾme̝
vermello	beɾmeʎo̝
verquer	beɾkeɾ
verza	beɾθa̝
verán	bɾaŋ
vesada	besaða̝
vesar	besaɾ
vestir	bestiɾ
vestir	bistiɾ
vetillo	betiʎo̝
vexar	beʃaɾ
vexiga	beʃiɣa̝
vexiga	biʃiɣa̝
vez	bes
vez	beθ
vezo	beso̝
vezo	beθo̝
viana	biana̝
vianda	bianda̝
vichelocrego	bit͡ʃelokɾɛɣo̝
videira	biðejɾa̝
vieites	biejte̝s
vigo	biħo̝
vigo	biɣo̝
vila	bila̝
vilaguillulfe	bilaɣiʎulfe̝
vilancico	bilanθiko
vilar	bilaɾ
vilargondurfe	bilaɾɡonduɾfe̝
vilariño	bilaɾiɲo̝
vilasantar	bilasantaɾ
vilouchada	bilowt͡ʃaða̝
vilán	bilaŋ
vime	bime̝
vimieiro	bimiejɾo̝
vinagre	binaɣɾe̝
vincallo	biŋkaʎo̝
vincha	bint͡ʃa̝
vinco	biŋko̝
vindima	bindima̝
vingar	biŋɡaɾ
viorto	biɔɾto̝
vira	biɾa̝
virar	biɾaɾ
viravolta	biɾaβɔlta̝
virilla	biɾiʎa̝
virilla	bɾiʎa̝
virxinidade	biɾʃiniða
virxinidade	biɾʃiniðaðe̝
viso	biso̝
vista	bista̝
vitureira	bituɾejɾa̝
viturón	bituɾo̝ŋ
viveiro	biβejɾo̝
vivenda	biβenda̝
vivenda	biβɛnda̝
vivir	biβiɾ
vixiar	biʃiaɾ
vizo	biso̝
vizo	biθo̝
vizoso	bisoso̝
vizoso	biθoso̝
viéitez	biejte̝θ
viña	biɲa̝
viñoa	biɲɔa̝
voitirón	bojtiɾo̝ŋ
voitre	bojtɾe̝
voiturón	bojtuɾo̝ŋ
volandeira	bolandejɾa̝
voleibol	bo̞le̞iβ̞o̞l
volta	bɔlta̝
vorco	bɔɾko̝
vougo	bowɣo̝
voutureira	bowtuɾejɾa̝
vurullo	buɾuʎo̝
wifi	wifi
xa	ʃa
xabre	ʃaβɾe̝
xacer	ʃaθeɾ
xadrez	ʃaðɾes
xadrez	ʃaðɾeθ
xalundes	ʃalundes
xan	ʃaŋ
xanela	ʃanɛla
xantar	ʃantaɾ
xardineiro	ʃaɾðinejɾo
xardón	ʃaɾðoŋ
xarxa	ʃaɾʃa
xas	ʃaːs̺
xato	ʃato̝
xaula	ʃawla̝
xaxún	ʃaʃuŋ
xeada	ʃeaða̝
xeada	ʃiaða̝
xear	ʃeaɾ
xear	ʃiaɾ
xebrar	ʃeβɾaɾ
xebre	ʃeβɾe̝
xeira	ʃejɾa̝̝
xeitar	ʃejtaɾ
xeito	ʃejto̝
xeitoso	ʃejtoso̝
xendra	ʃendɾa̝
xenebra	ʃenɛβɾɐ
xeno	ʃeno̝
xenro	ʃeŋɾo̝
xenro	ʃɛŋɾo̝
xente	ʃente̝
xeonlleira	ʃeonʎejɾa̝
xeonllo	ʃeonʎo̝
xeración	ʃeɾaθjoŋ
xerar	ʃeɾaɾ
xerga	ʃɛɾɣa̝
xergón	xeɾɣoŋ
xerme	ʃɛɾme̝
xermolar	ʃermolaɾ
xermolo	ʃeɾmolo̝
xesta	ʃɛsta̝
xiabre	ʃiaβɾe̝
xiao	ʃiao̯
xiba	ʃiβa̝
xibardo	ʃiβaɾðo̝
xilbarbeira	ʃilβaɾβejɾa̝
xilbarda	ʃilβaɾða̝
xiringa	ʃiɾiŋɡa̝
xiringar	ʃiɾiŋɡaɾ
xián	ʃiaŋ
xoaniña	ʃo̯aniɲa̝
xoaniña	ʃwaniɲa̝
xofre	ʃɔfɾɪ
xoga	ʃɔɣa̝
xogo	ʃɔɣo̝
xogral	ʃoɣɾal
xograr	ʃoɣɾaɾ
xolda	ʃɔlda̝
xostra	ʃostɾa̝
xostra	ʃɔstɾa̝
xouba	ʃowβa̝
xoves	ʃɔβe̝s
xudeu	ʃuðew
xunco	ʃuŋko̝
xunta	ʃunta̝
xunto	ʃunto̝
xuramento	ʃuɾamentʊ
xurdir	ʃuɾðiɾ
xurelo	ʃuɾɛlo̝
xurreira	ʃurejɾa̝
xurro	ʃuro̝
xurxo	ʃurʃo̝
xuíz	ʃuiθ
xuízo	ʃwis̻ʊ
xuízo	ʃwiθʊ
xógara	ʃɔɣa̝ɾa̝
zafra	safɾa
zafra	θafɾa
zamarra	samara̝
zamarra	θamara̝
zamborca	sambɔɾka̝
zamborca	θambɔɾka̝
zamburiña	sambuɾiɲa̝
zamburiña	θambuɾiɲa̝
zanca	θaŋka̝
zanfoga	θaɱfɔɣa̝
zanfona	saɱfona̝
zanfona	θaɱfona̝
zangro	θaŋɡɾo̝
zapateiro	sapatejɾo̝
zapateiro	θapatejɾo̝
zapato	sapato̝
zapato	θapato̝
zapping	θapin
zapón	sapoŋ
zapón	θapoŋ
zarabeto	θaɾaβeto̝
zarangallo	θaɾaŋɡaʎo̝
zarra	θara̝
zarrapico	sarapiko̝
zarrapico	θarapiko̝
zarro	θaro̝
zarzallo	θaɾθaʎo̝
zoar	soaɾ
zoar	zoaɾ
zoca	sɔka̝
zoca	θɔka̝
zoco	sɔko̝
zoco	θoko̝
zoco	θɔko̝
zopegar	θopeɣaɾ
zopo	θopo̝
zoqueiro	sɔkejɾo̝
zoqueiro	θɔkejɾo̝
zorra	sora̝
zorra	θora̝
zorregar	soreɡaɾ
zorregar	θoreɡaɾ
zorro	soro̝
zorro	θoro̝
zorza	sɔɾsa̝
zorza	θɔɾθa̝
zoscar	soskaɾ
zoscar	θoskaɾ
zoupar	θowpaɾ
zoupo	sowpo̝
zoupo	θowpo̝
zoupón	sowpoŋ
zoupón	θowpoŋ
zuchar	sut͡ʃaɾ
zuchar	θut͡ʃaɾ
zucho	sut͡ʃo̝
zucho	θut͡ʃo̝
zudre	θuðɾe̝
zugar	suɣaɾ
zugar	θuɣaɾ
zuncho	sunt͡ʃo̝
zuncho	θunt͡ʃo̝
zurrar	θuraɾ
zurreira	θurejɾa̝
zurro	θuro̝
ábrego	aβɾe̝ɣo̝
álido	alið̞o̝
ámago	ama̝ɣo̝
ámbar	amba̝ɾ
ámboa	ambo̯a̝
árbore	aɾβo̝ɾe̝
árgoma	aɾɣo̝ma̝
áspero	aspe̝ɾo̝
áspero	aspɾo̝
é	ɛ
érbedo	eɾβe̝ðo̝
óso	ɔso̝
