ក	kɑɑ
កក	kɑɑk
កកិត	kɑkət
កកូរ	kɑkou
កកើត	kɑɑkaət
កក់	kɑk
កក់ក្ដៅ	kɑkkdav
កក់សក់	kɑksɑk
កខ្វក់	kɑkvɑk
កង	kɑɑŋ
កង់	kɑŋ
កង្ហារ	kɑŋhaa
កញ្ចក់	kɑɲcɑk
កញ្ចប់	kɑɲcɑp
កញ្ច្រែង	kɑɲcraeŋ
កញ្ញា	kaɲɲaa
កដៃ	kɑɑday
កណ្ដាល	kɑndaal
កណ្ដឹង	kɑndəŋ
កណ្ដៀវ	kɑndiəv
កណ្ដោរ	kɑndao
កណ្ណិកា	kɑnəkaa
កត់	kɑt
កត់ត្រា	kɑttraa
កន្ត្រក	kɑntrɑɑk
កន្ត្រៃ	kɑntray
កន្ត្រៃកាត់ក្រចក	kɑntraykatkrɑcɑɑk
កន្ទក់	kɑntʊək
កន្ទុយ	kɑntuy
កន្ទេល	kɑnteel
កន្ធន់	kɑntʰʊən
កន្និកា	kɑnnikaa
កន្លង	kɑnlɑɑŋ
កន្លែង	kɑnlaeŋ
កន្លែងធ្វើការ	kɑnlaeŋtvəəkaa
កន្លះ	kɑnlah
កន្សែង	kɑnsaeŋ
កន្សែងពោះគោ	kɑnsaeŋpʊəhkoo
កប៉ាល់	kaʔpal
កប់	kɑp
កម្ចាត់	kɑmcat
កម្ដៅ	kɑmdav
កម្ទេច	kɑmtɨc
កម្ទេចកម្ទី	kɑmtɨckɑmtii
កម្ពស់	kɑmpʊəh
កម្ពុជា	kampuʔcie
កម្ពុជាក្រោម	kampuʔciekraom
កម្មករ	kammaʔkɑɑ
កម្មពៀរ	kampiə,kammeaʔpiə,kammaʔpiə
កម្មវិធី	kamviʔtʰii,kammaʔviʔtʰii,kammeaʔviʔtʰii
កម្រ	kɑmrɑɑ
កម្រាល	kɑmraal
កម្រាលព្រំ	kɑmraalprum
កម្រាលឥដ្ឋ	kɑmraalʔǝt
កម្រិត	kɑmrɨt
កម្រើក	kɑmraək
កម្លាំង	kɑmlaŋ
កម្សាន្ត	kɑmsaan
ករណី	kaʔraʔnəy
កសិកម្ម	kaʔseʔkam
កសិករ	kaʔseʔkɑɑ
កអាវ	kɑɑʔaav
កា	kaa
កាកសំណល់	kaaksɑmnɑl
កាក់	kak
កាច	kaac
កាច់ចង្កូត	kaccɑŋkout
កាដូ	kaadou
កាណូត	kaanout
កាត	kaat
កាតាប	kaataap
កាត់	kat
កាត់ចិត្ត	katcət
កាត់តម្លៃ	kattɑmlay
កាត់បន្ថយ	katbɑntʰɑɑy
កាទឹក	kaatɨk
កាន់	kan
កាន់តែ	kantae
កាបូប	kaaboup
កាមេរ៉ា	kaameeraa
កាយ	kaay
កាយវិការ	kaayviʔkaa
ការ	kaa
ការងារ	kaaŋie
ការចាយវាយ	kaacaayviey,kaacaayvay
ការដ្ឋាន	kaarattʰaan
ការតុង	kaatoŋ
ការទូត	kaatuut
ការពារ	kaapie
ការវះកាត់	kaaveahkat
ការសិក្សា	kaasǝksaa
ការិយាល័យ	kaareʔyaalay
ការី	kaarii
ការេ	kaaree
ការ៉ុត	kaarot
ការ៉ូ	karou
កាល	kaal
កាលបរិច្ឆេទ	kaalpaʔrəccʰaet,kaalbɑɑrəccʰaet
កាលពី	kaalpii
កាលពីក្មេង	kaalpiikmeeŋ
កាលពីមុន	kaalpiimun
កាលសម័យ	kaalsaʔmay
កាវ	kaav
កាស	kaah
កាសែត	kaasaet
កាស្យូ	kaasyou
កាហ្វេ	kaafee
កាំ	kam
កាំកង់	kamkɑŋ
កាំជណ្ដើរ	kamcʊəndaə
កាំបិត	kambət
កាំភ្លើង	kampləəŋ
កិច្ចការ	kəckaa
កិន	kən
កីឡា	kəylaa
កុងតឺន័រ	koŋtəɨnoa
កុមារី	koʔmaarəy
កុម្ម៉ង់	kommɑŋ
កុយ	koy
កុសល	koʔsɑl
កុហក	koʔhɑk
កុំ	kom
កុំព្យូទ័រ	kompyuutoa
កុំអាល	komʔaal
កុំឲ្យ	komʔaoy
កុំឲ្យតែ	komʔaoytae
កូកា	koukaa
កូកាកូឡា	koukaakoulaa
កូដ	kout
កូន	koun
កូនកន្សែង	kounkɑnsaeŋ
កូនក្មេង	kounkmeeŋ
កូនដៃ	kounday
កូនប្រុស	kounproh
កូនមាន់	kounmoan
កូនសិស្ស	kounsəh
កូនសិស្សលោក	kounsəhlook
កូនស្រី	kounsrǝy
កូពី	koupii
កូរ	kou
កូរពោះ	koupʊəh
កួច	kuəc
កើត	kaət
កើតឡើង	kaətlaəŋ
កើន	kaən
កើប	kaəp
កើយ	kaəy
កឿង	kɨəŋ
កៀក	kiək
កៀនស្វាយ	kiənsvaay
កៀប	kiəp
កេស	keeh
កេះ	keh
កែ	kae
កែង	kaeŋ
កែងដៃ	kaeŋday
កែប	kaep
កែវ	kaev
កោង	kaoŋ
កោរ	kao
កោស	kaoh
កៅឆាយ	kavcʰaay
កៅស៊ូ	kavsuu
កៅអី	kavʔəy
កំដរ	kɑmdɑɑ
កំណក	kɑmnɑɑk
កំណត់	kɑmnɑt
កំប៉ិត	kɑmpət
កំប៉ុង	kɑmpoŋ
កំប្លេ	kɑmplee
កំប្លែង	kɑmplaeŋ
កំពង់ធំ	kɑmpʊəŋtʰom
កំពង់ផែ	kɑmpʊəŋpʰae
កំពត	kɑmpɔɔt
កំពប់	kɑmpup
កំពុង	kɑmpuŋ
កំពុងតែ	kɑmpuŋtae
កំពូលភ្នំ	kɑmpuulpnum
កំសៀវ	kɑmsiəv
កំហុស	kɑmhoh
កំឡុង	kɑmloŋ
ក៏	kɑɑ
ក៏ដោយ	kɑɑdaoy
ក្ដាប់	kdap
ក្ដារ	kdaa
ក្ដោង	kdaoŋ
ក្ដោប	kdaop
ក្ដៅ	kdav
ក្ដៅខ្លួន	kdavkluən
ក្តី	kdəy
ក្នុង	knoŋ
ក្បង់	kbɑŋ
ក្បាច់	kbac
ក្បាល	kbaal
ក្បាលជង្គង់	kbaalcʊəŋkʊəŋ
ក្បាលរ៉ូប៊ីនេ	kbaalroubiinee
ក្បាលរ៉ូប៊ីនេទឹក	kbaalroubiineetɨk
ក្បូរក្បាច់	kboukbac
ក្បួន	kbuən
ក្បៀស	kbiəh
ក្បែរ	kbae
ក្មួយ	kmuəy
ក្មេង	kmeeŋ
ក្មេងប្រុស	kmeeŋproh
ក្មេងស្រី	kmeeŋsrǝy
ក្រ	krɑɑ
ក្រចក	krɑcɑɑk
ក្រចកដៃ	krɑcɑɑkday
ក្រញូវ	krɑɲəv
ក្រដាស	krɑdaah
ក្រដាសកេស	krɑdaahkeeh
ក្រដាសប្រាក់	krɑdaahprak
ក្រដាសឡាំង	krɑdaahlaŋ
ក្រណាត់	krɑnat
ក្រប	krɑɑp
ក្របី	krɑbəy
ក្រពះ	krɑpeah
ក្រមៅ	krɑmav
ក្រយៅដៃ	krɑyavday
ក្រសួង	krɑsuəŋ
ក្រហម	krɑhɑɑm
ក្រឡុក	krɑlok
ក្រឡេក	krɑleek
ក្រឡេចក្រឡុច	krɑləckrɑloc
ក្រអូប	krɑʔoup
ក្រាប	kraap
ក្រាល	kraal
ក្រាស	kraah
ក្រាស់	krah
ក្រិត	krət
ក្រឹម	krəm
ក្រុម	krom
ក្រុមគ្រួសារ	kromkruəsaa
ក្រុមហ៊ុន	kromhun
ក្រូច	krouc
ក្រូចឃ្វិច	krouckvɨc
ក្រូចឆ្មារ	krouccmaa
ក្រូចថ្លុង	krouctloŋ
ក្រូចពោធិ៍សាត់	kroucpoosat
ក្រូចសើច	kroucsaǝc
ក្រៀម	kriəm
ក្រៀមក្រំ	kriəmkrɑm
ក្រែង	kraeŋ
ក្រែងលោ	kraeŋloo
ក្រោក	kraok
ក្រោម	kraom
ក្រោយ	kraoy
ក្រោយពេល	kraoypeel
ក្រោយមក	kraoymɔɔk
ក្រៅ	krav
ក្រៅពី	kravpii
ក្លាយ	klaay
ក្លាសេ	klaasee
ក្លិន	klən
ក្លឹប	kləp
ក្លៀក	kliək
ក្លែងក្លាយ	klaeŋklaay
ក្លែប	klaep
ក្អម	kʔɑɑm
ក្អួត	kʔuət
ក្អឿក	kʔɨək
ក្អែក	kʔaek
ក្អែល	kʔael
ខ	kʰɑɑ
ខក	kʰɑɑk
ខកចិត្ត	kʰɑɑkcət
ខគោ	kʰɑɑkoo
ខណ្ឌ	kʰan
ខល	kʰɑɑl
ខាង	kʰaaŋ
ខាងកើត	kʰaaŋkaət
ខាងក្នុង	kʰaaŋknoŋ
ខាងក្រោម	kʰaaŋkraom
ខាងក្រោយ	kʰaaŋkraoy
ខាងក្រៅ	kʰaaŋkrav
ខាងចុង	kʰaaŋcoŋ
ខាងជើង	kʰaaŋcəəŋ
ខាងដើម	kʰaaŋdaəm
ខាងណា	kʰaaŋnaa
ខាងមុខ	kʰaaŋmuk
ខាងលិច	kʰaaŋlɨc
ខាងលើ	kʰaaŋlǝǝ
ខាត	kʰaat
ខាន	kʰaan
ខាប់	kʰap
ខារ៉ាអូខេ	kʰaaraaʔoukʰee
ខាំ	kʰam
ខិតខំ	kʰətkʰɑm
ខឹង	kʰəŋ
ខុស	kʰoh
ខុសគ្នា	kʰohknie
ខុសច្បាប់	kʰohcbap
ខុសឆ្គង	kʰohckɔɔŋ
ខុសត្រូវ	kʰohtrəv
ខុសទំនង	kʰohtumnɔɔŋ
ខុសវិន័យ	kʰohviʔney
ខុសៗគ្នា	kʰohkʰohknie
ខូច	kʰouc
ខូចខាត	kʰouckʰaat
ខូចខ្លួន	kʰouckluən
ខួបកំណើត	kʰuəpkɑmnaət
ខួរក្បាល	kʰuəkbaal
ខើច	kʰaəc
ខៀវ	kʰiəv
ខេត្ត	kʰaet
ខែ	kʰae
ខោ	kʰao
ខោក្នុង	kʰaoknoŋ
ខោទ្រនាប់	kʰaotrɔnoap
ខោវប៊យ	kʰaubɔɔy
ខោអាវ	kʰaoʔaav
ខំ	kʰɑm
ខំប្រឹង	kʰɑmprəŋ
ខះក	kʰahkɑɑ
ខ្ចប់	kcɑp
ខ្ចាយ	kcaay
ខ្ចី	kcəy
ខ្ជាក់	kceak
ខ្ជាប់	kcoap
ខ្ជិល	kcɨl
ខ្ញុំ	kɲom
ខ្ទង់	ktʊəŋ
ខ្ទប់	ktup
ខ្ទាត	ktiet
ខ្ទឹម	ktɨm
ខ្ទឹមបារាំង	ktɨmbaaraŋ
ខ្ទេច	ktɨc
ខ្ទះ	kteah
ខ្នង	knɑɑŋ
ខ្នុរ	knao,knol
ខ្នើយ	knaəy
ខ្នើយកើយ	knaəykaəy
ខ្ពង់ខ្ពស់	kpʊəŋkpʊəh
ខ្ពស់	kpʊəh
ខ្ពុរ	kpuu,kpul
ខ្មាសគេ	kmaahkee
ខ្មែរ	kmae
ខ្មោច	kmaoc
ខ្មៅ	kmav
ខ្យង	kyɑɑŋ,kcɑɑŋ
ខ្យល់	kcɑl,kyɑl,ksɑl
ខ្យល់គរ	kcɑlkɔɔ
ខ្លាច	klaac
ខ្លាញ់	klaɲ
ខ្លាំង	klaŋ
ខ្លី	kləy
ខ្លួន	kluən
ខ្លួនប្រាណ	kluənpraan
ខ្លួនឯង	kluənʔaeŋ
ខ្លែង	klaeŋ
ខ្លោង	klaoŋ
ខ្លោច	klaoc
ខ្លះ	klah
ខ្វល់	kvɑl
ខ្វិត	kvət
ខ្វេះ	kveh
ខ្វះ	kvah
ខ្សាច់	ksac
ខ្សែ	ksae
ខ្សែក្រវាត់	ksaekrɑvat
ខ្សែពួរ	ksaepuə
ខ្សោយ	ksaoy
គ	kɔɔ
គគ្រិច	kɔkrɨc
គង់តែ	kʊəŋtae
គណនា	keaʔnaʔnie
គណនី	keaʔnaʔnəy,keaʔnaʔnii
គណនេយ្យ	keaʔnaʔnəy,kʊənnaʔney
គណិត	keaʔnet
គត់	kʊət
គប់	kup
គប្បី	koapbəy
គម្រប	kumrɔɔp
គម្រោង	kumrooŋ
គម្លាត	kumliet
គរ	kɔɔ
គល់	kʊəl
គាត់	koat
គាស់	koah
គាំង	keaŋ
គិត	kɨt
គិតលុយ	kɨtluy
គិលានុប្បដ្ឋាយិកា	kiʔlienuʔpattʰaayiʔkaa
គីមី	kiimii
គីរីរម្យ	kiiriirom
គីឡូ	kiilou
គឺ	kɨɨ
គុក	kuk
គុណ	kun
គុណភាព	kunaʔpʰiep
គុម្ព	kum
គុយទាវ	kuytiev
គូ	kuu
គូទ	kuut
គូស	kuuh
គូសន្ទនា	kuusɑnteaʔnie
គួរ	kuə
គួរតែ	kuətae
គួរសម	kuəsɑɑm
គួរឲ្យ	kuəʔaoy
គេ	kee
គេង	keeŋ
គេងលក់	keeŋlʊək
គេច	kɨc
គោ	koo
គោក	kook
គោរព	koorup
គោលដៅ	kooldav
គោលបំណង	koolbɑmnɑɑŋ
គំនិត	kumnɨt
គំនូរ	kumnuu
គ្នា	knie
គ្នាយើង	knieyəəŋ
គ្មាន	kmien
គ្រង	krɔɔŋ
គ្រប	krɔɔp
គ្រប់	krup
គ្រប់កន្លែង	krupkɑnlaeŋ
គ្រប់គ្រាន់	krupkroan
គ្រប់ទីកន្លែង	kruptiikɑnlaeŋ
គ្រប់សព្វ	krupsɑp
គ្រលង	krɔlɔɔŋ
គ្រលុក	krɔluk
គ្រាន់តែ	kroantae
គ្រាន់បើ	kroanbaə
គ្រាប់	kroap
គ្រាប់ចុច	kroapcoc
គ្រាមភាសា	kriempʰiesaa
គ្រាំ	kroam
គ្រាំគ្រា	kroamkrie
គ្រីនធី	kriintʰii
គ្រុនចាញ់	kruncaɲ
គ្រូ	kruu
គ្រូក	kruuk
គ្រូបង្រៀន	kruubɑŋriən
គ្រូពេទ្យ	kruupɛɛt
គ្រួសារ	kruəsaa
គ្រឿង	krɨəŋ
គ្រឿងគ្រៅ	krɨəŋkrɨv
គ្រឿងញៀន	krɨəŋɲiən
គ្រឿងទេស	krɨəŋteeh
គ្រឿងផ្សំ	krɨəŋpsɑm
គ្រឿងស្រវឹង	krɨəŋsrɑvǝŋ
គ្រែ	krɛɛ
គ្រោះថ្នាក់	krʊəktnak
គ្រោះថ្នាក់ចរាចរណ៍	krʊəktnakcɑraacɑɑ
គ្រោះអាក្រក់	krʊəkʔaakrɑk
គ្លីនិក	kliinək
ឃាត់	kʰoat
ឃើញ	kʰəəɲ
ឃ្យូត	kyuut
ឃ្លា	klie
ឃ្លាន	klien
ឃ្លីងឃ្លោង	kliiŋklooŋ
ឃ្លុប	klup
ឃ្លោង	klooŋ
ងងឹត	ŋɔŋɨt
ងងុយ	ŋɔŋuy
ងាក	ŋiek
ងាប់	ŋoap
ងាយ	ŋiey
ងាយស្រួល	ŋieysruǝl
ងុយគេង	ŋuykeeŋ
ងុយដេក	ŋuydeek
ងូត	ŋuut
ងូតទឹក	ŋuuttɨk
ងើប	ŋəəp
ងើយ	ŋəəy
ងើយមើល	ŋəəyməəl
ង៉ៃ	ŋay
ង៉ៃក្រោយ	ŋaykraoy
ង៉ៃសុក្រ	ŋaysok
ង៉ៃសៅរ៍	ŋaysav
ង៉ៃហ្នឹង	ŋaynɨŋ
ង៉ៃអាទិត្យ	ŋayʔaatɨt
ច	cɑɑ
ចង	cɑɑŋ
ចងខ្សែ	cɑɑŋksae
ចងចាំ	cɑɑŋcam
ចងបូរ	cɑɑŋbou
ចង់	cɑŋ
ចង្កា	cɑŋkaa
ចង្កាក់	cɑŋkak
ចង្កឹះ	cɑŋkəh
ចង្កូត	cɑŋkout
ចង្កូម	cɑŋkoum
ចង្កៀង	cɑŋkiəŋ
ចង្កេះ	cɑŋkeh
ចង្ក្រាន	cɑŋkraan
ចង្រៃ	cɑŋray
ចង្រៃយោ	cɑŋrayyoo
ចង្វាក់	cɑŋvak
ចង្ហាន់	cɑŋhan
ចង្អុល	cɑŋʔol
ចង្អុលដៃ	cɑŋʔolday
ចង្អើរ	cɑŋʔaə
ចង្អៀត	cɑŋʔiət
ចត	cɑɑt
ចតុមុខ	caʔtommuk
ចត់	cɑt
ចន្ទគតិ	cankeaʔteʔ
ចន្ទល់	cɑntʊəl
ចន្លោះ	cɑnlɑh
ចប់	cɑp
ចម្ងល់	cɑmŋɑl
ចម្ងាយ	cɑmŋaay
ចម្រៀង	cɑmriəŋ
ចម្លង	cɑmlɑɑŋ
ចម្លាក់	cɑmlak
ចម្លើយ	cɑmlaəy
ចម្លែក	cɑmlaek
ចម្អិន	cɑmʔən
ចរណៃ	cɑɑranay
ចរន្ត	caʔrɑn
ចរាចរណ៍	cɑraacɑɑ
ចរិយា	caʔreʔyaa
ចាកចេញ	caakcəɲ
ចាក់	cak
ចាក់ក្រឡេក	cakkrɑleek
ចាក់សោ	caksao
ចាក់សោរក	caksaorɔɔk
ចាខ្វៃ	caakvay
ចាញ់	caɲ
ចាត់ទុក	cattuk
ចាន	caan
ចានគោម	caankoom
ចានដែក	caandaek
ចាន់	can
ចាបចៀន	caapciən
ចាប់	cap
ចាប់កាន់	capkan
ចាប់ចិត្ត	capcət
ចាប់ជាតិ	capciet
ចាប់ផ្ដើម	cappdaəm
ចាប់ពី	cappii
ចាប់ហួយ	caphuəy
ចាប់អារម្មណ៍	capʔaarɑm
ចាយ	caay
ចាស	caah
ចាស់	cah
ចាហួយ	caahuəy
ចាំ	cam
ចាំង	caŋ
ចាំងថ្ងៃ	caŋtŋay
ចាំបាច់	cambac
ចា៎ស	caah
ចិញ្ចឹម	cəɲcəm
ចិញ្ចើម	cəɲcaəm
ចិញ្ចើមថ្នល់	cəɲcaəmtnɑl,cəɲcaəmknɑl
ចិញ្ចើមផ្លូវ	cəɲcaəmpləv
ចិត	cət
ចិត្ត	cət
ចិត្តល្អ	cətlʔɑɑ
ចិន	cən
ចីពរ	ciipɔɔ
ចីវរ	ciivɔɔ
ចឹង	cəŋ
ចុក	cok
ចុកពោះ	cokpʊəh
ចុង	coŋ
ចុងក្រោយ	coŋkraoy
ចុងភៅ	coŋpʰɨv
ចុងសប្តាហ៍	coŋsappdaa
ចុច	coc
ចុម	com
ចុះ	coh
ចុះឈ្មោះ	cohcmʊəh
ចុះបើ	cohbaə
ចុះឡើង	cohlaəŋ
ចូក	couk
ចូល	coul
ចូលគេង	coulkeeŋ
ចូលគ្នា	coulknie
ចូលចិត្ត	coulcət
ចូលឆ្នាំ	coulcnam
ចូលឆ្នាំខ្មែរ	coulcnamkmae
ចូលរួម	coulruəm
ចូលលុយគ្នា	coulluyknie
ចូលហ៊ុន	coulhun
ចៀន	ciən
ចៀស	ciəh
ចៀសផ្លូវ	ciəhpləv
ចៀសវាង	ciəhvieŋ
ចេក	ceek
ចេញ	cəɲ
ចេញចូល	cəɲcoul
ចេញឈាម	cəɲcʰiem
ចេញដំណើរ	cəɲdɑmnaə
ចេតិយ	caetdəy
ចេត្រ	caet
ចេះ	ceh
ចេះតែ	cehtae
ចែក	caek
ចែកចេញជា	caekcəɲcie
ចែកឋាន	caektʰaan
ចែករំលែក	caekrumlɛɛk
ចែង	caeŋ
ចែងចាំង	caeŋcaŋ
ចែវ	caev
ចែវទូក	caevtuuk
ចែស	caeh
ចៃដន្យ	caydɑn
ចោរ	cao
ចោរកម្ម	caokam
ចោរឆក់	caocʰɑk
ចោល	caol
ចោលឈូង	caolcʰuuŋ
ចោះ	cɑh
ចៅ	cav
ចៅស្រី	cavsrǝy
ចំ	cɑm
ចំកណ្ដាល	cɑmkɑndaal
ចំការ	cɑmkaa
ចំណងជើង	cɑmnɑɑŋcəəŋ
ចំណងដៃ	cɑmnɑɑŋday
ចំណង់	cɑmnɑŋ
ចំណង់ចំណូលចិត្ត	cɑmnɑŋcɑmnoulcət
ចំណត	cɑmnɑɑt
ចំណាញ់	cɑmnaɲ
ចំណាន	cɑmnaan
ចំណាយ	cɑmnaay
ចំណាស់	cɑmnah
ចំណិត	cɑmnət
ចំណី	cɑmnəy
ចំណីចំណុក	cɑmnəycɑmnok
ចំណីអាហារ	cɑmnəyʔaahaa
ចំណេញ	cɑmnəɲ
ចំណែក	cɑmnaek
ចំណែកឯ	cɑmnaekʔae
ចំណោទ	cɑmnaot
ចំនួន	cɑmnuən
ចំបើង	cɑmbaəŋ
ចំពីមុខ	cɑmpiimuk
ចំពុះ	cɑmpuh
ចំពោះ	cɑmpʊəh
ចំរើន	cɑmraən
ចំហ	cɑmhɑɑ
ចំហាយទឹក	cɑmbaaytɨk,cɑmhaaytɨk
ចំហៀង	cɑmhiəŋ
ចំអន់	cɑmʔɑn
ច្បាប់	cbap
ច្បាម	cbaam
ច្បាស់	cbah
ច្បាស់លាស់	cbahloah
ច្រក	crɑɑk
ច្រកគាវ	crɑɑkkiev
ច្រត់	crɑt
ច្រត់ចង្កេះ	crɑtcɑŋkeh
ច្របល់	crɑbɑl
ច្របាច់	crɑbac
ច្របូកច្របល់	crɑboukcrɑbal
ច្រមុះ	crɑmoh
ច្រវា	crɑvaa
ច្រវាក់	crɑvak
ច្រឡូកច្រឡំ	crɑloukcrɑlɑm
ច្រឡំ	crɑlɑm
ច្រាស	craah
ច្រាសដុសធ្មេញ	craahdohtmɨɲ
ច្រាំង	craŋ
ច្រូត	crout
ច្រូតស្រូវ	croutsrǝv
ច្រើន	craən
ច្រើនតែ	craəntae
ច្រៀង	crieŋ
ឆត្រ	cʰat
ឆា	cʰaa
ឆាត	cʰaat
ឆាន់	cʰan
ឆាប	cʰaap
ឆាប់	cʰap
ឆាប់រហ័ស	cʰaprɔhah
ឆុង	cʰoŋ
ឆូត	cʰout
ឆួល	cʰuəl
ឆើត	cʰaət
ឆេះ	cʰeh
ឆែក	cʰaek
ឆែកមើល	cʰaekməəl
ឆៅ	cʰav
ឆ្កឹះ	ckəh
ឆ្កួត	ckuət
ឆ្កែ	ckae
ឆ្ងល់	cŋɑl
ឆ្ងាញ់	cŋaɲ
ឆ្ងាយ	cŋaay
ឆ្នាំ	cnam
ឆ្នាំង	cnaŋ
ឆ្នាំងខ្ទះ	cnaŋkteah
ឆ្នាំងសាក	cnaŋsaak
ឆ្នូត	cnoot
ឆ្នើម	cnaəm
ឆ្ពោះ	cpʊəh
ឆ្មា	cmaa
ឆ្មូល	cmoul
ឆ្លង	clɑɑŋ
ឆ្លងកាត់	clɑɑŋkat
ឆ្លាក់	clak
ឆ្លាត	claat
ឆ្លាស់	clah
ឆ្លុះ	cloh
ឆ្លើយ	claəy
ឆ្លៀត	cliət
ឆ្វេង	cveeŋ
ឆ្អិន	cʔən
ឆ្អឹង	cʔəŋ
ឆ្អែត	cʔaet
ជក់	cʊək
ជក់ចិត្ត	cʊəkcət
ជង្គង់	cʊəŋkʊəŋ
ជជែក	cɔcɛɛk
ជញ្ជាំង	cʊəɲceaŋ
ជញ្ជីង	cʊəɲcɨŋ
ជញ្ជូន	cʊəɲcuun
ជណ្ដើរ	cʊəndaə
ជណ្ដើរយន្ត	cʊəndaəyʊən
ជន	cʊən
ជនជាតិ	cɔɔnciet
ជនបទ	cɔɔnbɑt,cʊəneaʔbɑt
ជនបរទេស	cɔɔnbɑɑrəteeh
ជនរងគ្រោះ	cɔɔnrɔɔŋkrʊək
ជន់	cʊən
ជប៉ុន	ceaʔpon
ជប់លៀង	cupliǝŋ
ជម្រាបលា	cumrieplie
ជម្រាបសួរ	cumriepsuǝ
ជម្រើស	cumrəəh
ជម្រះ	cumreah
ជា	cie
ជាការស្រេច	ciekaasrac
ជាក់ជា	ceakcie
ជាក់ស្ដែង	ceaksdaeŋ
ជាង	cieŋ
ជាងគេ	cieŋkee
ជាច្រើន	ciecraən
ជាជាង	ciecieŋ
ជាដាច់ខាត	ciedackʰaat
ជាដើម	ciedaəm
ជាតា	cietaa
ជាតិ	ciet
ជាទីបំផុត	cietiibɑmpʰot
ជាទូទៅ	cietuutəv
ជាធម្មតា	cietʰoammeaʔtaa
ជានិច្ច	cienɨc
ជាន់	coan
ជាប់	coap
ជាប់គ្នា	coapknie
ជាប់នឹង	coapnɨŋ
ជាប់លេខ	coapleek
ជាប្រចាំ	cieprɑcam
ជាពិសេស	ciepiʔseeh
ជាមិនខាន	ciemɨnkʰaan
ជាមុន	ciemun
ជាមុនសិន	ciemunsən
ជាមួយ	ciemuəy
ជាមួយគ្នា	ciemuəyknie
ជាមួយនឹង	ciemuəynɨŋ
ជាយក្រុង	cieykroŋ
ជាយថាហេតុ	cieyeaʔtʰaahaet
ជាសះស្បើយ	ciesahsbaǝy
ជាស្រេច	ciesrac
ជិត	cɨt
ជិតខាង	cɨtkʰaaŋ
ជិតដល់	cɨtdɑl
ជិតស្និទ្ធ	cɨtsnǝt
ជិះ	cih
ជីដូន	ciidoun
ជីដូនជីតា	ciidounciitaa
ជីតា	ciitaa
ជីរ	cii
ជីវិត	ciivɨt
ជីវី	ciivii
ជីវៈជាតិ	ciiveaʔciet
ជុំគ្នា	cumknie
ជុំវិញ	cumvɨɲ
ជូត	cuut
ជូន	cuun
ជូនពរ	cuunpɔɔ
ជូរ	cuu
ជូរអែម	cuuʔaem
ជួន	cuən
ជួនជា	cuəncie
ជួប	cuəp
ជួបគ្នា	cuəpknie
ជួបជុំ	cuəpcum
ជួយ	cuəy
ជួយសង្គ្រោះ	cuəysɑŋkrʊəh
ជួរ	cuə
ជួល	cuəl
ជួសជុល	cuəhcul
ជើង	cəəŋ
ជើងពាន	cəəŋpien
ជើងម៉ា	cəəŋmaa
ជឿ	cɨə
ជែល	cɛɛl
ជោក	cook
ជោគជ័យ	cookcey
ជោរ	coo
ជំងឺ	cumŋɨɨ
ជំងឺគ្រុនចាញ់	cumŋɨɨkruncaɲ
ជំងឺគ្រុនឈាម	cumŋɨɨkruncʰiem
ជំនាញ	cumnieɲ
ជំនាន់	cumnoan
ជំនួយ	cumnuəy
ជំនួយការ	cumnuəykaa
ជំនួស	cumnuəh
ជំនឿ	cumnɨə
ជំរុំចិត្ត	cumrumcət
ជំហាន	cumhien
ជះ	ceah
ជ័រ	coa
ជ័រកៅស៊ូ	coakavsuu
ជ័រព្នៅ	coapnɨv
ជ្រក	crɔɔk
ជ្រកម្លប់	crɔɔkmlup
ជ្រញ់	crʊəɲ
ជ្រលក់	crɔlʊək
ជ្រាប	criep
ជ្រាបចូល	criepcoul
ជ្រាលជ្រៅ	crielcrɨv
ជ្រុង	cruŋ
ជ្រុល	crul
ជ្រុះ	cruh
ជ្រូក	cruuk
ជ្រួសគ្នា	cruəhknie
ជ្រើសរើស	crəəhrəəh
ជ្រែ	crɛɛ
ជ្រែងហោប៉ៅ	crɛɛŋhaopav
ជ្រៅ	crɨv
ជ្រះ	creah
ឈប់	cʰup
ឈរ	cʰɔɔ
ឈាងចូលលេង	cʰieŋcoulleeŋ
ឈាន	cʰien
ឈាម	cʰiem
ឈឺ	cʰɨɨ
ឈឺក្បាល	cʰɨɨkbaal
ឈឺចាប់	cʰɨɨcap
ឈឺពោះ	cʰɨɨpʊəh
ឈុត	cʰut
ឈូង	cʰuuŋ
ឈូស	cʰuuh
ឈើ	cʰəə
ឈើគូស	cʰəəkuuh
ឈើច្រត់	cʰəəcrɑt
ឈ្ងុយ	cŋuy
ឈ្ងៀម	cŋiəm
ឈ្នួល	cnuəl
ឈ្នះ	cneah
ឈ្មោល	cmool
ឈ្មោះ	cmʊəh
ឈ្មោះហៅក្រៅ	cmʊəhhavkrav
ញញឹម	ɲɔɲɨm
ញញួរ	ɲɔɲuə
ញាប់	ɲoap
ញាស់	ɲoah
ញី	ɲii
ញឹក	ɲɨk
ញឹកញាប់	ɲɨkɲoap
ញើស	ɲəəh
ញេញធ្មេញ	ɲɨɲtmɨɲ
ញ៉ាំ	ɲam
ញ៉ាំការ	ɲamkaa
ដក	dɑɑk
ដកប្រាក់	dɑɑkprak
ដក់	dɑk
ដង	dɑɑŋ
ដងទន្លេ	dɑɑŋtʊənlee
ដង្កូវ	dɑŋkəv
ដង្កូវទឹក	dɑŋkəvtɨk
ដង្ហើម	dɑŋhaəm
ដដែល	dɑdael
ដណ្ដប់	dɑndɑp
ដណ្ដើម	dɑndaəm
ដទៃទៀត	dɑteytiət
ដប	dɑɑp
ដប់	dɑp
ដប់ប្រាំ	dɑppram
ដរាបណា	dɑɑriepnaa
ដល់	dɑl
ដល់ពេលបច្ចុប្បន្ន	dɑlpeelpaccopbɑn
ដល់ហើយ	dɑlhaǝy
ដាក់	dak
ដាក់គ្នា	dakknie
ដាក់តាំង	daktaŋ
ដាក់បណ្ដាសា	dakbɑndaasaa
ដាក់បាត្រ	dakbaat
ដាក់ពាក្យ	dakpiek
ដាច់	dac
ដាណែត	daanaet
ដារិន	daarɨn
ដាលីន	daalɨn
ដាស់	dah
ដាំ	dam
ដាំបាយ	dambaay
ដិត	dət
ដី	dəy
ដីល្បាប់	dəylbap
ដីឥដ្ឋ	dəyʔǝt
ដឹក	dək
ដឹកជញ្ជូន	dəkcʊəɲcuun
ដឹកដៃ	dəkday
ដឹកទំនិញ	dəktumnɨɲ
ដឹង	dəŋ
ដឹងខ្លួន	dəŋkluən
ដឹងគុណ	dəŋkun
ដឹងចិត្ត	dəŋcət
ដឺម៉ង់	dəɨmɑŋ
ដុតឆេះ	dotcʰeh
ដុល្លារ	dollaa
ដុស	doh
ដុសធ្មេញ	dohtmɨɲ
ដុំ	dom
ដុំដែក	domdaek
ដុះ	doh
ដូច	douc
ដូចគ្នា	doucknie
ដូចគ្នានឹង	doucknienɨŋ
ដូចចង់	douccɑŋ
ដូចជា	douccie
ដូចមុន	doucmun
ដូចម្ដេច	doucmdəc
ដូច្នេះ	doucneh
ដូនតា	dountaa
ដូរ	dou
ដួល	duəl
ដួស	duəh
ដើម	daəm
ដើមឈើ	daəmcʰəə
ដើមដៃ	daəmday
ដើមទង	daəmtɔɔŋ
ដើមស្រូវ	daəmsrəv
ដើម្បី	daəmbəy
ដើរ	daə
ដើរលេង	daəleeŋ
ដេក	deek
ដេញ	dəɲ
ដេញដោល	dəɲdaol
ដេរ	dee
ដែក	daek
ដែកគោល	daekkool
ដែរ	dae
ដែល	dael
ដៃ	day
ដៃខ្លី	daykləy
ដៃគូ	daykuu
ដៃគូសន្ទនា	daykuusɑnteaʔnie
ដៃនាង	daynieŋ
ដៃអាវ	dayʔaav
ដោត	daot
ដោនឡូត	daonlout
ដោយ	daoy
ដោយចៃដន្យ	daoycaydɑn
ដោយសារ	daoysaa
ដោយសារតែ	daoysaatae
ដោយសេរី	daoyseerǝy
ដោយឡែក	daoylaek
ដោះ	dɑh
ដោះសា	dɑhsaa
ដោះសោ	dɑhsao
ដោះស្រាយ	dɑhsraay
ដំ	dɑm
ដំណាំ	dɑmnam
ដំណើរ	dɑmnaə
ដំណើរការ	dɑmnaəkaa
ដំណេក	dɑmneek
ដំណោះស្រាយ	dɑmnɑhsraay
ដំបូង	dɑmbouŋ
ដំបូល	dɑmboul
ដំបៅ	dɑmbav
ដំរី	dɑmrəy
ដំឡូងបារាំង	dɑmlouŋbaaraŋ
ដំឡើង	dɑmlaəŋ
ដ៏	dɑɑ
ដ្ឋាន	tʰaan
ឋានានុក្រម	tʰaanaanuʔkrɑm
ឋានៈ	tʰaanaʔ
ឌីជីថល	diiciitʰɑɑl
ឌុប	dup
ឌូយ	duuy
ណា	naa
ណាត់	nat
ណាមួយ	naamuəy
ណារី	naarii
ណាស់	nah
ណាំវ៉ា	namvaa
ណា៎	naa
ណូ	nou
ណេះ	neh
ណែន	naen
ណែនាំ	naenoam
ណោះ	nɑh
ត	tɑɑ
តក់ស្លុត	tɑkslot
តង់	tɑŋ
តថ្លៃ	tɑɑtlay
តម្កល់	tɑmkɑl
តម្បារ	tɑmbaa
តម្រង់	tɑmrɑŋ
តម្រាប់	tɑmrap
តម្រូវ	tɑmrəv
តម្រូវការ	tɑmrəvkaa
តម្រូវឲ្យ	tɑmrəvʔaoy
តម្រៀប	tɑmriəp
តម្លៃ	tɑmlay
តស៊ូ	tɑɑsuu
តស់	tɑh
តា	taa
តាក់ស៊ី	taksii
តាម	taam
តាមដាន	taamdaan
តាមពិត	taampɨt
តាមរយៈ	taamreaʔyeaʔ
តារា	taaraa
តារាង	taaraaŋ
តាស	taah
តាសអី	taahʔəy
តាំង	taŋ
តាំងពី	taŋpii
តិច	təc
តិចតួច	təctuəc
តិចទៀត	təctiət
តិចមើល	təcməəl
តឹង	təŋ
តុ	tok
តុក្កតា	tokkaʔtaa
តុំយ៉ាំ	tomyam
តូច	tuuc,touc
តូប	toup
តួ	tuə
តួនាទី	tuənietii
តើ	taə
តេ	tee
តេនីស	teeniih
តេឡេ	teelee
តែ	tae
តែង	taeŋ
តែងខ្លួន	taeŋkluən
តែងតែ	taeŋtae
តែងសេចក្តី	taeŋsəckdəy
តែប៉ុណ្ណោះ	taeponnɑh
តែពីសតែពាស	taepiihtaepieh
តែម	taem
តែម្ដង	taemdɑɑŋ
តៃកុង	taykoŋ
តោង	taoŋ
តំណាង	tɑmnaaŋ
តំបន់	tɑmbɑn
ត្នោត	tnaot
ត្បារ	tbaa
ត្បាល់	tbal
ត្បៀត	tbiət
ត្រកង	trɑkɑɑŋ
ត្រង	trɑɑŋ
ត្រង់	trɑŋ
ត្រង់ណា	trɑŋnaa
ត្រចៀក	trɑciək
ត្រជាក់	trɑceak
ត្រដាង	trɑdaaŋ
ត្រលប់	trɑlɑp
ត្រសក់	trɑsɑk
ត្រឡប់ត្រឡិន	trɑlɑptrɑlən
ត្រឡាច	trɑlaac
ត្រា	traa
ត្រាំ	tram
ត្រី	trəy
ត្រីដៀប	trəydiəp
ត្រីរ៉ស់	trəyrɑh
ត្រីអណ្ដែង	trəyʔɑndaeŋ
ត្រឹម	trəm
ត្រឹមតែ	trəmtae
ត្រឹមត្រូវ	trəmtrəv
ត្រូពិក	tropik
ត្រូវ	trəv
ត្រូវការ	trəvkaa
ត្រូវចិត្ត	trəvcət
ត្រូវតែ	trəvtae
ត្រូវនឹង	trəvnɨŋ
ត្រូវមាត់	trəvmoat
ត្រូវអំពើ	trəvʔɑmpəə
ត្រួត	truət
ត្រើយ	traəy
ត្រើយម្ខាង	traəymkʰaaŋ
ត្រៀម	triəm
ត្អើក	tʔaək
ថង់	tʰɑŋ
ថង់យាម	tʰɑŋyiem
ថត	tʰɑɑt
ថយក្រោយ	tʰɑɑykraoy
ថវិកា	tʰaʔviʔkaa
ថា	tʰaa
ថាច់ស្គ្រីន	tʰacskriin
ថាមពល	tʰaamaʔpʊəl
ថាស	tʰaah
ថាឲ្យ	tʰaaʔaoy
ថី	tʰəy
ថូ	tʰou
ថូផ្កា	tʰoupkaa
ថូហ្វល	tʰoufɑl
ថែ	tʰae
ថែម	tʰaem
ថែរក្សា	tʰaereaksaa
ថៃ	tʰay
ថោក	tʰaok
ថៅកែ	tʰavkae
ថ្គាម	tkiem
ថ្ងាស	tŋah
ថ្ងូរ	tŋou
ថ្ងៃ	tŋay
ថ្ងៃកំណើត	tŋaykɑmnaət
ថ្ងៃក្រោយ	tŋaykraoy
ថ្ងៃចន្ទ	tŋaycan
ថ្ងៃត្រង់	tŋaytrɑŋ
ថ្ងៃនេះ	tŋaynih
ថ្ងៃផុតកំណត់	tŋaypʰotkɑmnɑt
ថ្ងៃសីល	tŋaysǝl
ថ្ងៃសៅរ៍	tŋaysav
ថ្ងៃស្អែក	tŋaysʔaek
ថ្ងៃអាទិត្យ	tŋayʔaatɨt
ថ្នម	tnɑɑm
ថ្នល់	tnɑl,knɑl
ថ្នាក់	tnak
ថ្នាក់រៀន	tnakriən
ថ្នាំ	tnam
ថ្នាំដុសធ្មេញ	tnamdohtmɨɲ
ថ្នាំសន្លប់	tnamsɑnlɑp
ថ្នាំស្ពឹក	tnamspɨk
ថ្នេរ	tnee
ថ្ពក់	tpʊək
ថ្ពាល់	tpoal
ថ្ម	tmɑɑ
ថ្មី	tməy
ថ្មើរ	tmaə
ថ្មើរជើង	tmaəcəəŋ
ថ្លា	tlaa
ថ្លឹង	tləŋ
ថ្លើម	tlaəm
ថ្លៃ	tlay
ថ្វាយបង្គំ	tvaaybɑŋkum
ថ្វាយបង្គំព្រះ	tvaaybɑŋkumpreah
ទ	tɔɔ
ទង	tɔɔŋ
ទង់ជាតិ	tʊəŋciet
ទង្គិច	tʊəŋkɨc
ទង្វើ	tʊəŋvəə
ទទឹក	tɔtɨk
ទទួល	tɔtuəl
ទទួលទាន	tɔtuəltien
ទទួលយក	tɔtuəlyɔɔk
ទទួលរង	tɔtuəlrɔɔŋ
ទទេ	tɔtee
ទន់	tʊən
ទន់ខ្សោយ	tʊənksaoy
ទន្ទឹម	tʊəntɨm
ទន្លេ	tʊənlee
ទប់	tup
ទប់ទល់	tuptʊəl
ទម្ងន់	tumŋʊən
ទម្រ	tumrɔɔ
ទម្រេត	tumreet
ទម្លាក់	tumleak
ទម្លាប់	tumloap
ទល់	tʊəl
ទល់មុខ	tʊəlmuk
ទា	tie
ទាក់	teak
ទាក់ជើង	teakcəəŋ
ទាក់ទង	teaktɔɔŋ
ទាក់ទងគ្នា	teaktɔɔŋknie
ទាញ	tieɲ
ទាន	tien
ទាន់	toan
ទាប	tiep
ទាយ	tiey
ទារ	tie
ទាល់	toal
ទាល់តែ	toaltae
ទាស់ត្រង់	toahtrɑŋ
ទាំង	teaŋ
ទាំងនេះ	teaŋnih
ទាំងនោះ	teaŋnuh
ទាំងមូល	teaŋmuul
ទាំងស្រុង	teaŋsroŋ
ទាំងអស់	teaŋʔɑh
ទាំងអស់គ្នា	teaŋʔɑhknie
ទិញ	tɨɲ
ទិដ្ឋភាព	tittʰaʔpʰiep
ទិន្នន័យ	tɨnneaʔney
ទិស	tɨh
ទិសដៅ	tɨhdav
ទី	tii
ទីកន្លែង	tiikɑnlaeŋ
ទីក្រុង	tiikroŋ
ទីតាំង	tiitaŋ
ទីទុយ	tiituy
ទីទៃ	tiitey
ទីធ្លា	tiitlie
ទីនេះ	tiinih
ទីនោះ	tiinuh
ទីផ្សារ	tiipsaa
ទីរួមខេត្ត	tiiruəmkʰaet
ទឹក	tɨk
ទឹកកក	tɨkkɑɑ
ទឹកក្រឡុក	tɨkkrɑlok
ទឹកក្រអូប	tɨkkrɑʔoop
ទឹកក្រូច	tɨkkrouc
ទឹកខ្មេះ	tɨkkmeh
ទឹកចិត្ត	tɨkcət
ទឹកជំនន់	tɨkcumnʊən
ទឹកជ្រលក់	tɨkcrɔlʊək
ទឹកដក់	tɨkdɑk
ទឹកដោះគោ	tɨkdɑhkoo
ទឹកត្រី	tɨktrəy
ទឹកទន្លេ	tɨktʊənlee
ទឹកប្រាក់	tɨkprak
ទឹកភ្លៀង	tɨkpliəŋ
ទឹកមុខ	tɨkmuk
ទឹកមុខស្អុយ	tɨkmuksʔoy
ទឹកម៉ាស៊ីន	tɨkmaasin
ទឹករលក	tɨkrɔlɔɔk
ទឹកលិច	tɨklɨc
ទឹកសុទ្ធ	tɨksot
ទឹកស៊ីអ៊ីវ	tɨksiiʔiiv
ទឹកស៊ុប	tɨksup
ទុក	tuk
ទុកចិត្ត	tukcət
ទុកចោល	tukcaol
ទុកដាក់	tukdak
ទុកទុក	tuktuk
ទុក្ខ	tuk,tukkʰaʔ
ទុយោ	tuyoo
ទុរេន	tʰuureen,tuʔreen
ទុំ	tum
ទូ	tuu
ទូក	tuuk
ទូកក្ដោង	tuukkdaoŋ
ទូកចែវ	tuukcaev
ទូកញ្ចក់	tuukɑɲcɑk
ទូកម៉ាស៊ីន	tuukmaasin
ទូកអុំ	tuukʔom
ទូច	tuuc
ទូទាត់	tuutoat
ទូទាំង	tuuteaŋ
ទូទឹកកក	tuutɨkkɑɑk
ទូទៅ	tuutɨv
ទូន្មាន	tuulmien,tuunmien
ទូរទស្សន៍	tuureaʔtʊəh
ទូរស័ព្ទ	tuureaʔsap
ទូរស័ព្ទចល័ត	tuureaʔsapcaʔlat
ទូរស័ព្ទដៃ	tuureaʔsapday
ទូលាយ	tuuliey
ទើប	təəp
ទើបតែ	təəptae
ទើបនឹង	təəpnɨŋ
ទើស	təəh
ទើសទែង	təəhtɛɛŋ
ទៀង	tiəŋ
ទៀត	tiət
ទៀតសោត	tiətsaot
ទៀន	tien
ទេ	tee
ទេដឹង	teedəŋ
ទេតើ	teetaə
ទេសភាព	teehsaʔpʰiep
ទេហ	teehɑɑ
ទែម៉ូម៉ែត្រ	tɛɛmoumaet
ទោស	tooh
ទោះ	tʊəh
ទោះជា	tʊəhcie
ទោះបីជា	tʊəhbəycie
ទៅ	tɨv
ទៅកាន់	tɨvkan
ទៅដល់	tɨvdɑl
ទៅតាម	tɨvtaam
ទៅមុខ	tɨvmuk
ទៅវិញទៅមក	tɨvvɨɲtɨvmɔɔk
ទំនង	tumnɔɔŋ
ទំនប់ទឹក	tumnuptɨk
ទំនាក់ទំនង	tumneaktumnɔɔŋ
ទំនិញ	tumnɨɲ
ទំនុកចិត្ត	tumnukcət
ទំនើប	tumnəəp
ទំនេរ	tumnee
ទំនេរដៃ	tumneeday
ទំពក់	tumpʊək
ទំពា	tumpie
ទំពែក	tɑmpɛɛk
ទំព័រ	tumpoa
ទំហំ	tumhum
ទះ	teah
ទ្រ	trɔɔ
ទ្រនាប់ជើង	trɔnoapcəəŋ
ទ្រនិច	trɔnɨc
ទ្រព្យសម្បត្តិ	troapsɑmbat
ទ្រវែង	trɔvɛɛŋ
ទ្រាប់	troap
ទ្រាំ	troam
ទ្រូង	truuŋ
ទ្រើស	trəəh
ទ្វារ	tvie
ធ	tʰɔɔ
ធនាគារ	tʰeaʔniekie
ធម្មជាតិ	tʰoamʔciet,tʰoammeaʔciet
ធម្មតា	tʰoammeaʔtaa
ធាក់	tʰeak
ធាតុ	tʰiet
ធាត់	tʰoat
ធានា	tʰienie
ធានារ៉ាប់រង	tʰienieraprɔɔŋ
ធារី	tʰierii
ធារ៉ា	tʰieraa
ធី	tʰii
ធីតា	tʰiidaa
ធុង	tʰuŋ
ធុងសំរាម	tʰuŋsɑmraam
ធុញ	tʰuɲ
ធុញថប់	tʰuɲtʰɑp
ធុន	tʰun
ធុំក្លិន	tʰumklən
ធូប	tʰuup
ធូរ	tʰuu
ធូលី	tʰuulii
ធៀបការ	tʰiəpkaa
ធំ	tʰom
ធ្ងន់	tŋʊən
ធ្ងន់ធ្ងរ	tŋʊəntŋɔɔ
ធ្នើរ	tnəə
ធ្មឹង	tmɨŋ
ធ្មេញ	tmɨɲ
ធ្យូង	tyuuŋ,kcuuŋ
ធ្លាក់	tleak
ធ្លាប់	tloap
ធ្លាប់តែ	tloap
ធ្លាយ	tliey
ធ្វើ	tvəə
ធ្វើការ	tvəəkaa
ធ្វើដំណើរ	tvəədɑmnaə
ធ្វើមុខ	tvəəmuk
ធ្វើឡើង	tvəəlaəŋ
ធ្វើឲ្យ	tvəəʔaoy
ធ្វេសប្រហែស	tveehprɑhaeh
ន	nɔɔ
នង្គ័ល	ʔɑŋkoal,neaŋkoal,lʊəŋkoal
នរណា	nɔɔnaa
នរណាម្នាក់	nɔɔnaamneak
នរោត្តម	nɔroodɑm
នា	nie
នាក់	neak
នាគ	niek
នាគារ	niekie
នាង	nieŋ
នាទី	nietii
នានា	nienie
នាយ	niey
នារី	nierii
នាឡិកា	nieleʔkaa
នាឡិការោទ៍	nieliʔkaaroo
នាំ	noam
នាំគ្នា	noamknie
នាំចូល	noamcoul
នាំឲ្យ	noamʔaoy
និង	nɨŋ
និមន្ត	niʔmʊən
និមល	niʔmʊəl
និយម	niʔyum
និយាយ	niʔyiey
និយាយរួម	niʔyieyruəm
និយាយលេង	niʔyieyleeŋ
និយាយលេងសើច	niʔyieyleeŋsaǝc
និវាសដ្ឋាន	niʔviesattʰaan
និស្សិត	nihsət
នីតា	niitaa
នីតិវិធី	niiteʔviʔtʰii
នីមួយៗ	niimuəyniimuəy
នឹក	nɨk
នឹកឃើញ	nɨkkʰəəɲ
នឹង	nɨŋ
នឹងគ្នា	nɨŋknie
នុង	nuŋ
នុះ	nuh
នូវ	nɨv
នួក	nuək
នួន	nuən
នឿយ	nɨəy
នៀក	niək
នេះ	nih
នែ	nɛɛ,nɛʔ,nae
នៃ	ney
នោះ	nuh
នៅ	nɨv
នៅតែ	nɨvtae
នៅមុខ	nɨvmuk
នំ	num
នំខេក	numkʰeek
នំបញ្ចុក	numbɑɲcok
នំប៉័ង	numpaŋ
ន័យ	ney
ប	bɑɑ
បក	bɑɑk
បកប្រែ	bɑɑkprae
បក់	bɑk
បង	bɑɑŋ
បងប្រុស	bɑɑŋproh
បងប្អូន	bɑɑŋpʔoun
បងប្អូនជីដូន	bɑɑŋpʔounciidoun
បងស្រី	bɑɑŋsrǝy
បង់	bɑŋ
បង់បិទដំបៅ	bɑŋbətdɑmbav
បង់លុយ	bɑŋluy
បង្ក	bɑŋkɑɑ
បង្កង់	bɑŋkɑŋ
បង្កប់ន័យ	bɑŋkɑpney
បង្កាន់ដៃ	bɑŋkanday
បង្ការ	bɑŋkaa
បង្កើត	bɑŋkaət
បង្ខំ	bɑŋkʰɑm
បង្គន់	bɑŋkʊən
បង្គាប់	bɑŋkoap
បង្គោល	bɑŋkool
បង្រៀន	bɑŋriən
បង្វិល	bɑŋvəl
បង្ហាញ	bɑŋhaaɲ
បង្ហាញខ្លួន	bɑŋhaaɲkluən
បង្ហូត	bɑŋhoot
បង្ហូរ	bɑŋhou
បង្ហើយ	bɑŋhaəy
បង្ហោះ	bɑŋhɑh
បង្អង់	bɑŋʔɑŋ
បង្អស់	bɑŋʔɑh
បង្អុរ	bɑŋʔao,bɑŋʔol
បង្អួច	bɑŋʔuəc
បង្អែក	bɑŋʔaek
បង្អែម	bɑŋʔaem
បច្ចុប្បន្ន	paccopbɑn
បញ្ចប់	bɑɲcɑp
បញ្ចុះបញ្ចូល	bɑɲcohbɑɲcoul
បញ្ចូល	bɑɲcoul
បញ្ចេញ	bɑɲcəɲ
បញ្ច្រាស	bɑɲcraah
បញ្ឆេះ	bɑɲcʰeh
បញ្ជរ	bɑɲcɔɔ
បញ្ជា	bɑɲcie
បញ្ជាក់	bɑɲceak
បញ្ជោរ	bɑɲcoo
បញ្ជ្រៀត	bɑɲcriət
បញ្ឈប់	bɑɲcʰup
បញ្ឈរជង្គង់	bɑɲcʰɔɔcʊəŋkʊəŋ
បញ្ញា	paɲɲaa
បញ្ញើ	bɑɲɲaə
បញ្ហា	paɲhaa,baɲhaa
បដិមា	paʔdeʔmaa
បដិសេធ	paʔdeʔsaet
បឋម	paʔtʰɑm
បណ្ដាញ	bɑndaaɲ
បណ្ដាញទំនាក់ទំនងសង្គម	bɑndaaɲtumneaktumnɔɔŋsɑŋkum
បណ្ដាញសង្គម	bɑndaaɲsɑŋkum
បណ្ដាលឲ្យ	bɑndaalʔaoy
បណ្ដុំ	bɑndom
បណ្ដុះ	bɑndoh
បណ្ដូល	bɑndoul
បណ្ដើរ	bɑndaə
បណ្ដេញ	bɑndəɲ
បណ្ដោយ	bɑndaoy
បណ្ណាគារ	bannaakie
បណ្ណាល័យ	pannaalay
បត់	bɑt
បត់ជើង	bɑtcəəŋ
បទ	bɑt
បទនគររាជ	bɑtnɔkɔɔriec
បន់	bɑn
បន្ត	bɑntɑɑ
បន្តក់	bɑntɑk
បន្តិច	bɑntəc
បន្តិចក្រោយមក	bɑntəckraoymɔɔk
បន្តិចបន្តួច	bɑntəcbɑntuəc
បន្តុប	bɑntop
បន្ថយ	bɑntʰɑɑy
បន្ថែម	bɑntʰaem
បន្ទប់	bɑntup
បន្ទប់គេង	bɑntupkeeŋ
បន្ទប់ទឹក	bɑntuptɨk
បន្ទប់ល	bɑntuplɔɔ
បន្ទាន់	bɑntoan
បន្ទាប់	bɑntoap
បន្ទាប់ពី	bɑntoappii
បន្ទាប់មក	bɑntoapmɔɔk
បន្ទោស	bɑntooh
បន្ទះ	bɑnteah
បន្លា	bɑnlaa
បន្លឺ	bɑnlɨɨ,bɑnləɨ
បន្លែ	bɑnlae
បបរ	bɑbɑɑ
បបូរមាត់	bɑboumoat
បបួល	bɑbuəl
បម្រាម	bɑmraam
បម្រើ	bɑmraə
បរទេស	bɑɑrəteeh
បរិភោគ	bɑɑreʔpʰook
បរិមាណ	paʔreʔmaan
បរិយាកាស	paʔreʔyaakaah
បរិវេណ	bɑɑreʔveen
បរិស្ថាន	bɑɑreʔstʰaan
បស់	bɑh
បាក់	bak
បាក់តេរី	bakteerii
បាងកក	baaŋkɑɑk
បាច	baac
បាច់	bac
បាញ់	baɲ
បាត	baat
បាតដៃ	baatday
បាតទន្លេ	baattʊənlee
បាតសមុទ្រ	baatsaʔmot
បាត់	bat
បាត់បង់	batbɑŋ
បាត់បង់ជីវិត	batbɑŋciivɨt
បាត់ស្រេក	batsreek
បាត្រ	baat
បាទ	baat
បាន	baan
បានន័យថា	baanneytʰaa
បាប	baap
បាយ	baay
បាយដំណើប	baaydɑmnaəp
បាយដំណើបសំខ្យា	baaydɑmnaəpsɑŋkyaa
បាយបាយ	baaybaay
បាយៗ	baaybaay
បារមី	baareaʔməy
បារម្ភ	baarɑm
បារាំង	baaraŋ
បារី	baarəy,pərəy
បាល់	bal
បាល់ទាត់	baltoat
បាវ	baav
បាសក	baasɑk
បាំង	baŋ
បាំងវាំងនន	baŋveaŋnɔɔn
បិណ្ឌ	bən
បិណ្ឌបាត	bənbaat
បិទ	bət
បិទបាំង	bətbaŋ
បី	bəy
បីសាច	bəysaac
បឹង	bəŋ
បឺត	bəɨt
បុក	bok
បុគ្គល	bokkʊəl
បុគ្គលិក	bokkeaʔlɨk
បុណ្យ	bon
បុណ្យទាន	bontien
បុប្ផា	boppʰaa
បុព្វការី	boppeaʔkaarəy
បុរស	boʔrɑh
បុរាណ	boʔraan
បូក	bouk
បូជា	boucie
បូនើស	bounǝǝs
បូម	boum
បូរ៉ា	bouraa
បួង	buəŋ
បួងសួង	buəŋsuəŋ
បួន	buən
បើ	baə
បើក	baək
បើកចំហ	baəkcɑmhɑɑ
បើកបរ	baəkbɑɑ
បើសិនជា	baəsəncie
បៀតបៀន	biətbiən
បៀម	biəm
បៀរ	biǝ
បេតុង	beetoŋ
បេះ	beh
បេះដូង	behdouŋ
បេះបិទ	behbət
បែក	baek
បែកគុម្ព	baekkum
បែកញើស	baekɲəəh
បែកអេក	baekʔeek
បែងចែក	baeŋcaek
បែនស្រូវ	baensrǝv
បែប	baep
បែរ	bae
បៃតង	baytɑɑŋ
បោក	baok
បោស	baoh
បោះ	bɑh
បោះចោល	bɑhcaol
បោះជំហាន	bɑhcumhien
បោះពុម្ព	bɑhpum
បំណង	bɑmnɑɑŋ
បំណែក	bɑmnaek
បំបាត់	bɑmbat
បំបែក	bɑmbaek
បំផុត	bɑmpʰot
បំពង	bɑmpɔɔŋ
បំពង់	bɑmpʊəŋ
បំពង់ក	bɑmpʊəŋkɑɑ
បំពង់បឺត	bɑmpʊəŋbəɨt
បំពានច្បាប់	bɑmpiencbap
បំពេញ	bɑmpɨɲ
បំភ្លឺ	bɑmplɨɨ
បះ	bah
ប៉ង	pɑɑŋ
ប៉ង់	pɑŋ
ប៉ា	paa
ប៉ាក់	pak
ប៉ាក់ប៉ើក	pakpaək
ប៉ាត	paat
ប៉ាន់តែ	pantae
ប៉ាន់ស្មាន	pansmaan
ប៉ាវ	paav
ប៉ាស់ស្ព័រ	pahspoa
ប៉ិកគក់	pəkkʊək
ប៉ិន	pən
ប៉ិបស៊ី	pepsii
ប៉ុក	pok
ប៉ុណ្ណា	ponnaa
ប៉ុណ្ណឹង	ponnəŋ
ប៉ុណ្ណោះ	ponnɑh
ប៉ុន	pon
ប៉ុនណា	ponnaa
ប៉ុន្តែ	pontae
ប៉ុន្មាន	ponmaan
ប៉ូលិស	poulih
ប៉េងប៉ោះ	peeŋpɑh
ប៉ែក	paek
ប៉ោត	paot
ប៉ោម	paom
ប៉ះ	pah
ប៉ះចំ	pahcɑm
ប៉ះទង្គិច	pahtʊəŋkɨc
ប៉ះពាល់	pahpoal
ប៊ិច	bic
ប៊ីចេង	biiceeŋ
ប៊ីដុង	biidoŋ
ប៊ីយេរ	biiyɛɛ
ប៊ូតុង	buutoŋ
ប្ដឹង	pdəŋ
ប្ដូរ	pdou
ប្តី	pdəy
ប្រកប	prɑkɑɑp
ប្រកបមុខរបរ	prɑkɑɑpmukrɔbɑɑ
ប្រកបរបរ	prɑkɑɑprɔbɑɑ
ប្រកាច់	prɑkac
ប្រកាន់	prɑkan
ប្រកួត	prɑkuət
ប្រគល់	prɑkʊəl
ប្រគេន	prɑkeen
ប្រចាំ	prɑcam
ប្រចាំថ្ងៃ	prɑcamtŋay
ប្រជាជន	prɑciecʊən
ប្រជាប្រិយ	prɑcieprəy
ប្រជាប្រិយភាព	prɑcieprəypʰiep
ប្រជុំ	prɑcum
ប្រជុំជន	prɑcumcɔɔn
ប្រជែង	prɑcɛɛŋ
ប្រជ្រៀត	prɑcriet
ប្រញាប់	prɑɲap
ប្រញាប់ប្រញាល់	prɑɲapprɑɲal
ប្រដាប់	prɑdap
ប្រដូច	prɑdouc
ប្រណាំង	prɑnaŋ
ប្រតិកម្ម	prɑteʔkam
ប្រតិទិន	prɑteʔtɨn
ប្រថុយ	prɑtʰoy
ប្រទេស	prɑteeh
ប្រធាន	prɑtʰien
ប្រធានបទ	prɑtʰienbɑt
ប្រផេះ	prɑpʰeh
ប្រពន្ធ	prɑpʊən
ប្រពៃណី	prɑpeynii
ប្រព័ន្ធ	prɑpoan
ប្រព្រឹត្ត	prɑprɨt
ប្រភព	prɑpʰup
ប្រភេទ	prɑpʰeet
ប្រមាណ	prɑmaan
ប្រមូល	prɑmoul
ប្រយោជន៍	prɑyaoc
ប្រយ័ត្ន	prɑyat
ប្រយ័ត្នប្រយែង	prɑyatprɑyaeŋ
ប្រលែង	prɑlaeŋ
ប្រល័យ	prɑlay
ប្រវែង	prɑvaeŋ
ប្រសក	prɑsɑk
ប្រសិទ្ធភាព	prɑsətpʰiep
ប្រសិទ្ធិភាព	prɑsəttʰiʔpʰiep,prɑsettʰiʔpʰiep
ប្រសិន	prɑsən
ប្រសិនបើ	prɑsənbaə
ប្រហាក់ប្រហែល	prɑhakprɑhael
ប្រហុក	prɑhok
ប្រហើរ	prɑhaə
ប្រហែល	prɑhael
ប្រហែស	prɑhaeh
ប្រហោង	prɑhaoŋ
ប្រឡង	prɑlɑɑŋ
ប្រឡាក់	prɑlak
ប្រឡេះ	prɑleh
ប្រឡោះ	prɑlɑh
ប្រអប់	prɑʔɑp
ប្រអប់ស្នោ	prɑʔɑpsnao
ប្រាកដ	prakɑt
ប្រាកដជា	praakɑɑtcie
ប្រាក់	prak
ប្រាក់ខែ	prakkʰae
ប្រាក់រាយ	prakriey
ប្រាក់អាប់	prakʔap
ប្រាថ្នា	pratnaa
ប្រាប់	prap
ប្រារព្ធ	praarup
ប្រាស់	prah
ប្រាំ	pram
ប្រាំង	praŋ
ប្រាំបី	prambəy
ប្រាំបួន	prambuən
ប្រាំពិល	prampɨl
ប្រាំពីរ	prampii,prampɨl
ប្រាំមួយ	prammuəy
ប្រឹង	prəŋ
ប្រឹងប្រែង	prəŋpraeŋ
ប្រុង	proŋ
ប្រុងប្រយ័ត្ន	proŋprɑyat
ប្រុស	proh
ប្រូតេអ៊ីន	prouteeʔiin
ប្រូម៉ូសិន	broumousǝn
ប្រើ	praə
ប្រើប្រាស់	praəprah
ប្រើឲ្យ	praəʔaoy
ប្រៀប	priəp
ប្រេង	preeŋ
ប្រេងកូឡា	preeŋkoulaa
ប្រេងខ្យល់	preeŋkcɑl,preeŋkyɑl
ប្រេន	breen
ប្រេះ	preh
ប្រែ	prae
ប្រែប្រួល	praepruəl
ប្រៃ	pray
ប្រៃសណីយ៍	praysaʔnii
ប្លាស្ទិក	plaastɨk
ប្លែក	plaek
ប្អូន	pʔoun
ប្អូនស្រី	pʔounsrǝy
ផង	pʰɑɑŋ
ផងដែរ	pʰɑɑŋdae
ផត	pʰɑɑt
ផល	pʰɑl
ផលដំណាំ	pʰɑldɑmnam
ផលិត	pʰɑlɨt,pʰɑlət
ផាក	pʰaak
ផានិត	pʰaanɨt
ផាមួង	pʰaamuəŋ
ផារី	pʰaarii
ផិនណលធី	pʰənnɑltʰii
ផឹក	pʰək
ផុង	pʰoŋ
ផុត	pʰot
ផុយ	pʰoy
ផែ	pʰae
ផែនដី	pʰaendəy
ផែនទី	pʰaentii
ផ្កា	pkaa
ផ្កាឈូក	pkaacʰuuk
ផ្កាប់	pkap
ផ្គត់ផ្គង់	pkʊətpkʊəŋ
ផ្គុំ	pkum
ផ្ងារ	pŋaa
ផ្ចិត	pcət,psət
ផ្ញើ	pɲaə
ផ្ដល់	pdɑl
ផ្ដាច់	pdac
ផ្ដាសាយ	pdaasaay
ផ្ដុំ	pdom
ផ្ដើម	pdaəm
ផ្ដេក	pdeek
ផ្ដេសផ្ដាស	pdeehpdaah
ផ្តិល	ptəl
ផ្ទាប់	ptoap
ផ្ទាល់	ptoal
ផ្ទាល់ខ្លួន	ptoalkluən
ផ្ទាំង	pteaŋ
ផ្ទុយ	ptuy
ផ្ទុយទៅវិញ	ptuytɨvvɨɲ
ផ្ទុយពី	ptuypii
ផ្ទេរ	ptee
ផ្ទៃ	ptey
ផ្ទៃមុខ	pteymuk
ផ្ទៃសមុទ្រ	pteysaʔmot
ផ្ទះ	pteah
ផ្ទះបាយ	pteahbaay
ផ្ទះល្វែង	pteahlvɛɛŋ
ផ្នែក	pnaek
ផ្លាក	plaak
ផ្លាកតម្លៃ	plaaktɑmlay
ផ្លាស់	plah
ផ្លិតទឹក	pləttɨk
ផ្លុំ	plom
ផ្លូវ	pləv
ផ្លូវការ	pləvkaa
ផ្លូវគោក	pləvkook
ផ្លូវជាតិ	pləvciet
ផ្លូវដែក	pləvdaek
ផ្លូវថ្នល់	pləvtnɑl
ផ្លូវទាល់	pləvtoal
ផ្លូវទឹក	pləvtɨk
ផ្លូវភេទ	pləvpʰeet
ផ្លូវលំ	pləvlum
ផ្លូវអាកាស	pləvʔaakaah
ផ្លែ	plae
ផ្លែឈើ	plaecʰəə
ផ្សង	psɑɑŋ
ផ្សាយ	psaay
ផ្សារ	psaa
ផ្សារទំនើប	psaatumnəəp
ផ្សាររាត្រី	psaarietrəy
ផ្សេង	pseeŋ
ផ្សេងទៀត	pseeŋtiət
ផ្សែង	psaeŋ
ផ្សំ	psɑm
ផ្សំថ្នាំ	psɑmtnam
ផ្អាប់ទុក	pʔaptuk
ផ្អៀង	pʔiəŋ
ផ្អែក	pʔaek
ផ្អែម	pʔaem
ព	pɔɔ
ពង	pɔɔŋ
ពងក្រពើ	pɔɔŋkrɑpəə
ពងមាន់	pɔɔŋmoan
ពញ្ញាក់	pʊəɲɲeak
ពណ៌	poa
ពត់ខ្លួន	pʊətkluən
ពន្ធ	pʊən
ពន្ធធនាគារ	pʊəntʰeaʔniekie
ពន្ធនាគារ	pʊəntʰeaʔniekie
ពន្យល់	pʊənyʊəl
ពន្លិច	pʊənlɨc
ពន្លឺ	pʊənlɨɨ
ពពក	pɔpɔɔk
ពពុះ	pɔpuh
ពរ	pɔɔ
ពរ្សឺឡែន	poasəɨlaen,pɔɔksəɨlaen
ពលកម្ម	pʊəlleaʔkam
ពាក់	peak
ពាក់កណ្ដាល	peakkɑndaal
ពាក់ឆៀង	peakcʰiəŋ
ពាក់ព័ន្ធ	peakpoan
ពាក្យ	piek
ពាក្យពេចន៍	piekpɨc
ពាក្យមុសា	piekmuʔsaa
ពាក្យសុំ	pieksom
ពាក្យសូរដូច	pieksoudouc
ពាក្យសំដី	pieksɑmdəy
ពាក្យស្លោក	piekslaok
ពាង	pieŋ
ពាន់	poan
ពាសវាលពាសកាល	piehvielpiehkaal
ពិចនិច	pɨcnɨc
ពិត	pɨt
ពិតជា	pɨtcie
ពិតប្រាកដ	pɨtpraakɑɑt
ពិតមែន	pɨtmɛɛn
ពិតាន	pidaan
ពិធី	piʔtʰii
ពិធីករ	piʔtʰiikɑɑ
ពិធីបុណ្យ	piʔtʰiibon
ពិនិត្យ	piʔnɨt
ពិនិត្យមើល	piʔnɨtməəl
ពិន័យ	piʔney
ពិន្ទុ	pɨntuʔ
ពិបាក	piʔbaak
ពិបាកចិត្ត	piʔbaakcət
ពិពណ៌នា	piʔpoanaʔnie,piʔpoanie
ពិភាក្សា	piʔpʰieksaa
ពិសា	piisaa,piʔsaa
ពិសិដ្ឋ	piʔsət
ពិសី	piʔsəy
ពិសេស	piʔseh
ពី	pii
ពីក្រោម	piikraom
ពីក្រោយ	piikraoy
ពីងពាង	piiŋpieŋ
ពីដើម	piidaəm
ពីព្រោះ	piiprʊəh
ពីមុន	piimun
ពីរ	pii,pɨl
ពីរណ្ដប់	piindɑp
ពីរោះ	piirʊəh
ពឹង	pɨŋ
ពឹងផ្អែក	pɨŋpʔaek
ពឹងពាក់	pɨŋpeak
ពុក	puk
ពុកមាត់	pukmoat
ពុល	pul
ពុលបាយ	pulbaay
ពុលរលក	pulrɔlɔɔk
ពុំ	pum
ពុំខាន	pumkʰaan
ពុំទាន់	pumtoan
ពុំសូវ	pumsəv
ពុះ	puh
ពូ	puu
ពូក	puuk
ពូកែ	puukae
ពូជ	puuc
ពូត	puut
ពូថៅ	puutʰav
ពូន	puun
ពូនភ្នំ	puunpnum
ពួក	puək
ពួកខ្ញុំ	puəkkɲom
ពួកគាត់	puəkkoat
ពួកគេ	puəkkee
ពួកម៉ាក	puəkmaak
ពេក	peek
ពេជ្រ	pɨc
ពេញ	pɨɲ
ពេញចិត្ត	pɨɲcət
ពេញនិយម	pɨɲniʔyum
ពេទ្យ	pɛɛt
ពេល	peel
ពេលខ្លះ	peelklah
ពេលថ្ងៃ	peeltŋay
ពេលថ្ងៃត្រង់	peeltŋaytrɑŋ
ពេលទំនេរ	peeltumnee
ពេលព្រឹក	peelprɨk
ពេលព្រឹកព្រលឹម	peelprɨkprɔlɨm
ពេលយប់	peelyup
ពេលល្ងាច	peellŋiec
ពេលវេលា	peelveelie
ពែង	pɛɛŋ
ពែនភ្នែន	pɛɛnpnɛɛn
ពោត	poot
ពោធិ៍សាត់	poosat
ពោរ	pou
ពោរពេញ	poopɨɲ
ពោល	pool
ពោះ	pʊəh
ពំនូក	pumnuuk
ព័ត៌មាន	poadɑɑmien
ព័ទ្ធ	poat
ព្យញ្ជនៈ	pyʊəɲceaʔneaʔ
ព្យាបាល	pyiebaal
ព្យាយាម	pyieyiem
ព្យួរ	pyuə
ព្រម	prɔɔm
ព្រមគ្នា	prɔɔmknie
ព្រមទាំង	prɔɔmteaŋ
ព្រលឹម	prɔlɨm
ព្រាយ	priey
ព្រី	prii
ព្រីន	priin
ព្រឹក	prɨk
ព្រឹកមិញ	prɨkmɨɲ
ព្រុស	pruh
ព្រួយ	pruəy
ព្រួយបារម្ភ	pruəybaarɑm
ព្រួស	pruəh
ព្រៃ	prey
ព្រោះ	prʊəh
ព្រោះអី	prʊəhʔəy
ព្រះ	preah
ព្រះចន្ទ	preahcan
ព្រះពុទ្ធ	preahput
ព្រះពុទ្ធសាសនា	preahputsaasnaa
ព្រះមហាក្សត្រ	preahmɔhaaksat
ព្រះវិហារ	preahviʔhie
ព្រះសង្ឃ	preahsɑŋ
ព្រះអាទិត្យ	preahʔaatɨt
ភ	pʰɔɔ
ភក់	pʰʊək
ភស្តុតាង	pʰoahtaaŋ
ភា	pʰie
ភាគ	pʰiek
ភាគច្រើន	pʰiekcraən
ភាគរយ	pʰiekrɔɔy
ភាគី	pʰiekii
ភាន់ច្រឡំ	pʰoancrɑlɑm
ភាព	pʰiep
ភាយ	pʰiey
ភាសា	pʰiesaa
ភីហ្សា	piisaa
ភូមិ	pʰuum
ភួយ	pʰuəy
ភេសជ្ជៈ	pʰeehsacceaʔ
ភោជនីយដ្ឋាន	pʰooceaʔniiyeaʔtʰaan
ភ័យ	pʰey
ភ្ជាប់	pcoap
ភ្ជាប់នឹង	pcoapnɨŋ
ភ្ជួរ	pcuə
ភ្ជួរស្រែ	pcuəsrae
ភ្ញាក់	pɲeak
ភ្ញាក់ផ្អើល	pɲeakpʔaəl
ភ្ញៀវ	pɲiəv
ភ្នាក់ងារ	pneakŋie
ភ្នាល់	pnoal
ភ្នែក	pnɛɛk
ភ្នំ	pnum
ភ្នំបូកគោ	pnumboukkoo
ភ្នំពេញ	pnumpɨɲ
ភ្នំសន្ទុក	pnumsɑntuk
ភ្លាម	pliem
ភ្លី	plii
ភ្លឹក	plɨk
ភ្លឹង	plɨŋ
ភ្លឺ	plɨɨ
ភ្លើង	pləəŋ
ភ្លើងស៊ីញ៉ូ	pləəŋsiiɲou
ភ្លើងស្តុប	pləəŋstop
ភ្លៀង	pliəŋ
ភ្លេង	pleeŋ
ភ្លេងជាតិ	pleeŋciet
ភ្លេច	plɨc
ភ្លេចខ្លួន	plɨckluən
ភ្លេចដៃ	plɨcday
ភ្លេចភ្លាំង	plɨcpleaŋ
ភ្លែត	plɛɛt
ភ្លៅ	plɨv
ម	mɔɔ
មក	mɔɔk
មកកាន់	mɔɔkkan
មកដល់	mɔɔkdɑl
មកពី	mɔɔkpii
មកុដ	meaʔkot,mɔkot
មង្ឃុត	mʊəŋkʰut
មណ្ឌល	mʊəndʊəl
មណ្ឌលគិរី	mʊəndʊəlkiʔrii
មធ្យម	matyum,meaʔtyum
មធ្យោបាយ	matyoubaay
មនុស្ស	meaʔnuh,mɔnuh
មនុស្សម្នា	mɔnuhmnie
មនុស្សម្នាក់	meaʔnuhmneak
មន្ទិល	mʊəntɨl
មន្ទីរពេទ្យ	mʊəntiipɛɛt
មរកត	meaʔreaʔkɑt,mɔrəkɑt
មាតា	miedaa
មាត់	moat
មាត់ច្រាំង	moatcraŋ
មាត់ទន្លេ	moattʊənlee
មាត់ទឹក	moattɨk
មាន	mien
មានការ	mienkaa
មានគុណ	mienkun
មានណា	miennaa
មានទៅស្អី	mientɨvsʔǝy
មានន័យ	mienney
មានបាន	mienbaan
មានប្រសាសន៍	mienprɑsaah
មានអី	mienʔəy
មាន់	moan
មាស	mieh
មាំ	moam
មិញ	mɨɲ
មិត្ត	mɨt
មិត្តប្រុស	mɨtproh
មិត្តភក្តិ	mɨtpʰeaʔ
មិត្តស្រី	mɨtsrəy
មិន	mɨn
មិនខាន	mɨnkʰaan
មិនខ្វល់	mɨnkvɑl
មិនដែល	mɨndael
មិនថា	mɨntʰaa
មិនទាន់	mɨntoan
មិនទាំង	mɨnteaŋ
មិនបាច់	mɨnbac
មិនមែន	mɨnmɛɛn
មិនសូវ	mɨnsəv
មិនអីទេ	mɨnʔəytee
មី	mii
មីង	miiŋ
មីនុយ	miinuy
មុខ	muk
មុខងារ	mukŋie
មុខជូរ	mukcuu
មុខតំណ	mukdɑmnɑɑ
មុខមាត់	mukmoat
មុខរបរ	mukrɔbɑɑ
មុខរបួស	mukrɔbuəh
មុខវិជ្ជា	mukvɨccie
មុខស្អុយ	muksʔoy
មុជ	muc
មុត	mut
មុន	mun
មុននឹង	munnɨŋ
មុំ	mum
មូរ	muu
មូល	muul
មូលហេតុ	muulhaet
មូស	muuh
មូសខ្លា	muuhklaa
មូសដែកគោល	muuhdaekkool
មួក	muək
មួកការពារ	muəkkaapie
មួកសុវត្ថិភាព	muəksoʔvattʰeʔpʰiep
មួម៉ៅ	muəmav
មួយ	muəy
មួយទឹក	muəytɨk
មួយទៀត	muəytiət
មួយវិញទៀត	muəyvɨɲtiət
មួល	muəl
មើម	məəm
មើល	məəl
មើលឃើញ	məəlkʰəəɲ
មើលទៅ	məəltɨv
មេ	mee
មេឃ	meek
មេឃស្រទុំ	meeksrɑɑtum
មេដៃ	meeday
មេមាន់	meemoan
មេរៀន	meeriən
មេរោគ	meerook
មេសា	meesaa
មែន	mɛɛn
មែនទែន	mɛɛntɛɛn
មោឃៈ	mookʰeaʔ
ម៉ង	mɑɑŋ
ម៉ស់	mɑh
ម៉ា	maa
ម៉ាក	maak
ម៉ាក់	mak
ម៉ាគំនរ	maakumnɔɔ
ម៉ាឃីតធីង	maakʰiitʰiiŋ
ម៉ាណ្ដប់	maandɑp
ម៉ាន	maan
ម៉ាស៊ីន	maasin
ម៉ាស៊ីនត្រជាក់	maasintrɑceak
ម៉ាស៊ីនបញ្ចាំងស្លាយ	maasinbɑɲcaŋslaay
ម៉ាស៊ីនបូមធូលី	maasinboumtʰuulii
ម៉ាស៊ីនបោកខោអាវ	maasinbaokkʰaoʔaav
ម៉ាស៊ីនលាងចាន	maasinlieŋcaan
ម៉ាស៊ូត	maasuut
ម៉ាស្ទ័រ	maastoa
ម៉ាឡេស៊ី	maaleezii
ម៉ឺន	məɨn
ម៉ូត	mout
ម៉ូតូ	moutou
ម៉ូតូឌុប	moutoudup
ម៉ូទ័រ	moutoa
ម៉ូនីទ័រ	mouniitoa
ម៉ូយ	mouy
ម៉េច	məc
ម៉េចក៏	məckɑɑ
ម៉េចចឹង	məccəŋ
ម៉េចដែរ	məcdae
ម៉េចហ្នឹង	məcnɨŋ
ម៉េប	məp
ម៉េះ	meh
ម៉ែ	mae
ម៉ោ	mao
ម៉ោង	maoŋ
ម៉ោពី	maopii
ម្ខាង	mkʰaaŋ
ម្ខាងទៀត	mkʰaaŋtiət
ម្ចាស់	mcah
ម្ជុល	mcul
ម្ជុលចាក់ថ្នាំ	mculcaktnam
ម្ជូរ	mcuu
ម្ដង	mdɑɑŋ
ម្ដងទៀត	mdɑɑŋtiət
ម្ដងម្នាក់	mdɑɑŋmneak
ម្ដងៗ	mdɑɑŋmdɑɑŋ
ម្ដាយ	mdaay
ម្ដុំ	mdom
ម្ទេស	mteeh
ម្ទេសប្លោក	mteehplaok
ម្នាក់	mneak
ម្នាក់ឯង	mneakʔaeŋ
ម្នាស់	mnoah
ម្ភៃ	mpʰey
ម្យ៉ាង	myaaŋ
ម្យ៉ាងទៀត	myaaŋtiət
ម្យ៉ាងម្នាក់	myaaŋmneak
ម្យ៉ាងវិញទៀត	myaaŋvɨɲtiət
ម្រាម	mriem
ម្រាមដៃ	mriemday
ម្រាមដៃនាង	mriemdaynieŋ
ម្រាមនាងដៃ	mriemnieŋday
ម្លប់	mlup
ម្លិះ	mlih
ម្ល៉េះ	mleh
ម្សិលមិញ	msəlmɨɲ
ម្សិលម្ង៉ៃ	msəlmŋay
ម្សៅ	msav
ម្ហូប	mhoup
យក	yɔɔk
យកចិត្តទុកដាក់	yɔɔkcəttukdak
យកម៉ង	yɔɔkmɑɑŋ
យក្ស	yeak
យន្តហោះ	yʊənhɑh
យប់	yup
យល់	yʊəl
យល់ព្រម	yʊəlprɔɔm
យល់សប្តិ	yʊəlsɑp
យល់ស្រប	yʊəlsrɑɑp
យាម	yiem
យាយ	yiey
យី	yii
យឹត	yɨt
យឺត	yɨɨt
យឺតយ៉ាវ	yɨɨtyaav
យុថ្កា	yuttkaa
យុវជន	yuʔveaʔcʊən
យុវវ័យ	yuʔveaʔvey
យូធូប	yuutʰuup
យូរ	yuu
យួរ	yuə
យើង	yəəŋ
យេស	yeeh
យោក	yook
យោបល់	yoobɑl
យោល	yool
យ៉ាង	yaaŋ
យ៉ាងដូចម្ដេច	yaaŋdoucmdəc
យ៉ាងណាក៏ដោយ	yaaŋnaakɑɑdaoy
យ៉ាងតិច	yaaŋtəc
យ៉ាងម៉េច	yaaŋməc
យ៉ាប់	yap
យ៉ាប់ម៉ង	yapmɑɑŋ
រ	rɔɔ
រក	rɔɔk
រកលុយ	rɔɔkluy
រកស៊ី	rɔɔksii
រក្សា	reaksaa
រងា	rɔŋie
រងាវ	rɔŋiev
រងើកភ្លើង	rɔŋəəkpləəŋ
រង់ចាំ	rʊəŋcam,rɔɔŋcam
រង្គើ	rʊəŋkəə
រង្វង់	rʊəŋvʊəŋ
រង្វាស់រង្វាល់	rʊəŋvoahrʊəŋvoal
រចនាបថ	reaʔcaʔnaabɑt
រញ៉េរញ៉ៃ	rɔɲeerɔɲay
រដូវ	rɔdəv
រដូវក្ដៅ	rɔdəvkdav
រដូវត្រជាក់	rɔdəvtrɑceak
រដូវប្រាំង	rɔdəvpraŋ
រដូវភ្លៀង	rɔdəvpliəŋ
រដូវរងា	rɔdəvrɔŋie
រដូវវស្សា	rɔdəvvoahsaa
រដ្ឋ	roat
រណារ	rɔnaa
រតនា	reaʔtaʔnaa
រតនៈ	roattaʔnaʔ,reaʔtaʔnaʔ
រត់	rʊət
រថភ្លើង	rʊətpləəŋ
រថយន្ត	rʊətyʊən
រថយន្តក្រុង	rʊətyʊənkroŋ
រទេះ	rɔteh
រទេះភ្លើង	rɔtehpləəŋ
រនាប	rɔniep
រនាស់	rɔnoah
រនាំង	rɔneaŋ
រន្ទះ	rʊənteah
រន្ធ	rʊən
របង	rɔbɑɑŋ
របស់	rɔbɑh
របស់របរ	rɔbɑhrɔbɑɑ
របាទ	rɔbaat
របាយការណ៍	rɔbaaykaa
របារ	rɔbaa
របាំង	rɔbaŋ
របូត	rɔbout
របួស	rɔbuəh
របៀប	rɔbiəp
រប៉ាត់រប៉ាយ	rɔpatrɔpaay
រពឹស	rɔpɨh
រមណីយដ្ឋាន	reaʔmeaʔniiyeaʔtʰaan
រមាស់	rɔmoah
រមួល	rɔmuəl
រយ	rɔɔy
រយៈ	reaʔyeaʔ
រយៈពេល	reaʔyeaʔpeel
រលក	rɔlɔɔk
រលត់	rɔlʊət
រលាក	rɔliek
រលាត់	rɔloat
រលាយ	rɔliey
រលាស់	rɔloah
រលុង	rɔluŋ
រលោង	rɔlooŋ
រវល់	rɔvʊəl
រវាង	rɔvieŋ
រវិច	rɔvɨc
រសជាតិ	rʊəhciet
រសាត់	rɔsat
រសៀល	rɔsiəl
រស់	rʊəh
រស់នៅ	rʊəhnɨv
រស់រាន	rʊəhrien
រស្មី	reaʔsməy
រហន់	rɔhɑn
រហូត	rɔhout
រហូតដល់	rɔhoutdɑl
រហែក	rɔhaek
រហ័ស	rɔhah
រអិល	rɔʔəl
រអិលដួល	rɔʔəlduəl
រអៀសខ្លួន	rɔʔiəhkluən
រអែង	rɔʔaeŋ
រាក	riek
រាក់	reak
រាក់ទាក់	reakteak
រាង	rieŋ
រាងកាយ	rieŋkaay
រាត្រី	rietrəy
រានហាល	rienhaal
រាប	riep
រាប់	roap
រាប់បាត្រ	roapbaat
រាប់អាន	roapʔaan
រាយប៉ាយ	rieypaay
រាល់	roal
រាល់តែដង	roaltaedɑɑŋ
រាល់ថ្ងៃ	roaltŋay
រាវ	riev
រាវចាន	rievcaan
រាស់	roah
រាំ	roam
រាំង	reaŋ
រាំច្រៀង	roamcrieŋ
រិះគន់	rihkʊən
រីក	riik
រីកចំរើន	riikcɑmraən
រីករាយ	riikriey
រីង	riiŋ
រីផត	riipʰɑɑt
រីឯ	riiʔae
រឹង	rɨŋ
រឹងកំព្រឹស	rɨŋkɑmprɨh
រឹត	rɨt
រុក្ខជាតិ	rukkʰaʔciet
រុញ	ruɲ
រុំ	rum
រូប	ruup
រូបគំនូរ	ruupkumnuu
រូបថត	ruuptʰɑɑt
រូបភាព	ruuppʰiep
រូបមន្ត	ruupmʊən
រូបរាង	ruuprieŋ
រួច	ruəc
រួចរាល់	ruəcroal
រួម	ruəm
រួយ	ruəy
រួសរាន់	ruəhroan
រួសរាយ	ruəhriey
រើ	rəə
រើស	rəəh
រឿង	rɨəŋ
រឿងរ៉ាវ	rɨəŋraav
រៀង	riəŋ
រៀងរាល់	riəŋroal
រៀងរាល់ថ្ងៃ	riəŋroaltŋay
រៀន	riən
រៀប	riəp
រៀបចំ	riəpcɑm
រៀបរយ	riəprɔɔy
រៀបរាប់	riəproap
រៀម	riəm
រៀល	riəl
រេ	ree
រែក	rɛɛk
រោង	rooŋ
រោទ៍	roo
រោម	room
រំខាន	rumkʰaan
រំពេចនោះ	rumpɨcnuh
រំភើប	rumpʰəəp
រំលង	rumlɔɔŋ
រំលាយអាហារ	rumlieyʔaahaa
រំលឹក	rumlɨk
រំលែក	rumlɛɛk
រំលែកទុក្ខ	rumlɛɛktuk
រំសាយ	rumsaay
រះ	reah
រ៉ាប់រង	raprɔɔŋ
រ៉ឺម៉ក	rəɨmɑɑk
រ៉ូប	roup
រ៉ូប៊ីនេទឹក	roubiineetɨk
រ៉ូលើខូសស្ទើ	rouləəkʰouhstǝǝ
ល	lɔɔ
លក់	lʊək
លក់ដាច់	lʊəkdac
លក់ដូរ	lʊəkdou
លក្ខខណ្ឌ	leakkʰan
លក្ខណៈ	leakkʰaʔnaʔ
លក្ខិណា	leakkʰəʔnaʔ
លង់	lʊəŋ
លង់ទឹក	lʊəŋtɨk
លង់លក់	lʊəŋlʊək
លត	lɔɔt
លទ្ធផល	lattʰeaʔpʰɑl
លទ្ធភាព	lattʰeaʔpʰiep
លម្អ	lumʔɑɑ
លា	lie
លាក់កន្សែង	leakkansaeŋ
លាក់បាំង	leakbaŋ
លាគ្នា	lieknie
លាង	lieŋ
លាងចាន	lieŋcaan
លាងមាត់	lieŋmoat
លាត	liet
លាន់	loan
លាន់មាត់	loanmoat
លាប	liep
លាយ	liey
លាយឡំ	lieylɑm
លាស់	loah
លិច	lɨc
លីង	liiŋ
លីដា	liidaa
លីអូ	liiʔou
លុតជង្គង់	lutcʊəŋkʊəŋ
លុបចោល	lupcaol
លុបមុខ	lupmuk
លុបលាង	luplieŋ
លុយ	luy
លុយជាប់	luycoap
លុយរាយ	luyriey
លុយអាប់	luyʔap
លុះ	luh
លុះត្រាតែ	luhtraatae
លូ	luu
លូក	luuk
លូត	luut
លូតលាស់	luutloah
លូន	luun
លួច	luəc
លើ	ləə
លើក	lǝǝk
លើកក្រោយ	lǝǝkkraoy
លើកមុន	lǝǝkmun
លើកលែង	lǝǝklɛɛŋ
លើស	lǝǝh
លើសលស់	lǝǝhlʊəh
លឿង	lɨəŋ
លឿន	lɨən
លៀន	liǝn
លេខ	leek
លេខរៀង	leekriəŋ
លេខសម្ងាត់	leeksɑmŋat
លេង	leeŋ
លេងសើច	leeŋsaǝc
លេប	leep
លេស	leeh
លែង	lɛɛŋ
លែងកើត	lɛɛŋkaət
លែងរួច	lɛɛŋruəc
លោក	look
លោកគ្រូ	lookkruu
លោកសង្ឃ	looksɑŋ
លោត	loot
លំដាប់លំដោយ	lumdaplumdaoy
លំនឹង	lumnɨŋ
លំបាក	lumbaak
លំហាត់	lumhat
លំហើយ	lumhaəy
លំហែ	lumhae,rumhae
លំអងផ្កា	lumʔɑɑŋpkaa
ល្ងាច	lŋiec
ល្បាប់	lbap
ល្បី	lbəy
ល្បឿន	lbɨǝn
ល្បែង	lbaeŋ
ល្មម	lmɔɔm
ល្មុត	lmut
ល្វីង	lviiŋ
ល្ហុង	lhoŋ
ល្អ	lʔɑɑ
ល្អប្រើ	lʔɑɑpraə
ល្អមើល	lʔɑɑməəl
វង្វេង	vʊəŋveeŋ
វង្វេងផ្លូវ	vʊəŋveeŋpləv
វចនានុក្រម	veaʔcaʔnaanuʔkrɑm
វឌ្ឍនៈ	veattʰaʔnaʔ
វណ្ណា	vannaʔ
វត្ត	voat
វត្តភ្នំ	voatpnum
វត្ថុ	voattʰoʔ
វប្បធម៌	voappaʔtʰoa
វស្សា	voahsaa
វា	vie
វាយ	vay,viey
វាល	viel
វាល់	voal
វាសនា	viehsnaa,viesaʔnaa
វាស់	voah
វាំងនន	veaŋnɔɔn
វិក្កយបត្រ	vikkaʔyaeaʔbat
វិចិត្រ	viʔcət
វិច្ឆិកា	vɨcceʔkaa
វិជ្ជាពេទ្យ	vɨcciepɛɛt
វិញ	vɨɲ
វិធី	viʔtʰii
វិធីសាស្ត្រ	viʔtʰiisaah
វិន័យ	viʔney
វិបុល	viʔbol
វិមានឯករាជ្យ	viʔmienʔaekriec
វិល	vɨl
វិលមុខ	vɨlmuk
វិះ	vih
វីដេអូ	viideeʔou
វីតាមីន	viitaamiin
វីរៈ	viireaʔ
វុទ្ធី	vutʰii
វៀតណាម	viətnaam
វៀល	viəl
វេច	vɨc
វេជ្ជបញ្ជា	vɨcceaʔbɑɲcie
វេជ្ជបណ្ឌិត	vɨcceaʔbɑndɨt
វេជ្ជសាស្ត្រ	vɨcceaʔsaah
វេន	veen
វែក	vɛɛk
វែង	vɛɛŋ
វៃ	vey
វះ	veah
វះកាត់	veahkat
វ៉ា	vaa
វ៉ាយហ៉្វាយ	waayfaay
វ៉ែនតា	vaentaa
វ៉ៃ	vay
វ័យ	vey
ស	sɑɑ
សកម្មភាព	saʔkammeaʔpʰiep
សក់	sɑk
សង	sɑɑŋ
សងខាង	sɑɑŋkʰaaŋ
សង់	sɑŋ
សង្កត់	sɑŋkɑt
សង្គម	sɑŋkum
សង្គ្រោះ	sɑŋkrʊəh
សង្ឃ	sɑŋ
សង្ឃឹម	sɑŋkʰɨm
សង្សារ	sɑŋsaa
សង្ស័យ	sɑŋsay
សង្ហា	sɑŋhaa
សច្ចា	saccaa
សញ្ជឹង	sɑɲcɨŋ
សញ្ញា	saɲɲaa
សញ្ញាគុណ	saɲɲaakun
សញ្ញាបូក	saɲɲaabouk
សណ្ដាប់ធ្នាប់	sɑndaptnoap
សណ្ដូក	sɑndouk
សណ្ដូកជើង	sɑndoukcəəŋ
សណ្ដែក	sɑndaek
សណ្ដែកកួរ	sɑndaekkuə
សណ្ឋាគារ	sɑntʰaakie
សត្វ	sat
សត្វពាហនៈ	satpiehaʔnaʔ
សត្វល្អិត	satlʔǝt
សន្តិសុខ	sɑnteʔsok
សន្ទនា	sɑnteaʔnie
សន្ទុះ	sɑntuh
សន្ទូង	sɑntuuŋ
សន្ធរម៉ុក	sɑntʰɔɔmok
សន្យា	sɑnyaa
សន្លប់	sɑnlɑp
សន្លឹក	sɑnlək
សន្សើម	sɑnsaǝm
សន្សំសំចៃ	sɑnsɑmsɑmcay
សប្តាហ៍	sappdaa
សប្បាយ	sapbaay
សប្បាយចិត្ត	sapbaaycət
សព្វ	sɑp
សព្វថ្ងៃ	sɑptŋay
សភាព	saʔpʰiep
សម	sɑm,sɑɑm
សមរម្យ	sɑmrum
សមាជិក	saʔmaacɨk
សមុទ្រ	saʔmot
សម័យ	saʔmay
សម្គាល់	sɑmkoal
សម្ងាត់	sɑmŋat
សម្ងំ	sɑmŋɑm
សម្ដែង	sɑmdaəŋ
សម្បជញ្ញៈ	sampaʔcʊəɲɲeaʔ
សម្បត្តិ	sɑmbat
សម្បូរ	sɑmbou
សម្ផស្ស	sampʰɑh
សម្ភារៈ	sɑmpʰiereaʔ
សម្ភាសន៍	sɑmpʰieh
សម្រស់	sɑmrɑh
សម្រាក	sɑmraak
សម្រាន្ត	sɑmraan
សម្រាប់	sɑmrap
សម្រុក	sɑmrok
សម្រួល	sɑmruǝl
សម្រេច	sɑmrac
សម្រេចចិត្ត	sɑmraccət
សម្ល	sɑmlɑɑ
សម្លប្រហើរ	sɑmlɑɑprɑhaə
សម្លាប់	sɑmlap
សម្លឹង	samlǝŋ
សម្លៀកបំពាក់	sɑmliəkbɑmpeak
សម្អាត	sɑmʔaat
សរសើរ	sɑɑsaə
សរសេរ	sɑɑsee
សរសៃ	sɑɑsay,təsay
សរុប	saʔrop
សល់	sɑl
សសរ	sɑsɑɑ
សស្ងាច	sɑɑsŋaac
សា	saa
សាក	saak
សាកលវិទ្យាល័យ	saakɑlvittyielay
សាកល្បង	saaklbɑɑŋ
សាក្សី	saaksəy
សាង	saaŋ
សាងសង់	saaŋsɑŋ
សាច	saac
សាច់	sac
សាច់ការ	sackaa
សាច់ក្រណាត់	sackrɑnat
សាច់ញាតិ	sacɲiet
សាច់ដុំ	sacdom
សាច់ប្រាក់	sacprak
សាធារណៈ	saatʰiereaʔnaʔ
សាន	saan
សាប	saap
សាបស្រូវ	saapsrǝv
សាប៊ូ	saabuu
សាប៊ូកក់សក់	saabuukɑksɑk
សាប៊ូដុសខ្លួន	saabuudohkluən
សាមញ្ញ	saamaɲ
សាមសិប	saamsəp
សាមីខ្លួន	saamǝykluən
សាយឡិន	saaylən
សារ	saaraʔ,saa
សារជាតិ	saaraʔciet
សារធាតុ	saaraʔtʰiet
សារភាព	saaraʔpʰiep
សាល	saal
សាលា	saalaa
សាលារៀន	saalaariən
សាវម៉ាវ	saavmaav
សាឡុង	saaloŋ
សាឡេត	saaleet
សាំង	saŋ
សាំងហ្គាពួរ	saŋkaapuə
សិក្ខាសាលា	səkkʰaasaalaa,sekkʰaasaalaa
សិក្សា	səksaa
សិង	səŋ
សិដ្ឋ	sət
សិត	sət
សិទ្ធិ	sət
សិន	sən
សិស្ស	səh
សិស្សានុសិស្ស	səhsaanuʔsəh
សីតុណ្ហភាព	səytonhaʔpʰiep
សីតុណ្ហមាត្រ	səytonhaʔmiet
សីល	səl
សីលធម៌	sǝltʰoa,seltʰoa
សីហា	səyhaa
សឹង	səŋ
សឹងតែ	sǝŋtae
សឹងអី	səŋʔəy
សឺរ៉ាំង	səɨraŋ
សុខ	sok
សុខចិត្ត	sokcət
សុខទុក្ខ	soktuk
សុខភាព	sokkʰapʰiep
សុខសប្បាយ	soksapbaay
សុខា	soʔkʰaa
សុខុម	sokʰom
សុខៗ	soksok
សុគន្ធ	soʔkʊən
សុជាតា	soʔcietaa
សុជាតិ	soʔciet
សុជីវធម៌	soʔciiveaʔtʰoa
សុទ្ធ	sot
សុទ្ធតែ	sottae
សុទ្ធា	sottʰie
សុផល	soʔpʰɑl
សុភមង្គល	soʔpʰeaʔmeaŋkʊəl,soʔpʰeaʔmʊəŋkʊəl
សុភា	soʔpʰie
សុភាព	soʔpʰiep
សុភាពបុរស	soʔpʰiepboʔrɑh
សុភាសិត	soʔpʰiesət
សុភី	soʔpʰii
សុភ័ក្រ	soʔpʰeak
សុរិយគតិ	soʔreʔyaʔkeaʔteʔ
សុវណ្ណ	soʔvan
សុវត្ថិភាព	soʔvattʰeʔpʰiep
សុំ	som
សុំទោស	somtooh
សូត្រ	sout
សូត្រធម៌	souttʰoa
សូន្យ	soun
សូម	soum
សូម្បី	soumbəy
សូម្បីតែ	soumbəytae
សូវ	səv
សួត	suət
សួន	suən
សួរ	suə
សួស្ដី	suǝsdǝy
សើច	saəc
សើម	saəm
សៀត	siǝt
សៀមរាប	siǝmriep
សៀវភៅ	siǝvpʰɨv
សេចក្តី	səckdəy
សេន	seen,saen
សេព	saep
សេរី	seerəy
សេរេ	seeree
សេរ៉ូម	seeroum
សេវា	seevie,seevaa
សេវាកម្ម	seeviekam,seevaakam
សេះ	seh
សែង	saeŋ
សែន	saen
សែសិប	saesǝp
សោកស្ដាយ	saoksdaay
សោភា	saopʰie
សោភ័ណភាព	saopʰoanapʰiep
សោះ	sɑh
សំ	sɑm
សំខាន់	sɑmkʰan
សំដី	sɑmdəy
សំដៅ	sɑmdav
សំណង	sɑmnɑɑŋ
សំណង់	sɑmnɑŋ
សំណាង	sɑmnaaŋ
សំណាប	sɑmnaap
សំណួរ	sɑmnuə
សំណើម	sɑmnaəm
សំបក	sɑmbɑɑk
សំបុក	sɑmbok
សំបុត្រ	sɑmbot
សំបុត្រឡាន	sɑmbotlaan
សំប៉ែត	sɑmpaet
សំពត់	sɑmpʊət
សំពត់ហូល	sɑmpʊəthoul
សំពះ	sɑmpeah
សំយុង	sɑmyoŋ
សំយោគសញ្ញា	saŋyooksaɲɲaa
សំរាម	sɑmraam
សំឡី	sɑmləy
សំឡេង	sɑmleeŋ
ស៊ក	sɔɔk
ស៊ប់	sup
ស៊យ	sɔɔy
ស៊យអាណេះ	sɔɔyʔaaneh
ស៊ាំ	soam
ស៊ិន	sin
ស៊ី	sii
ស៊ីក្លូ	siiklou
ស៊ីឈ្នួល	siicnuəl
ស៊ីញ៉ូ	siiɲou
ស៊ីណា	siinaa
ស៊ីពេល	siipeel
ស៊ីម	siim
ស៊ីម៉ងត៍	siimɑŋ
ស៊ីរ៉ែន	siiraen
ស៊ីសង	siisɑɑŋ
ស៊ីសាមុត	siisaamut
ស៊ុប	sup
ស៊ុម	sum
ស៊ូគីស៊ុប	suukiisup
ស៊េរី	seerii
ស័ក្ដិសិទ្ធិ	saksət
ស័ក្តិសម	saksɑm
ស្កប់ស្កល់	skɑpskɑl
ស្ករ	skɑɑ
ស្ករស	skɑɑsɑɑ
ស្កុត	skot
ស្កូវ	skǝv
ស្កៀប	skiǝp
ស្គាល់	skoal
ស្គាល់គ្នា	skoalknie
ស្គែន	skɛɛn
ស្គ្រីន	skriin
ស្ងាត់	sŋat
ស្ងាប	sŋaap
ស្ងួត	sŋuət
ស្ងៀម	sŋiǝm
ស្ងោរ	sŋao
ស្ដាប់	sdap
ស្ដាប់ឮ	sdaplɨɨ
ស្ដាយ	sdaay
ស្ដាំ	sdam
ស្ដី	sdǝy
ស្ដីបន្ទោស	sdǝybɑntooh
ស្ដីឲ្យ	sdǝyʔaoy
ស្ដុក	sdok
ស្ដើង	sdaəŋ
ស្តង់	stɑŋ
ស្តាតអូឡាំពិក	staatʔoulampɨk
ស្តាយ	staay
ស្តុប	stop
ស្ត្រី	strǝy
ស្ថានទូត	stʰaantuut
ស្ថានភាព	stʰaanpʰiep
ស្ថានីយ	stʰaanii
ស្ថាប័ន	stʰaaban
ស្ថិត	stʰət,tʰət
ស្ទង់	stʊəŋ
ស្ទាប	stiep
ស្ទូង	stuuŋ
ស្ទើរ	stǝǝ
ស្ទើរគ្រប់	stǝǝkrup
ស្ទះ	steah
ស្ទះចរាចរណ៍	steahcɑraacɑɑ
ស្នាក់	snak
ស្នាម	snaam
ស្និត	snǝt
ស្និទ្ធស្នាល	snǝtsnaal
ស្នួ	snuə
ស្នេហា	snaehaa
ស្នែង	snaeŋ
ស្បង់	sbɑŋ
ស្បើយ	sbaəy
ស្បែក	sbaek
ស្បែកជើង	sbaekcǝǝŋ
ស្បែកជើងប៉ាតា	sbaekcǝǝŋbaataa
ស្បែកជើងប៊ូ	sbaekcǝǝŋpuu
ស្បែកជើងផ្ទាត់	sbaekcəəŋptoat
ស្បែកជើងស៊ក	sbaekcǝǝŋsɔɔk
ស្ពាយ	spiey
ស្ពៃ	spey
ស្មា	smaa
ស្មាតហ្វូន	smaatfoun
ស្មាន	smaan
ស្មារតី	smaardəy
ស្មាអាវ	smaaʔaav
ស្មុគ	smok
ស្មើ	smaə
ស្មើគ្នា	smaǝknie
ស្មើនឹង	smaǝnɨŋ
ស្មោះ	smɑh
ស្មៅ	smav
ស្ម័គ្រចិត្ត	smakcət
ស្រក	srɑɑk
ស្រក់	srɑk
ស្រងូតស្រងាត់	srɑŋoutsrɑŋat
ស្រង់	srɑŋ
ស្រង់មតិ	srɑŋmeaʔteʔ
ស្រដៀង	srɑdiǝŋ
ស្រដៀងនឹង	srɑdiǝŋnɨŋ
ស្រប	srɑɑp
ស្របាល	srɑbaal
ស្រពោន	srɑpoon
ស្រមោល	srɑmaol
ស្រវឹង	srɑvǝŋ
ស្រស់	srɑh
ស្រស់បំព្រង	srɑhbɑmprɔɔŋ
ស្រស់ស្រាយ	srɑhsraay
ស្រស់ស្រូប	srɑhsroop
ស្រស់ស្អាត	srɑhsʔaat
ស្រឡាញ់	srɑlaɲ
ស្រឡេវ	srɑleev
ស្រឡះ	srɑlah
ស្រា	sraa
ស្រាក្រហម	sraakrɑhɑɑm
ស្រាត	sraat
ស្រាប់	srap
ស្រាប់តែ	sraptae
ស្រាយ	sraay
ស្រាល	sraal
ស្រាវជ្រាវ	sraavcriev
ស្រាវិស្គី	sraaviskii
ស្រី	srəy
ស្រីខួច	srəykʰuəc
ស្រីពេជ្រ	srǝypɨc
ស្រីរ័ត្ន	srəyroat
ស្រុក	srok
ស្រុកកំណើត	srokkɑmnaət
ស្រុកស្រែ	sroksrae
ស្រុស	sroh
ស្រូប	sroup
ស្រូវ	srəv
ស្រូវប្រាំង	srǝvpraŋ
ស្រូវវស្សា	srǝvvoahsaa
ស្រួច	sruəc
ស្រួល	sruəl
ស្រួលខ្លួន	sruǝlkluən
ស្រួលបួល	sruǝlbuəl
ស្រេក	sreek
ស្រេកទឹក	sreektɨk
ស្រេច	srac
ស្រេចតែ	sractae
ស្រែ	srae
ស្រែក	sraek
ស្រែកហៅ	sraekhav
ស្រោច	sraoc
ស្រោម	sraom
ស្រោមជើង	sraomcəəŋ
ស្រះ	srah
ស្រៈ	sraʔ
ស្ល	slɑɑ
ស្លន់ស្លោ	slanslao
ស្លាក់	slak
ស្លាដក់	slaadɑk
ស្លាប	slaap
ស្លាបចាក់	slaapcak
ស្លាបព្រា	slaapprie
ស្លាប់	slap
ស្លឹក	slək
ស្លៀក	sliək
ស្លៀកពាក់	sliǝkpeak
ស្វាគមន៍	svaakum
ស្វាង	svaaŋ
ស្វាយ	svaay
ស្វាយកែវចិន	svaaykaevcən
ស្វាយកែវរមៀត	svaaykaevrɔmiet
ស្វាយប៉ោម	svaaypaom
ស្វិត	svət
ស្វែងរក	svaeŋrɔɔk
ស្វ័យ	svay
ស្វ័យប្រវត្តិ	svayprɑvoat
ស្អាត	sʔaat
ស្អាតបាត	sʔaatbaat
ស្អិត	sʔət
ស្អី	sʔǝy
ស្អុយ	sʔoy
ស្អុះ	sʔoh
ស្អុះស្អាប់	sʔohsʔap
ស្អែក	sʔaek
ហក់	hɑk
ហត់	hɑt
ហត់នឿយ	hatnɨəy
ហប់	hɑp
ហា	haa
ហាក	haak
ហាក់ដូចជា	hakdouccie
ហាង	haaŋ
ហាងកាហ្វេ	haaŋkaafee
ហាត់	hat
ហាត់ប្រាណ	hatpraan
ហាន់	han
ហាម	haam
ហាល	haal
ហាលថ្ងៃ	haaltŋay
ហិត	hǝt
ហឹរ	haə,həl
ហុច	hoc
ហុត	hot
ហុយ	hoy
ហូត	hout
ហូប	houp
ហូបចុក	houpcok
ហូយ	houy
ហូរ	hou
ហូល	houl
ហួត	huət
ហួស	huǝh
ហើប	haəp
ហើមពោះ	haǝmpʊəh
ហើយ	haǝy
ហើយដៃ	haǝyday
ហើយនិង	haǝynɨŋ
ហើយៗ	haǝyhaǝy
ហើរ	haǝ
ហៀរ	hiǝ
ហៀរសំបោរ	hiǝsɑmbao
ហេតុ	haet
ហេតុការណ៍	haetkaa
ហេតុផល	haetpʰɑl
ហេតុអី	haetʔəy
ហេតុអ្វី	haetʔvǝy
ហេមប័រហ្គឹរ	hemboakɨ
ហេវ	heev
ហេឡូ	heelou
ហែក	haek
ហែលទឹក	haeltɨk
ហោប៉ៅ	haopav
ហោះ	hɑh
ហៅ	hav
ហ៊ាន	hien
ហ៊ើយ	hǝǝy
ហ្គារ៉ាស់	gaarah
ហ្គាស	geah
ហ្គូហ្គល	kuukɔɔl
ហ្គេម	kɛɛm,keem
ហ្គែរ	kae
ហ្នឹង	nɨŋ
ហ្នឹងណា	nɨŋnaa
ហ្នឹងមែន	nɨŋmɛɛn
ហ្នឹងហើយ	nɨŋhaǝy
ហ្នឹងអ៎	nɨŋʔɑɑ
ហ្នុង	noŋ
ហ្ន៎	nɑɑ
ហ្មត់	mɑt
ហ្មត់ចត់	mɑtcɑt
ហ្វាន់តា	fantaa
ហ្វាម៉ាស៊ី	faamaasii
ហ្វូម	foum
ហ្វេសប៊ុក	feehbuk
ហ្វែល	fael
ហ្វ្រង់កា	frɑŋkaa
ហ្សែន	sɛɛn
ហ្អ	ʔɑ
ឡប់ៗ	lɑplɑp
ឡាតេ	laatee
ឡាន	laan
ឡានក្រុង	laankroŋ
ឡានពេទ្យ	laanpɛɛt
ឡាបូ	laabou
ឡាម	laam
ឡាវ	laav
ឡាំង	laŋ
ឡាំងក្រដាស	laŋkrɑdaah
ឡូយ	looy
ឡើង	laəŋ
ឡើងវិញ	laəŋvɨɲ
ឡើយ	laəy
ឡេ	lee
ឡេវ	leev
ឡែក	laek
អកុសល	ʔaʔkoʔsɑl
អក្ខរាវិរុទ្ធ	ʔakkʰaʔraaviʔrut
អក្សរ	ʔaksɑɑ
អក្សរកាត់	ʔaksɑɑkat
អគារ	ʔaʔkie
អគ្គិសនី	ʔakkihsaʔnii
អង់គ្លេស	ʔɑŋkleeh
អង្ករ	ʔɑŋkɑɑ
អង្ករខ្សាយ	ʔɑŋkɑɑksaay
អង្ករដំណើប	ʔɑŋkɑɑdɑmnaəp
អង្កាល់	ʔɑŋkaal
អង្គ	ʔɑŋ
អង្គចងចាំ	ʔɑŋcɑɑŋcam
អង្គញ់	ʔɑŋkʊəɲ
អង្គុយ	ʔɑŋkuy
អង្គែ	ʔɑŋkɛɛ
អង្រែ	ʔɑŋrɛɛ
អង្វែង	ʔɑŋvaeŋ
អង្សា	ʔɑŋsaa
អង្សាសេ	ʔɑŋsaasee
អង្អែល	ʔɑŋʔael
អញ្ចាញធ្មេញ	ʔɑɲcaaɲtmɨɲ
អញ្ចឹង	ʔɑɲcəŋ
អញ្ចុះ	ʔɑɲcoh
អញ្ចេក	ʔɑɲcek
អញ្ចេះ	ʔɑɲceh
អញ្ចោះ	ʔɑɲcɑh
អញ្ជើញ	ʔɑɲcəəɲ
អណ្ដាត	ʔɑndaat
អណ្ដែត	ʔɑndaet
អណ្ដែតអណ្ដូង	ʔɑndaetʔɑndouŋ
អតិថិជន	ʔaʔteʔtʰeʔcɔɔn
អត់	ʔɑt
អត់កើត	ʔɑtkaət
អត់ឃ្លាន	ʔɑtklien
អត់ដែល	ʔɑtdael
អត់ទាន់	ʔɑttoan
អត់ទៀង	ʔɑttiəŋ
អត់ទេស	ʔɑtteeh
អត់ទោស	ʔɑttooh
អត់ធ្មត់	ʔɑttmʊət
អត់សូវ	ʔɑtsəv
អត់អីណាអី	ʔɑtʔəynaaʔəy
អត់អីទេ	ʔɑtʔəytee
អត់អីអេ	ʔɑtʔəyʔee
អត់អីអេ៎	ʔɑtʔəyʔee
អត់អំពើ	ʔɑtʔɑmpǝǝ
អត្តសញ្ញាណប័ណ្ណ	ʔattaʔsaɲɲaanban
អត្ថន័យ	ʔattʰaʔney
អត្ថប្រយោជន៍	ʔattʰaʔprɑyaoc
អធ្រាត្រ	ʔaʔtriet
អនឡាញ	ʔɑɑnlaaɲ
អនាគត	ʔaʔnaakʊət
អនាម័យ	ʔaʔnaamay
អនុញ្ញាត	ʔaʔnuɲɲaat
អនុវត្ត	ʔaʔnuʔvoat
អនុស្សាវរីយ៍	ʔaʔnuhsaavaʔrii
អន្ទិត	ʔɑntɨt
អន្ធិល	ʔɑntʰɨl
អន្លក់	ʔɑnlʊək
អប	ʔɑɑp
អបអរ	ʔɑɑpʔɑɑ
អបអរសាទរ	ʔɑɑpʔɑɑsaatɔɔ
អបិយជំនឿ	ʔappəyyeaʔcumnɨə
អប់រំ	ʔɑprum
អផ្សុក	ʔapsok
អភិវឌ្ឍ	ʔaʔpʰiʔvoat
អម្បាញ់មិញ	ʔɑmbaɲmɨɲ
អរគុណ	ʔɑɑkun
អរុណសួស្ដី	ʔaʔrunsuǝsdǝy
អរូបី	ʔaʔruupǝy
អសន្តិសុខ	ʔaʔsɑnteʔsok
អសុរោះ	ʔaʔsoʔrɑh
អស់	ʔɑh
អស់កម្លាំង	ʔɑhkɑmlaŋ
អស់រលីង	ʔɑhrɔliiŋ
អស់សាំង	ʔɑhsaŋ
អស់សំណើច	ʔɑhsɑmnaəc
អា	ʔaa
អាកប្បកិរិយា	ʔaakappaʔkeʔriʔyaa
អាការៈ	ʔaakaaraʔ,ʔaakaa
អាកាស	ʔaakaah
អាកាសធាតុ	ʔaakaasaʔtʰiet
អាក់អន់ស្រពន់ចិត្ត	ʔakʔɑnsrɑpʊəncət
អាក្រក់	ʔaakrɑk
អាខោន	ʔaakʰaon
អាគុយ	ʔaakuy
អាគ្នេយ៍	ʔaknee
អាង	ʔaaŋ
អាច	ʔaac
អាជីព	ʔaaciip
អាទិត្យ	ʔaatɨt
អាទិភាព	ʔaatɨʔpʰiep
អាន	ʔaan
អានេះ	ʔaanih
អានោះ	ʔaanuh
អាប់	ʔap
អាប់ដេត	ʔapdeet
អាប់ឱនកិត្តិយស	ʔapʔaonketteʔyʊəh
អាពាហ៍ពិពាហ៍	ʔaapiepiʔpie
អាពួកម៉ាក	ʔaapuəkmaak
អាមេរិក	ʔaameerik
អាម៉ាហ្ស៉ូន	ʔaamaasɑn
អាយហ្វូន	ʔaayfoun
អាយុ	ʔaayuʔ
អារក្សអ្នកតា	ʔaarakneaktaa,ʔaareakneaktaa
អារម្មណ៍	ʔaarɑm
អាលុយមីញ៉ូម	ʔaaluymiiɲoum
អាល់កុល	ʔalko
អាវ	ʔaav
អាវធំ	ʔaavtʰom
អាវយឺត	ʔaavyɨɨt
អាវរងា	ʔaavrɔŋie
អាវសាច់ក្រណាត់	ʔaavsackrɑnat
អាសន្នអន្ធក្រ	ʔaasɑnʔɑnkrɑɑ
អាសយដ្ឋាន	ʔaasaʔyattʰaan
អាស៊ី	ʔaazii
អាស៊ីត	ʔaasiit
អាស្រ័យ	ʔaasray
អាហារ	ʔaahaa
អាហារដ្ឋាន	ʔaahaatʰaan
អាហារសម្រន់	ʔaahaasɑmrɑn
អាហ្នឹង	ʔaanɨŋ
អាឡូ	ʔaalou
អាឡែង	ʔaalaeŋ
អាឡែងតា	ʔaalaeŋtaa
អាំង	ʔaŋ
អា៎	ʔaa
អី	ʔəy
អីគេ	ʔəykee
អីចឹង	ʔəycəŋ
អីទៅ	ʔəytɨv
អីយ៉ាស់	ʔəyyah
អីវ៉ាន់	ʔəyvan
អឹម	ʔəm
អឺ	ʔəɨ
អឺរ៉ុប	ʔəɨrop
អឺអើ	ʔəɨʔaə
អឺះ	ʔɨh
អុជ	ʔoc
អុជៗ	ʔocʔoc
អុស	ʔoh
អុំ	ʔom
អុំទូក	ʔomtuuk
អូ	ʔou
អូខេ	ʔoukʰee
អូតូម៉ាទិច	ʔoutoumaatɨc
អូតែល	ʔoutael
អូន	ʔoun
អូយ	ʔooy
អូស	ʔouh
អូស្ត្រាលី	ʔoostraalii
អូហ្វីស	oufiih
អូ៎	ʔou
អើយ	ʔaəy,ʔəəy
អៀន	ʔiǝn
អៀម	ʔiǝm
អេ	ʔee
អេក្រង់	ʔeekrɑŋ
អេធីអឹម	ʔeetʰiiʔəm
អេប៉ុង	ʔeepoŋ
អេឡិចត្រូនិច	eeləttrounɨt
អេ៎	ʔee
អេ៎អី	ʔeeʔəy
អែប	ʔaep
អំណោយ	ʔɑmnaoy
អំណោយផល	ʔɑmnaoypʰɑl
អំបិល	ʔɑmbəl
អំបូង	ʔɑmbouŋ
អំបែង	ʔɑmbaeŋ
អំបោស	ʔɑmbaoh
អំបោះ	ʔɑmbɑh
អំពី	ʔɑmpii
អំពូល	ʔɑmpuul
អំពូលភ្លើង	ʔɑmpuulpləəŋ
អំពូលម៉ែត្រ	ʔɑmpuulmaet
អំពើ	ʔɑmpəə
អំពើល្អ	ʔɑmpǝǝlʔɑɑ
អំពៅ	ʔɑmpɨv
អំឡុង	ʔɑmloŋ
អ៊ី	ʔii
អ៊ីនធឺណិត	ʔintʰɨɨnet
អ៊ីម៉ែល	ʔiimael
អ៊ីអន	ʔiiʔɑɑn
អ៊ឹស	ʔɨh
អ៊ឺ	ʔɨɨ
អ៊ុត	ʔut
អ៊ុនៗ	ʔunʔun
អ៊ុះ	ʔuh
អ៊ូយ	ʔouy
អ៊ើ	ʔəə
អ៊ំ	ʔum,ʔom
អ៎	ʔɑɑ
អ្នក	neak
អ្នកកំប្លែង	neakkɑmplaeŋ
អ្នកចម្រៀង	neakcɑmriəŋ
អ្នកចំការ	neakcɑmkaa
អ្នកជិតខាង	neakcɨtkʰaaŋ
អ្នកជំងឺ	neakcumŋɨɨ
អ្នកដទៃ	neakdɑtey
អ្នកដំណើរ	neakdɑmnaə
អ្នកឌុប	neakdup
អ្នកណា	neaknaa
អ្នកទទួល	neaktɔtuəl
អ្នកទទួលភ្ញៀវ	neaktɔtuəlpɲiəv
អ្នកទិញ	neaktɨɲ
អ្នកទេសចរណ៍	neakteehsaʔcɑɑ
អ្នកធ្វើការ	neaktvəəkaa
អ្នកបម្រើ	neakbɑmraə
អ្នកបើកបរ	neakbaəkbɑɑ
អ្នករត់តុ	neakrʊəttok
អ្នករត់ម៉ូតូឌុប	neakrʊətmoutoudup
អ្នករត់សំបុត្រ	neakrʊətsɑmbot
អ្នកលក់	neaklʊək
អ្នកស្រែ	neaksrae
អ្វី	ʔvəy
អ្វីមួយ	ʔvǝymuǝy
ឥដ្ឋ	ʔət
ឥត	ʔət
ឥរិយាបថ	ʔeʔreʔyaabɑt
ឥឡូវ	ʔləv,ʔəyləv,ʔiʔləv
ឥឡូវនេះ	ʔəyləvnih,ʔləvnih,ʔiʔləvnih
ឥឡូវហ្នឹង	ʔəyləvnɨŋ,ʔləvnɨŋ,ʔiʔləvnɨŋ
ឧទាហរណ៍	ʔuʔtiehɑɑ
ឧទ្ទិស	ʔuttɨh
ឧបករណ៍	ʔuʔpaʔkɑɑ
ឧបសគ្គ	ʔuʔpaʔsak
ឧបាសក	ʔuʔbaasɑk
ឧស្ម័ន	ʔusman
ឧស្សាហ៍	ʔussaa
ឪពុក	ʔǝvpuk
ឪពុកម្ដាយ	ʔǝvpukmdaay
ឪឡឹក	ʔǝvlǝk
ឫស	rɨh
ឬ	rɨɨ
ឬក៏	rɨɨkɑɑ
ឬនៅ	rɨɨnɨv
ឮ	lɨɨ
ឮសូរ	lɨɨsou
ឯ	ʔae
ឯកសណ្ឋាន	ʔaeksɑntʰaan
ឯកសារ	ʔaekaʔsaa
ឯកា	ʔaekaa
ឯង	ʔaeŋ
ឯណា	ʔaenaa
ឱ	ʔao
ឱកាស	ʔaokaah
ឱន	ʔaon
ឱប	ʔaop
ឱបដៃ	ʔaopday
ឱសថស្ថាន	ʔaosɑɑtʰɑɑstʰaan
ឲ្យ	ʔaoy
ឲ្យឈឹង	ʔaoycʰɨŋ
ឲ្យតែ	ʔaoytae
ឲ្យពរ	ʔaoypɔɔ
