а	a
аба	aba
абажур	abaʒur
абаџија	abad͡ʒija
абдал	abdaɫ
абдикација	abdikat͡sija
аберација	abɛrat͡sija
аблатив	abɫatif
аболира	abɔliɾa
аболиција	abɔlit͡sija
абонент	abɔnɛnt
авганистан	avɡanistan
август	avɡust
авенија	avɛnija
авиоиндустрија	avijɔindustrija
авиокомпанија	avijɔkɔmpanija
авиолинија	avijɔlinija
авион	avijɔn
авиони	avijɔni
авионче	avijɔnt͡ʃɛ
авијација	avijat͡sija
автархија	aftarxija
автентикација	aftɛntikat͡sija
автобиографија	aftɔbijɔɡrafija
автоматизација	aftɔmatizat͡sija
автоматски	aftɔmatski
автомобил	aftɔmɔbiɫ
авторизација	aftɔɾizat͡sija
авторка	aftɔrka
авторов	aftɔɾɔf
автостоперка	aftɔstɔpɛrka
автостоперски	aftɔstɔpɛrski
аглест	aɡlɛst
агломер	aɡɫɔmɛr
агломерација	aɡɫɔmɛrat͡sija
аглутинација	aɡɫutinat͡sija
агрономија	aɡrɔnɔmija
адаптација	adaptat͡sija
администраторка	administratɔrka
адреса	adrɛsa
аеродинамика	aɛɾɔdinamika
аеронаутика	aɛɾɔnautika
азбука	azbuka
аздисува	azdisuva
азербајџан	azɛrbajd͡ʒan
азотен	azɔtɛn
аирлија	airlija
академија	akadɛmija
акал	akaɫ
аквариум	akvaɾijum
аклиматизација	aklimatizat͡sija
ако	akɔ
акредитација	akrɛditat͡sija
аксиологија	aksijɔɫɔɡija
актерски	aktɛrski
актерство	aktɛrstvɔ
активација	aktivat͡sija
актуализација	aktualizat͡sija
акумулација	akumuɫat͡sija
акустика	akustika
акцентираност	akt͡sɛntiɾanɔst
ала	aɫa
алат	aɫat
алати	aɫati
алегорија	alɛɡɔɾija
алигатор	aliɡatɔr
алитерација	alitɛrat͡sija
алкален	aɫkalɛn
алкохоличарка	aɫkɔxɔlit͡ʃarka
алтернација	aɫtɛrnat͡sija
алхемија	aɫxɛmija
ама	ama
аман	aman
амански	amanski
амбасадорка	ambasadɔrka
амвон	aɱvɔn
америка	amɛɾika
американец	amɛrikanɛt͡s
американка	amɛrikaŋka
американски	amɛrikanski
амерички	amɛɾit͡ʃki
амин	amin
амнезија	amnɛzija
амнестија	amnɛstija
амортизација	amɔrtizat͡sija
ампутација	amputat͡sija
амстердам	amstɛrdam
амстердамски	amstɛrdamski
аналитичарка	analitit͡ʃarka
ананас	ananas
анасон	anasɔn
анафора	anafɔɾa
ангел	aŋɡɛɫ
ангелски	aŋɡɛɫski
ангелче	aŋɡɛɫt͡ʃɛ
англиски	aŋɡliski
англија	aŋɡlija
анемија	anɛmija
анестетичарка	anɛstɛtit͡ʃarka
аниматорка	animatɔrka
анкара	aŋkaɾa
анкарски	aŋkarski
анкета	ankɛta
анови	anɔvi
аномалија	anɔmalija
анорексија	anɔrɛksija
антиобиотички	antijɔbijɔtit͡ʃki
антипатија	antipatija
антонимија	antɔnimija
анјон	anjɔn
аорист	aɔɾist
апелациски	apɛɫat͡siski
аписки	apiski
апија	apija
апликација	aplikat͡sija
апозициски	apɔzit͡siski
апозиција	apɔzit͡sija
апостол	apɔstɔɫ
април	apriɫ
апсеник	apsɛnik
апстракција	apstrakt͡sija
аптека	aptɛka
арамилак	aramiɫak
арамиски	aramiski
аргентина	arɡɛntina
аргументациски	arɡumɛntat͡siski
аргументација	arɡumɛntat͡sija
арен	aɾɛn
арзухал	arzuxaɫ
аристократија	aɾistɔkratija
аристотел	aɾistɔtɛɫ
аритметика	aɾitmɛtika
аритметички	aɾitmɛtit͡ʃki
арнаут	arnaut
арнаутка	arnautka
арно	arnɔ
арнотија	arnɔtija
артикулација	artikuɫat͡sija
артикулира	artikuliɾa
археолог	arxɛɔɫɔk
археологија	arxɛɔɫɔɡija
архитектура	arxitɛktuɾa
асиметрија	asimɛtrija
асимилациски	asimiɫat͡siski
асимилација	asimiɫat͡sija
аскетство	askɛtstvɔ
асови	asɔvi
асоцијација	asɔt͡sijat͡sija
аспирација	aspirat͡sija
астронаутски	astrɔnautski
аташе	ataʃɛ
ателје	atɛljɛ
атина	atina
атови	atɔvi
атом	atɔm
атрофија	atrɔfija
аукциски	aukt͡siski
аукција	aukt͡sija
афазија	afazija
афикс	afiks
африка	afrika
ајван	ajvan
ајвани	ajvani
ајванче	ajvant͡ʃɛ
ајвар	ajvar
ајвари	ajvaɾi
ајде	ajdɛ
ајдутство	ajdutstvɔ
ајдучки	ajdut͡ʃki
ајкула	ajkuɫa
аљкавост	alkavɔst
аџиски	ad͡ʒiski
баба	baba
бабуле	babulɛ
бабулест	babulɛst
бавнорастечки	bavnɔrastɛt͡ʃki
бавност	bavnɔst
багдадски	baɡdatski
багремов	baɡrɛmɔf
бадем	badɛm
бадемов	badɛmɔf
бадемче	badɛmt͡ʃɛ
бадијала	badijaɫa
бадник	badnik
баднички	badnit͡ʃki
базален	bazalɛn
базалтов	bazaɫtɔf
базука	bazuka
базуки	bazuki
бакрдан	bakr̩dan
баку	baku
бакујски	bakujski
балистика	balistika
балкон	baɫkɔn
балон	baɫɔn
балонче	baɫɔnt͡ʃɛ
бамбусов	bambusɔf
банализација	banalizat͡sija
банана	banana
бананче	banant͡ʃɛ
бангладеш	baŋɡɫadɛʃ
бандарски	bandarski
бандитски	banditski
банка	baŋka
барабанче	barabant͡ʃɛ
барателка	baratɛɫka
барање	baɾaɲɛ
бардови	bardɔvi
барем	baɾɛm
барови	baɾɔvi
барок	baɾɔk
барокен	baɾɔkɛn
баронство	baɾɔnstvɔ
басови	basɔvi
бастун	bastun
бастунче	bastunt͡ʃɛ
батак	batak
баталува	bataɫuva
баш	baʃ
бајатост	bajatɔst
бајач	bajat͡ʃ
бајачки	bajat͡ʃki
бајрактар	bajraktar
бебе	bɛbɛ
бебенце	bɛbɛnt͡sɛ
бебешки	bɛbɛʃki
бебуле	bɛbulɛ
беглост	bɛɡɫɔst
бегов	bɛɡɔf
беда	bɛda
беден	bɛdɛn
бедност	bɛdnɔst
бедро	bɛdrɔ
без	bɛs
безбожнички	bɛzbɔʒnit͡ʃki
безбожност	bɛzbɔʒnɔst
безбол	bɛzbɔɫ
безболност	bɛzbɔɫnɔst
безбојност	bɛzbɔjnɔst
безбројност	bɛzbrɔjnɔst
безвизен	bɛzvizɛn
безвкусност	bɛsfkusnɔst
безвредност	bɛzvrɛdnɔst
безвременост	bɛzvrɛmɛnɔst
безвучност	bɛzvut͡ʃnɔst
безглавост	bɛzɡɫavɔst
безгласност	bɛzɡɫasnɔst
безготовински	bɛzɡɔtɔvinski
безграничност	bɛzɡranit͡ʃnɔst
безгрижност	bɛzɡriʒnɔst
безделник	bɛzdɛɫnik
бездејност	bɛzdɛjnɔst
бездејство	bɛzdɛjstvɔ
бездомнички	bɛzdɔmnit͡ʃki
бездомништво	bɛzdɔmniʃtvɔ
бездруго	bɛzdruɡɔ
безживотност	bɛʒʒivɔtnɔst
безизлезност	bɛzizlɛznɔst
безизразен	bɛzizrazɛn
безименост	bɛzimɛnɔst
безличност	bɛzlit͡ʃnɔst
безмалку	bɛzmaɫku
безмерност	bɛzmɛrnɔst
безначајност	bɛznat͡ʃajnɔst
безобличност	bɛzɔblit͡ʃnɔst
безобразност	bɛzɔbraznɔst
безопасен	bɛzɔpasɛn
безопасност	bɛzɔpasnɔst
безосновност	bɛzɔsnɔvnɔst
безрадосност	bɛzradɔsnɔst
безрасудност	bɛzrasudnɔst
безрбетник	bɛzr̩bɛtnik
безропотност	bɛzrɔpɔtnɔst
безумност	bɛzumnɔst
безусловност	bɛzusɫɔvnɔst
безутешност	bɛzutɛʃnɔst
безѕвезден	bɛzd͡zvɛzdɛn
белград	bɛɫɡrat
белградски	bɛɫɡratski
белетристички	bɛlɛtristit͡ʃki
бели	bɛli
белило	bɛliɫɔ
белогазец	bɛɫɔɡazɛt͡s
белокрилест	bɛɫɔkrilɛst
белучка	bɛɫut͡ʃka
бендисува	bɛndisuva
бензин	bɛnzin
бепче	bɛpt͡ʃɛ
берба	bɛrba
бербер	bɛrbɛr
берберка	bɛrbɛrka
берберница	bɛrbɛrnit͡sa
берберство	bɛrbɛrstvɔ
берлин	bɛrlin
берлински	bɛrlinski
берн	bɛrn̩
бернски	bɛrn̩ski
бес	bɛs
беседа	bɛsɛda
бескарактерност	bɛskaraktɛrnɔst
бескрајност	bɛskrajnɔst
бесмисленост	bɛsmislɛnɔst
бесови	bɛsɔvi
бесплатност	bɛspɫatnɔst
бесплодност	bɛspɫɔdnɔst
бесплотност	bɛspɫɔtnɔst
бесповратност	bɛspɔvratnɔst
беспогрешност	bɛspɔɡrɛʃnɔst
беспокојност	bɛspɔkɔjnɔst
беспокојство	bɛspɔkɔjstvɔ
беспорочност	bɛspɔɾɔt͡ʃnɔst
беспределност	bɛsprɛdɛɫnɔst
беспредметност	bɛsprɛdmɛtnɔst
беспрекорност	bɛsprɛkɔrnɔst
беспризорност	bɛsprizɔrnɔst
беспримерност	bɛsprimɛrnɔst
беспристраност	bɛspristranɔst
беспристрасност	bɛspristrasnɔst
бесрамница	bɛsramnit͡sa
бессилност	bɛssiɫnɔst
бессовесност	bɛssɔvɛsnɔst
бессодржајност	bɛssɔdr̩ʒajnɔst
бестелесност	bɛstɛlɛsnɔst
бестија	bɛstija
бесцелност	bɛst͡sɛɫnɔst
бесценетост	bɛst͡sɛnɛtɔst
бесчесност	bɛʃt͡ʃɛsnɔst
бесчовечност	bɛʃt͡ʃɔvɛt͡ʃnɔst
бетер	bɛtɛr
бетонски	bɛtɔnski
бечви	bɛt͡ʃvi
бејзбол	bɛjzbɔɫ
бејрут	bɛjrut
бејрутски	bɛjrutski
беља	bɛla
бељаџија	bɛlad͡ʒija
беќарство	bɛcarstvɔ
беџови	bɛd͡ʒɔvi
би	bi
бибер	bibɛr
библиографија	biblijɔɡrafija
библиотека	biblijɔtɛka
библиски	bibliski
бивш	bifʃ
бигамија	biɡamija
бигор	biɡɔr
бигоросува	biɡɔrɔsuva
бидејќи	bidɛjci
бикови	bikɔvi
билет	bilɛt
билетарница	bilɛtarnit͡sa
билетарници	bilɛtarnit͡si
билјар	biljar
билјарство	biljarstvɔ
биоенергија	bijɔɛnɛrɡija
биолог	bijɔɫɔk
биопсија	bijɔpsija
биохемија	bijɔxɛmija
биполарност	bipɔɫarnɔst
бирачки	biɾat͡ʃki
биро	birɔ
бирократизација	biɾɔkratizat͡sija
биртија	birtija
бисерка	bisɛrka
бискупија	biskupija
бискупов	biskupɔf
бистрина	bistrina
битност	bitnɔst
битола	bitɔɫa
битолчанец	bitɔɫt͡ʃanɛt͡s
битолчанка	bitɔɫt͡ʃaŋka
битолчанче	bitɔɫt͡ʃant͡ʃɛ
бичува	bit͡ʃuva
бишкек	biʃkɛk
бишкечки	biʃkɛt͡ʃki
благ	bɫak
благајник	bɫaɡajnik
благајничка	bɫaɡajnit͡ʃka
благо	bɫaɡɔ
благовременост	bɫaɡɔvrɛmɛnɔst
благоглаголивост	bɫaɡɔɡɫaɡɔlivɔst
благодушност	bɫaɡɔduʃnɔst
благоевград	bɫaɡɔɛvɡrat
благозвучност	bɫaɡɔzvut͡ʃnɔst
благонаклонетост	bɫaɡɔnakɫɔnɛtɔst
благородничка	bɫaɡɔrɔdnit͡ʃka
благородништво	bɫaɡɔrɔdniʃtvɔ
благородност	bɫaɡɔɾɔdnɔst
благост	bɫaɡɔst
благотворност	bɫaɡɔtvɔrnɔst
блазон	bɫazɔn
блазони	bɫazɔni
блазонирања	bɫazɔniɾaɲa
блазонирање	bɫazɔniɾaɲɛ
блато	bɫatɔ
бледост	blɛdɔst
блескавост	blɛskavɔst
блеснува	blɛsnuva
близнак	bliznak
близначе	bliznat͡ʃɛ
близост	blizɔst
близу	blizu
бликнува	bliknuva
блискост	bliskɔst
блогови	bɫɔɡɔvi
блокови	bɫɔkɔvi
блокче	bɫɔkt͡ʃɛ
блудник	bɫudnik
блудничи	bɫudnit͡ʃi
блуднички	bɫudnit͡ʃki
блудствува	bɫutstvuva
блуе	bɫuɛ
блуз	bɫus
блуткавост	bɫutkavɔst
бог	bɔk
богат	bɔɡat
богобојазливост	bɔɡɔbɔjazlivɔst
богови	bɔɡɔvi
богословија	bɔɡɔsɫɔvija
бодибилдерка	bɔdibiɫdɛrka
бодови	bɔdɔvi
бодрост	bɔdrɔst
боже	bɔʒɛ
божем	bɔʒɛm
божественост	bɔʒɛstvɛnɔst
божик	bɔʒik
божилак	bɔʒiɫak
божиќ	bɔʒic
бозон	bɔzɔn
бои	bɔi
боица	bɔit͡sa
боичка	bɔit͡ʃka
бок	bɔk
бокс	bɔks
боксови	bɔksɔvi
болежливост	bɔlɛʒlivɔst
болезливост	bɔlɛzlivɔst
болник	bɔɫnik
бомба	bɔmba
бомбардер	bɔmbardɛr
бомбаш	bɔmbaʃ
бонбона	bɔmbɔna
бонбонче	bɔmbɔnt͡ʃɛ
борење	bɔɾɛɲɛ
борови	bɔɾɔvi
босна	bɔsna
ботаничар	bɔtanit͡ʃar
ботови	bɔtɔvi
боцкавост	bɔt͡skavɔst
боцнува	bɔt͡snuva
бочвар	bɔt͡ʃvar
бочварство	bɔt͡ʃvarstvɔ
бојлер	bɔjlɛr
бојлерче	bɔjlɛrt͡ʃɛ
брада	brada
брадва	bradva
брадичка	bradit͡ʃka
брак	brak
бракови	brakɔvi
бран	bran
бранителство	branitɛɫstvɔ
бранов	branɔf
бранови	branɔvi
бранува	branuva
бранче	brant͡ʃɛ
брат	brat
братислава	bratisɫava
братиславски	bratisɫafski
братов	bratɔf
братоубиство	bratɔubistvɔ
братуле	bratulɛ
братучедов	bratut͡ʃɛdɔf
братучедски	bratut͡ʃɛtski
братче	bratt͡ʃɛ
брашнен	braʃnɛn
брашнест	braʃnɛst
брашноса	braʃnɔsa
брбливост	br̩blivɔst
брборење	br̩bɔɾɛɲɛ
брборка	br̩bɔrka
брборко	br̩bɔrkɔ
брборливост	br̩bɔrlivɔst
бргу	br̩ɡu
брегови	brɛɡɔvi
бреза	brɛza
брезичка	brɛzit͡ʃka
брезов	brɛzɔf
брестов	brɛstɔf
брзак	br̩zak
брзоплет	br̩zɔplɛt
брисел	brisɛɫ
бриселски	brisɛɫski
британија	britanija
брифинг	brifiŋk
брише	briʃɛ
бркови	br̩kɔvi
брлив	br̩lif
брливост	br̩livɔst
брод	brɔt
бродарство	brɔdarstvɔ
бродови	brɔdɔvi
бродоградба	brɔdɔɡradba
бродоградилиште	brɔdɔɡradiliʃtɛ
броеви	brɔɛvi
броење	brɔɛɲɛ
брои	brɔi
броило	brɔiɫɔ
бротче	brɔtt͡ʃɛ
брош	brɔʃ
број	brɔj
бројност	brɔjnɔst
бројчаник	brɔjt͡ʃanik
брут	brut
бруталност	brutaɫnɔst
брутови	brutɔvi
бруцош	brut͡sɔʃ
бруќе	brucɛ
брцнува	br̩t͡snuva
бршленов	br̩ʃlɛnɔf
бубаче	bubat͡ʃɛ
бубачка	bubat͡ʃka
бубрежен	bubrɛʒɛn
бугар	buɡar
бугарин	buɡaɾin
бугарија	buɡaɾija
бугарка	buɡarka
бугарски	buɡarski
будала	budaɫa
будалест	budalɛst
будалче	budaɫt͡ʃɛ
будилник	budiɫnik
будимпештански	budimpɛʃtanski
буква	bukva
буков	bukɔf
букурешт	bukuɾɛʃt
булка	buɫka
бумбар	bumbar
бумбаров	bumbaɾɔf
бумбарче	bumbart͡ʃɛ
бунар	bunar
бунарски	bunarski
бунарче	bunart͡ʃɛ
бунгалов	buŋɡaɫɔf
бундичка	bundit͡ʃka
бунтови	buntɔvi
бунтовништво	buntɔvniʃtvɔ
бура	buɾa
бургас	burɡas
буржоазија	burʒɔazija
бурност	burnɔst
бут	but
бутан	butan
бутнува	butnuva
бутче	butt͡ʃɛ
буцнува	but͡snuva
бучава	but͡ʃava
бучкуриш	but͡ʃkuɾiʃ
бушавост	buʃavɔst
бушилка	buʃiɫka
бујност	bujnɔst
бујрум	bujrum
в	f
в	v
в	və
вага	vaɡa
вагон	vaɡɔn
вагонче	vaɡɔnt͡ʃɛ
вадуц	vadut͡s
вадучки	vadut͡ʃki
вазал	vazaɫ
вака	vaka
валенција	valɛnt͡sija
валиден	validɛn
валидност	validnɔst
валканост	vaɫkanɔst
вампир	vampir
вампирски	vampirski
вампирче	vampirt͡ʃɛ
ваму	vamu
варварин	varvaɾin
варварка	varvarka
варварство	varvarstvɔ
варен	vaɾɛn
вари	vaɾi
варна	varna
варов	vaɾɔf
варшава	varʃava
ватерполо	vatɛrpɔɫɔ
ватикански	vatikanski
ваш	vaʃ
вашингтон	vaʃiŋktɔn
вашингтонски	vaʃiŋktɔnski
вбројува	vbrɔjuva
вдлабнатост	vdɫabnatɔst
вдовство	vdɔfstvɔ
веб	vɛp
веда	vɛda
веднаш	vɛdnaʃ
ведро	vɛdrɔ
ведрост	vɛdrɔst
вежбанка	vɛʒbaŋka
вез	vɛs
везден	vɛzdɛn
везе	vɛzɛ
везиров	vɛziɾɔf
везирство	vɛzirstvɔ
век	vɛk
века	vɛka
велепредавство	vɛlɛprɛdafstvɔ
велигден	vɛliɡdɛn
велик	vɛlik
велингтон	vɛliŋktɔn
велингтонски	vɛliŋktɔnski
величество	vɛlit͡ʃɛstvɔ
велможа	vɛɫmɔʒa
велосипед	vɛɫɔsipɛt
венеција	vɛnɛt͡sija
венечен	vɛnɛt͡ʃɛn
вентилациски	vɛntiɫat͡siski
вентилација	vɛntiɫat͡sija
венче	vɛnt͡ʃɛ
вепар	vɛpar
вера	vɛɾa
вереник	vɛɾɛnik
верничка	vɛrnit͡ʃka
веровит	vɛɾɔvit
вероотстапник	vɛɾɔɔtstapnik
веројатно	vɛrɔjatnɔ
весел	vɛsɛɫ
веселост	vɛsɛɫɔst
вест	vɛst
вестителка	vɛstitɛɫka
ветер	vɛtɛr
ветеран	vɛtɛran
ветерче	vɛtɛrt͡ʃɛ
ветка	vɛtka
ветре	vɛtrɛ
ветренце	vɛtrɛnt͡sɛ
ветрило	vɛtriɫɔ
ветришта	vɛtriʃta
ветриште	vɛtriʃtɛ
ветрови	vɛtrɔvi
ветровит	vɛtrɔvit
ветруле	vɛtrulɛ
вечера	vɛt͡ʃɛɾa
вечерашен	vɛt͡ʃɛɾaʃɛn
вечерва	vɛt͡ʃɛrva
вечно	vɛt͡ʃnɔ
веќе	vɛcɛ
вжештеност	vʒɛʃtɛnɔst
взори	vzɔɾi
вибрациски	vibrat͡siski
вибрација	vibrat͡sija
видело	vidɛɫɔ
видра	vidra
видрин	vidrin
видричка	vidrit͡ʃka
вие	vijɛ
виена	vijɛna
виенски	vijɛnski
виза	viza
викенд	vikɛnt
викендичка	vikɛndit͡ʃka
вики	viki
викинг	vikiŋk
викиншки	vikinʃki
википедија	vikipɛdija
викиречник	vikirɛt͡ʃnik
вилин	vilin
вилица	vilit͡sa
вилнус	viɫnus
вилнуски	viɫnuski
вилушка	viɫuʃka
виме	vimɛ
винарка	vinarka
винарски	vinarski
винарство	vinarstvɔ
вино	vinɔ
винов	vinɔf
виножито	vinɔʒitɔ
винце	vint͡sɛ
виолина	vijɔlina
вирус	viɾus
висне	visnɛ
виснува	visnuva
високообразовен	visɔkɔɔbrazɔvɛn
високосен	visɔkɔsɛn
висост	visɔst
височина	visɔt͡ʃina
вистинољубивост	vistinɔlubivɔst
витез	vitɛs
витези	vitɛzi
витешки	vitɛʃki
витештва	vitɛʃtva
витештво	vitɛʃtvɔ
витка	vitka
виткост	vitkɔst
витлер	vitlɛr
виуличав	vijulit͡ʃaf
више	viʃɛ
вишнов	viʃnɔf
вишок	viʃɔk
виљушка	viluʃka
вклопеност	fkɫɔpɛnɔst
вклучителност	fkɫut͡ʃitɛɫnɔst
вкоренетост	fkɔrɛnɛtɔst
вкочанетост	fkɔt͡ʃanɛtɔst
влада	vɫada
владар	vɫadar
владетелка	vɫadɛtɛɫka
владејачки	vɫadɛjat͡ʃki
владика	vɫadika
влажност	vɫaʒnɔst
влакненце	vɫaknɛnt͡sɛ
влакнест	vɫaknɛst
влакно	vɫaknɔ
власец	vɫasɛt͡s
властољубивост	vɫastɔlubivɔst
влашко	vɫaʃkɔ
влезен	vlɛzɛn
влепи	vlɛpi
влепува	vlɛpuva
влечко	vlɛt͡ʃkɔ
влијателност	vlijatɛɫnɔst
вмрежува	vmrɛʒuva
внатре	vnatrɛ
внатрешен	vnatrɛʃɛn
внедри	vnɛdri
внедрува	vnɛdruva
внес	vnɛs
внук	vnuk
внуков	vnukɔf
внуче	vnut͡ʃɛ
во	u
во	vɔ
вовед	vɔvɛt
воглавно	vɔɡɫavnɔ
вода	vɔda
водава	vɔdava
водам	vɔdam
водана	vɔdana
водат	vɔdat
водата	vɔdata
воденичар	vɔdɛnit͡ʃar
воденичарка	vɔdɛnit͡ʃarka
водест	vɔdɛst
водете	vɔdɛtɛ
води	vɔdi
водиве	vɔdivɛ
водиме	vɔdimɛ
водине	vɔdinɛ
водите	vɔditɛ
водиш	vɔdiʃ
водиште	vɔdiʃtɛ
водо	vɔdɔ
водоводен	vɔdɔvɔdɛn
водоотпорност	vɔdɔɔtpɔrnɔst
возбуденост	vɔzbudɛnɔst
воздржаност	vɔzdr̩ʒanɔst
воздух	vɔzdux
воздухопловство	vɔzduxɔpɫɔfstvɔ
возила	vɔziɫa
возило	vɔziɫɔ
возмутува	vɔzmutuva
вознемирувачки	vɔznɛmiruvat͡ʃki
воин	vɔin
воинственост	vɔinstvɛnɔst
воинство	vɔinstvɔ
вокатив	vɔkatif
вол	vɔɫ
волан	vɔɫan
волнарство	vɔɫnarstvɔ
волов	vɔɫɔf
волфрам	vɔɫfram
волчиште	vɔɫt͡ʃiʃtɛ
волчјак	vɔɫt͡ʃjak
волшебник	vɔɫʃɛbnik
волшебност	vɔɫʃɛbnɔst
вон	vɔn
вонка	vɔŋka
вонредност	vɔnrɛdnɔst
вообичајува	vɔɔbit͡ʃajuva
воодушевеност	vɔɔduʃɛvɛnɔst
воопшто	vɔɔpʃtɔ
воскликнува	vɔskliknuva
воскоса	vɔskɔsa
воспаленост	vɔspalɛnɔst
воспалителен	vɔspalitɛlɛn
воспита	vɔspita
воспитувач	vɔspituvat͡ʃ
восприемливост	vɔsprijɛmlivɔst
восприемчивост	vɔsprijɛmt͡ʃivɔst
вотка	vɔtka
вошка	vɔʃka
вошливост	vɔʃlivɔst
воѓе	vɔɟɛ
војводство	vɔjvɔtstvɔ
војник	vɔjnik
војниче	vɔjnit͡ʃɛ
впечатливост	fpɛt͡ʃatlivɔst
впие	fpijɛ
вплетува	fplɛtuva
впрочем	fprɔt͡ʃɛm
вработувач	vrabɔtuvat͡ʃ
враг	vrak
вран	vran
вранец	vranɛt͡s
врапченце	vrapt͡ʃɛnt͡sɛ
врапчуле	vrapt͡ʃulɛ
врат	vrat
врата	vrata
вратарка	vratarka
вратиче	vratit͡ʃɛ
вратка	vratka
врач	vrat͡ʃ
врашки	vraʃki
враќе	vracɛ
врбов	vr̩bɔf
врв	vr̩f
врвнојазичен	vr̩vnɔjazit͡ʃɛn
врева	vrɛva
вреднувач	vrɛdnuvat͡ʃ
време	vrɛmɛ
врескало	vrɛskaɫɔ
вреснува	vrɛsnuva
вретено	vrɛtɛnɔ
вретенце	vrɛtɛnt͡sɛ
вреќа	vrɛca
вреќичка	vrɛcit͡ʃka
вреќиште	vrɛciʃtɛ
врзе	vr̩zɛ
врзоп	vr̩zɔp
врзува	vr̩zuva
врие	vrijɛ
врне	vr̩nɛ
врти	vr̩ti
врша	vr̩ʃa
вршалка	vr̩ʃaɫka
вселена	fsɛlɛna
всушност	fsuʃnɔst
втораче	ftɔɾat͡ʃɛ
вторник	ftɔrnik
втрча	ftr̩t͡ʃa
вулгаризација	vuɫɡaɾizat͡sija
вулкан	vuɫkan
вујко	vujkɔ
вујков	vujkɔf
вујнин	vujnin
вујче	vujt͡ʃɛ
вход	fxɔt
вчера	ft͡ʃɛɾa
вчеравечер	ft͡ʃɛravɛt͡ʃɛr
вљубеност	vlubɛnɔst
вџашеност	vd͡ʒaʃɛnɔst
в’лтава	vəɫtava
габа	ɡaba
габер	ɡabɛr
габеров	ɡabɛɾɔf
габичка	ɡabit͡ʃka
гавран	ɡavran
гавранов	ɡavranɔf
гавранче	ɡavrant͡ʃɛ
гадливост	ɡadlivɔst
газ	ɡas
газдин	ɡazdin
газенце	ɡazɛnt͡sɛ
гази	ɡazi
галванизација	ɡaɫvanizat͡sija
галебов	ɡalɛbɔf
галежност	ɡalɛʒnɔst
ганѕало	ɡand͡zaɫɔ
гатачки	ɡatat͡ʃki
гајда	ɡajda
гајдар	ɡajdar
гајдари	ɡajdaɾi
гајдаџии	ɡajdad͡ʒii
гајдаџија	ɡajdad͡ʒija
гајди	ɡajdi
генерал	ɡɛnɛraɫ
генералисимус	ɡɛnɛɾalisimus
генетика	ɡɛnɛtika
генетичарка	ɡɛnɛtit͡ʃarka
генитив	ɡɛnitif
геотермален	ɡɛɔtɛrmalɛn
германец	ɡɛrmanɛt͡s
германка	ɡɛrmaŋka
герунд	ɡɛɾunt
гејша	ɡɛjʃa
гиздавост	ɡizdavɔst
гихт	ɡixt
главатар	ɡɫavatar
главатарство	ɡɫavatarstvɔ
главен	ɡɫavɛn
глагол	ɡɫaɡɔɫ
глаголица	ɡɫaɡɔlit͡sa
гладен	ɡɫadɛn
гладува	ɡɫaduva
глас	ɡɫas
гласачки	ɡɫasat͡ʃki
гласеж	ɡɫasɛʃ
гласилен	ɡɫasilɛn
гласилка	ɡɫasiɫka
гласиште	ɡɫasiʃtɛ
гласничка	ɡɫasnit͡ʃka
гласче	ɡɫaʃt͡ʃɛ
гласје	ɡɫasjɛ
гледа	ɡlɛda
гледачки	ɡlɛdat͡ʃki
глекав	ɡlɛkaf
глина	ɡlina
глинен	ɡlinɛn
глобализација	ɡɫɔbalizat͡sija
глогов	ɡɫɔɡɔf
гломазност	ɡɫɔmaznɔst
глоса	ɡɫɔsa
глувче	ɡɫuft͡ʃɛ
глужд	ɡɫuʃt
глупавост	ɡɫupavɔst
глушец	ɡɫuʃɛt͡s
гнаси	ɡnasi
гнасотилак	ɡnasɔtiɫak
гнасотија	ɡnasɔtija
гневност	ɡnɛvnɔst
гнезденце	ɡnɛzdɛnt͡sɛ
гнездо	ɡnɛzdɔ
гнет	ɡnɛt
гнилост	ɡniɫɔst
го	ɡɔ
говедо	ɡɔvɛdɔ
година	ɡɔdina
годинава	ɡɔdinava
годинашен	ɡɔdinaʃɛn
годишник	ɡɔdiʃnik
гои	ɡɔi
гол	ɡɔɫ
голем	ɡɔlɛm
големство	ɡɔlɛmstvɔ
голич	ɡɔlit͡ʃ
голтнички	ɡɔɫtnit͡ʃki
голтнува	ɡɔɫtnuva
голушка	ɡɔɫuʃka
голф	ɡɔɫf
гомнарски	ɡɔmnarski
гора	ɡɔɾa
горе	ɡɔɾɛ
гори	ɡɔɾi
горчливост	ɡɔrt͡ʃlivɔst
господ	ɡɔspɔt
господарство	ɡɔspɔdarstvɔ
господин	ɡɔspɔdin
господство	ɡɔspɔtstvɔ
госпоѓа	ɡɔspɔɟa
гостилница	ɡɔstiɫnit͡sa
гостилничарка	ɡɔstiɫnit͡ʃarka
гостопримливост	ɡɔstɔprimlivɔst
гостољубивост	ɡɔstɔlubivɔst
готварски	ɡɔtvarski
готварство	ɡɔtvarstvɔ
готвач	ɡɔtvat͡ʃ
готвачка	ɡɔtvat͡ʃka
готован	ɡɔtɔvan
готовински	ɡɔtɔvinski
готовност	ɡɔtɔvnɔst
грабливост	ɡrablivɔst
гравитациски	ɡravitat͡siski
гравче	ɡraft͡ʃɛ
град	ɡrat
града	ɡrada
градација	ɡradat͡sija
градба	ɡradba
гради	ɡradi
градина	ɡradina
градинарка	ɡradinarka
градини	ɡradini
градински	ɡradinski
градителка	ɡraditɛɫka
градови	ɡradɔvi
гракнува	ɡraknuva
грам	ɡram
грамада	ɡramada
граматика	ɡramatika
граматикализација	ɡramatikalizat͡sija
грамаѓе	ɡramaɟɛ
граната	ɡranata
гранитен	ɡranitɛn
граничник	ɡranit͡ʃnik
гранка	ɡraŋka
гранче	ɡrant͡ʃɛ
гратче	ɡratt͡ʃɛ
граѓанин	ɡraɟanin
грб	ɡr̩p
грбавост	ɡr̩bavɔst
грбови	ɡr̩bɔvi
грбовник	ɡr̩bɔvnik
грбоносен	ɡr̩bɔnɔsɛn
грбоносец	ɡr̩bɔnɔsɛt͡s
грбоносци	ɡr̩bɔnɔst͡si
грд	ɡr̩t
гребнува	ɡrɛbnuva
гревче	ɡrɛft͡ʃɛ
грее	ɡrɛɛ
греота	ɡrɛɔta
греотичка	ɡrɛɔtit͡ʃka
грешка	ɡrɛʃka
грижливост	ɡriʒlivɔst
гризе	ɡrizɛ
гризнува	ɡriznuva
грк	ɡr̩k
гркинка	ɡr̩kiŋka
грлица	ɡr̩lit͡sa
грло	ɡr̩ɫɔ
грмувче	ɡr̩muft͡ʃɛ
грмушест	ɡr̩muʃɛst
грмушка	ɡr̩muʃka
грнец	ɡr̩nɛt͡s
грнче	ɡr̩n̩t͡ʃɛ
гробарски	ɡrɔbarski
гроза	ɡrɔza
грозје	ɡrɔzjɛ
грозјенце	ɡrɔzjɛnt͡sɛ
громогласност	ɡrɔmɔɡɫasnɔst
грофовија	ɡrɔfɔvija
грубијанство	ɡrubijanstvɔ
група	ɡrupa
групација	ɡrupat͡sija
групичка	ɡrupit͡ʃka
грутка	ɡrutka
грутче	ɡrutt͡ʃɛ
грција	ɡr̩t͡sija
грчки	ɡr̩t͡ʃki
губернија	ɡubɛrnija
губитнички	ɡubitnit͡ʃki
гудачки	ɡudat͡ʃki
гуде	ɡudɛ
гужва	ɡuʒva
гукнува	ɡuknuva
гулаб	ɡuɫap
гулабарник	ɡuɫabarnik
гулабов	ɡuɫabɔf
гулапче	ɡuɫapt͡ʃɛ
гума	ɡuma
гумичка	ɡumit͡ʃka
гурабија	ɡurabija
гусарски	ɡusarski
гусарство	ɡusarstvɔ
густ	ɡust
гушав	ɡuʃaf
гушнува	ɡuʃnuva
гуштер	ɡuʃtɛr
гуштерски	ɡuʃtɛrski
гуштерче	ɡuʃtɛrt͡ʃɛ
да	daː
даб	dap
дабар	dabar
даблин	dablin
даблински	dablinski
дабов	dabɔf
дабје	dabjɛ
давеник	davɛnik
дада	dada
даде	dadɛ
дака	daka
дакански	dakanski
далекоисточен	dalɛkɔistɔt͡ʃɛn
далечност	dalɛt͡ʃnɔst
дали	dali
дамаск	damask
даночник	danɔt͡ʃnik
дапче	dapt͡ʃɛ
дарежливост	darɛʒlivɔst
дарителка	daritɛɫka
дата	data
датив	datif
дафинов	dafinɔf
два	dva
дваесет	dvaɛsɛt
дваж	dvaʃ
дванаесет	dvanaɛsɛt
двапати	dvapati
двајца	dvajt͡sa
двесте	dvɛstɛ
двечки	dvɛt͡ʃki
двигател	dviɡatɛɫ
двоженство	dvɔʒɛnstvɔ
дволик	dvɔlik
двонасочност	dvɔnasɔt͡ʃnɔst
двополов	dvɔpɔɫɔf
двор	dvɔr
дворче	dvɔrt͡ʃɛ
дворјанство	dvɔrjanstvɔ
двосмислен	dvɔsmislɛn
двостраност	dvɔstranɔst
двоуснен	dvɔusnɛn
двојазичност	dvɔjazit͡ʃnɔst
двојка	dvɔjka
двојник	dvɔjnik
двојност	dvɔjnɔst
двојче	dvɔjt͡ʃɛ
дебитен	dɛbitɛn
деведесет	dɛvɛdɛsɛt
деверов	dɛvɛɾɔf
девет	dɛvɛt
деветмина	dɛvɛtmina
деветнаесет	dɛvɛtnaɛsɛt
деветпати	dɛvɛtpati
деветстотини	dɛvɛtstɔtini
девиза	dɛviza
девица	dɛvit͡sa
девијација	dɛvijat͡sija
девојчинство	dɛvɔjt͡ʃinstvɔ
дегенерација	dɛɡɛnɛrat͡sija
деградација	dɛɡradat͡sija
дегустација	dɛɡustat͡sija
дедов	dɛdɔf
дедомразовци	dɛdɔmrazɔft͡si
дежурство	dɛʒurstvɔ
дезинформација	dɛziɱfɔrmat͡sija
дека	dɛka
декември	dɛkɛɱvri
деклинациски	dɛklinat͡siski
декорација	dɛkɔrat͡sija
делбен	dɛɫbɛn
делегациска	dɛlɛɡat͡siska
делегација	dɛlɛɡat͡sija
деливост	dɛlivɔst
деликатност	dɛlikatnɔst
делка	dɛɫka
деловник	dɛɫɔvnik
делотворност	dɛɫɔtvɔrnɔst
делумно	dɛɫumnɔ
делфински	dɛɫfinski
деменција	dɛmɛnt͡sija
демонски	dɛmɔnski
демонстраторка	dɛmɔnstratɔrka
демонстрација	dɛmɔnstrat͡sija
ден	dɛn
дена	dɛna
денар	dɛnar
денари	dɛnaɾi
денарски	dɛnarski
денарче	dɛnart͡ʃɛ
дендрохронологија	dɛndrɔxrɔnɔɫɔɡija
денес	dɛnɛs
денеска	dɛnɛska
денешен	dɛnɛʃɛn
денешница	dɛnɛʃnit͡sa
дени	dɛni
денов	dɛnɔf
денови	dɛnɔvi
деновиве	dɛnɔvivɛ
деновине	dɛnɔvinɛ
деновите	dɛnɔvitɛ
денон	dɛnɔn
денот	dɛnɔt
денски	dɛnski
дента	dɛnta
дену	dɛnu
депилациски	dɛpiɫat͡siski
депо	dɛpɔ
депонија	dɛpɔnija
депортација	dɛpɔrtat͡sija
дереџе	dɛɾɛd͡ʒɛ
дерман	dɛrman
дерматологија	dɛrmatɔɫɔɡija
десен	dɛsɛn
десет	dɛsɛt
десетка	dɛsɛtka
десетмина	dɛsɛtmina
десетпати	dɛsɛtpati
десетче	dɛsɛtt͡ʃɛ
десница	dɛsnit͡sa
десничарка	dɛsnit͡ʃarka
деспот	dɛspɔt
деспотство	dɛspɔtstvɔ
дестилациски	dɛstiɫat͡siski
дестинација	dɛstinat͡sija
дете	dɛtɛ
детево	dɛtɛvɔ
детено	dɛtɛnɔ
детето	dɛtɛtɔ
детиште	dɛtiʃtɛ
детонациски	dɛtɔnat͡siski
детонација	dɛtɔnat͡sija
детски	dɛtski
детство	dɛtstvɔ
детуле	dɛtulɛ
дефинициски	dɛfinit͡siski
дефлација	dɛfɫat͡sija
деформација	dɛfɔrmat͡sija
дехидрација	dɛxidrat͡sija
деца	dɛt͡sa
децава	dɛt͡sava
децана	dɛt͡sana
децата	dɛt͡sata
дечиња	dɛt͡ʃiɲa
дејствителност	dɛjstvitɛɫnɔst
дење	dɛɲɛ
диван	divan
дивизма	divizma
дивокоза	divɔkɔza
дивјачка	divjat͡ʃka
дигитализација	diɡitalizat͡sija
дигнатост	diɡnatɔst
диграф	diɡraf
дидактика	didaktika
дизајнер	dizajnɛr
дизентерија	dizɛntɛɾija
дим	dim
динамика	dinamika
динамичност	dinamit͡ʃnɔst
династички	dinastit͡ʃki
дипли	dipli
дипломатија	dipɫɔmatija
дипломски	dipɫɔmski
дирек	diɾɛk
директност	diɾɛktnɔst
директорство	dirɛktɔrstvɔ
дисертациски	disɛrtat͡siski
дисквалификација	diskvalifikat͡sija
дискриминација	diskriminat͡sija
дислексија	dislɛksija
дистопија	distɔpija
дихотомија	dixɔtɔmija
дихтува	dixtuva
дишење	diʃɛɲɛ
длабок	dɫabɔk
дневник	dnɛvnik
дни	dni
дниве	dnivɛ
днине	dninɛ
дните	dnitɛ
дно	dnɔ
добања	dɔbaɲa
добивка	dɔbifka
добие	dɔbijɛ
добиточен	dɔbitɔt͡ʃɛn
добојува	dɔbɔjuva
добрина	dɔbrina
добричува	dɔbrit͡ʃuva
добришува	dɔbriʃuva
добро	dɔbrɔ
добро	dɔˑβ̞rɔ̩
добрососедство	dɔbrɔsɔsɛtstvɔ
добројува	dɔbrɔjuva
доварува	dɔvaɾuva
довек	dɔvɛk
довечер	dɔvɛt͡ʃɛr
довикува	dɔvikuva
довиткува	dɔvitkuva
довлекува	dɔvlɛkuva
доволно	dɔvɔɫnɔ
догледува	dɔɡlɛduva
догма	dɔɡma
догмечува	dɔɡmɛt͡ʃuva
договор	dɔɡɔvɔr
договори	dɔɡɔvɔɾi
догодина	dɔɡɔdina
догорува	dɔɡɔɾuva
догребува	dɔɡrɛbuva
додаток	dɔdatɔk
додека	dɔdɛka
доделка	dɔdɛɫka
додиплува	dɔdipɫuva
додуша	dɔduʃa
дожд	dɔʃt
дождови	dɔʒdɔvi
дозакопча	dɔzakɔpt͡ʃa
дозволивост	dɔzvɔlivɔst
дозрева	dɔzrɛva
доигрува	dɔiɡruva
доиспитува	dɔispituva
доистребува	dɔistrɛbuva
докажливост	dɔkaʒlivɔst
доказ	dɔkas
докастри	dɔkastri
докачи	dɔkat͡ʃi
докинува	dɔkinuva
доколку	dɔkɔɫku
докопува	dɔkɔpuva
докројува	dɔkrɔjuva
докрпува	dɔkr̩puva
докршува	dɔkr̩ʃuva
доктор	dɔktɔr
докторува	dɔktɔɾuva
доктрина	dɔktrina
документација	dɔkumɛntat͡sija
докупува	dɔkupuva
долговечност	dɔɫɡɔvɛt͡ʃnɔst
долгокос	dɔɫɡɔkɔs
долгометражен	dɔɫɡɔmɛtraʒɛn
долготрајност	dɔɫɡɔtrajnɔst
доле	dɔlɛ
долепи	dɔlɛpi
должински	dɔɫʒinski
должничка	dɔɫʒnit͡ʃka
долижува	dɔliʒuva
долина	dɔlina
доличност	dɔlit͡ʃnɔst
долу	dɔɫu
долупува	dɔɫupuva
дом	dɔm
дома	dɔma
домазни	dɔmazni
домака	dɔmaka
домарка	dɔmarka
домат	dɔmat
домачка	dɔmat͡ʃka
домерува	dɔmɛɾuva
домесува	dɔmɛsuva
домеша	dɔmɛʃa
домива	dɔmiva
домота	dɔmɔta
донесува	dɔnɛsuva
дооблекува	dɔɔblɛkuva
дообликува	dɔɔblikuva
дообработува	dɔɔbrabɔtuva
дообразложува	dɔɔbrazɫɔʒuva
дообјаснува	dɔɔbjasnuva
доодговара	dɔɔdɡɔvaɾa
доопремува	dɔɔprɛmuva
доострува	dɔɔstruva
допадливост	dɔpadlivɔst
допекува	dɔpɛkuva
допива	dɔpiva
допие	dɔpijɛ
допинг	dɔpiŋk
допирливост	dɔpirlivɔst
дописник	dɔpisnik
дописничка	dɔpisnit͡ʃka
доплетува	dɔplɛtuva
допливува	dɔplivuva
доползи	dɔpɔɫzi
доправа	dɔprava
допраша	dɔpraʃa
допрва	dɔpr̩va
допржува	dɔpr̩ʒuva
допукува	dɔpukuva
допушува	dɔpuʃuva
доработува	dɔɾabɔtuva
доразгледува	dɔɾazɡlɛduva
дорамнува	dɔramnuva
дораскажува	dɔɾaskaʒuva
доредува	dɔrɛduva
доруча	dɔɾut͡ʃa
доручек	dɔɾut͡ʃɛk
дорушува	dɔruʃuva
досега	dɔsɛɡa
досекува	dɔsɛkuva
доселеничка	dɔsɛlɛnit͡ʃka
досетливост	dɔsɛtlivɔst
доскока	dɔskɔka
доследност	dɔslɛdnɔst
дослушува	dɔsɫuʃuva
доспива	dɔspiva
доста	dɔsta
доставувач	dɔstavuvat͡ʃ
достега	dɔstɛɡa
достиска	dɔstiska
достоинственост	dɔstɔinstvɛnɔst
достоинство	dɔstɔinstvɔ
достојност	dɔstɔjnɔst
дострижува	dɔstriʒuva
достудува	dɔstuduva
досушува	dɔsuʃuva
дотепува	dɔtɛpuva
дотка	dɔtka
доткајува	dɔtkajuva
дотовари	dɔtɔvaɾi
дотови	dɔtɔvi
дотогаш	dɔtɔɡaʃ
дотогај	dɔtɔɡaj
дотолчува	dɔtɔɫt͡ʃuva
дотопи	dɔtɔpi
дотркала	dɔtr̩kaɫa
дотрошува	dɔtrɔʃuva
дотура	dɔtuɾa
доукрасува	dɔukrasuva
доуништува	dɔuniʃtuva
доуредува	dɔurɛduva
доусовршува	dɔusɔvr̩ʃuva
доучува	dɔut͡ʃuva
доцна	dɔt͡sna
доцртува	dɔt͡sr̩tuva
дочистува	dɔt͡ʃistuva
дочитува	dɔt͡ʃituva
дошара	dɔʃaɾa
дошепнува	dɔʃɛpnuva
дошива	dɔʃiva
дошиша	dɔʃiʃa
дошминка	dɔʃmiŋka
доѕидува	dɔd͡ziduva
дојадува	dɔjaduva
дојденец	dɔjdɛnɛt͡s
дојка	dɔjka
доџвакува	dɔd͡ʒvakuva
драгоценост	draɡɔt͡sɛnɔst
драматичност	dramatit͡ʃnɔst
драстичност	drastit͡ʃnɔst
дрвар	dr̩var
дрво	dr̩vɔ
дрворед	dr̩vɔɾɛt
дрвоса	dr̩vɔsa
дрвосечач	dr̩vɔsɛt͡ʃat͡ʃ
дрдорење	dr̩dɔɾɛɲɛ
дрдорко	dr̩dɔrkɔ
дреарски	drɛarski
древен	drɛvɛn
древност	drɛvnɔst
дремнува	drɛmnuva
дренов	drɛnɔf
дречливост	drɛt͡ʃlivɔst
држава	dr̩ʒava
држави	dr̩ʒavi
државичка	dr̩ʒavit͡ʃka
државност	dr̩ʒavnɔst
државјанин	dr̩ʒavjanin
држи	dr̩ʒi
дрзне	dr̩znɛ
дрзок	dr̩zɔk
дрка	dr̩ka
дрнда	dr̩nda
дрндало	dr̩ndaɫɔ
дрндање	dr̩n̩daɲɛ
дрнка	dr̩n̩ka
дрогира	drɔɡiɾa
дрпнува	dr̩pnuva
дрт	dr̩t
друг	druk
другар	druɡar
другарка	druɡarka
другарува	druɡaɾuva
другарче	druɡart͡ʃɛ
другпат	drukpat
дружба	druʒba
дубаи	dubai
дува	duva
дувачки	duvat͡ʃki
дувне	duvnɛ
дудлец	dudlɛt͡s
дума	duma
дунав	dunaf
дупка	dupka
дупчуле	dupt͡ʃulɛ
дури	duɾi
дух	dux
духовитост	duxɔvitɔst
духовништво	duxɔvniʃtvɔ
душа	duʃa
душкало	duʃkaɫɔ
дуќан	ducan
ебам	ɛbam
ебе	ɛbɛ
евакуација	ɛvakuat͡sija
евалуација	ɛvaɫuat͡sija
еволуциски	ɛvɔɫut͡siski
евра	ɛvra
еврејство	ɛvrɛjstvɔ
евро	ɛvrɔ
европски	ɛvrɔpski
евруле	ɛvrulɛ
евтин	ɛftin
егзибиција	ɛɡzibit͡sija
егзистенција	ɛɡzistɛnt͡sija
егзотичност	ɛɡzɔtit͡ʃnɔst
егоистичност	ɛɡɔistit͡ʃnɔst
егоцентричност	ɛɡɔt͡sɛntrit͡ʃnɔst
едвај	ɛdvaj
еден	ɛdɛn
единаесет	ɛdinaɛsɛt
единственост	ɛdinstvɛnɔst
единство	ɛdinstvɔ
едначи	ɛdnat͡ʃi
еднаш	ɛdnaʃ
еднобојност	ɛdnɔbɔjnɔst
едновременост	ɛdnɔvrɛmɛnɔst
едногласност	ɛdnɔɡɫasnɔst
еднозначност	ɛdnɔznat͡ʃnɔst
едноличност	ɛdnɔlit͡ʃnɔst
еднонасочност	ɛdnɔnasɔt͡ʃnɔst
еднообразност	ɛdnɔɔbraznɔst
едноставност	ɛdnɔstavnɔst
едностраност	ɛdnɔstranɔst
едноударен	ɛdnɔudaɾɛn
едноумие	ɛdnɔumijɛ
еднојазичност	ɛdnɔjazit͡ʃnɔst
едренце	ɛdrɛnt͡sɛ
едро	ɛdrɔ
едукација	ɛdukat͡sija
еж	ɛʃ
еже	ɛʒɛ
еженце	ɛʒɛnt͡sɛ
ежиња	ɛʒiɲa
ежов	ɛʒɔf
ежови	ɛʒɔvi
езеро	ɛzɛɾɔ
езерце	ɛzɛrt͡sɛ
езотеричност	ɛzɔtɛɾit͡ʃnɔst
ек	ɛk
еким	ɛkim
екимка	ɛkimka
економичност	ɛkɔnɔmit͡ʃnɔst
екран	ɛkran
екранизација	ɛkranizat͡sija
експедиција	ɛkspɛdit͡sija
експлозија	ɛkspɫɔzija
експресионистички	ɛksprɛsijɔnistit͡ʃki
екстерен	ɛkstɛɾɛn
екстраполација	ɛkstrapɔɫat͡sija
ексцентричност	ɛkst͡sɛntrit͡ʃnɔst
ела	ɛɫa
елеганција	ɛlɛɡant͡sija
елек	ɛlɛk
електрика	ɛlɛktrika
електроиндустрија	ɛlɛktrɔindustrija
електроника	ɛlɛktrɔnika
елен	ɛlɛn
еленче	ɛlɛnt͡ʃɛ
елече	ɛlɛt͡ʃɛ
елиминација	ɛliminat͡sija
елка	ɛɫka
елки	ɛɫki
елкичка	ɛɫkit͡ʃka
елов	ɛɫɔf
елоквентност	ɛɫɔkvɛntnɔst
ем	ɛm
емиграциски	ɛmiɡrat͡siski
емисија	ɛmisija
емитува	ɛmituva
енергичност	ɛnɛrɡit͡ʃnɔst
енклитика	ɛnklitika
енклитичен	ɛnklitit͡ʃɛn
ентропија	ɛntrɔpija
епика	ɛpika
епилепсија	ɛpilɛpsija
епископија	ɛpiskɔpija
епистемологија	ɛpistɛmɔɫɔɡija
епифора	ɛpifɔɾa
ербап	ɛrbap
ербиум	ɛrbijum
ергенство	ɛrɡɛnstvɔ
ергенува	ɛrɡɛnuva
ереван	ɛɾɛvan
еревански	ɛrɛvanski
еротика	ɛrɔtika
есен	ɛsɛn
есеноска	ɛsɛnɔska
ескалација	ɛskaɫat͡sija
естетичарка	ɛstɛtit͡ʃarka
есцајг	ɛst͡sajk
етимологија	ɛtimɔɫɔɡija
етнографија	ɛtnɔɡrafija
етнологија	ɛtnɔɫɔɡija
еугеника	ɛuɡɛnika
еуфонија	ɛufɔnija
ефемерност	ɛfɛmɛrnɔst
жаба	ʒaba
жабарка	ʒabarka
жабичка	ʒabit͡ʃka
жабји	ʒabji
жали	ʒali
жар	ʒar
жарче	ʒart͡ʃɛ
ждригнува	ʒdriɡnuva
желба	ʒɛɫba
желбен	ʒɛɫbɛn
желевце	ʒɛlɛft͡sɛ
железарски	ʒɛlɛzarski
железен	ʒɛlɛzɛn
железнички	ʒɛlɛznit͡ʃki
железо	ʒɛlɛzɔ
желкин	ʒɛɫkin
желудец	ʒɛɫudɛt͡s
жена	ʒɛna
женава	ʒɛnava
женана	ʒɛnana
жената	ʒɛnata
жени	ʒɛni
жениве	ʒɛnivɛ
женине	ʒɛninɛ
жените	ʒɛnitɛ
женкарство	ʒɛŋkarstvɔ
жено	ʒɛnɔ
женски	ʒɛnski
жетварка	ʒɛtvarka
живинарство	ʒivinarstvɔ
живински	ʒivinski
живописен	ʒivɔpisɛn
живописност	ʒivɔpisnɔst
живот	ʒivɔt
животи	ʒivɔti
животинка	ʒivɔtiŋka
животинче	ʒivɔtint͡ʃɛ
животно	ʒivɔtnɔ
животност	ʒivɔtnɔst
жиг	ʒik
жизнерадосност	ʒiznɛradɔsnɔst
жила	ʒiɫa
жилавост	ʒiɫavɔst
жиличка	ʒilit͡ʃka
жило	ʒiɫɔ
жир	ʒir
жиро	ʒiɾɔ
житарство	ʒitarstvɔ
жителка	ʒitɛɫka
житен	ʒitɛn
жито	ʒitɔ
жичен	ʒit͡ʃɛn
жолтило	ʒɔɫtiɫɔ
жонглер	ʒɔŋɡlɛr
жонглерка	ʒɔŋɡlɛrka
жонглерски	ʒɔŋɡlɛrski
жонглерство	ʒɔŋɡlɛrstvɔ
жртва	ʒr̩tva
жубор	ʒubɔr
жуборење	ʒubɔɾɛɲɛ
жупа	ʒupa
журнал	ʒurnaɫ
журналист	ʒurnalist
заб	zap
забавност	zabavnɔst
забарство	zabarstvɔ
забеганост	zabɛɡanɔst
забележителност	zabɛlɛʒitɛɫnɔst
забележливост	zabɛlɛʒlivɔst
забелешка	zabɛlɛʃka
забест	zabɛst
забиберува	zabibɛɾuva
забие	zabijɛ
забновенечен	zabnɔvɛnɛt͡ʃɛn
забодува	zabɔduva
заболекарка	zabɔlɛkarka
заборавеност	zabɔravɛnɔst
забрадува	zabraduva
забрзаност	zabr̩zanɔst
забришува	zabriʃuva
забули	zabuli
забулува	zabuɫuva
забутува	zabutuva
забучува	zabut͡ʃuva
заварувач	zavaɾuvat͡ʃ
завева	zavɛva
завеса	zavɛsa
завесичка	zavɛsit͡ʃka
завет	zavɛt
заветен	zavɛtɛn
завие	zavijɛ
заводливост	zavɔdlivɔst
завојува	zavɔjuva
заврзува	zavr̩zuva
заврнува	zavr̩nuva
завртува	zavr̩tuva
завршува	zavr̩ʃuva
завчера	zaft͡ʃɛɾa
загаденост	zaɡadɛnɔst
загадочност	zaɡadɔt͡ʃnɔst
загатка	zaɡatka
загатливост	zaɡatlivɔst
загинува	zaɡinuva
загледаност	zaɡlɛdanɔst
заглушува	zaɡɫuʃuva
загнојува	zaɡnɔjuva
заговор	zaɡɔvɔr
заговорница	zaɡɔvɔrnit͡sa
загорува	zaɡɔɾuva
заграб	zaɡrap
заграденост	zaɡradɛnɔst
загреб	zaɡrɛp
загрепски	zaɡrɛpski
загриженост	zaɡriʒɛnɔst
загрижувачки	zaɡriʒuvat͡ʃki
загризува	zaɡrizuva
загрмува	zaɡr̩muva
загрозеност	zaɡrɔzɛnɔst
загубува	zaɡubuva
загушливост	zaɡuʃlivɔst
загушува	zaɡuʃuva
задавува	zadavuva
задишаност	zadiʃanɔst
задновенечен	zadnɔvɛnɛt͡ʃɛn
задоволителност	zadɔvɔlitɛɫnɔst
задолженост	zadɔɫʒɛnɔst
задолжителност	zadɔɫʒitɛɫnɔst
задорко	zadɔrkɔ
задоцнува	zadɔt͡snuva
задремува	zadrɛmuva
задршка	zadr̩ʃka
задувува	zaduvuva
задуманост	zadumanɔst
задутре	zadutrɛ
задушува	zaduʃuva
заебанција	zaɛbant͡sija
заедништво	zaɛdniʃtvɔ
заедно	zaɛdnɔ
заема	zaɛma
заемност	zaɛmnɔst
заечува	zaɛt͡ʃuva
зажлеби	zaʒlɛbi
зажлебува	zaʒlɛbuva
зажуборува	zaʒubɔɾuva
зазвучи	zazvut͡ʃi
заздравува	zazdravuva
заискрува	zaiskruva
закаже	zakaʒɛ
закалува	zakaɫuva
заканувачки	zakanuvat͡ʃki
заквичува	zakvit͡ʃuva
закитува	zakituva
заклокотува	zakɫɔkɔtuva
заклопи	zakɫɔpi
заклучен	zakɫut͡ʃɛn
заколува	zakɔɫuva
закон	zakɔn
закопа	zakɔpa
закочува	zakɔt͡ʃuva
закржлавеност	zakr̩ʒɫavɛnɔst
закрилник	zakriɫnik
закркорува	zakr̩kɔɾuva
закрпува	zakr̩puva
закуп	zakup
закупнина	zakupnina
закупничка	zakupnit͡ʃka
закуска	zakuska
заладува	zaɫaduva
залажува	zaɫaʒuva
залајува	zaɫajuva
заледеност	zalɛdɛnɔst
заледува	zalɛduva
залез	zalɛs
залепува	zalɛpuva
заличува	zalit͡ʃuva
заложник	zaɫɔʒnik
заложница	zaɫɔʒnit͡sa
заложнички	zaɫɔʒnit͡ʃki
залудност	zaɫudnɔst
замавтува	zamaftuva
замагленост	zamaɡlɛnɔst
замазнува	zamaznuva
замастува	zamastuva
заматеност	zamatɛnɔst
заматкува	zamatkuva
заматува	zamatuva
замајува	zamajuva
заменичка	zamɛnit͡ʃka
заменливост	zamɛnlivɔst
замерка	zamɛrka
замесува	zamɛsuva
замешува	zamɛʃuva
замира	zamiɾa
замирисува	zamirisuva
замисленост	zamislɛnɔst
замок	zamɔk
замолува	zamɔɫuva
заморност	zamɔrnɔst
замоци	zamɔt͡si
замразува	zamrazuva
замрсеност	zamr̩sɛnɔst
замрсува	zamr̩suva
занаетчиски	zanaɛtt͡ʃiski
зандански	zandanski
занемареност	zanɛmaɾɛnɔst
занесеност	zanɛsɛnɔst
занимливост	zanimlivɔst
занишува	zaniʃuva
заобленост	zaɔblɛnɔst
заора	zaɔɾa
заостанатост	zaɔstanatɔst
заострува	zaɔstruva
запад	zapat
западњак	zapadɲak
запазува	zapazuva
запаливост	zapalivɔst
запалка	zapaɫka
запаметува	zapamɛtuva
запева	zapɛva
запегла	zapɛɡɫa
запекува	zapɛkuva
записник	zapisnik
заплакнува	zapɫaknuva
заплакува	zapɫakuva
запливува	zaplivuva
запловува	zapɫɔvuva
запнува	zapnuva
заповед	zapɔvɛt
заповедничка	zapɔvɛdnit͡ʃka
запомнува	zapɔmnuva
запоставеност	zapɔstavɛnɔst
запрегнува	zaprɛɡnuva
запрепастеност	zaprɛpastɛnɔst
запржува	zapr̩ʒuva
запршка	zapr̩ʃka
заптија	zaptija
запушеност	zapuʃɛnɔst
запче	zapt͡ʃɛ
заразност	zaɾaznɔst
зарекува	zarɛkuva
заржува	zarʒuva
зарипнатост	zaripnatɔst
заробенички	zaɾɔbɛnit͡ʃki
зародиш	zaɾɔdiʃ
засакува	zasakuva
засвирува	zasviɾuva
засводи	zasvɔdi
засводува	zasvɔduva
засебност	zasɛbnɔst
засекогаш	zasɛkɔɡaʃ
засипнатост	zasipnatɔst
заситеност	zasitɛnɔst
засити	zasiti
засладува	zasɫaduva
заслепеност	zaslɛpɛnɔst
заслепителен	zaslɛpitɛlɛn
заслепувачки	zaslɛpuvat͡ʃki
засмева	zasmɛva
засмрдува	zasmr̩duva
заспива	zaspiva
заспие	zaspijɛ
засраменост	zasramɛnɔst
застанува	zastanuva
застапеност	zastapɛnɔst
застапнички	zastapnit͡ʃki
застапништво	zastapniʃtvɔ
застарува	zastaɾuva
застрашувачки	zastraʃuvat͡ʃki
застудува	zastuduva
засукува	zasukuva
затапеност	zatapɛnɔst
заташкува	zataʃkuva
затајува	zatajuva
затвор	zatvɔr
затворенички	zatvɔrɛnit͡ʃki
затвореност	zatvɔɾɛnɔst
затворски	zatvɔrski
затегнатост	zatɛɡnatɔst
затекнува	zatɛknuva
затилок	zatiɫɔk
затоа	zatɔa
заточение	zatɔt͡ʃɛnijɛ
заточеништво	zatɔt͡ʃɛniʃtvɔ
затреперува	zatrɛpɛɾuva
затрпа	zatr̩pa
зацвилува	zat͡sviɫuva
зацврчува	zat͡svr̩t͡ʃuva
зачаденост	zat͡ʃadɛnɔst
зачадува	zat͡ʃaduva
зачекорува	zat͡ʃɛkɔɾuva
зачестеност	zat͡ʃɛstɛnɔst
зачешла	zat͡ʃɛʃɫa
зачмаеност	zat͡ʃmaɛnɔst
зачуденост	zat͡ʃudɛnɔst
зачудувачки	zat͡ʃuduvat͡ʃki
зачукува	zat͡ʃukuva
зашива	zaʃiva
зашилува	zaʃiɫuva
зашо	zaʃɔ
заштедува	zaʃtɛduva
заштитеност	zaʃtitɛnɔst
заштитнички	zaʃtitnit͡ʃki
заштитува	zaʃtituva
зашто	zaʃtɔ
заѕвонува	zad͡zvɔnuva
зајадливост	zajadlivɔst
зајадува	zajaduva
зајачиште	zajat͡ʃiʃtɛ
зајдисонце	zajdisɔnt͡sɛ
заљубеност	zalubɛnɔst
заќутува	zacutuva
збеснува	zbɛsnuva
збиеност	zbijɛnɔst
зближува	zbliʒuva
збор	zbɔr
зборливост	zbɔrlivɔst
зборообразување	zbɔɾɔɔbrazuvaɲɛ
збороред	zbɔɾɔɾɛt
зборување	zbɔruvaɲɛ
зборче	zbɔrt͡ʃɛ
збрка	zbr̩ka
збрца	zbr̩t͡sa
збунувачки	zbunuvat͡ʃki
звање	zvaɲɛ
звуков	zvukɔf
звучност	zvut͡ʃnɔst
згаденост	zɡadɛnɔst
згазнува	zɡaznuva
згаснува	zɡasnuva
зглоб	zɡɫɔp
зглопче	zɡɫɔpt͡ʃɛ
згмечува	zɡmɛt͡ʃuva
згодност	zɡɔdnɔst
зголеменост	zɡɔlɛmɛnɔst
зграда	zɡrada
зградичка	zɡradit͡ʃka
зградиште	zɡradiʃtɛ
зграпчува	zɡrapt͡ʃuva
згрбавеност	zɡr̩bavɛnɔst
згрешува	zɡrɛʃuva
згрижува	zɡriʒuva
згрозеност	zɡrɔzɛnɔst
згрченост	zɡr̩t͡ʃɛnɔst
згура	zɡuɾa
згуснатост	zɡusnatɔst
згуснувач	zɡusnuvat͡ʃ
здебелува	zdɛbɛɫuva
здиплува	zdipɫuva
здоболува	zdɔbɔɫuva
здодевност	zdɔdɛvnɔst
здравје	zdravjɛ
здрвеност	zdr̩vɛnɔst
здруженост	zdruʒɛnɔst
зебрест	zɛbrɛst
зев	zɛf
зеленчук	zɛlɛnt͡ʃuk
зеленчуков	zɛlɛnt͡ʃukɔf
зелче	zɛɫt͡ʃɛ
зелје	zɛljɛ
зема	zɛma
земе	zɛmɛ
земја	zɛmja
земјичка	zɛmjit͡ʃka
земјоделец	zɛmjɔdɛlɛt͡s
земјоделство	zɛmjɔdɛɫstvɔ
земјопоседник	zɛmjɔpɔsɛdnik
зеница	zɛnit͡sa
зетов	zɛtɔf
зима	zima
зимава	zimava
зиме	zimɛ
зимоска	zimɔska
зимурливост	zimurlivɔst
зијан	zijan
златарка	zɫatarka
златарски	zɫatarski
златарство	zɫatarstvɔ
златен	zɫatɛn
златест	zɫatɛst
златокрилест	zɫatɔkrilɛst
златце	zɫatt͡sɛ
злокобност	zɫɔkɔbnɔst
злосторница	zɫɔstɔrnit͡sa
злоупотреба	zɫɔupɔtrɛba
злоупотребувач	zɫɔupɔtrɛbuvat͡ʃ
змиест	zmijɛst
змиин	zmiin
змииште	zmiiʃtɛ
змиски	zmiski
змијуле	zmijulɛ
змијулест	zmijulɛst
знак	znak
знаме	znamɛ
знаменосец	znamɛnɔsɛt͡s
знаменце	znamɛnt͡sɛ
значи	znat͡ʃi
зоврива	zɔvriva
зограф	zɔɡraf
зора	zɔɾa
зошо	zɔʃɔ
зошто	zɔʃtɔ
зрее	zrɛɛ
зрнест	zr̩nɛst
зрно	zr̩nɔ
зрнце	zr̩n̩t͡sɛ
зуцне	zut͡snɛ
и	i
иако	ijakɔ
ивичи	ivit͡ʃi
игла	iɡɫa
иглест	iɡlɛst
игличка	iɡlit͡ʃka
играч	iɡrat͡ʃ
играчка	iɡrat͡ʃka
играчки	iɡrat͡ʃki
игривост	iɡrivɔst
идеален	idɛalɛn
идеализација	idɛalizat͡sija
идентификација	idɛntifikat͡sija
идеја	idɛja
идиличност	idilit͡ʃnɔst
идолопоклонство	idɔɫɔpɔkɫɔnstvɔ
избавител	izbavitɛɫ
избацува	izbat͡suva
избезуменост	izbɛzumɛnɔst
избирачки	izbiɾat͡ʃki
избодува	izbɔduva
избор	izbɔr
избраник	izbranik
избраница	izbranit͡sa
избрзува	izbr̩zuva
избувен	izbuvɛn
избувливост	izbuvlivɔst
изведба	izvɛdba
изведувач	izvɛduvat͡ʃ
изведувачка	izvɛduvat͡ʃka
изведувачки	izvɛduvat͡ʃki
извезувач	izvɛzuvat͡ʃ
известувач	izvɛstuvat͡ʃ
известувачка	izvɛstuvat͡ʃka
извештаченост	izvɛʃtat͡ʃɛnɔst
извидник	izvidnik
извидничка	izvidnit͡ʃka
извиднички	izvidnit͡ʃki
извидува	izviduva
извидувач	izviduvat͡ʃ
извикува	izvikuva
извинувачки	izvinuvat͡ʃki
извисува	izvisuva
извиткува	izvitkuva
извитоперува	izvitɔpɛɾuva
извичен	izvit͡ʃɛn
извлекува	izvlɛkuva
извод	izvɔt
изводливост	izvɔdlivɔst
извонредност	izvɔnrɛdnɔst
извор	izvɔr
изворче	izvɔrt͡ʃɛ
изврива	izvriva
извршен	izvr̩ʃɛn
извршител	izvr̩ʃitɛɫ
извршителка	izvr̩ʃitɛɫka
изгали	izɡali
изгладнетост	izɡɫadnɛtɔst
изгнаси	izɡnasi
изготви	izɡɔtvi
изгрев	izɡrɛf
изгрејсонце	izɡrɛjsɔnt͡sɛ
изгрицка	izɡrit͡ska
изгушка	izɡuʃka
издашност	izdaʃnɔst
издвојува	izdvɔjuva
изделка	izdɛɫka
издишка	izdiʃka
издлабува	izdɫabuva
издолженост	izdɔɫʒɛnɔst
издолжува	izdɔɫʒuva
издушува	izduʃuva
изеде	izɛdɛ
изедначеност	izɛdnat͡ʃɛnɔst
изедува	izɛduva
излапен	izɫapɛn
излапеност	izɫapɛnɔst
излачува	izɫat͡ʃuva
излезен	izlɛzɛn
излета	izlɛta
излетува	izlɛtuva
излечивост	izlɛt͡ʃivɔst
излижува	izliʒuva
излишност	izliʃnɔst
изложбен	izɫɔʒbɛn
излудува	izɫuduva
измазнува	izmaznuva
измамнички	izmamnit͡ʃki
измаченост	izmat͡ʃɛnɔst
изменува	izmɛnuva
измерува	izmɛɾuva
изминува	izminuva
изморува	izmɔɾuva
измрзнува	izmr̩znuva
измрсува	izmr̩suva
изнаака	iznaaka
изнаброи	iznabrɔi
изнабута	iznabuta
изнавари	iznavaɾi
изнавезе	iznavɛzɛ
изнавитка	iznavitka
изнавреѓа	iznavrɛɟa
изнаврне	iznavr̩nɛ
изнагали	iznaɡali
изнагнете	iznaɡnɛtɛ
изнаголта	iznaɡɔɫta
изнаготви	iznaɡɔtvi
изнадава	iznadava
изнаделка	iznadɛɫka
изнадроби	iznadrɔbi
изназеме	iznazɛmɛ
изнакапе	iznakapɛ
изнакара	iznakaɾa
изнакваси	iznakvasi
изнакити	iznakiti
изнакопа	iznakɔpa
изнакраде	iznakradɛ
изнакрка	iznakr̩ka
изналепи	iznalɛpi
изналупа	iznaɫupa
изнамачка	iznamat͡ʃka
изнамрчи	iznamr̩t͡ʃi
изнаоблече	iznaɔblɛt͡ʃɛ
изнапика	iznapika
изнапише	iznapiʃɛ
изнаплете	iznaplɛtɛ
изнаполни	iznapɔɫni
изнаправи	iznapravi
изнапреде	iznaprɛdɛ
изнапржи	iznapr̩ʒi
изнареди	iznaɾɛdi
изнасади	iznasadi
изнасее	iznasɛɛ
изнасече	iznasɛt͡ʃɛ
изнастава	iznastava
изнастиска	iznastiska
изнатепа	iznatɛpa
изнаучи	iznaut͡ʃi
изнафали	iznafali
изнафрла	iznafr̩ɫa
изнацепи	iznat͡sɛpi
изнацрпи	iznat͡sr̩pi
изнашара	iznaʃaɾa
изнајмува	iznajmuva
изнемоштеност	iznɛmɔʃtɛnɔst
изненаденост	iznɛnadɛnɔst
изненадност	iznɛnadnɔst
изнервираност	iznɛrviɾanɔst
износеност	iznɔsɛnɔst
износува	iznɔsuva
изнудувач	iznuduvat͡ʃ
изобличеност	izɔblit͡ʃɛnɔst
изолациски	izɔɫat͡siski
изопаченик	izɔpat͡ʃɛnik
изопаченост	izɔpat͡ʃɛnɔst
изостанок	izɔstanɔk
изостреност	izɔstrɛnɔst
изработувач	izrabɔtuvat͡ʃ
израел	izraɛɫ
изразитост	izrazitɔst
изретчува	izrɛtt͡ʃuva
изречен	izrɛt͡ʃɛn
изрипува	izripuva
изрод	izrɔt
изустува	izustuva
иконописец	ikɔnɔpisɛt͡s
или	ili
иловица	iɫɔvit͡sa
илустрација	iɫustrat͡sija
илјада	iljada
име	imɛ
имено	imɛnɔ
именува	imɛnuva
именце	imɛnt͡sɛ
имиграциски	imiɡrat͡siski
имиграција	imiɡrat͡sija
имитаторка	imitatɔrka
имотност	imɔtnɔst
императорка	impɛratɔrka
импресија	imprɛsija
импровизаторка	imprɔvizatɔrka
импровизација	imprɔvizat͡sija
имунологија	imunɔɫɔɡija
инаетчија	inaɛtt͡ʃija
инаквост	inakvɔst
инаку	inaku
инвестициски	iɱvɛstit͡siski
индексен	indɛksɛn
индиец	indijɛt͡s
индикација	indikat͡sija
индија	indija
индијка	indijka
инерција	inɛrt͡sija
иницијаторка	init͡sijatɔrka
иницијација	init͡sijat͡sija
инквизициски	iŋkvizit͡siski
инквизиција	iŋkvizit͡sija
инкубациски	iŋkubat͡siski
иновациски	inɔvat͡siski
иновација	inɔvat͡sija
инсинуација	insinuat͡sija
инспекторка	inspɛktɔrka
инспекторски	inspɛktɔrski
инспекциски	inspɛkt͡siski
инсталациски	instaɫat͡siski
инсталација	instaɫat͡sija
инструкторка	instruktɔrka
интеграциски	intɛɡrat͡siski
интеграција	intɛɡrat͡sija
интеракција	intɛrakt͡sija
интервју	intɛrvju
интерен	intɛɾɛn
интерес	intɛɾɛs
интересчија	intɛrɛʃt͡ʃija
интернационален	intɛrnat͡sijɔnalɛn
интерпретациски	intɛrprɛtat͡siski
интерпункциски	intɛrpuŋkt͡siski
интонациски	intɔnat͡siski
интонација	intɔnat͡sija
интранет	intranɛt
интуиција	intuit͡sija
инфлациски	infɫat͡siski
инфлација	infɫat͡sija
информатика	iɱfɔrmatika
информатичарски	iɱfɔrmatit͡ʃarski
информациски	iɱfɔrmat͡siski
инфузија	infuzija
ираде	iɾadɛ
ирак	irak
иран	iran
иридиум	iridijum
ироничност	irɔnit͡ʃnɔst
иселеничка	isɛlɛnit͡ʃka
иселенички	isɛlɛnit͡ʃki
иселеништво	isɛlɛniʃtvɔ
исечок	isɛt͡ʃɔk
искача	iskat͡ʃa
искашлува	iskaʃɫuva
исклучив	iskɫut͡ʃif
исклучиво	iskɫut͡ʃivɔ
исклучителност	iskɫut͡ʃitɛɫnɔst
ископува	iskɔpuva
искористува	iskɔristuva
искорнува	iskɔrnuva
искосува	iskɔsuva
искра	iskra
искреност	iskrɛnɔst
искривеност	iskrivɛnɔst
искривоколчува	iskrivɔkɔɫt͡ʃuva
искривува	iskrivuva
искричка	iskrit͡ʃka
искрснува	iskr̩snuva
иследи	islɛdi
исончаност	isɔnt͡ʃanɔst
испакнатост	ispaknatɔst
испива	ispiva
испита	ispita
испитувач	ispituvat͡ʃ
испише	ispiʃɛ
исплата	ispɫata
исплатливост	ispɫatlivɔst
испливува	isplivuva
испобаци	ispɔbat͡si
испобега	ispɔbɛɡa
испобрише	ispɔbriʃɛ
испобрка	ispɔbr̩ka
исповади	ispɔvadi
исповедалница	ispɔvɛdaɫnit͡sa
исповеден	ispɔvɛdɛn
исповедник	ispɔvɛdnik
исповеднички	ispɔvɛdnit͡ʃki
исповитка	ispɔvitka
исповрти	ispɔvr̩ti
испогази	ispɔɡazi
испогмечи	ispɔɡmɛt͡ʃi
испогради	ispɔɡradi
испогреши	ispɔɡrɛʃi
испогризе	ispɔɡrizɛ
исподвлече	ispɔdvlɛt͡ʃɛ
испожени	ispɔʒɛni
испозаборави	ispɔzabɔɾavi
испозагине	ispɔzaɡinɛ
испозакачи	ispɔzakat͡ʃi
испозапали	ispɔzapali
испозатвори	ispɔzatvɔɾi
испоздрави	ispɔzdravi
испоказни	ispɔkazni
испокара	ispɔkaɾa
испокаса	ispɔkasa
испоколе	ispɔkɔlɛ
испокорне	ispɔkɔrnɛ
испокраде	ispɔkradɛ
испокрпи	ispɔkr̩pi
испокубе	ispɔkubɛ
испокупи	ispɔkupi
исполаже	ispɔɫaʒɛ
исполепи	ispɔlɛpi
исползи	ispɔɫzi
исполнителност	ispɔɫnitɛɫnɔst
испомажи	ispɔmaʒi
испомачка	ispɔmat͡ʃka
испомоча	ispɔmɔt͡ʃa
испонарача	ispɔnaɾat͡ʃa
испонастине	ispɔnastinɛ
испонаучи	ispɔnaut͡ʃi
испоначичка	ispɔnat͡ʃit͡ʃka
испообеси	ispɔɔbɛsi
испооговара	ispɔɔɡɔvaɾa
испоотвори	ispɔɔtvɔɾi
испопрати	ispɔprati
испопродаде	ispɔprɔdadɛ
испопрска	ispɔpr̩ska
испопука	ispɔpuka
испоразбуди	ispɔrazbudi
испорака	ispɔɾaka
испорачувач	ispɔrat͡ʃuvat͡ʃ
испоруга	ispɔɾuɡa
испосакати	ispɔsakati
испосере	ispɔsɛɾɛ
испосече	ispɔsɛt͡ʃɛ
испосник	ispɔsnik
испоснички	ispɔsnit͡ʃki
испосништво	ispɔsniʃtvɔ
испостиска	ispɔstiska
испотепа	ispɔtɛpa
испотпише	ispɔtpiʃɛ
испотутка	ispɔtutka
испоубие	ispɔubijɛ
испоумре	ispɔumrɛ
испоуништи	ispɔuniʃti
испоутне	ispɔutnɛ
испофаќа	ispɔfaca
испофрла	ispɔfr̩ɫa
испохефта	ispɔxɛfta
испоцрка	ispɔt͡sr̩ka
испочитува	ispɔt͡ʃituva
испразнува	ispraznuva
испрекинатост	isprɛkinatɔst
испреплетеност	isprɛplɛtɛnɔst
испреплетува	isprɛplɛtuva
испржува	ispr̩ʒuva
испруженост	ispruʒɛnɔst
испукува	ispukuva
испупченост	ispupt͡ʃɛnɔst
испупчува	ispupt͡ʃuva
испцуе	ispt͡suɛ
истанченост	istant͡ʃɛnɔst
истенчува	istɛnt͡ʃuva
истиснува	istisnuva
истишува	istiʃuva
истовара	istɔvaɾa
истовремено	istɔvrɛmɛnɔ
истовременост	istɔvrɛmɛnɔst
истоименик	istɔimɛnik
историчарка	istɔrit͡ʃarka
источњак	istɔt͡ʃɲak
истоштува	istɔʃtuva
истражувачка	istraʒuvat͡ʃka
истребувач	istrɛbuvat͡ʃ
истребувачка	istrɛbuvat͡ʃka
истрелува	istrɛɫuva
истресува	istrɛsuva
истрчува	istr̩t͡ʃuva
истумба	istumba
исушува	isuʃuva
исфаќа	isfaca
исфрлен	isfr̩lɛn
исходен	isxɔdɛn
исцицува	ist͡sit͡suva
исцрнува	ist͡sr̩nuva
исцрпеност	ist͡sr̩pɛnɔst
исцрпност	ist͡sr̩pnɔst
исцрта	ist͡sr̩ta
исцртува	ist͡sr̩tuva
исцрцорува	ist͡sr̩t͡sɔɾuva
исчистува	iʃt͡ʃistuva
итербиум	itɛrbijum
итност	itnɔst
итрец	itrɛt͡s
итрина	itrina
итрост	itrɔst
ич	it͡ʃ
ишарет	iʃaɾɛt
ишка	iʃka
ишмукува	iʃmukuva
ишне	iʃnɛ
кабел	kabɛɫ
кабелче	kabɛɫt͡ʃɛ
кабул	kabuɫ
кабулски	kabuɫski
кавал	kavaɫ
кавалче	kavaɫt͡ʃɛ
кавгаџика	kavɡad͡ʒika
каде	kadɛ
кадифе	kadifɛ
кадија	kadija
кадра	kadra
кадравост	kadravɔst
кажигаз	kaʒiɡas
казанџија	kazand͡ʒija
казахстан	kazaxstan
казненик	kaznɛnik
каивче	kaift͡ʃɛ
каиш	kaiʃ
како	kakɔ
какофонија	kakɔfɔnija
кактус	kaktus
кал	kaɫ
кале	kalɛ
календар	kalɛndar
калиум	kalijum
калкан	kaɫkan
калорија	kaɫɔɾija
калуѓерство	kaɫuɟɛrstvɔ
калфа	kaɫfa
камион	kamijɔn
камионче	kamijɔnt͡ʃɛ
камо	kamɔ
камоли	kamɔli
камшик	kamʃik
камшиче	kamʃit͡ʃɛ
канада	kanada
канбера	kambɛɾa
канберски	kambɛrski
кандило	kandiɫɔ
кандилце	kandiɫt͡sɛ
капак	kapak
капинов	kapinɔf
капнатост	kapnatɔst
кара	kaɾa
карактеризација	kaɾaktɛɾizat͡sija
каранфилче	karaɱfiɫt͡ʃɛ
каросерија	kaɾɔsɛɾija
карта	karta
карти	karti
картичка	kartit͡ʃka
картографија	kartɔɡrafija
карфиол	karfijɔɫ
карши	karʃi
каса	kasa
касиер	kasijɛr
касиерка	kasijɛrka
касичка	kasit͡ʃka
касмет	kasmɛt
касметлија	kasmɛtlija
каснатина	kasnatina
каснува	kasnuva
кастрација	kastrat͡sija
кат	kat
каталог	kataɫɔk
катанец	katanɛt͡s
катанче	katant͡ʃɛ
катастарски	katastarski
катаљарда	katalarda
категоризација	katɛɡɔɾizat͡sija
катедрала	katɛdraɫa
катраноса	katranɔsa
катче	katt͡ʃɛ
катјон	katjɔn
кафе	kafɛ
кафез	kafɛs
кафенце	kafɛnt͡sɛ
кафеџија	kafɛd͡ʒija
кафиња	kafiɲa
кафуле	kafulɛ
каца	kat͡sa
каци	kat͡si
качамак	kat͡ʃamak
качество	kat͡ʃɛstvɔ
каша	kaʃa
кашичка	kaʃit͡ʃka
кај	kaj
кајгана	kajɡana
кајсиичка	kajsiit͡ʃka
кајсија	kajsija
кајче	kajt͡ʃɛ
квадрат	kvadrat
квадратче	kvadratt͡ʃɛ
квалификација	kvalifikat͡sija
кварт	kvart
квас	kvas
квасец	kvasɛt͡s
кваси	kvasi
квебек	kvɛbɛk
квислинг	kvisliŋk
келнер	kɛɫnɛr
келнерка	kɛɫnɛrka
кенгурче	kɛŋɡurt͡ʃɛ
кепец	kɛpɛt͡s
кибернетика	kibɛrnɛtika
кибрит	kibrit
кибритче	kibritt͡ʃɛ
кивнува	kivnuva
киев	kijɛf
киевски	kijɛfski
килимар	kilimar
килимарски	kilimarski
килимарство	kilimarstvɔ
килимче	kilimt͡ʃɛ
километарски	kiɫɔmɛtarski
кимнува	kimnuva
кина	kina
кинематографија	kinɛmatɔɡrafija
кинетика	kinɛtika
кипарски	kiparski
киселкавост	kisɛɫkavɔst
кифла	kifɫa
кифличка	kiflit͡ʃka
кичма	kit͡ʃma
кишињев	kiʃiɲɛf
кишињевски	kiʃiɲɛfski
клавичембала	kɫavit͡ʃɛmbaɫa
клавичембало	kɫavit͡ʃɛmbaɫɔ
клада	kɫada
клапнува	kɫapnuva
класика	kɫasika
класификациски	kɫasifikat͡siski
класификација	kɫasifikat͡sija
клати	kɫati
клаустрофобија	kɫaustrɔfɔbija
клацка	kɫat͡ska
клекнува	klɛknuva
клема	klɛma
клен	klɛn
клептоманија	klɛptɔmanija
клер	klɛr
клетвен	klɛtvɛn
клетка	klɛtka
кликнува	kliknuva
климатизација	klimatizat͡sija
клинички	klinit͡ʃki
клинче	klint͡ʃɛ
клистир	klistir
клитика	klitika
клише	kliʃɛ
клоцнува	kɫɔt͡snuva
клумка	kɫumka
клунка	kɫuŋka
клуч	kɫut͡ʃ
клуче	kɫut͡ʃɛ
кметов	kmɛtɔf
кметува	kmɛtuva
кнежевства	knɛʒɛfstva
кнежевство	knɛʒɛfstvɔ
кнежество	knɛʒɛstvɔ
кнез	knɛs
книга	kniɡa
книгава	kniɡava
книгана	kniɡana
книгата	kniɡata
книги	kniɡi
книгиве	kniɡivɛ
книгине	kniɡinɛ
книгите	kniɡitɛ
книго	kniɡɔ
книжар	kniʒar
книжарка	kniʒarka
книжарница	kniʒarnit͡sa
книжарски	kniʒarski
книжен	kniʒɛn
книжуле	kniʒulɛ
ко	kɔ
коа	kɔa
кобила	kɔbiɫa
ковче	kɔft͡ʃɛ
ковчест	kɔft͡ʃɛst
кога	kɔɡa
код	kɔt
кодификација	kɔdifikat͡sija
кодош	kɔdɔʃ
кое	kɔɛ
коза	kɔza
козарски	kɔzarski
козарство	kɔzarstvɔ
козичка	kɔzit͡ʃka
козметичар	kɔzmɛtit͡ʃar
козметичарка	kɔzmɛtit͡ʃarka
кои	kɔi
кокиче	kɔkit͡ʃɛ
кокори	kɔkɔɾi
кокосов	kɔkɔsɔf
кола	kɔɫa
колаче	kɔɫat͡ʃɛ
колаченце	kɔɫat͡ʃɛnt͡sɛ
колбас	kɔɫbas
колебливост	kɔlɛblivɔst
коледе	kɔlɛdɛ
колекција	kɔlɛkt͡sija
колено	kɔlɛnɔ
коленце	kɔlɛnt͡sɛ
количество	kɔlit͡ʃɛstvɔ
колкав	kɔɫkaf
колку	kɔɫku
колкумина	kɔɫkumina
колокациски	kɔɫɔkat͡siski
колоквиум	kɔɫɔkvijum
колонизациски	kɔɫɔnizat͡siski
колосек	kɔɫɔsɛk
команда	kɔmanda
комар	kɔmar
комарец	kɔmaɾɛt͡s
комарци	kɔmart͡si
комби	kɔmbi
комика	kɔmika
комисиски	kɔmisiski
комичарка	kɔmit͡ʃarka
комичарски	kɔmit͡ʃarski
комичност	kɔmit͡ʃnɔst
коморач	kɔmɔɾat͡ʃ
комотност	kɔmɔtnɔst
компактност	kɔmpaktnɔst
компарација	kɔmparat͡sija
компензација	kɔmpɛnzat͡sija
компир	kɔmpir
компиров	kɔmpiɾɔf
компирче	kɔmpirt͡ʃɛ
комплексност	kɔmplɛksnɔst
комплицираност	kɔmplit͡siɾanɔst
композиторски	kɔmpɔzitɔrski
композициски	kɔmpɔzit͡siski
компонента	kɔmpɔnɛnta
компромис	kɔmprɔmis
компјутер	kɔmpjutɛr
компјутеризација	kɔmpjutɛɾizat͡sija
комунизам	kɔmunizam
комшилак	kɔmʃiɫak
конверзациски	kɔɱvɛrzat͡siski
конверзација	kɔɱvɛrzat͡sija
конверзија	kɔɱvɛrzija
конгрес	kɔŋɡrɛs
кондензатор	kɔndɛnzatɔr
кондензација	kɔndɛnzat͡sija
кондиција	kɔndit͡sija
кондуктерка	kɔnduktɛrka
кондуктерски	kɔnduktɛrski
конексија	kɔnɛksija
конечно	kɔnɛt͡ʃnɔ
конзерваториум	kɔnzɛrvatɔɾijum
конзервација	kɔnzɛrvat͡sija
конзул	kɔnzuɫ
конкуренција	kɔŋkurɛnt͡sija
конотација	kɔnɔtat͡sija
констатација	kɔnstatat͡sija
конституција	kɔnstitut͡sija
конта	kɔnta
контактен	kɔntaktɛn
континент	kɔntinɛnt
контурен	kɔntuɾɛn
конфедерациски	kɔɱfɛdɛrat͡siski
конференциски	kɔɱfɛrɛnt͡siski
конфигурација	kɔɱfiɡurat͡sija
конфискација	kɔɱfiskat͡sija
конфузен	kɔɱfuzɛn
конфучиј	kɔɱfut͡ʃij
концизен	kɔnt͡sizɛn
концизност	kɔnt͡siznɔst
конјугациски	kɔnjuɡat͡siski
координаторка	kɔɔrdinatɔrka
координаторски	kɔɔrdinatɔrski
координација	kɔɔrdinat͡sija
копан	kɔpan
копаничар	kɔpanit͡ʃar
копанче	kɔpant͡ʃɛ
копито	kɔpitɔ
копитце	kɔpitt͡sɛ
копнува	kɔpnuva
коприва	kɔpriva
коприна	kɔprina
копула	kɔpuɫa
копје	kɔpjɛ
копјенце	kɔpjɛnt͡sɛ
кора	kɔɾa
кораб	kɔɾap
корелација	kɔɾɛɫat͡sija
корен	kɔɾɛn
коренче	kɔɾɛnt͡ʃɛ
кореја	kɔrɛja
користољубивост	kɔɾistɔlubivɔst
корито	kɔɾitɔ
коритце	kɔɾitt͡sɛ
коричка	kɔɾit͡ʃka
корне	kɔrnɛ
корпорациски	kɔrpɔrat͡siski
корупција	kɔrupt͡sija
коса	kɔsa
косачка	kɔsat͡ʃka
коси	kɔsi
косичка	kɔsit͡ʃka
коска	kɔska
коскест	kɔskɛst
коски	kɔski
космологија	kɔsmɔɫɔɡija
космонаут	kɔsmɔnaut
космонаутка	kɔsmɔnautka
косово	kɔsɔvɔ
костенов	kɔstɛnɔf
костим	kɔstim
костимче	kɔstimt͡ʃɛ
котларски	kɔtɫarski
кофа	kɔfa
коцка	kɔt͡ska
коцкарски	kɔt͡skarski
коцкест	kɔt͡skɛst
коцкичка	kɔt͡skit͡ʃka
кочан	kɔt͡ʃan
кочина	kɔt͡ʃina
кошарка	kɔʃarka
кошмар	kɔʃmar
кошница	kɔʃnit͡sa
кошничарски	kɔʃnit͡ʃarski
кошничка	kɔʃnit͡ʃka
кој	kɔj
која	kɔja
коњ	kɔɲ
коњарство	kɔɲarstvɔ
коњица	kɔɲit͡sa
коњушарски	kɔɲuʃarski
коњче	kɔɲt͡ʃɛ
крава	krava
кравар	kravar
краварка	kravarka
краварски	kravarski
краварство	kravarstvɔ
кравче	kraft͡ʃɛ
крадец	kradɛt͡s
крадешкум	kradɛʃkum
крал	kraɫ
кралоубиство	kraɫɔubistvɔ
кралски	kraɫski
кралува	kraɫuva
крап	krap
краставичка	krastavit͡ʃka
кратковечност	kratkɔvɛt͡ʃnɔst
кратковид	kratkɔvit
краткометражен	kratkɔmɛtraʒɛn
краткост	kratkɔst
краткотрајност	kratkɔtrajnɔst
краток	kratɔk
крај	kraj
крајморски	krajmɔrski
крајпатен	krajpatɛn
крајречен	krajrɛt͡ʃɛn
крајче	krajt͡ʃɛ
крв	kr̩f
крводарител	kr̩vɔdaɾitɛɫ
крвожедност	kr̩vɔʒɛdnɔst
крволочност	kr̩vɔɫɔt͡ʃnɔst
крдо	kr̩dɔ
креација	krɛat͡sija
кревкост	krɛfkɔst
креда	krɛda
кредитен	krɛditɛn
крекнува	krɛknuva
кремен	krɛmɛn
крепкост	krɛpkɔst
крепосник	krɛpɔsnik
крзнар	kr̩znar
крзнарски	kr̩znarski
крзнарство	kr̩znarstvɔ
крзно	kr̩znɔ
криволов	krivɔɫɔf
кризен	krizɛn
крикет	krikɛt
крикнува	kriknuva
крилест	krilɛst
крило	kriɫɔ
крилце	kriɫt͡sɛ
кринов	krinɔf
криптологија	kriptɔɫɔɡija
кристал	kristaɫ
кристализација	kristalizat͡sija
критика	kritika
критичар	kritit͡ʃar
критичарски	kritit͡ʃarski
критичност	kritit͡ʃnɔst
криумчар	krijumt͡ʃar
кришум	kriʃum
кркнува	kr̩knuva
кров	krɔf
кровче	krɔft͡ʃɛ
крои	krɔi
крокодил	krɔkɔdiɫ
кромид	krɔmit
кромитче	krɔmitt͡ʃɛ
кроце	krɔt͡sɛ
крошна	krɔʃna
крошничка	krɔʃnit͡ʃka
крој	krɔj
кројка	krɔjka
крпа	kr̩pa
крпичка	kr̩pit͡ʃka
крпче	kr̩pt͡ʃɛ
крст	kr̩st
крстоносен	kr̩stɔnɔsɛn
крт	kr̩t
круна	kruna
круничка	krunit͡ʃka
крутост	krutɔst
круша	kruʃa
крцкавост	kr̩t͡skavɔst
крцнува	kr̩t͡snuva
крчма	kr̩t͡ʃma
крчмарски	kr̩t͡ʃmarski
крчмичка	kr̩t͡ʃmit͡ʃka
кршливост	kr̩ʃlivɔst
кршталник	kr̩ʃtaɫnik
крштелен	kr̩ʃtɛlɛn
крџалија	kr̩d͡ʒalija
ксенофоб	ksɛnɔfɔp
ксенофобичен	ksɛnɔfɔbit͡ʃɛn
ксенофобија	ksɛnɔfɔbija
ктиторски	ktitɔrski
куалалумпурски	kuaɫaɫumpurski
кугла	kuɡɫa
куглање	kuɡɫaɲɛ
кугличка	kuɡlit͡ʃka
кука	kuka
кукичка	kukit͡ʃka
кукла	kukɫa
кукларство	kukɫarstvɔ
кукле	kuklɛ
кукличе	kuklit͡ʃɛ
кукличка	kuklit͡ʃka
кукурек	kukuɾɛk
култивација	kuɫtivat͡sija
култура	kuɫtuɾa
кумин	kumin
кумов	kumɔf
кумува	kumuva
кумулација	kumuɫat͡sija
кумче	kumt͡ʃɛ
куп	kup
куповен	kupɔvɛn
купопродажба	kupɔprɔdaʒba
купувачки	kupuvat͡ʃki
купче	kupt͡ʃɛ
кур	kur
курва	kurva
курварство	kurvarstvɔ
курви	kurvi
курвин	kurvin
курвинство	kurvinstvɔ
курвиче	kurvit͡ʃɛ
курвичка	kurvit͡ʃka
куре	kuɾɛ
курна	kurna
курови	kuɾɔvi
курсен	kursɛn
кус	kus
кусок	kusɔk
кусур	kusur
кутивче	kutift͡ʃɛ
кутија	kutija
кутнува	kutnuva
кутре	kutrɛ
кутриња	kutriɲa
куфер	kufɛr
куферче	kufɛrt͡ʃɛ
куцнува	kut͡snuva
куче	kut͡ʃɛ
кученце	kut͡ʃɛnt͡sɛ
кучиште	kut͡ʃiʃtɛ
кучиња	kut͡ʃiɲa
кучуле	kut͡ʃulɛ
кујна	kujna
кујни	kujni
кујничка	kujnit͡ʃka
куќа	kuca
куќарка	kucarka
куќуле	kuculɛ
кљакуш	klakuʃ
кљанка	klaŋka
кљанкач	klaŋkat͡ʃ
кљанкање	klaŋkaɲɛ
к’смет	kəsmɛt
лабавост	ɫabavɔst
лабилност	ɫabiɫnɔst
лав	ɫaf
лаворов	ɫavɔɾɔf
лавче	ɫaft͡ʃɛ
лавчиња	ɫaft͡ʃiɲa
ладен	ɫadɛn
ладничок	ɫadnit͡ʃɔk
лажичка	ɫaʒit͡ʃka
лажливост	ɫaʒlivɔst
лажност	ɫaʒnɔst
лакомство	ɫakɔmstvɔ
лакрдија	ɫakr̩dija
лактациски	ɫaktat͡siski
лактација	ɫaktat͡sija
лале	ɫalɛ
лаленце	ɫalɛnt͡sɛ
ламба	ɫamba
ламбичка	ɫambit͡ʃka
лани	ɫani
лански	ɫanski
лапачка	ɫapat͡ʃka
лапнува	ɫapnuva
лапсус	ɫapsus
лаптоп	ɫaptɔp
ларвин	ɫarvin
ласерски	ɫasɛrski
ласица	ɫasit͡sa
ласка	ɫaska
ласкавост	ɫaskavɔst
ластик	ɫastik
ластиче	ɫastit͡ʃɛ
лафи	ɫafi
лаѓа	ɫaɟa
лајно	ɫajnɔ
лебарник	lɛbarnik
лев	lɛf
левица	lɛvit͡sa
левичарка	lɛvit͡ʃarka
легален	lɛɡalɛn
легализација	lɛɡalizat͡sija
легендарност	lɛɡɛndarnɔst
легија	lɛɡija
лед	lɛt
леденост	lɛdɛnɔst
ледина	lɛdina
ледник	lɛdnik
лезбејски	lɛzbɛjski
лезетски	lɛzɛtski
лекарство	lɛkarstvɔ
лековитост	lɛkɔvitɔst
лекомисленост	lɛkɔmislɛnɔst
лексикографија	lɛksikɔɡrafija
лексикологија	lɛksikɔɫɔɡija
лекторски	lɛktɔrski
лекувачка	lɛkuvat͡ʃka
лелека	lɛlɛka
лема	lɛma
лента	lɛnta
лентичка	lɛntit͡ʃka
лепило	lɛpiɫɔ
лепливост	lɛplivɔst
лепрозен	lɛprɔzɛn
лепче	lɛpt͡ʃɛ
летала	lɛtaɫa
летало	lɛtaɫɔ
летач	lɛtat͡ʃ
лете	lɛtɛ
летен	lɛtɛn
летнува	lɛtnuva
лето	lɛtɔ
летово	lɛtɔvɔ
леток	lɛtɔk
летописец	lɛtɔpisɛt͡s
летоска	lɛtɔska
леукемија	lɛukɛmija
леунка	lɛuŋka
лешинарски	lɛʃinarski
леќа	lɛca
ливада	livada
ливаѓе	livaɟɛ
лигуш	liɡuʃ
лидер	lidɛr
лизгавост	lizɡavɔst
лизгачки	lizɡat͡ʃki
лизнува	liznuva
ликвидација	likvidat͡sija
ликов	likɔf
лимарски	limarski
лимен	limɛn
лимета	limɛta
лимон	limɔn
лимони	limɔni
лимонов	limɔnɔf
лимонче	limɔnt͡ʃɛ
липов	lipɔf
лисабон	lisabɔn
лисабонски	lisabɔnski
лисица	lisit͡sa
лисиче	lisit͡ʃɛ
лиснат	lisnat
литанија	litanija
литарски	litarski
литература	litɛɾatuɾa
литија	litija
лифт	lift
лихва	lixva
лихварка	lixvarka
лихварски	lixvarski
лихварство	lixvarstvɔ
лице	lit͡sɛ
лицемерство	lit͡sɛmɛrstvɔ
лиценце	lit͡sɛnt͡sɛ
лицитаторски	lit͡sitatɔrski
ловоров	ɫɔvɔɾɔf
ловџиски	ɫɔvd͡ʒiski
логорски	ɫɔɡɔrski
логорува	ɫɔɡɔɾuva
лозов	ɫɔzɔf
локатив	ɫɔkatif
локна	ɫɔkna
лом	ɫɔm
ломотење	ɫɔmɔtɛɲɛ
лондон	ɫɔndɔn
лондонец	ɫɔndɔnɛt͡s
лондонка	ɫɔndɔŋka
лондонски	ɫɔndɔnski
лондончанец	ɫɔndɔnt͡ʃanɛt͡s
лондончанка	ɫɔndɔnt͡ʃaŋka
лопата	ɫɔpata
лопатче	ɫɔpatt͡ʃɛ
лотосов	ɫɔtɔsɔf
лош	ɫɔʃ
лошотија	ɫɔʃɔtija
лудачки	ɫudat͡ʃki
лудува	ɫuduva
лук	ɫuk
лукче	ɫukt͡ʃɛ
луле	ɫulɛ
луленце	ɫulɛnt͡sɛ
лулиња	ɫuliɲa
луна	ɫuna
лунѕа	ɫund͡za
лупа	ɫupa
лупи	ɫupi
лутециум	ɫutɛt͡sijum
луѓе	ɫuɟɛ
луѓево	ɫuɟɛvɔ
луѓено	ɫuɟɛnɔ
луѓето	ɫuɟɛtɔ
маало	maaɫɔ
мавзолеј	mavzɔlɛj
магаре	maɡaɾɛ
магаренце	maɡaɾɛnt͡sɛ
магарица	maɡaɾit͡sa
магионичарски	maɡijɔnit͡ʃarski
магистерски	maɡistɛrski
магичност	maɡit͡ʃnɔst
магла	maɡɫa
магливост	maɡlivɔst
маглоса	maɡɫɔsa
маде	madɛ
мадрид	madrit
мадридски	madritski
маж	maʃ
мажа	maʒa
мажи	maʒi
маживе	maʒivɛ
мажине	maʒinɛ
мажите	maʒitɛ
мажов	maʒɔf
мажон	maʒɔn
мажот	maʒɔt
мажу	maʒu
мазност	maznɔst
македонец	makɛdɔnɛt͡s
македонија	makɛdɔnija
македонка	makɛdɔŋka
македонки	makɛdɔŋki
македонски	makɛdɔnski
македонци	makɛdɔnt͡si
македонче	makɛdɔnt͡ʃɛ
маков	makɔf
максимален	maksimalɛn
мал	maɫ
маларичен	maɫaɾit͡ʃɛn
малверзациски	maɫvɛrzat͡siski
малинов	malinɔf
малку	maɫku
малкуцка	maɫkut͡ska
малолетнички	maɫɔlɛtnit͡ʃki
малост	maɫɔst
малубројност	maɫubrɔjnɔst
малце	maɫt͡sɛ
мама	mama
мамут	mamut
мамутски	mamutski
мангал	maŋɡaɫ
мангуп	maŋɡup
мангупче	maŋɡupt͡ʃɛ
мандарински	mandarinski
манипулативен	manipuɫativɛn
маничен	manit͡ʃɛn
манџа	mand͡ʒa
манџичка	mand͡ʒit͡ʃka
мапа	mapa
марка	marka
март	mart
маршира	marʃiɾa
маса	masa
масиче	masit͡ʃɛ
маска	maska
маскенбал	maskɛmbaɫ
масленост	maslɛnɔst
масленце	maslɛnt͡sɛ
масло	masɫɔ
мастика	mastika
мастилен	mastilɛn
математика	matɛmatika
математики	matɛmatiki
математичар	matɛmatit͡ʃar
математичарка	matɛmatit͡ʃarka
математичарски	matɛmatit͡ʃarski
матерка	matɛrka
матичен	matit͡ʃɛn
маче	mat͡ʃɛ
мачеништво	mat͡ʃɛniʃtvɔ
маченце	mat͡ʃɛnt͡sɛ
мачителка	mat͡ʃitɛɫka
мачиште	mat͡ʃiʃtɛ
мачиња	mat͡ʃiɲa
мачка	mat͡ʃka
мачкиште	mat͡ʃkiʃtɛ
мачор	mat͡ʃɔr
мачорски	mat͡ʃɔrski
мачуле	mat͡ʃulɛ
машина	maʃina
машинерија	maʃinɛɾija
маѓар	maɟar
маѓарско	maɟarskɔ
маѓепсаност	maɟɛpsanɔst
мај	maj
мајкин	majkin
мајкоубиство	majkɔubistvɔ
мајмун	majmun
мајмуни	majmuni
мајстор	majstɔr
мајсторија	majstɔɾija
мајсторство	majstɔrstvɔ
мајсторче	majstɔrt͡ʃɛ
мајчин	majt͡ʃin
маџуро	mad͡ʒuɾɔ
маџуроански	mad͡ʒuɾɔanski
ме	mɛ
меана	mɛana
мев	mɛf
мевце	mɛft͡sɛ
мегаломанија	mɛɡaɫɔmanija
медарски	mɛdarski
медовина	mɛdɔvina
мезе	mɛzɛ
мека	mɛka
меланхоличност	mɛɫanxɔlit͡ʃnɔst
меланхолија	mɛɫanxɔlija
мелник	mɛɫnik
мелничар	mɛɫnit͡ʃar
мелничарка	mɛɫnit͡ʃarka
мелничарски	mɛɫnit͡ʃarski
мелнички	mɛɫnit͡ʃki
мелодичност	mɛɫɔdit͡ʃnɔst
менливост	mɛnlivɔst
менталитет	mɛntalitɛt
менторка	mɛntɔrka
менторски	mɛntɔrski
менторство	mɛntɔrstvɔ
мерач	mɛɾat͡ʃ
мерило	mɛɾiɫɔ
месарка	mɛsarka
месест	mɛsɛst
месец	mɛsɛt͡s
месечарка	mɛsɛt͡ʃarka
месечарство	mɛsɛt͡ʃarstvɔ
месечина	mɛsɛt͡ʃina
месингов	mɛsiŋɡɔf
месо	mɛsɔ
местенце	mɛstɛnt͡sɛ
место	mɛstɔ
местоположба	mɛstɔpɔɫɔʒba
металургија	mɛtaɫurɡija
метарски	mɛtarski
метафизика	mɛtafizika
метеорологија	mɛtɛɔɾɔɫɔɡija
метла	mɛtɫa
метличе	mɛtlit͡ʃɛ
метличка	mɛtlit͡ʃka
методичност	mɛtɔdit͡ʃnɔst
методологија	mɛtɔdɔɫɔɡija
метонимија	mɛtɔnimija
метрика	mɛtrika
метропола	mɛtrɔpɔɫa
механизација	mɛxanizat͡sija
механичарски	mɛxanit͡ʃarski
меч	mɛt͡ʃ
мече	mɛt͡ʃɛ
мечеви	mɛt͡ʃɛvi
меченце	mɛt͡ʃɛnt͡sɛ
мечиња	mɛt͡ʃiɲa
мечка	mɛt͡ʃka
мечок	mɛt͡ʃɔk
мечта	mɛt͡ʃta
мечувалец	mɛt͡ʃuvalɛt͡s
мечувалка	mɛt͡ʃuvaɫka
мечувалки	mɛt͡ʃuvaɫki
мечувалство	mɛt͡ʃuvaɫstvɔ
мечувалци	mɛt͡ʃuvaɫt͡si
мешнува	mɛʃnuva
меѓувремен	mɛɟuvrɛmɛn
меѓугенерациски	mɛɟuɡɛnɛrat͡siski
меѓуетнички	mɛɟuɛtnit͡ʃki
меѓукултурен	mɛɟukuɫtuɾɛn
меѓународен	mɛɟunaɾɔdɛn
меѓусебност	mɛɟusɛbnɔst
мизантропија	mizantrɔpija
мил	miɫ
миленик	milɛnik
милениче	milɛnit͡ʃɛ
милион	milijɔn
милионер	milijɔnɛr
милијарда	milijarda
милозвучност	miɫɔzvut͡ʃnɔst
мимика	mimika
министерски	ministɛrski
минливост	minlivɔst
минск	minsk
мир	mir
мирис	miɾis
мирисливост	mirislivɔst
мириснува	mirisnuva
мирољубивост	miɾɔlubivɔst
мирта	mirta
мирува	miɾuva
мисиркин	misirkin
мисирче	misirt͡ʃɛ
мислител	mislitɛɫ
мислителка	mislitɛɫka
митарство	mitarstvɔ
митинг	mitiŋk
мишка	miʃka
млад	mɫat
младоженски	mɫadɔʒɛnski
младолик	mɫadɔlik
младоликост	mɫadɔlikɔst
млекар	mlɛkar
млекарски	mlɛkarski
млекарство	mlɛkarstvɔ
млеко	mlɛkɔ
млекце	mlɛkt͡sɛ
млечност	mlɛt͡ʃnɔst
мливо	mlivɔ
млитавост	mlitavɔst
мнение	mnɛnijɛ
многу	mnɔɡu
многу	nɔɡu
многубројност	mnɔɡubrɔjnɔst
многулик	mnɔɡulik
многупати	mnɔɡupati
множеник	mnɔʒɛnik
множество	mnɔʒɛstvɔ
мобилизација	mɔbilizat͡sija
мовче	mɔft͡ʃɛ
могила	mɔɡiɫa
модалност	mɔdaɫnɔst
модификација	mɔdifikat͡sija
модул	mɔduɫ
модуларен	mɔduɫaɾɛn
модулација	mɔduɫat͡sija
мое	mɔɛ
може	mɔʒɛ
можеби	mɔʒɛbi
молерисува	mɔlɛrisuva
молив	mɔlif
молитва	mɔlitva
молкома	mɔɫkɔma
молчаливост	mɔɫt͡ʃalivɔst
моме	mɔmɛ
момин	mɔmin
моминство	mɔminstvɔ
момиче	mɔmit͡ʃɛ
момуле	mɔmulɛ
момчештво	mɔmt͡ʃɛʃtvɔ
момчуле	mɔmt͡ʃulɛ
монархиски	mɔnarxiski
монах	mɔnax
монахува	mɔnaxuva
монаштво	mɔnaʃtvɔ
моногамија	mɔnɔɡamija
монопол	mɔnɔpɔɫ
мора	mɔɾa
морач	mɔɾat͡ʃ
море	mɔɾɛ
морков	mɔrkɔf
морковче	mɔrkɔft͡ʃɛ
морнарство	mɔrnarstvɔ
морфофонологија	mɔrfɔfɔnɔɫɔɡija
москва	mɔskva
московски	mɔskɔfski
мост	mɔst
мостови	mɔstɔvi
мостра	mɔstra
моторен	mɔtɔɾɛn
моторика	mɔtɔɾika
мочовод	mɔt͡ʃɔvɔt
мој	mɔj
мравка	mrafka
мравче	mraft͡ʃɛ
мравји	mravji
мраз	mras
мразулец	mrazulɛt͡s
мранѕул	mrand͡zuɫ
мрачност	mrat͡ʃnɔst
мрднува	mr̩dnuva
мрежа	mrɛʒa
мрежичка	mrɛʒit͡ʃka
мрзливост	mr̩zlivɔst
мрсул	mr̩suɫ
мрсулавост	mr̩suɫavɔst
мртвило	mr̩tviɫɔ
мртов	mr̩tɔf
му	mu
мувливост	muvlivɔst
мудрец	mudrɛt͡s
мудрува	mudruva
музика	muzika
музичарка	muzit͡ʃarka
музичарски	muzit͡ʃarski
мукнува	muknuva
муктар	muktar
муле	mulɛ
муленце	mulɛnt͡sɛ
муслимански	muslimanski
мутациски	mutat͡siski
муце	mut͡sɛ
муцка	mut͡ska
мушама	muʃama
мушичка	muʃit͡ʃka
мушмула	muʃmuɫa
набабреност	nababrɛnɔst
набавка	nabafka
набира	nabiɾa
набожен	nabɔʒɛn
набрашни	nabraʃni
набрашнува	nabraʃnuva
набројува	nabrɔjuva
набљудувачки	nabluduvat͡ʃki
навасува	navasuva
наведнува	navɛdnuva
навивачки	navivat͡ʃki
навигациски	naviɡat͡siski
навиткува	navitkuva
навлажнува	navɫaʒnuva
навлажува	navɫaʒuva
наводени	navɔdɛni
наводенува	navɔdɛnuva
наводнува	navɔdnuva
наврапитост	navrapitɔst
навраќа	navraca
навреденост	navrɛdɛnɔst
навредливост	navrɛdlivɔst
наврнува	navr̩nuva
наврти	navr̩ti
нагазува	naɡazuva
нагласеност	naɡɫasɛnɔst
наглост	naɡɫɔst
нагорчува	naɡɔrt͡ʃuva
нагостува	naɡɔstuva
награба	naɡraba
нагрдува	naɡr̩duva
нагризува	naɡrizuva
нагрнува	naɡr̩nuva
над	nat
надареност	nadaɾɛnɔst
надарува	nadaɾuva
надвикува	nadvikuva
надвишува	nadviʃuva
надвозник	nadvɔznik
надгласилен	nadɡɫasilɛn
надградува	nadɡraduva
надежен	nadɛʒɛn
надежност	nadɛʒnɔst
наденува	nadɛnuva
надживува	nadʒivuva
надзборува	nadzbɔɾuva
надзорен	nadzɔɾɛn
надзорничка	nadzɔrnit͡ʃka
надлежност	nadlɛʒnɔst
надморски	nadmɔrski
надмоќност	nadmɔcnɔst
надничарка	nadnit͡ʃarka
надничарски	nadnit͡ʃarski
надоаѓа	nadɔaɟa
надоградува	nadɔɡraduva
надополнува	nadɔpɔɫnuva
надотера	nadɔtɛɾa
надразнетост	nadraznɛtɔst
надреденост	nadrɛdɛnɔst
надуеност	naduɛnɔst
наемен	naɛmɛn
наемник	naɛmnik
назад	nazat
назадност	nazadnɔst
назадува	nazaduva
назализација	nazalizat͡sija
наивност	naivnɔst
накаже	nakaʒɛ
накалемува	nakalɛmuva
наквасува	nakvasuva
накиснува	nakisnuva
накитува	nakituva
наклеветува	naklɛvɛtuva
наклонетост	nakɫɔnɛtɔst
накодошува	nakɔdɔʃuva
накопа	nakɔpa
накосеност	nakɔsɛnɔst
накострешеност	nakɔstrɛʃɛnɔst
накострешува	nakɔstrɛʃuva
налепи	nalɛpi
налета	nalɛta
наликува	nalikuva
наложништво	naɫɔʒniʃtvɔ
налудничавост	naɫudnit͡ʃavɔst
намаленост	namalɛnɔst
намамува	namamuva
намачкува	namat͡ʃkuva
намеле	namɛlɛ
наменски	namɛnski
намерува	namɛɾuva
намеси	namɛsi
наместува	namɛstuva
наминува	naminuva
намирисува	namirisuva
намокрува	namɔkruva
намолува	namɔɫuva
намотува	namɔtuva
намрштеност	namr̩ʃtɛnɔst
намуртеност	namurtɛnɔst
намќорски	namcɔrski
нанижува	naniʒuva
наобразба	naɔbrazba
наочари	naɔt͡ʃaɾi
наочарчиња	naɔt͡ʃart͡ʃiɲa
наочник	naɔt͡ʃnik
нападност	napadnɔst
напакува	napakuva
напасник	napasnik
напатеност	napatɛnɔst
напивка	napifka
наплеска	naplɛska
наплиска	napliska
наплука	napɫuka
напнува	napnuva
наполнува	napɔɫnuva
напомена	napɔmɛna
напоменува	napɔmɛnuva
напоредник	napɔɾɛdnik
напоредност	napɔɾɛdnɔst
напорност	napɔrnɔst
напрашува	napraʃuva
напрегнатост	naprɛɡnatɔst
напредност	naprɛdnɔst
напротив	naprɔtif
напудри	napudri
нараторски	naratɔrski
нарација	narat͡sija
народен	naɾɔdɛn
народност	naɾɔdnɔst
нарцизам	nart͡sizam
нас	nas
насадува	nasaduva
насамарува	nasamaɾuva
насапунува	nasapunuva
насаскува	nasaskuva
насее	nasɛɛ
население	nasɛlɛnijɛ
населеност	nasɛlɛnɔst
насече	nasɛt͡ʃɛ
насилничка	nasiɫnit͡ʃka
наситува	nasituva
наследност	naslɛdnɔst
насловува	nasɫɔvuva
наслутува	nasɫutuva
насоли	nasɔli
наспроти	nasprɔti
настани	nastani
настинува	nastinuva
настојчивост	nastɔjt͡ʃivɔst
настрадува	nastraduva
настран	nastran
настроеност	nastrɔɛnɔst
натажува	nataʒuva
натамошен	natamɔʃɛn
натежнува	natɛʒnuva
натопорува	natɔpɔɾuva
наточува	natɔt͡ʃuva
натприродност	natpriɾɔdnɔst
натпросечност	natprɔsɛt͡ʃnɔst
натрапник	natrapnik
натрапничка	natrapnit͡ʃka
натрапува	natrapuva
наука	nauka
научноистражувачки	naut͡ʃnɔistraʒuvat͡ʃki
научува	naut͡ʃuva
нафрла	nafr̩ɫa
нацеди	nat͡sɛdi
национализам	nat͡sijɔnalizam
национализација	nat͡sijɔnalizat͡sija
нацрпи	nat͡sr̩pi
начекува	nat͡ʃɛkuva
начелен	nat͡ʃɛlɛn
наш	naʃ
нашара	naʃaɾa
најавувач	najavuvat͡ʃ
најгвирц	najɡvirt͡s
најквирц	najkvirt͡s
најлонски	najɫɔnski
неа	nɛa
неактивност	nɛaktivnɔst
неарно	nɛarnɔ
небаре	nɛbaɾɛ
небеса	nɛbɛsa
небесен	nɛbɛsɛn
небиднина	nɛbidnina
небитност	nɛbitnɔst
небо	nɛbɔ
небричен	nɛbrit͡ʃɛn
невалиден	nɛvalidɛn
невалидност	nɛvalidnɔst
неверничка	nɛvɛrnit͡ʃka
неверојатност	nɛvɛrɔjatnɔst
невеста	nɛvɛsta
невиден	nɛvidɛn
невистина	nɛvistina
невистинитост	nɛvistinitɔst
невооружан	nɛvɔɔɾuʒan
невоспитаност	nɛvɔspitanɔst
неврологија	nɛvrɔɫɔɡija
негација	nɛɡat͡sija
него	nɛɡɔ
негов	nɛɡɔf
негодува	nɛɡɔduva
негостопримливост	nɛɡɔstɔprimlivɔst
негостољубивост	nɛɡɔstɔlubivɔst
недвижнина	nɛdviʒnina
недвижнини	nɛdviʒnini
недвижност	nɛdviʒnɔst
недвижности	nɛdviʒnɔsti
недела	nɛdɛɫa
неделивост	nɛdɛlivɔst
неделник	nɛdɛɫnik
недобоен	nɛdɔbɔɛn
недобричен	nɛdɔbrit͡ʃɛn
недобро	nɛdɔbrɔ
недобушен	nɛdɔbuʃɛn
недоварен	nɛdɔvaɾɛn
недоверба	nɛdɔvɛrba
недоволност	nɛdɔvɔɫnɔst
недовршеност	nɛdɔvr̩ʃɛnɔst
недогорен	nɛdɔɡɔɾɛn
недоготвен	nɛdɔɡɔtvɛn
недограден	nɛdɔɡradɛn
недозволен	nɛdɔzvɔlɛn
недозволивост	nɛdɔzvɔlivɔst
недозреан	nɛdɔzrɛan
недоискажан	nɛdɔiskaʒan
недокажан	nɛdɔkaʒan
недокваканост	nɛdɔkvakanɔst
недокршен	nɛdɔkr̩ʃɛn
недолепен	nɛdɔlɛpɛn
недолечен	nɛdɔlɛt͡ʃɛn
недоличност	nɛdɔlit͡ʃnɔst
недолупен	nɛdɔɫupɛn
недомесен	nɛdɔmɛsɛn
недонесен	nɛdɔnɛsɛn
недооформен	nɛdɔɔfɔrmɛn
недооценет	nɛdɔɔt͡sɛnɛt
недопечен	nɛdɔpɛt͡ʃɛn
недопиен	nɛdɔpijɛn
недопишан	nɛdɔpiʃan
недоплатен	nɛdɔpɫatɛn
недоплетен	nɛdɔplɛtɛn
недоправен	nɛdɔpravɛn
недопрен	nɛdɔprɛn
недопржен	nɛdɔpr̩ʒɛn
недопушен	nɛdɔpuʃɛn
недоработен	nɛdɔrabɔtɛn
недоразбран	nɛdɔɾazbran
недоразвиен	nɛdɔrazvijɛn
недоразвиеност	nɛdɔɾazvijɛnɔst
недораснат	nɛdɔɾasnat
недораснатост	nɛdɔrasnatɔst
недорасонет	nɛdɔrasɔnɛt
недоречен	nɛdɔɾɛt͡ʃɛn
недорешен	nɛdɔɾɛʃɛn
недосежност	nɛdɔsɛʒnɔst
недосечен	nɛdɔsɛt͡ʃɛn
недоследност	nɛdɔslɛdnɔst
недосликан	nɛdɔslikan
недоставен	nɛdɔstavɛn
недостижност	nɛdɔstiʒnɔst
недостоинственост	nɛdɔstɔinstvɛnɔst
недостојност	nɛdɔstɔjnɔst
недосушен	nɛdɔsuʃɛn
недотеран	nɛdɔtɛɾan
недоткаен	nɛdɔtkaɛn
недотресен	nɛdɔtrɛsɛn
недотриен	nɛdɔtrijɛn
недотрошен	nɛdɔtrɔʃɛn
недоучен	nɛdɔut͡ʃɛn
недочистен	nɛdɔt͡ʃistɛn
недочитан	nɛdɔt͡ʃitan
недошиен	nɛdɔʃijɛn
недоѕидан	nɛdɔd͡zidan
недојаден	nɛdɔjadɛn
недругарски	nɛdruɡarski
недруштвеност	nɛdruʃtvɛnɔst
недугавост	nɛduɡavɔst
нежив	nɛʒif
незабележан	nɛzabɛlɛʒan
незабележливост	nɛzabɛlɛʒlivɔst
незадоволителност	nɛzadɔvɔlitɛɫnɔst
незаинтересираност	nɛzaintɛɾɛsiɾanɔst
незаконитост	nɛzakɔnitɔst
незакотвен	nɛzakɔtvɛn
незакрепнатост	nɛzakrɛpnatɔst
незаменливост	nɛzamɛnlivɔst
незамисливост	nɛzamislivɔst
незаоблен	nɛzaɔblɛn
незапирливост	nɛzapirlivɔst
незачуван	nɛzat͡ʃuvan
незаштитен	nɛzaʃtitɛn
незаштитеност	nɛzaʃtitɛnɔst
незгодност	nɛzɡɔdnɔst
неидентификуван	nɛidɛntifikuvan
неизбричен	nɛizbrit͡ʃɛn
неизбришан	nɛizbriʃan
неизводливост	nɛizvɔdlivɔst
неизлечивост	nɛizlɛt͡ʃivɔst
неизлупен	nɛizɫupɛn
неизмазнет	nɛizmaznɛt
неизмерност	nɛizmɛrnɔst
неизметен	nɛizmɛtɛn
неизмиен	nɛizmijɛn
неизразен	nɛizrazɛn
неизрамнет	nɛizramnɛt
неизречен	nɛizrɛt͡ʃɛn
неизјаснет	nɛizjasnɛt
неискажливост	nɛiskaʒlivɔst
неискоренливост	nɛiskɔrɛnlivɔst
неискористен	nɛiskɔɾistɛn
неискреност	nɛiskrɛnɔst
неискусност	nɛiskusnɔst
неисплакнат	nɛispɫaknat
неисполнет	nɛispɔɫnɛt
неисправен	nɛispravɛn
неистребливост	nɛistrɛblivɔst
неисхранетост	nɛisxranɛtɔst
неисчистен	nɛiʃt͡ʃistɛn
нека	nɛka
некадарен	nɛkadaɾɛn
неказнет	nɛkaznɛt
неколку	nɛkɔlku
некрофилија	nɛkrɔfilija
нелегален	nɛlɛɡalɛn
нелупен	nɛɫupɛn
немарност	nɛmarnɔst
немаштија	nɛmaʃtija
неменливост	nɛmɛnlivɔst
немец	nɛmɛt͡s
немечко	nɛmɛt͡ʃkɔ
немиен	nɛmijɛn
немил	nɛmiɫ
немилосрдие	nɛmiɫɔsr̩dijɛ
немилосрдност	nɛmiɫɔsr̩dnɔst
немилост	nɛmiɫɔst
неморалност	nɛmɔɾaɫnɔst
немост	nɛmɔst
нему	nɛmu
ненавикнат	nɛnaviknat
ненавикнатост	nɛnaviknatɔst
ненагласеност	nɛnaɡɫasɛnɔst
ненаграден	nɛnaɡradɛn
ненадарен	nɛnadaɾɛn
ненадејност	nɛnadɛjnɔst
ненадминат	nɛnadminat
ненадминатост	nɛnadminatɔst
ненадоместливост	nɛnadɔmɛstlivɔst
ненамачкан	nɛnamat͡ʃkan
ненаместен	nɛnamɛstɛn
ненаметливост	nɛnamɛtlivɔst
ненаоружан	nɛnaɔɾuʒan
ненапишан	nɛnapiʃan
ненаправен	nɛnapravɛn
ненареден	nɛnaɾɛdɛn
ненасаден	nɛnasadɛn
ненаселеност	nɛnasɛlɛnɔst
ненаспан	nɛnaspan
ненашетан	nɛnaʃɛtan
ненајавен	nɛnajavɛn
ненајаден	nɛnajadɛn
ненормалност	nɛnɔrmaɫnɔst
необновен	nɛɔbnɔvɛn
необновлив	nɛɔbnɔvlif
необновливост	nɛɔbnɔvlivɔst
необоен	nɛɔbɔɛn
необоснованост	nɛɔbɔsnɔvanɔst
необработливост	nɛɔbrabɔtlivɔst
необузданост	nɛɔbuzdanɔst
необучен	nɛɔbut͡ʃɛn
необјавен	nɛɔbjavɛn
необјаснет	nɛɔbjasnɛt
необјаснив	nɛɔbjasnif
необјаснивост	nɛɔbjasnivɔst
неовластен	nɛɔvɫastɛn
неодговорност	nɛɔdɡɔvɔrnɔst
неодмереност	nɛɔdmɛɾɛnɔst
неодобрен	nɛɔdɔbrɛn
неоздравен	nɛɔzdravɛn
неоладен	nɛɔɫadɛn
неопипливост	nɛɔpiplivɔst
неопишан	nɛɔpiʃan
неоправдан	nɛɔpravdan
неопределеност	nɛɔprɛdɛlɛnɔst
неопходност	nɛɔpxɔdnɔst
неоран	nɛɔɾan
неорганизираност	nɛɔrɡaniziɾanɔst
неоснован	nɛɔsnɔvan
неостварливост	nɛɔstvarlivɔst
неоткриен	nɛɔtkrijɛn
неотстранливост	nɛɔtstranlivɔst
неотуѓивост	nɛɔtuɟivɔst
неоштетен	nɛɔʃtɛtɛn
непал	nɛpaɫ
непланиран	nɛpɫaniɾan
неплатен	nɛpɫatɛn
непобитност	nɛpɔbitnɔst
неповреден	nɛpɔvrɛdɛn
неповредливост	nɛpɔvrɛdlivɔst
неповрзан	nɛpɔvr̩zan
неповрзаност	nɛpɔvr̩zanɔst
неповторливост	nɛpɔftɔrlivɔst
непогода	nɛpɔɡɔda
непогодност	nɛpɔɡɔdnɔst
непогрешливост	nɛpɔɡrɛʃlivɔst
неподготвен	nɛpɔdɡɔtvɛn
неподготвеност	nɛpɔdɡɔtvɛnɔst
неподмитливост	nɛpɔdmitlivɔst
неподносливост	nɛpɔdnɔslivɔst
неподобен	nɛpɔdɔbɛn
неподобност	nɛpɔdɔbnɔst
непокажан	nɛpɔkaʒan
непокриен	nɛpɔkrijɛn
неполнолетност	nɛpɔɫnɔlɛtnɔst
неположен	nɛpɔɫɔʒɛn
непосакуван	nɛpɔsakuvan
непосредност	nɛpɔsrɛdnɔst
непостојаност	nɛpɔstɔjanɔst
непоткупливост	nɛpɔtkuplivɔst
непотполност	nɛpɔtpɔɫnɔst
непотребност	nɛpɔtrɛbnɔst
непоштеден	nɛpɔʃtɛdɛn
неправедност	nɛpravɛdnɔst
непреводливост	nɛprɛvɔdlivɔst
непрекинатост	nɛprɛkinatɔst
непрекинливост	nɛprɛkinlivɔst
непреодност	nɛprɛɔdnɔst
непресушност	nɛprɛsuʃnɔst
непретпазливост	nɛprɛtpazlivɔst
непривлечност	nɛprivlɛt͡ʃnɔst
непризнаен	nɛpriznaɛn
неприкладност	nɛprikɫadnɔst
неприкосновеност	nɛprikɔsnɔvɛnɔst
неприкриен	nɛprikrijɛn
неприлагоден	nɛpriɫaɡɔdɛn
неприлика	nɛprilika
неприменливост	nɛprimɛnlivɔst
неприфатен	nɛprifatɛn
непријавен	nɛprijavɛn
непријателка	nɛprijatɛɫka
непробојност	nɛprɔbɔjnɔst
непроверен	nɛprɔvɛɾɛn
непроветрен	nɛprɔvɛtrɛn
непровидност	nɛprɔvidnɔst
непрозрачност	nɛprɔzrat͡ʃnɔst
непрокопсаност	nɛprɔkɔpsanɔst
непроменливост	nɛprɔmɛnlivɔst
непроодност	nɛprɔɔdnɔst
непропустливост	nɛprɔpustlivɔst
непростен	nɛprɔstɛn
непрочистен	nɛprɔt͡ʃistɛn
непрочитан	nɛprɔt͡ʃitan
непроширен	nɛprɔʃiɾɛn
непушач	nɛpuʃat͡ʃ
неразбирливост	nɛɾazbirlivɔst
неразбран	nɛɾazbran
неразбраност	nɛrazbranɔst
неразделност	nɛrazdɛɫnɔst
неразреден	nɛrazrɛdɛn
неразумност	nɛrazumnɔst
неразјаснет	nɛrazjasnɛt
неразјаснетост	nɛɾazjasnɛtɔst
нераскинливост	nɛɾaskinlivɔst
нерасположеност	nɛɾaspɔɫɔʒɛnɔst
нерастворливост	nɛɾastvɔrlivɔst
нередовност	nɛrɛdɔvnɔst
нерешен	nɛɾɛʃɛn
нерешителност	nɛɾɛʃitɛɫnɔst
нерешливост	nɛrɛʃlivɔst
несакан	nɛsakan
несамостојност	nɛsamɔstɔjnɔst
несварливост	nɛsvarlivɔst
несебичност	nɛsɛbit͡ʃnɔst
несигурност	nɛsiɡurnɔst
несилка	nɛsiɫka
нескротливост	nɛskrɔtlivɔst
неснаодливост	nɛsnaɔdlivɔst
несовесност	nɛsɔvɛsnɔst
несовладан	nɛsɔvɫadan
несовпадливост	nɛsɔfpadlivɔst
несогласност	nɛsɔɡɫasnɔst
несодржајност	nɛsɔdr̩ʒajnɔst
несоодветност	nɛsɔɔdvɛtnɔst
несочуван	nɛsɔt͡ʃuvan
неспокојност	nɛspɔkɔjnɔst
неспомнат	nɛspɔmnat
неспоредлив	nɛspɔɾɛdlif
неспоредливост	nɛspɔrɛdlivɔst
несправедливост	nɛspravɛdlivɔst
неспремност	nɛsprɛmnɔst
несразмерност	nɛsrazmɛrnɔst
несреденост	nɛsrɛdɛnɔst
нестабилност	nɛstabiɫnɔst
несфатливост	nɛsfatlivɔst
нетактичност	nɛtaktit͡ʃnɔst
нетолеранција	nɛtɔlɛrant͡sija
неточност	nɛtɔt͡ʃnɔst
неугледност	nɛuɡlɛdnɔst
неудобност	nɛudɔbnɔst
неудопство	nɛudɔpstvɔ
неукрасен	nɛukrasɛn
неумешност	nɛumɛʃnɔst
неумност	nɛumnɔst
неумоливост	nɛumɔlivɔst
неуништливост	nɛuniʃtlivɔst
неупотребен	nɛupɔtrɛbɛn
неуредност	nɛuɾɛdnɔst
неуслужливост	nɛusɫuʒlivɔst
неусогласеност	nɛusɔɡɫasɛnɔst
неуспех	nɛuspɛx
неуставност	nɛustavnɔst
неутрализација	nɛutralizat͡sija
нехуманост	nɛxumanɔst
нецелосност	nɛt͡sɛɫɔsnɔst
нечесност	nɛt͡ʃɛsnɔst
нечистотија	nɛt͡ʃistɔtija
нечитливост	nɛt͡ʃitlivɔst
нечујност	nɛt͡ʃujnɔst
нешта	nɛʃta
нешто	nɛʃtɔ
нејзе	nɛjzɛ
нива	niva
ниво	nivɔ
нивје	nivjɛ
ние	nijɛ
никаквец	nikakvɛt͡s
нимфа	niɱfa
нимфоманија	niɱfɔmanija
нискост	niskɔst
ничкум	nit͡ʃkum
ништо	niʃtɔ
ништожност	niʃtɔʒnɔst
нов	nɔf
новина	nɔvina
новинар	nɔvinar
новинарка	nɔvinarka
новинарство	nɔvinarstvɔ
новини	nɔvini
новост	nɔvɔst
нога	nɔɡa
ногопис	nɔɡɔpis
ноември	nɔɛɱvri
нож	nɔʃ
ножици	nɔʒit͡si
ножички	nɔʒit͡ʃki
ноздра	nɔzdra
нокт	nɔkt
нокти	nɔkti
нокшир	nɔkʃir
нокширче	nɔkʃirt͡ʃɛ
нормализација	nɔrmalizat͡sija
носивост	nɔsivɔst
носорог	nɔsɔɾɔk
носталгичност	nɔstaɫɡit͡ʃnɔst
нострификација	nɔstrifikat͡sija
нотарка	nɔtarka
нотарски	nɔtarski
ној	nɔj
ноќ	nɔc
ноќе	nɔcɛ
ноќева	nɔcɛva
ноќница	nɔcnit͡sa
ноџе	nɔd͡ʒɛ
нужник	nuʒnik
нужност	nuʒnɔst
нукуалофа	nukuaɫɔfa
нукуалофански	nukuaɫɔfanski
нула	nuɫa
нѐ	nɛ
обвинителка	ɔbvinitɛɫka
обвинителски	ɔbvinitɛɫski
обврзник	ɔbvr̩znik
обдарува	ɔbdaɾuva
обдукција	ɔbdukt͡sija
обединетост	ɔbɛdinɛtɔst
обезбојува	ɔbɛzbɔjuva
обезвластува	ɔbɛzvɫastuva
обезвучи	ɔbɛzvut͡ʃi
обезвучува	ɔbɛzvut͡ʃuva
обезименува	ɔbɛzimɛnuva
обезмастува	ɔbɛzmastuva
обезнадежува	ɔbɛznadɛʒuva
обезоружува	ɔbɛzɔruʒuva
обелува	ɔbɛɫuva
обемност	ɔbɛmnɔst
обесправеност	ɔbɛspravɛnɔst
обесхрабреност	ɔbɛsxrabrɛnɔst
обесштетува	ɔbɛʃʃtɛtuva
обзнани	ɔbznani
обзнанува	ɔbznanuva
обилен	ɔbilɛn
обилност	ɔbiɫnɔst
обичен	ɔbit͡ʃɛn
облак	ɔbɫak
облаче	ɔbɫat͡ʃɛ
облачност	ɔbɫat͡ʃnɔst
облог	ɔbɫɔk
обнадежува	ɔbnadɛʒuva
обновлив	ɔbnɔvlif
обожавателка	ɔbɔʒavatɛɫka
обор	ɔbɔr
обостраност	ɔbɔstranɔst
образование	ɔbrazɔvanijɛ
обратно	ɔbratnɔ
обувка	ɔbufka
објавувач	ɔbjavuvat͡ʃ
ова	ɔva
оваа	ɔvaa
оваму	ɔvamu
овација	ɔvat͡sija
овде	ɔvdɛ
овдека	ɔvdɛka
овдешен	ɔvdɛʃɛn
овенатост	ɔvɛnatɔst
овенува	ɔvɛnuva
овес	ɔvɛs
овие	ɔvijɛ
овнешки	ɔvnɛʃki
овогодишен	ɔvɔɡɔdiʃɛn
овоштарство	ɔvɔʃtarstvɔ
овошје	ɔvɔʃjɛ
овој	ɔvɔj
овца	ɔft͡sa
овци	ɔft͡si
овчар	ɔft͡ʃar
овчаров	ɔft͡ʃaɾɔf
овчарство	ɔft͡ʃarstvɔ
овчарче	ɔft͡ʃart͡ʃɛ
овчи	ɔft͡ʃi
оган	ɔɡan
оганче	ɔɡant͡ʃɛ
огламник	ɔɡɫamnik
огласен	ɔɡɫasɛn
огласник	ɔɡɫasnik
огледало	ɔɡlɛdaɫɔ
огледалце	ɔɡlɛdaɫt͡sɛ
оглупавеност	ɔɡɫupavɛnɔst
огноотпорност	ɔɡnɔɔtpɔrnɔst
ограда	ɔɡrada
ограниченост	ɔɡranit͡ʃɛnɔst
огранок	ɔɡranɔk
ограѓе	ɔɡraɟɛ
огромност	ɔɡrɔmnɔst
одбегнува	ɔdbɛɡnuva
одбива	ɔdbiva
одбивност	ɔdbivnɔst
одборник	ɔdbɔrnik
одбој	ɔdbɔj
одбојка	ɔdbɔjka
одбранува	ɔdbranuva
одважност	ɔdvaʒnɔst
одведува	ɔdvɛduva
одвиткува	ɔdvitkuva
одвлекува	ɔdvlɛkuva
одвојува	ɔdvɔjuva
одвратност	ɔdvratnɔst
одвртува	ɔdvr̩tuva
одгатнува	ɔdɡatnuva
одгледувач	ɔdɡlɛduvat͡ʃ
одгледувачки	ɔdɡlɛduvat͡ʃki
одговор	ɔdɡɔvɔr
одговори	ɔdɡɔvɔɾi
одгризува	ɔdɡrizuva
оддалеченост	ɔddalɛt͡ʃɛnɔst
одерува	ɔdɛɾuva
оди	ɔdi
одигрува	ɔdiɡruva
одлази	ɔdɫazi
одлазува	ɔdɫazuva
одлежи	ɔdlɛʒi
одличност	ɔdlit͡ʃnɔst
одмазднички	ɔdmazdnit͡ʃki
одмаздољубивост	ɔdmazdɔlubivɔst
одмереност	ɔdmɛɾɛnɔst
одмерува	ɔdmɛɾuva
одметник	ɔdmɛtnik
одмореност	ɔdmɔɾɛnɔst
одморски	ɔdmɔrski
однародува	ɔdnarɔduva
однесува	ɔdnɛsuva
одработува	ɔdrabɔtuva
одреденост	ɔdrɛdɛnɔst
одредиште	ɔdrɛdiʃtɛ
одродник	ɔdrɔdnik
одушевеност	ɔduʃɛvɛnɔst
одјури	ɔdjuɾi
озарува	ɔzaɾuva
озвучи	ɔzvut͡ʃi
озвучува	ɔzvut͡ʃuva
озон	ɔzɔn
озрачува	ɔzrat͡ʃuva
океан	ɔkɛan
окленд	ɔklɛnt
оклоп	ɔkɫɔp
оклопен	ɔkɫɔpɛn
око	ɔkɔ
оков	ɔkɔf
ококорува	ɔkɔkɔɾuva
околен	ɔkɔlɛn
околност	ɔkɔɫnɔst
окрвавува	ɔkr̩vavuva
окрка	ɔkr̩ka
оксидација	ɔksidat͡sija
октомври	ɔktɔɱvri
окупаторски	ɔkupatɔrski
окупациски	ɔkupat͡siski
окупација	ɔkupat͡sija
олабави	ɔɫabavi
олабавува	ɔɫabavuva
оладува	ɔɫaduva
олеснителен	ɔlɛsnitɛlɛn
олимпиец	ɔlimpijɛt͡s
олтарски	ɔɫtarski
омаеност	ɔmaɛnɔst
оман	ɔman
омекнатост	ɔmɛknatɔst
омекнувач	ɔmɛknuvat͡ʃ
омеѓува	ɔmɛɟuva
омлет	ɔmlɛt
омлитавува	ɔmlitavuva
онади	ɔnadi
онаму	ɔnamu
онде	ɔndɛ
ондека	ɔndɛka
онеспособеност	ɔnɛspɔsɔbɛnɔst
ономастика	ɔnɔmastika
оној	ɔnɔj
онтологија	ɔntɔɫɔɡija
опавче	ɔpaft͡ʃɛ
опасен	ɔpasɛn
опасност	ɔpasnɔst
опашка	ɔpaʃka
опашува	ɔpaʃuva
опера	ɔpɛɾa
операциски	ɔpɛrat͡siski
опипува	ɔpipuva
опис	ɔpis
опитомува	ɔpitɔmuva
опијанетост	ɔpijanɛtɔst
опијанува	ɔpijanuva
опнува	ɔpnuva
опозициски	ɔpɔzit͡siski
ополномоштеник	ɔpɔɫnɔmɔʃtɛnik
опомена	ɔpɔmɛna
опортунистички	ɔpɔrtunistit͡ʃki
опојност	ɔpɔjnɔst
определеност	ɔprɛdɛlɛnɔst
опредметува	ɔprɛdmɛtuva
опсадник	ɔpsadnik
опседнатост	ɔpsɛdnatɔst
опседнува	ɔpsɛdnuva
опсипува	ɔpsipuva
опстанува	ɔpstanuva
опстојува	ɔpstɔjuva
опсудува	ɔpsuduva
оптегнатост	ɔptɛɡnatɔst
оптегнува	ɔptɛɡnuva
оптимистичност	ɔptimistit͡ʃnɔst
опустошува	ɔpustɔʃuva
опуштеност	ɔpuʃtɛnɔst
опчинетост	ɔpt͡ʃinɛtɔst
опширност	ɔpʃirnɔst
орален	ɔɾalɛn
ораница	ɔranit͡sa
орасположува	ɔɾaspɔɫɔʒuva
ораторски	ɔratɔrski
организаторски	ɔrɡanizatɔrski
организациски	ɔrɡanizat͡siski
орден	ɔrdɛn
ординарии	ɔrdinaɾii
ординарија	ɔrdinaɾija
орев	ɔɾɛf
оревокршачка	ɔɾɛvɔkr̩ʃat͡ʃka
оревче	ɔɾɛft͡ʃɛ
орелски	ɔɾɛɫski
оривче	ɔɾift͡ʃɛ
ориентациски	ɔɾijɛntat͡siski
ориз	ɔɾis
орле	ɔrlɛ
орлов	ɔrɫɔf
орнитологија	ɔrnitɔɫɔɡija
орница	ɔrnit͡sa
оро	ɔɾɔ
ортак	ɔrtak
ортопедија	ɔrtɔpɛdija
орце	ɔrt͡sɛ
орјат	ɔrjat
орјати	ɔrjati
орјатин	ɔrjatin
орјатка	ɔrjatka
орјатски	ɔrjatski
оса	ɔsa
осакатува	ɔsakatuva
осамне	ɔsamnɛ
осамостојува	ɔsamɔstɔjuva
осарник	ɔsarnik
освежувач	ɔsvɛʒuvat͡ʃ
освен	ɔsvɛn
осветленост	ɔsvɛtlɛnɔst
освојувачки	ɔsvɔjuvat͡ʃki
оседлува	ɔsɛdɫuva
оси	ɔsi
осигурител	ɔsiɡuɾitɛɫ
осило	ɔsiɫɔ
осин	ɔsin
осквернител	ɔskvɛrnitɛɫ
осквернува	ɔskvɛrnuva
оскудност	ɔskudnɔst
осло	ɔsɫɔ
ослоански	ɔsɫɔanski
ослободеност	ɔsɫɔbɔdɛnɔst
ослободителка	ɔsɫɔbɔditɛɫka
осмиум	ɔsmijum
основен	ɔsnɔvɛn
особеност	ɔsɔbɛnɔst
оспособеност	ɔspɔsɔbɛnɔst
оставка	ɔstafka
остарува	ɔstaɾuva
острилка	ɔstriɫka
острина	ɔstrina
остров	ɔstrɔf
островче	ɔstrɔft͡ʃɛ
осум	ɔsum
осумдесет	ɔsumdɛsɛt
осуммина	ɔsummina
осумнаесет	ɔsumnaɛsɛt
осумстотини	ɔsumstɔtini
осцилациски	ɔst͡siɫat͡siski
осцилација	ɔst͡siɫat͡sija
отава	ɔtava
отавјански	ɔtavjanski
отапеност	ɔtapɛnɔst
отапува	ɔtapuva
отвора	ɔtvɔɾa
отвореност	ɔtvɔɾɛnɔst
отвори	ɔtvɔɾi
отец	ɔtɛt͡s
откачува	ɔtkat͡ʃuva
откинува	ɔtkinuva
откочи	ɔtkɔt͡ʃi
откупува	ɔtkupuva
откупувач	ɔtkupuvat͡ʃ
оториноларингологија	ɔtɔɾinɔɫaɾiŋɡɔɫɔɡija
отпадник	ɔtpadnik
отпадничка	ɔtpadnit͡ʃka
отпадништво	ɔtpadniʃtvɔ
отпакува	ɔtpakuva
отпара	ɔtpaɾa
отпатува	ɔtpatuva
отпечати	ɔtpɛt͡ʃati
отпишува	ɔtpiʃuva
отпловува	ɔtpɫɔvuva
отпоздрави	ɔtpɔzdravi
отрезнува	ɔtrɛznuva
отров	ɔtrɔf
отровност	ɔtrɔvnɔst
отрпнува	ɔtr̩pnuva
отсвирува	ɔtsviɾuva
отсекува	ɔtsɛkuva
отсечност	ɔtsɛt͡ʃnɔst
отстапка	ɔtstapka
отстои	ɔtstɔi
оттурнува	ɔtturnuva
отуѓеност	ɔtuɟɛnɔst
отчукува	ɔtt͡ʃukuva
отшелник	ɔtʃɛɫnik
отшрафува	ɔtʃrafuva
оформува	ɔfɔrmuva
офталмологија	ɔftaɫmɔɫɔɡija
офтика	ɔftika
охрид	ɔxrit
охриѓанец	ɔxriɟanɛt͡s
охриѓанка	ɔxriɟaŋka
охриѓанче	ɔxriɟant͡ʃɛ
оцет	ɔt͡sɛt
оцрт	ɔt͡sr̩t
оцртува	ɔt͡sr̩tuva
очи	ɔt͡ʃi
очигледност	ɔt͡ʃiɡlɛdnɔst
очила	ɔt͡ʃiɫa
очник	ɔt͡ʃnik
очовечува	ɔt͡ʃɔvɛt͡ʃuva
оштетеник	ɔʃtɛtɛnik
оќелавува	ɔcɛɫavuva
оќори	ɔcɔɾi
оќорува	ɔcɔɾuva
оџачарски	ɔd͡ʒat͡ʃarski
оџачарство	ɔd͡ʒat͡ʃarstvɔ
па	pa
па	pʰa
падежен	padɛʒɛn
пазар	pazar
пазарче	pazart͡ʃɛ
пазарџија	pazard͡ʒija
пакет	pakɛt
пакетче	pakɛtt͡ʃɛ
пакистан	pakistan
палавост	paɫavɔst
палатализација	paɫatalizat͡sija
палента	palɛnta
палеонтологија	palɛɔntɔɫɔɡija
палестина	palɛstina
палец	palɛt͡s
паликир	palikir
паликирски	palikirski
палка	paɫka
палмов	paɫmɔf
палтенце	paɫtɛnt͡sɛ
палто	paɫtɔ
палче	paɫt͡ʃɛ
памук	pamuk
памуче	pamut͡ʃɛ
пандан	pandan
панкер	paŋkɛr
панкерка	paŋkɛrka
пантомимичарка	pantɔmimit͡ʃarka
пантомимичен	pantɔmimit͡ʃɛn
папок	papɔk
папочен	papɔt͡ʃɛn
папски	papski
папсува	papsuva
папучарски	paput͡ʃarski
пара	paɾa
парада	parada
паралела	paɾalɛɫa
пари	paɾi
париз	paɾis
париски	paɾiski
париче	paɾit͡ʃɛ
парк	park
паркинг	parkiŋk
паркче	parkt͡ʃɛ
парник	parnik
пародија	parɔdija
партал	partaɫ
парталче	partaɫt͡ʃɛ
партицип	partit͡sip
парчуле	part͡ʃulɛ
пасивност	pasivnɔst
пасинок	pasinɔk
пасија	pasija
пасош	pasɔʃ
пасошки	pasɔʃki
пастеризација	pastɛɾizat͡sija
пасторски	pastɔrski
патеник	patɛnik
патетичност	patɛtit͡ʃnɔst
патка	patka
патлиџан	patlid͡ʒan
патлиџанче	patlid͡ʒant͡ʃɛ
патопис	patɔpis
патор	patɔr
патче	patt͡ʃɛ
паун	paun
паунов	paunɔf
паунче	paunt͡ʃɛ
пајаков	pajakɔf
пајка	pajka
пајче	pajt͡ʃɛ
певливост	pɛvlivɔst
педер	pɛdɛr
педерастија	pɛdɛrastija
педерка	pɛdɛrka
педерство	pɛdɛrstvɔ
педерче	pɛdɛrt͡ʃɛ
педесет	pɛdɛsɛt
педијатрија	pɛdijatrija
педофилија	pɛdɔfilija
пеење	pɛɛɲɛ
пекарство	pɛkarstvɔ
пекинг	pɛkiŋk
пекиншки	pɛkinʃki
пелена	pɛlɛna
пеленче	pɛlɛnt͡ʃɛ
пенетрација	pɛnɛtrat͡sija
пенис	pɛnis
пенкало	pɛŋkaɫɔ
пепелник	pɛpɛɫnik
пеперутка	pɛpɛɾutka
пеперуткин	pɛpɛɾutkin
пеперутче	pɛpɛɾutt͡ʃɛ
перверзија	pɛrvɛrzija
пердаши	pɛrdaʃi
пердув	pɛrduf
пердувче	pɛrduft͡ʃɛ
период	pɛɾijɔt
перипетија	pɛɾipɛtija
периферија	pɛɾifɛɾija
пермутација	pɛrmutat͡sija
перница	pɛrnit͡sa
перничка	pɛrnit͡ʃka
перо	pɛɾɔ
персиски	pɛrsiski
персонификација	pɛrsɔnifikat͡sija
перфидност	pɛrfidnɔst
перцепција	pɛrt͡sɛpt͡sija
перјаница	pɛrjanit͡sa
песимистичност	pɛsimistit͡ʃnɔst
песма	pɛsma
песна	pɛsna
песничка	pɛsnit͡ʃka
песок	pɛsɔk
пет	pɛt
петел	pɛtɛɫ
петлов	pɛtɫɔf
петмина	pɛtmina
петнаесет	pɛtnaɛsɛt
петок	pɛtɔk
петокрак	pɛtɔkrak
петолиние	pɛtɔlinijɛ
петстотини	pɛtstɔtini
петунија	pɛtunija
печалбарски	pɛt͡ʃaɫbarski
печурка	pɛt͡ʃurka
печурче	pɛt͡ʃurt͡ʃɛ
пешкир	pɛʃkir
пешкирче	pɛʃkirt͡ʃɛ
пештерски	pɛʃtɛrski
пивар	pivar
пиварски	pivarski
пиварство	pivarstvɔ
пивнува	pivnuva
пиво	pivɔ
пивце	pift͡sɛ
пигментација	piɡmɛntat͡sija
пие	pijɛ
пиење	pijɛɲɛ
пикадо	pikadɔ
пикнува	piknuva
пиков	pikɔf
пингвин	piŋɡvin
пинјин	pinjin
пиперка	pipɛrka
пиперче	pipɛrt͡ʃɛ
пиратство	piɾatstvɔ
пироманија	piɾɔmanija
писателство	pisatɛɫstvɔ
пискавост	piskavɔst
писменце	pismɛnt͡sɛ
писмо	pismɔ
писмуле	pismulɛ
писнува	pisnuva
писта	pista
питомост	pitɔmɔst
пица	pit͡sa
пицерија	pit͡sɛɾija
пицнат	pit͡snat
пичка	pit͡ʃka
пички	pit͡ʃki
пиштол	piʃtɔɫ
пиштолче	piʃtɔɫt͡ʃɛ
пишуваат	piʃuvaat
пишувам	piʃuvam
пишуваме	piʃuvamɛ
пишувате	piʃuvatɛ
пишуваш	piʃuvaʃ
пишувај	piʃuvaj
пишувајте	piʃuvajtɛ
пишување	piʃuvaɲɛ
пијан	pijan
пињола	piɲɔɫa
плагијаторски	pɫaɡijatɔrski
пламен	pɫamɛn
пламенче	pɫamɛnt͡ʃɛ
пламнува	pɫamnuva
план	pɫan
планета	pɫanɛta
планина	pɫanina
планинарски	pɫaninarski
планинче	pɫanint͡ʃɛ
пласт	pɫast
пластичарски	pɫastit͡ʃarski
платина	pɫatina
платинест	pɫatinɛst
платински	pɫatinski
платненце	pɫatnɛnt͡sɛ
платно	pɫatnɔ
платонски	pɫatɔnski
платформа	pɫatfɔrma
плачливост	pɫat͡ʃlivɔst
плаши	pɫaʃi
плаши	sɛpɫaʃi
плебеец	plɛbɛɛt͡s
плевен	plɛvɛn
племе	plɛmɛ
плен	plɛn
плет	plɛt
плејбек	plɛjbɛk
пливање	plivaɲɛ
плик	plik
плиснува	plisnuva
плиткост	plitkɔst
пловдив	pɫɔvdif
пловност	pɫɔvnɔst
плод	pɫɔt
плодови	pɫɔdɔvi
плотски	pɫɔtski
плуг	pɫuk
плука	pɫuka
плукалник	pɫukaɫnik
плукнува	pɫuknuva
пневмонија	pnɛvmɔnija
пномпенски	pnɔmpɛnski
побегнува	pɔbɛɡnuva
победа	pɔbɛda
победи	pɔbɛdi
победител	pɔbɛditɛɫ
побелува	pɔbɛɫuva
побеснува	pɔbɛsnuva
побожност	pɔbɔʒnɔst
поборник	pɔbɔrnik
поборништво	pɔbɔrniʃtvɔ
побратим	pɔbratim
побрбори	pɔbr̩bɔɾi
побркува	pɔbr̩kuva
побудалува	pɔbudaɫuva
побутнува	pɔbutnuva
поварди	pɔvardi
повари	pɔvaɾi
повелбен	pɔvɛɫbɛn
повереник	pɔvɛɾɛnik
повереничка	pɔvɛrɛnit͡ʃka
повеќезначност	pɔvɛcɛznat͡ʃnɔst
повеќејазичност	pɔvɛcɛjazit͡ʃnɔst
повикува	pɔvikuva
повиси	pɔvisi
повози	pɔvɔzi
поврат	pɔvrat
повратност	pɔvratnɔst
повраќа	pɔvraca
повреви	pɔvrɛvi
поврие	pɔvrijɛ
поврне	pɔvr̩nɛ
поврти	pɔvr̩ti
повторливост	pɔftɔrlivɔst
погазува	pɔɡazuva
погалами	pɔɡaɫami
погалува	pɔɡaɫuva
погани	pɔɡani
погинува	pɔɡinuva
погледнува	pɔɡlɛdnuva
поглода	pɔɡɫɔda
поглуми	pɔɡɫumi
погмечи	pɔɡmɛt͡ʃi
погодност	pɔɡɔdnɔst
погодува	pɔɡɔduva
погори	pɔɡɔɾi
поготви	pɔɡɔtvi
поградец	pɔɡradɛt͡s
погрден	pɔɡr̩dɛn
погрешува	pɔɡrɛʃuva
погрицка	pɔɡrit͡ska
погрми	pɔɡr̩mi
погуга	pɔɡuɡa
под	pɔt
поданица	pɔdanit͡sa
подбел	pɔdbɛɫ
подбира	pɔdbiɾa
подвиткува	pɔdvitkuva
подвозник	pɔdvɔznik
подгорица	pɔdɡɔɾit͡sa
подгорички	pɔdɡɔɾit͡ʃki
подгорчува	pɔdɡɔrt͡ʃuva
подготвеност	pɔdɡɔtvɛnɔst
подградец	pɔdɡradɛt͡s
поддржател	pɔddr̩ʒatɛɫ
поддршка	pɔddr̩ʃka
поделува	pɔdɛɫuva
подзаборави	pɔdzabɔɾavi
подзаврти	pɔdzavr̩ti
подзагори	pɔdzaɡɔɾi
подзагрижи	pɔdzaɡriʒi
подзадоцни	pɔdzadɔt͡sni
подзакачи	pɔdzakat͡ʃi
подзакрепне	pɔdzakrɛpnɛ
подзакрпи	pɔdzakr̩pi
подзалади	pɔdzaɫadi
подзамиже	pɔdzamiʒɛ
подзамириса	pɔdzamiɾisa
подзамрзне	pɔdzamr̩znɛ
подзаниша	pɔdzaniʃa
подзаобли	pɔdzaɔbli
подзапржи	pɔdzapr̩ʒi
подзарасне	pɔdzaɾasnɛ
подзарипне	pɔdzaɾipnɛ
подзасипне	pɔdzasipnɛ
подзастане	pɔdzastanɛ
подзасука	pɔdzasuka
подзатегне	pɔdzatɛɡnɛ
подзатемни	pɔdzatɛmni
подзачешла	pɔdzat͡ʃɛʃɫa
подзачисти	pɔdzat͡ʃisti
подзголеми	pɔdzɡɔlɛmi
подзине	pɔdzinɛ
подивеност	pɔdivɛnɔst
подигнува	pɔdiɡnuva
подизлиже	pɔdizliʒɛ
подизрамни	pɔdizramni
подискара	pɔdiskaɾa
подискастри	pɔdiskastri
подискриви	pɔdiskrivi
подиспегла	pɔdispɛɡɫa
подиспече	pɔdispɛt͡ʃɛ
подисправи	pɔdispravi
подиспразни	pɔdisprazni
подиспраша	pɔdispraʃa
подистури	pɔdistuɾi
подисчисти	pɔdiʃt͡ʃisti
подлец	pɔdlɛt͡s
подлизне	pɔdliznɛ
подлост	pɔdɫɔst
подмитливост	pɔdmitlivɔst
подмладок	pɔdmɫadɔk
подмножество	pɔdmnɔʒɛstvɔ
подмолност	pɔdmɔɫnɔst
подмрдне	pɔdmr̩dnɛ
поднаближува	pɔdnabliʒuva
поднавали	pɔdnavali
поднаведне	pɔdnavɛdnɛ
поднамали	pɔdnamali
поднамести	pɔdnamɛsti
поднаостри	pɔdnaɔstri
поднареди	pɔdnaɾɛdi
поднастине	pɔdnastinɛ
поднаучи	pɔdnaut͡ʃi
поднови	pɔdnɔvi
подносливост	pɔdnɔslivɔst
подоближи	pɔdɔbliʒi
подобност	pɔdɔbnɔst
подозривост	pɔdɔzrivɔst
подои	pɔdɔi
подопијани	pɔdɔpijani
подосвежи	pɔdɔsvɛʒi
подосвести	pɔdɔsvɛsti
подосветли	pɔdɔsvɛtli
подослаби	pɔdɔsɫabi
подослободи	pɔdɔsɫɔbɔdi
подостари	pɔdɔstaɾi
подоткрие	pɔdɔtkrijɛ
подотпара	pɔdɔtpaɾa
подотрезни	pɔdɔtrɛzni
подочен	pɔdɔt͡ʃɛn
подразбистри	pɔdrazbistri
подразвесели	pɔdrazvɛsɛli
подразголи	pɔdrazɡɔli
подразмести	pɔdrazmɛsti
подраспара	pɔdraspaɾa
подрасплете	pɔdrasplɛtɛ
подрасчисти	pɔdraʃt͡ʃisti
подрашири	pɔdraʃiɾi
подрдори	pɔdr̩dɔɾi
подреденост	pɔdrɛdɛnɔst
подреме	pɔdrɛmɛ
подрипнува	pɔdripnuva
подробност	pɔdrɔbnɔst
подружи	pɔdruʒi
подрум	pɔdrum
подрумски	pɔdrumski
поевтинува	pɔɛftinuva
позајмувач	pɔzajmuvat͡ʃ
поимник	pɔimnik
показен	pɔkazɛn
поканува	pɔkanuva
покајник	pɔkajnik
поквачи	pɔkvat͡ʃi
поквичи	pɔkvit͡ʃi
поклати	pɔkɫati
поклечи	pɔklɛt͡ʃi
поклопец	pɔkɫɔpɛt͡s
поколва	pɔkɔɫva
покрека	pɔkrɛka
покривка	pɔkrifka
покркори	pɔkr̩kɔɾi
покровителка	pɔkrɔvitɛɫka
покука	pɔkuka
пол	pɔɫ
полае	pɔɫaɛ
полази	pɔɫazi
поларизаторски	pɔɫaɾizatɔrski
поларизациски	pɔɫaɾizat͡siski
поларизација	pɔɫaɾizat͡sija
поларност	pɔɫarnɔst
поле	pɔlɛ
полежи	pɔlɛʒi
полемика	pɔlɛmika
поленце	pɔlɛnt͡sɛ
полетен	pɔlɛtɛn
полжав	pɔɫʒaf
полжавче	pɔɫʒaft͡ʃɛ
полигамија	pɔliɡamija
полисемија	pɔlisɛmija
политика	pɔlitika
политичарски	pɔlitit͡ʃarski
полифонија	pɔlifɔnija
полица	pɔlit͡sa
полковник	pɔɫkɔvnik
полковнички	pɔɫkɔvnit͡ʃki
полнолетнички	pɔɫnɔlɛtnit͡ʃki
половина	pɔɫɔvina
половичност	pɔɫɔvit͡ʃnɔst
полски	pɔɫski
полубог	pɔɫubɔk
полувреме	pɔɫuvrɛmɛ
полугодие	pɔɫuɡɔdijɛ
полузатворен	pɔɫuzatvɔɾɛn
полула	pɔɫuɫa
полунаводник	pɔɫunavɔdnik
полуостров	pɔɫuɔstrɔf
полуотворен	pɔɫuɔtvɔɾɛn
полупа	pɔɫupa
полусвест	pɔɫusvɛst
полуспроводник	pɔɫusprɔvɔdnik
полјоделство	pɔɫjɔdɛɫstvɔ
помавта	pɔmafta
помагач	pɔmaɡat͡ʃ
помие	pɔmijɛ
помодреност	pɔmɔdrɛnɔst
поморски	pɔmɔrski
помпезност	pɔmpɛznɔst
помрачува	pɔmrat͡ʃuva
понеделник	pɔnɛdɛɫnik
пониша	pɔniʃa
поноси	pɔnɔsi
понудува	pɔnuduva
пооди	pɔɔdi
поора	pɔɔɾa
поофка	pɔɔfka
поп	pɔp
попати	pɔpati
попишти	pɔpiʃti
попишувач	pɔpiʃuvat͡ʃ
поплаче	pɔpɫat͡ʃɛ
поплете	pɔplɛtɛ
поплука	pɔpɫuka
попречен	pɔprɛt͡ʃɛn
попреченост	pɔprɛt͡ʃɛnɔst
попречувач	pɔprɛt͡ʃuvat͡ʃ
попржи	pɔpr̩ʒi
поприма	pɔprima
популација	pɔpuɫat͡sija
порабува	pɔrabuva
пораснува	pɔrasnuva
порнографија	pɔrnɔɡrafija
пород	pɔɾɔt
породилиште	pɔɾɔdiliʃtɛ
поротник	pɔɾɔtnik
порта	pɔrta
портичка	pɔrtit͡ʃka
портрет	pɔrtrɛt
портретски	pɔrtrɛtski
поруменува	pɔɾumɛnuva
поручек	pɔɾut͡ʃɛk
посвири	pɔsviɾi
посебност	pɔsɛbnɔst
посегнува	pɔsɛɡnuva
поседник	pɔsɛdnik
посен	pɔsɛn
посетителка	pɔsɛtitɛɫka
посече	pɔsɛt͡ʃɛ
поскапува	pɔskapuva
поскока	pɔskɔka
послание	pɔsɫanijɛ
последен	pɔslɛdɛn
последователност	pɔslɛdɔvatɛɫnɔst
последок	pɔslɛdɔk
послика	pɔslika
послужува	pɔsɫuʒuva
посмртница	pɔsmr̩tnit͡sa
посока	pɔsɔka
поспаност	pɔspanɔst
посредништво	pɔsrɛdniʃtvɔ
посредство	pɔsrɛtstvɔ
поставеност	pɔstavɛnɔst
постапен	pɔstapɛn
постелен	pɔstɛlɛn
постенка	pɔstɛŋka
постепеност	pɔstɛpɛnɔst
постиска	pɔstiska
постмодерен	pɔstmɔdɛɾɛn
постојаност	pɔstɔjanɔst
постројка	pɔstrɔjka
пот	pɔt
потарашка	pɔtaɾaʃka
потекло	pɔtɛkɫɔ
потекува	pɔtɛkuva
потемнетост	pɔtɛmnɛtɔst
потемнува	pɔtɛmnuva
поти	pɔti
потиснатост	pɔtisnatɔst
поткаже	pɔtkaʒɛ
поткара	pɔtkaɾa
поткастри	pɔtkastri
поткупливост	pɔtkuplivɔst
поткупувач	pɔtkupuvat͡ʃ
поток	pɔtɔk
потонува	pɔtɔnuva
поточе	pɔtɔt͡ʃɛ
поточен	pɔtɔt͡ʃɛn
потпекува	pɔtpɛkuva
потпече	pɔtpɛt͡ʃɛ
потпивнува	pɔtpivnuva
потпис	pɔtpis
потписник	pɔtpisnik
потпорасне	pɔtpɔɾasnɛ
потпраша	pɔtpraʃa
потпржува	pɔtpr̩ʒuva
потпросечност	pɔtprɔsɛt͡ʃnɔst
потргне	pɔtr̩ɡnɛ
потребен	pɔtrɛbɛn
потребност	pɔtrɛbnɔst
потрепери	pɔtrɛpɛɾi
потресеност	pɔtrɛsɛnɔst
потркала	pɔtr̩kaɫa
потропа	pɔtrɔpa
потрошува	pɔtrɔʃuva
потрпи	pɔtr̩pi
потсетник	pɔtsɛtnik
потсече	pɔtsɛt͡ʃɛ
потскрати	pɔtskrati
потсоблече	pɔtsɔblɛt͡ʃɛ
потсопне	pɔtsɔpnɛ
потстанарски	pɔtstanarski
потстопли	pɔtstɔpli
потточка	pɔttɔt͡ʃka
потхранетост	pɔtxranɛtɔst
потчинетост	pɔtt͡ʃinɛtɔst
потчинува	pɔtt͡ʃinuva
поулавува	pɔuɫavuva
поучност	pɔut͡ʃnɔst
похотливост	pɔxɔtlivɔst
поцрнетост	pɔt͡sr̩nɛtɔst
поцрта	pɔt͡sr̩ta
почестува	pɔt͡ʃɛstuva
почива	pɔt͡ʃiva
почисти	pɔt͡ʃisti
почитувач	pɔt͡ʃituvat͡ʃ
почука	pɔt͡ʃuka
пошие	pɔʃijɛ
пошта	pɔʃta
поштарка	pɔʃtarka
поштарски	pɔʃtarski
поѕвечи	pɔd͡zvɛt͡ʃi
поѕвони	pɔd͡zvɔni
појадок	pɔjadɔk
поџвака	pɔd͡ʒvaka
прабаба	prababa
правда	pravda
правдољубивост	pravdɔlubivɔst
праведност	pravɛdnɔst
правило	praviɫɔ
правопис	pravɔpis
прага	praɡa
празник	praznik
празноглавост	praznɔɡɫavɔst
празнословие	praznɔsɫɔvijɛ
праисторија	praistɔɾija
практика	praktika
прасенце	prasɛnt͡sɛ
прастар	prastar
прасуле	prasulɛ
пратеништво	pratɛniʃtvɔ
прачка	prat͡ʃka
прашки	praʃki
прв	pr̩f
првин	pr̩vin
првобитност	pr̩vɔbitnɔst
првородство	pr̩vɔrɔtstvɔ
првостепен	pr̩vɔstɛpɛn
пргавост	pr̩ɡavɔst
прдеж	pr̩dɛʃ
прднува	pr̩dnuva
пребара	prɛbaɾa
пребарувач	prɛbaɾuvat͡ʃ
пребирливост	prɛbirlivɔst
пребои	prɛbɔi
преболи	prɛbɔli
преболува	prɛbɔɫuva
пребричува	prɛbrit͡ʃuva
пребрише	prɛbriʃɛ
пребришува	prɛbriʃuva
преброди	prɛbrɔdi
пребродува	prɛbrɔduva
преброи	prɛbrɔi
пребројува	prɛbrɔjuva
превари	prɛvaɾi
преведе	prɛvɛdɛ
преведува	prɛvɛduva
превезе	prɛvɛzɛ
превезува	prɛvɛzuva
превземе	prɛvzɛmɛ
превива	prɛviva
превие	prɛvijɛ
превитка	prɛvitka
превиткува	prɛvitkuva
превласт	prɛvɫast
превод	prɛvɔt
превозник	prɛvɔznik
превоспита	prɛvɔspita
преврзе	prɛvr̩zɛ
преврзува	prɛvr̩zuva
преврие	prɛvrijɛ
преврне	prɛvr̩nɛ
преврнува	prɛvr̩nuva
преврска	prɛvr̩ska
преврти	prɛvr̩ti
превртува	prɛvr̩tuva
прегази	prɛɡazi
прегазува	prɛɡazuva
прегладни	prɛɡɫadni
преглас	prɛɡɫas
прегледа	prɛɡlɛda
прегледува	prɛɡlɛduva
преговара	prɛɡɔvaɾa
прегори	prɛɡɔɾi
прегорува	prɛɡɔɾuva
преграден	prɛɡradɛn
прегради	prɛɡradi
преградува	prɛɡraduva
прегрева	prɛɡrɛva
прегрее	prɛɡrɛɛ
прегризе	prɛɡrizɛ
прегризува	prɛɡrizuva
прегрне	prɛɡr̩nɛ
прегрнува	prɛɡr̩nuva
прегрупира	prɛɡrupiɾa
предава	prɛdava
предавање	prɛdavaɲɛ
предавник	prɛdavnik
предавнички	prɛdavnit͡ʃki
предаде	prɛdadɛ
предвестува	prɛdvɛstuva
предвиди	prɛdvidi
предвидува	prɛdviduva
предводи	prɛdvɔdi
предводник	prɛdvɔdnik
предградие	prɛdɡradijɛ
преде	prɛdɛ
предизвика	prɛdizvika
предизвикува	prɛdizvikuva
предикација	prɛdikat͡sija
предимство	prɛdimstvɔ
предипли	prɛdipli
предлага	prɛdɫaɡa
предлог	prɛdɫɔk
предложи	prɛdɫɔʒi
предложува	prɛdɫɔʒuva
предназначи	prɛdnaznat͡ʃi
предоговори	prɛdɔɡɔvɔɾi
предодреденост	prɛdɔdrɛdɛnɔst
предок	prɛdɔk
предомисли	prɛdɔmisli
предомислува	prɛdɔmisɫuva
предосети	prɛdɔsɛti
предосеќа	prɛdɔsɛca
предочи	prɛdɔt͡ʃi
предочува	prɛdɔt͡ʃuva
предродилен	prɛdrɔdilɛn
предупреди	prɛduprɛdi
предупредува	prɛduprɛduva
предучилиштен	prɛdut͡ʃiliʃtɛn
предци	prɛtt͡si
прежали	prɛʒali
прежива	prɛʒiva
преживее	prɛʒivɛɛ
преживува	prɛʒivuva
презадолженост	prɛzadɔɫʒɛnɔst
презакаже	prɛzakaʒɛ
презакажува	prɛzakaʒuva
презакопа	prɛzakɔpa
презаситеност	prɛzasitɛnɔst
презасити	prɛzasiti
презаспива	prɛzaspiva
презаспие	prɛzaspijɛ
презема	prɛzɛma
преземе	prɛzɛmɛ
презентира	prɛzɛntiɾa
презиме	prɛzimɛ
презими	prɛzimi
презира	prɛziɾa
презрева	prɛzrɛva
презрее	prɛzrɛɛ
преименува	prɛimɛnuva
преиначи	prɛinat͡ʃi
преиначува	prɛinat͡ʃuva
преиспита	prɛispita
преиспитува	prɛispituva
прекитува	prɛkituva
преклоп	prɛkɫɔp
прекоси	prɛkɔsi
прекрасност	prɛkrasnɔst
прекривка	prɛkrifka
прекрои	prɛkrɔi
прекршител	prɛkr̩ʃitɛɫ
прекршочен	prɛkr̩ʃɔt͡ʃɛn
прекршување	prɛkr̩ʃuvaɲɛ
прекубројност	prɛkubrɔjnɔst
прекумерност	prɛkumɛrnɔst
прележи	prɛlɛʒi
прелистува	prɛlistuva
прелистувач	prɛlistuvat͡ʃ
прелистувачи	prɛlistuvat͡ʃi
премаленост	prɛmalɛnɔst
премачкува	prɛmat͡ʃkuva
премеле	prɛmɛlɛ
премете	prɛmɛtɛ
премива	prɛmiva
премореност	prɛmɔɾɛnɔst
преморува	prɛmɔɾuva
премреже	prɛmrɛʒɛ
премрзне	prɛmr̩znɛ
пренагласи	prɛnaɡɫasi
пренамени	prɛnamɛni
пренапрегнатост	prɛnaprɛɡnatɔst
пренапрегне	prɛnaprɛɡnɛ
пренатрупа	prɛnatrupa
пренатрупаност	prɛnatrupanɔst
пренесувач	prɛnɛsuvat͡ʃ
преноќева	prɛnɔcɛva
преноќиште	prɛnɔciʃtɛ
преобликува	prɛɔblikuva
преобработи	prɛɔbrabɔti
преод	prɛɔt
преодност	prɛɔdnɔst
преопредели	prɛɔprɛdɛli
преоптеретеност	prɛɔptɛrɛtɛnɔst
преоптовареност	prɛɔptɔvaɾɛnɔst
преора	prɛɔɾa
преосетливост	prɛɔsɛtlivɔst
преосмисли	prɛɔsmisli
препакува	prɛpakuva
препараторски	prɛparatɔrski
препечати	prɛpɛt͡ʃati
препече	prɛpɛt͡ʃɛ
преплакне	prɛpɫaknɛ
преплете	prɛplɛtɛ
преплетува	prɛplɛtuva
препливува	prɛplivuva
преплови	prɛpɫɔvi
препознатливост	prɛpɔznatlivɔst
преполовеност	prɛpɔɫɔvɛnɔst
препород	prɛpɔɾɔt
препреденост	prɛprɛdɛnɔst
препржи	prɛpr̩ʒi
препржува	prɛpr̩ʒuva
препродаде	prɛprɔdadɛ
прерасне	prɛɾasnɛ
прераспредели	prɛɾasprɛdɛli
прерија	prɛɾija
преса	prɛsa
преслече	prɛslɛt͡ʃɛ
пресликува	prɛslikuva
пресложи	prɛsɫɔʒi
пресметлив	prɛsmɛtlif
пресними	prɛsnimi
пресоли	prɛsɔli
пресолува	prɛsɔɫuva
пресостави	prɛsɔstavi
пресретливост	prɛsrɛtlivɔst
пресретне	prɛsrɛtnɛ
престанок	prɛstanɔk
престанува	prɛstanuva
престапен	prɛstapɛn
престапник	prɛstapnik
престапничка	prɛstapnit͡ʃka
престапништво	prɛstapniʃtvɔ
престегне	prɛstɛɡnɛ
престол	prɛstɔɫ
престолен	prɛstɔlɛn
престојува	prɛstɔjuva
престрои	prɛstrɔi
претне	prɛtnɛ
претплата	prɛtpɫata
претплатник	prɛtpɫatnik
претплатничка	prɛtpɫatnit͡ʃka
претпразничен	prɛtpraznit͡ʃɛn
претприемништво	prɛtprijɛmniʃtvɔ
претприемчивост	prɛtprijɛmt͡ʃivɔst
претресува	prɛtrɛsuva
претрпува	prɛtr̩puva
претседава	prɛtsɛdava
претседателство	prɛtsɛdatɛɫstvɔ
претставништво	prɛtstavniʃtvɔ
претстои	prɛtstɔi
претходничка	prɛtxɔdnit͡ʃka
преупати	prɛupati
префикс	prɛfiks
префриганост	prɛfriɡanɔst
пречисти	prɛt͡ʃisti
пречкртува	prɛt͡ʃkr̩tuva
пречувствителност	prɛt͡ʃufstvitɛɫnɔst
прешие	prɛʃijɛ
прешминка	prɛʃmiŋka
преѕида	prɛd͡zida
прељубник	prɛlubnik
приближност	pribliʒnɔst
прибор	pribɔr
прибраност	pribranɔst
приватизација	privatizat͡sija
привременост	privrɛmɛnɔst
приврзаничка	privr̩zanit͡ʃka
приврзаност	privr̩zanɔst
привршува	privr̩ʃuva
придушувач	priduʃuvat͡ʃ
призвук	prizvuk
приземност	prizɛmnɔst
признаница	priznanit͡sa
прикладност	prikɫadnɔst
приклучница	prikɫut͡ʃnit͡sa
приклучок	prikɫut͡ʃɔk
прикове	prikɔvɛ
прилегнува	prilɛɡnuva
прилепува	prilɛpuva
прилог	priɫɔk
примарен	primaɾɛn
применливост	primɛnlivɔst
пример	primɛr
примеса	primɛsa
примрзи	primr̩zi
приправник	pripravnik
приредба	priɾɛdba
природа	priɾɔda
присебност	prisɛbnɔst
приспособливост	prispɔsɔblivɔst
пристапност	pristapnɔst
пристрасност	pristrasnɔst
притвореничка	pritvɔrɛnit͡ʃka
притиснува	pritisnuva
притисочен	pritisɔt͡ʃɛn
прифали	prifali
прифатеност	prifatɛnɔst
причина	prit͡ʃina
приштински	priʃtinski
пријател	prijatɛɫ
пријателче	prijatɛɫt͡ʃɛ
пробив	prɔbif
проблематичност	prɔblɛmatit͡ʃnɔst
прободува	prɔbɔduva
пробој	prɔbɔj
пробојност	prɔbɔjnɔst
пробушува	prɔbuʃuva
провалничка	prɔvaɫnit͡ʃka
провев	prɔvɛf
проверка	prɔvɛrka
проверлив	prɔvɛrlif
провинциски	prɔvint͡siski
провокаторски	prɔvɔkatɔrski
провокација	prɔvɔkat͡sija
прогресија	prɔɡrɛsija
продавница	prɔdavnit͡sa
проектен	prɔɛktɛn
проекциски	prɔɛkt͡siski
прозвучи	prɔzvut͡ʃi
прозвучува	prɔzvut͡ʃuva
прозодија	prɔzɔdija
прозор	prɔzɔr
прозорец	prɔzɔɾɛt͡s
прозорче	prɔzɔrt͡ʃɛ
прозрачност	prɔzrat͡ʃnɔst
производство	prɔizvɔtstvɔ
произлегува	prɔizlɛɡuva
проклитика	prɔklitika
прокобник	prɔkɔbnik
прокобница	prɔkɔbnit͡sa
прокрварува	prɔkr̩vaɾuva
пролазува	prɔɫazuva
пролет	prɔlɛt
пролетоска	prɔlɛtɔska
пролив	prɔlif
променливост	prɔmɛnlivɔst
промрморува	prɔmr̩mɔɾuva
пронаоѓач	prɔnaɔɟat͡ʃ
пронајдок	prɔnajdɔk
проневера	prɔnɛvɛɾa
проневерувач	prɔnɛvɛɾuvat͡ʃ
проникливост	prɔniklivɔst
проникнува	prɔniknuva
прооден	prɔɔdɛn
проодува	prɔɔduva
пропие	prɔpijɛ
прописен	prɔpisɛn
прописност	prɔpisnɔst
проповедник	prɔpɔvɛdnik
проповедница	prɔpɔvɛdnit͡sa
пропорција	prɔpɔrt͡sija
пропустливост	prɔpustlivɔst
прорти	prɔrti
просветен	prɔsvɛtɛn
просветленост	prɔsvɛtlɛnɔst
просечност	prɔsɛt͡ʃnɔst
простирка	prɔstirka
проститутка	prɔstitutka
простодушност	prɔstɔduʃnɔst
простор	prɔstɔr
просторност	prɔstɔrnɔst
просјачки	prɔsjat͡ʃki
противвоспалителен	prɔtivvɔspalitɛlɛn
противзаконски	prɔtivzakɔnski
противнички	prɔtivnit͡ʃki
противпожарен	prɔtifpɔʒaɾɛn
противположен	prɔtifpɔɫɔʒɛn
противприроден	prɔtifpriɾɔdɛn
противречен	prɔtivrɛt͡ʃɛn
противуставен	prɔtivustavɛn
протокол	prɔtɔkɔɫ
проточен	prɔtɔt͡ʃɛn
протресе	prɔtrɛsɛ
професорство	prɔfɛsɔrstvɔ
процветува	prɔt͡svɛtuva
процедува	prɔt͡sɛduva
прочепка	prɔt͡ʃɛpka
прочитува	prɔt͡ʃituva
прошепотува	prɔʃɛpɔtuva
проширува	prɔʃiɾuva
проѕирка	prɔd͡zirka
прслук	pr̩sɫuk
прслуче	pr̩sɫut͡ʃɛ
прснува	pr̩snuva
прст	pr̩st
прсте	pr̩stɛ
прстен	pr̩stɛn
прстенче	pr̩stɛnt͡ʃɛ
прсторед	pr̩stɔɾɛt
пршка	pr̩ʃka
пршки	pr̩ʃki
психа	psixa
психијатрија	psixijatrija
птица	ptit͡sa
птичка	ptit͡ʃka
пукнува	puknuva
пукот	pukɔt
пунктуација	puŋktuat͡sija
пупка	pupka
пупунец	pupunɛt͡s
пупче	pupt͡ʃɛ
пура	puɾa
пури	puɾi
пустец	pustɛt͡s
пустиник	pustinik
пушачки	puʃat͡ʃki
пушење	puʃɛɲɛ
пуши	puʃi
пушка	puʃka
пушта	puʃta
пушти	puʃti
пцовисува	pt͡sɔvisuva
пцост	pt͡sɔst
пчела	pt͡ʃɛɫa
пчеларник	pt͡ʃɛɫarnik
пчели	pt͡ʃɛli
пчеличка	pt͡ʃɛlit͡ʃka
пченче	pt͡ʃɛnt͡ʃɛ
пљампа	plampa
раб	rap
раби	rabi
работа	rabɔta
работник	rabɔtnik
работничка	rabɔtnit͡ʃka
работоспособност	rabɔtɔspɔsɔbnɔst
рабоќе	rabɔcɛ
равенство	ravɛnstvɔ
рагби	raɡbi
радар	radar
радарски	radarski
радио	radijɔ
радиоемисија	radijɔɛmisija
радиостаница	radijɔstanit͡sa
радијација	radijat͡sija
разбере	razbɛɾɛ
разбира	razbiɾa
разбирливост	razbirlivɔst
разблажува	razbɫaʒuva
разборитост	razbɔɾitɔst
разбој	razbɔj
разбојничка	razbɔjnit͡ʃka
разбојнички	razbɔjnit͡ʃki
разбојништво	razbɔjniʃtvɔ
разбран	razbran
разбраност	razbranɔst
разбудува	razbuduva
разбушавеност	razbuʃavɛnɔst
разбушавува	razbuʃavuva
разведрува	razvɛdruva
развиеност	razvijɛnɔst
развлеченост	razvlɛt͡ʃɛnɔst
развратник	razvratnik
развратница	razvratnit͡sa
развратност	razvratnɔst
разгаленост	razɡalɛnɔst
разгаштеност	razɡaʃtɛnɔst
разгаштува	razɡaʃtuva
разговор	razɡɔvɔr
разговорливост	razɡɔvɔrlivɔst
разголеност	razɡɔlɛnɔst
разгранетост	razɡranɛtɔst
раздвоеност	razdvɔɛnɔst
разделеност	razdɛlɛnɔst
разлабавеност	razɫabavɛnɔst
разлика	razlika
различност	razlit͡ʃnɔst
разлошеност	razɫɔʃɛnɔst
размазеност	razmazɛnɔst
размер	razmɛr
размерлив	razmɛrlif
размерливост	razmɛrlivɔst
разнишаност	razniʃanɔst
разнобоен	raznɔbɔɛn
разнобојност	raznɔbɔjnɔst
разноликост	raznɔlikɔst
разнородност	raznɔɾɔdnɔst
разностраност	raznɔstranɔst
разочарувачки	razɔt͡ʃaruvat͡ʃki
разработи	razrabɔti
разработува	razrabɔtuva
разрани	razrani
разреденост	razrɛdɛnɔst
разредувач	razrɛduvat͡ʃ
разреже	razrɛʒɛ
разрушеност	razruʃɛnɔst
разубавеност	razubavɛnɔst
разузданост	razuzdanɔst
разум	razum
разурнатост	razurnatɔst
рак	rak
рака	raka
ракав	rakaf
ракавица	rakavit͡sa
ракавичка	rakavit͡ʃka
ракавче	rakaft͡ʃɛ
ракета	rakɛta
ракија	rakija
раководител	rakɔvɔditɛɫ
раководителка	rakɔvɔditɛɫka
ракомет	rakɔmɛt
ракче	rakt͡ʃɛ
ралник	raɫnik
раменце	ramɛnt͡sɛ
рамка	ramka
рамнодушност	ramnɔduʃnɔst
рамномерност	ramnɔmɛrnɔst
рамност	ramnɔst
рамнојазичен	ramnɔjazit͡ʃɛn
рамо	ramɔ
ран	ran
ранг	raŋk
рандеву	randɛvu
ранец	ranɛt͡s
рано	ranɔ
ранобуден	ranɔbudɛn
ранозрелост	ranɔzrɛɫɔst
ранче	rant͡ʃɛ
рапсодија	rapsɔdija
раса	rasa
расад	rasat
расади	rasadi
расеаност	rasɛanɔst
раседлува	rasɛdɫuva
расекува	rasɛkuva
расели	rasɛli
раселува	rasɛɫuva
расече	rasɛt͡ʃɛ
расипаност	rasipanɔst
расипништво	rasipniʃtvɔ
раситнува	rasitnuva
раскали	raskali
раскалуѓери	raskaɫuɟɛɾi
раскитува	raskituva
расклопува	raskɫɔpuva
раскове	raskɔvɛ
раскол	raskɔɫ
расколник	raskɔɫnik
раскошност	raskɔʃnɔst
раскрвавеност	raskr̩vavɛnɔst
раскрене	raskrɛnɛ
раскрепости	raskrɛpɔsti
раскрои	raskrɔi
раскрсти	raskr̩sti
распаднатост	raspadnatɔst
распашува	raspaʃuva
распаќе	raspacɛ
распердаши	raspɛrdaʃi
распетла	raspɛtɫa
распис	raspis
распласти	raspɫasti
расповие	raspɔvijɛ
расподели	raspɔdɛli
расположлив	raspɔɫɔʒlif
расположливост	raspɔɫɔʒlivɔst
распоредба	raspɔɾɛdba
распостеле	raspɔstɛlɛ
расправа	rasprava
распрденост	raspr̩dɛnɔst
распределеност	rasprɛdɛlɛnɔst
распространетост	rasprɔstranɛtɔst
распростре	rasprɔstrɛ
распуштеност	raspuʃtɛnɔst
растапка	rastapka
растение	rastɛnijɛ
растревоженост	rastrɛvɔʒɛnɔst
растрепереност	rastrɛpɛɾɛnɔst
растроеност	rastrɔɛnɔst
растројство	rastrɔjstvɔ
расуди	rasudi
расудност	rasudnɔst
расука	rasuka
расфрла	rasfr̩ɫa
расцути	rast͡suti
расчепка	raʃt͡ʃɛpka
расчетка	raʃt͡ʃɛtka
расчешла	raʃt͡ʃɛʃɫa
расчовечи	raʃt͡ʃɔvɛt͡ʃi
рафинерија	rafinɛɾija
рационализација	rat͡sijɔnalizat͡sija
раширува	raʃiɾuva
раштрканост	raʃtr̩kanɔst
реа	rɛa
реав	rɛaf
реавост	rɛavɔst
реализација	rɛalizat͡sija
реалистичност	rɛalistit͡ʃnɔst
реалност	rɛaɫnɔst
ребренце	rɛbrɛnt͡sɛ
ребро	rɛbrɔ
ревија	rɛvija
ревност	rɛvnɔst
регенерација	rɛɡɛnɛrat͡sija
регистарски	rɛɡistarski
регистраторски	rɛɡistratɔrski
регистрациски	rɛɡistrat͡siski
регистрација	rɛɡistrat͡sija
регресија	rɛɡrɛsija
регулаторски	rɛɡuɫatɔrski
регулациски	rɛɡuɫat͡siski
регулација	rɛɡuɫat͡sija
редакторка	rɛdaktɔrka
редакторски	rɛdaktɔrski
редакторство	rɛdaktɔrstvɔ
редакциски	rɛdakt͡siski
редакција	rɛdakt͡sija
редовност	rɛdɔvnɔst
редукција	rɛdukt͡sija
редупликација	rɛduplikat͡sija
режија	rɛʒija
резбар	rɛzbar
резбарски	rɛzbarski
резбарство	rɛzbarstvɔ
резерват	rɛzɛrvat
резиденција	rɛzidɛnt͡sija
резолуција	rɛzɔɫut͡sija
резултат	rɛzuɫtat
реинкарнација	rɛiŋkarnat͡sija
река	rɛka
рекатегоризација	rɛkatɛɡɔɾizat͡sija
реквием	rɛkvijɛm
рекичка	rɛkit͡ʃka
рекламациски	rɛkɫamat͡siski
рекламација	rɛkɫamat͡sija
реконструкциски	rɛkɔnstrukt͡siski
реконструкција	rɛkɔnstrukt͡sija
рекреација	rɛkrɛat͡sija
релација	rɛɫat͡sija
релјефен	rɛljɛfɛn
рема	rɛma
рендгенски	rɛndɡɛnski
ренде	rɛndɛ
рениум	rɛnijum
репа	rɛpa
репетициски	rɛpɛtit͡siski
репортер	rɛpɔrtɛr
репрезентациски	rɛprɛzɛntat͡siski
репрезентација	rɛprɛzɛntat͡sija
репродукциски	rɛprɔdukt͡siski
република	rɛpublika
ресичен	rɛsit͡ʃɛn
реставраторски	rɛstavratɔrski
реставрација	rɛstavrat͡sija
ресто	rɛstɔ
ресторан	rɛstɔran
реторика	rɛtɔɾika
реума	rɛuma
реформаторка	rɛfɔrmatɔrka
рехабилитација	rɛxabilitat͡sija
рецитација	rɛt͡sitat͡sija
реч	rɛt͡ʃ
речник	rɛt͡ʃnik
решеност	rɛʃɛnɔst
решето	rɛʃɛtɔ
рејкјавик	rɛjkjavik
рејкјавички	rɛjkjavit͡ʃki
риба	riba
рига	riɡa
ригански	riɡanski
ригидност	riɡidnɔst
ризичност	rizit͡ʃnɔst
рим	rim
рипнува	ripnuva
рипче	ript͡ʃɛ
рис	ris
рисјанин	risjanin
ритмичност	ritmit͡ʃnɔst
рицар	rit͡sar
рицарски	rit͡sarski
роб	rɔp
робот	rɔbɔt
роботизација	rɔbɔtizat͡sija
ров	rɔf
ровкост	rɔfkɔst
ровчица	rɔft͡ʃit͡sa
рог	rɔk
рогат	rɔɡat
род	rɔt
родилен	rɔdilɛn
родилка	rɔdiɫka
родина	rɔdina
роднина	rɔdnina
родовник	rɔdɔvnik
родоотстапник	rɔdɔɔtstapnik
родољубивост	rɔdɔlubivɔst
рокер	rɔkɛr
рокерка	rɔkɛrka
роковник	rɔkɔvnik
ролерка	rɔlɛrka
ролја	rɔlja
романтичарка	rɔmantit͡ʃarka
ронка	rɔŋka
ронливост	rɔnlivɔst
ронче	rɔnt͡ʃɛ
роса	rɔsa
росичка	rɔsit͡ʃka
ротациски	rɔtat͡siski
рочиште	rɔt͡ʃiʃtɛ
рубрика	rubrika
рударка	rudarka
рударство	rudarstvɔ
рудник	rudnik
ружа	ruʒa
ружичка	ruʒit͡ʃka
рунтав	runtaf
рунтавост	runtavɔst
рус	rus
русе	rusɛ
русин	rusin
русинка	rusiŋka
русија	rusija
руски	ruski
рутински	rutinski
руча	rut͡ʃa
ручек	rut͡ʃɛk
сабајле	sabajlɛ
сабота	sabɔta
сабја	sabja
сабји	sabji
сад	sat
сака	saka
салата	saɫata
салатичка	saɫatit͡ʃka
сало	saɫɔ
само	samɔ
самовластие	samɔvɫastijɛ
самогласка	samɔɡɫaska
самодејност	samɔdɛjnɔst
самодржавие	samɔdr̩ʒavijɛ
саможивност	samɔʒivnɔst
самокритичност	samɔkritit͡ʃnɔst
самоодржлив	samɔɔdr̩ʒlif
самостојност	samɔstɔjnɔst
самострел	samɔstrɛɫ
самоубиец	samɔubijɛt͡s
самоубиствен	samɔubistvɛn
самоубиство	samɔubistvɔ
самоуштво	samɔuʃtvɔ
самохран	samɔxran
самољубивост	samɔlubivɔst
самрачен	samrat͡ʃɛn
самуил	samuiɫ
самун	samun
сандала	sandaɫa
сандаче	sandat͡ʃɛ
сантиметар	santimɛtar
сантиметри	santimɛtri
сапун	sapun
сапунарство	sapunarstvɔ
сапунче	sapunt͡ʃɛ
сапунџија	sapund͡ʒija
сараево	saraɛvɔ
сарма	sarma
сармичка	sarmit͡ʃka
сатана	satana
сатира	satiɾa
сатисфакција	satisfakt͡sija
сауна	sauna
сафра	safra
сајбија	sajbija
свастика	svastika
светлост	svɛtɫɔst
световност	svɛtɔvnɔst
светост	svɛtɔst
свештеник	svɛʃtɛnik
свеќа	svɛca
свеќарка	svɛcarka
свеќарски	svɛcarski
свеќарство	svɛcarstvɔ
свеќичка	svɛcit͡ʃka
свидетелство	svidɛtɛɫstvɔ
свиен	svijɛn
свикува	svikuva
свиларка	sviɫarka
свиларски	sviɫarski
свиларство	sviɫarstvɔ
свилест	svilɛst
свинче	svint͡ʃɛ
свирач	sviɾat͡ʃ
свирепост	sviɾɛpɔst
свирење	sviɾɛɲɛ
свирче	svirt͡ʃɛ
свиѓа	sviɟa
свиња	sviɲa
свињарка	sviɲarka
свињарник	sviɲarnik
свињарница	sviɲarnit͡sa
свињарски	sviɲarski
свињарство	sviɲarstvɔ
сводник	svɔdnik
сводништво	svɔdniʃtvɔ
своевидност	svɔɛvidnɔst
своеглавост	svɔɛɡɫavɔst
своина	svɔina
сврзаност	svr̩zanɔst
свртува	svr̩tuva
свршеничка	svr̩ʃɛnit͡ʃka
свршенички	svr̩ʃɛnit͡ʃki
се	sɛ
север	sɛvɛr
севкупност	sɛfkupnɔst
седало	sɛdaɫɔ
седело	sɛdɛɫɔ
седенка	sɛdɛŋka
седларски	sɛdɫarski
седларство	sɛdɫarstvɔ
седмица	sɛdmit͡sa
седница	sɛdnit͡sa
седнува	sɛdnuva
седум	sɛdum
седумдесет	sɛdumdɛsɛt
седумка	sɛdumka
седуммина	sɛdummina
седумнаесет	sɛdumnaɛsɛt
седумстотини	sɛdumstɔtini
сее	sɛɛ
сеирџија	sɛird͡ʒija
секојдневност	sɛkɔjdnɛvnɔst
секташтво	sɛktaʃtvɔ
секторски	sɛktɔrski
селанство	sɛɫanstvɔ
село	sɛɫɔ
селотејп	sɛɫɔtɛjp
селце	sɛɫt͡sɛ
семе	sɛmɛ
семестар	sɛmɛstar
семестарски	sɛmɛstarski
семиологија	sɛmijɔɫɔɡija
семкар	sɛmkar
сенаторски	sɛnatɔrski
сензација	sɛnzat͡sija
сено	sɛnɔ
сеприсутен	sɛprisutɛn
сеприсутност	sɛprisutnɔst
септември	sɛptɛɱvri
септички	sɛptit͡ʃki
сердар	sɛrdar
сердарски	sɛrdarski
сесија	sɛsija
сестра	sɛstra
сестраност	sɛstranɔst
сестринство	sɛstrinstvɔ
сестриче	sɛstrit͡ʃɛ
сеструле	sɛstrulɛ
сеул	sɛuɫ
сефте	sɛftɛ
сечач	sɛt͡ʃat͡ʃ
сечило	sɛt͡ʃiɫɔ
сибирски	sibirski
сигурносен	siɡurnɔsɛn
сигурност	siɡurnɔst
сиднеј	sidnɛj
сиднејски	sidnɛjski
сиже	siʒɛ
силеџиство	silɛd͡ʒistvɔ
симболизација	simbɔlizat͡sija
симетричност	simɛtrit͡ʃnɔst
симетрија	simɛtrija
симпатичен	simpatit͡ʃɛn
симпатичност	simpatit͡ʃnɔst
симпозиум	simpɔzijum
симфонија	simfɔnija
син	sin
сина	sina
синап	sinap
сингапур	siŋɡapur
синоптички	sinɔptit͡ʃki
синоубиство	sinɔubistvɔ
синоќа	sinɔca
синтетика	sintɛtika
синхронизација	sinxrɔnizat͡sija
синче	sint͡ʃɛ
синџир	sind͡ʒir
синџирче	sind͡ʒirt͡ʃɛ
сиот	sijɔt
сипаничав	sipanit͡ʃaf
сирачки	siɾat͡ʃki
сиренце	siɾɛnt͡sɛ
сирење	siɾɛɲɛ
сиромашност	sirɔmaʃnɔst
систематизација	sistɛmatizat͡sija
сите	sitɛ
ситничавост	sitnit͡ʃavɔst
ситничарка	sitnit͡ʃarka
ситничарски	sitnit͡ʃarski
ситничарство	sitnit͡ʃarstvɔ
ситнурија	sitnuɾija
сито	sitɔ
ситуациски	situat͡siski
скапост	skapɔst
скелетен	skɛlɛtɛn
скептик	skɛptik
скептичност	skɛptit͡ʃnɔst
скиснатост	skisnatɔst
скита	skita
скитничка	skitnit͡ʃka
скитнички	skitnit͡ʃki
скитништво	skitniʃtvɔ
скијање	skijaɲɛ
складност	skɫadnɔst
скокнува	skɔknuva
скокотливост	skɔkɔtlivɔst
сколовранец	skɔɫɔvranɛt͡s
скопјанец	skɔpjanɛt͡s
скопјанка	skɔpjaŋka
скопјанче	skɔpjant͡ʃɛ
скопје	skɔpjɛ
скорпија	skɔrpija
скотски	skɔtski
скрб	skr̩p
скржавост	skr̩ʒavɔst
скришност	skriʃnɔst
скробен	skrɔbɛn
скротум	skrotum
скршнува	skr̩ʃnuva
скудност	skudnɔst
скулпторски	skuɫptɔrski
скулптурен	skuɫptuɾɛn
слаб	sɫap
слава	sɫava
славеј	sɫavɛj
славејче	sɫavɛjt͡ʃɛ
славољубивост	sɫavɔlubivɔst
сладок	sɫadɔk
сладолед	sɫadɔlɛt
сладоледџија	sɫadɔlɛdd͡ʒija
сламен	sɫamɛn
сланина	sɫanina
сланиница	sɫaninit͡sa
сланинка	sɫaniŋka
слаткарски	sɫatkarski
слаткарство	sɫatkarstvɔ
слаткоречивост	sɫatkɔrɛt͡ʃivɔst
слеан	slɛan
следбеничка	slɛdbɛnit͡ʃka
слива	sliva
сливов	slivɔf
сливче	slift͡ʃɛ
сликарски	slikarski
сликичка	slikit͡ʃka
сликовен	slikɔvɛn
сликовит	slikɔvit
сликовитост	slikɔvitɔst
слободољубивост	sɫɔbɔdɔlubivɔst
словенец	sɫɔvɛnɛt͡s
словенка	sɫɔvɛŋka
словенски	sɫɔvɛnski
слово	sɫɔvɔ
сложен	sɫɔʒɛn
сложенка	sɫɔʒɛŋka
сложеност	sɫɔʒɛnɔst
слонче	sɫɔnt͡ʃɛ
слончиња	sɫɔnt͡ʃiɲa
служба	sɫuʒba
слушателка	sɫuʃatɛɫka
смарагден	smaɾaɡdɛn
смет	smɛt
сметка	smɛtka
сметководителка	smɛtkɔvɔditɛɫka
смешност	smɛʃnɔst
смлачи	smɫat͡ʃi
смоквин	smɔkvin
смола	smɔɫa
смотаност	smɔtanɔst
смотра	smɔtra
смрдливост	smr̩dlivɔst
смреков	smrɛkɔf
смрзнатост	smr̩znatɔst
смрт	smr̩t
смрчак	smr̩t͡ʃak
снаин	snain
снаодливост	snaɔdlivɔst
снајпер	snajpɛr
снајперка	snajpɛrka
снег	snɛk
снеговит	snɛɡɔvit
снеговица	snɛɡɔvit͡sa
снегулка	snɛɡuɫka
снегулки	snɛɡuɫki
снегулче	snɛɡuɫt͡ʃɛ
снеже	snɛʒɛ
снежиња	snɛʒiɲa
снеможува	snɛmɔʒuva
снесува	snɛsuva
снешко	snɛʃkɔ
снешковци	snɛʃkɔft͡si
снисходливост	snisxɔdlivɔst
снобовски	snɔbɔfski
сноп	snɔp
снопче	snɔpt͡ʃɛ
снопје	snɔpjɛ
сношти	snɔʃti
соавторство	sɔaftɔrstvɔ
соба	sɔba
собитие	sɔbitijɛ
собичка	sɔbit͡ʃka
соблазнивост	sɔbɫaznivɔst
соборен	sɔbɔɾɛn
соборува	sɔbɔɾuva
советничка	sɔvɛtnit͡ʃka
советски	sɔvɛtski
совладливост	sɔvɫadlivɔst
совпадливост	sɔfpadlivɔst
современост	sɔvrɛmɛnɔst
согласка	sɔɡɫaska
соговорница	sɔɡɔvɔrnit͡sa
согорување	sɔɡɔruvaɲɛ
содржаен	sɔdr̩ʒaɛn
соединет	sɔɛdinɛt
соединети	sɔɛdinɛti
соединетост	sɔɛdinɛtɔst
сожителство	sɔʒitɛɫstvɔ
создание	sɔzdanijɛ
сознание	sɔznanijɛ
соин	sɔin
сокак	sɔkak
сокаче	sɔkat͡ʃɛ
сокачки	sɔkat͡ʃki
сокол	sɔkɔɫ
соколар	sɔkɔɫar
соларен	sɔɫaɾɛn
соленост	sɔlɛnɔst
солза	sɔɫza
солзичка	sɔɫzit͡ʃka
солун	sɔɫun
соматски	sɔmatski
сомнение	sɔmnɛnijɛ
сомнителност	sɔmnitɛɫnɔst
сомничавост	sɔmnit͡ʃavɔst
сомот	sɔmɔt
сомун	sɔmun
сон	sɔn
сонародник	sɔnaɾɔdnik
сонародничка	sɔnarɔdnit͡ʃka
сонетен	sɔnɛtɛn
сонце	sɔnt͡sɛ
сонценце	sɔnt͡sɛnt͡sɛ
сонцуле	sɔnt͡sulɛ
соодветност	sɔɔdvɛtnɔst
соодветство	sɔɔdvɛtstvɔ
сооднос	sɔɔdnɔs
сопатничка	sɔpatnit͡ʃka
соперничка	sɔpɛrnit͡ʃka
соплеменица	sɔplɛmɛnit͡sa
сопотписник	sɔpɔtpisnik
сопруг	sɔpruk
сопруга	sɔpruɡa
сопружник	sɔpruʒnik
сопружничка	sɔpruʒnit͡ʃka
сопружништво	sɔpruʒniʃtvɔ
сопственица	sɔpstvɛnit͡sa
сопственички	sɔpstvɛnit͡ʃki
сопствеништво	sɔpstvɛniʃtvɔ
сопче	sɔpt͡ʃɛ
соседство	sɔsɛtstvɔ
сословие	sɔsɫɔvijɛ
сосопственик	sɔsɔpstvɛnik
сот	sɔt
соучесница	sɔut͡ʃɛsnit͡sa
соучеснички	sɔut͡ʃɛsnit͡ʃki
соучесништво	sɔut͡ʃɛsniʃtvɔ
соучество	sɔut͡ʃɛstvɔ
соучествува	sɔut͡ʃɛstvuva
софија	sɔfija
сочност	sɔt͡ʃnɔst
сочувствителност	sɔt͡ʃufstvitɛɫnɔst
сојузништво	sɔjuzniʃtvɔ
спарува	spaɾuva
спасителен	spasitɛlɛn
спасувачки	spasuvat͡ʃki
спахија	spaxija
сперма	spɛrma
специјализација	spɛt͡sijalizat͡sija
спечалува	spɛt͡ʃaɫuva
спикер	spikɛr
спикерка	spikɛrka
спинета	spinɛta
спинети	spinɛti
списание	spisanijɛ
сплеткар	splɛtkar
сполај	spɔɫaj
споменица	spɔmɛnit͡sa
споменичен	spɔmɛnit͡ʃɛn
спонзорски	spɔnzɔrski
спонтаност	spɔntanɔst
споредлив	spɔɾɛdlif
споредливост	spɔrɛdlivɔst
споредност	spɔɾɛdnɔst
спорен	spɔɾɛn
спорност	spɔrnɔst
спорост	spɔɾɔst
спорт	spɔrt
споцрка	spɔt͡sr̩ka
спојка	spɔjka
справа	sprava
справедливост	spravɛdlivɔst
спрат	sprat
спремност	sprɛmnɔst
спринтер	sprintɛr
спринтерка	sprintɛrka
спроводен	sprɔvɔdɛn
спроводник	sprɔvɔdnik
сразмер	srazmɛr
сразмерност	srazmɛrnɔst
србин	sr̩bin
србинка	sr̩biŋka
срдечност	sr̩dɛt͡ʃnɔst
сребрар	srɛbrar
сребрен	srɛbrɛn
сребрест	srɛbrɛst
среда	srɛda
среден	srɛdɛn
среденост	srɛdɛnɔst
сретнува	srɛtnuva
срна	sr̩na
срнче	sr̩nt͡ʃɛ
сродност	srɔdnɔst
срочиште	srɔt͡ʃiʃtɛ
српски	sr̩pski
срце	sr̩t͡sɛ
срценце	sr̩t͡sɛnt͡sɛ
срцуле	sr̩t͡sulɛ
стабилизација	stabilizat͡sija
стабилност	stabiɫnɔst
става	stava
стави	stavi
стагнација	staɡnat͡sija
стадиум	stadijum
стадо	stadɔ
стаклар	stakɫar
стакларка	stakɫarka
стакларски	stakɫarski
стакларство	stakɫarstvɔ
стакленички	staklɛnit͡ʃki
стакленце	staklɛnt͡sɛ
сталешки	stalɛʃki
сталоженост	staɫɔʒɛnɔst
стан	stan
станарство	stanarstvɔ
станбен	stambɛn
стандардизација	standardizat͡sija
станува	stanuva
станче	stant͡ʃɛ
стап	stap
стаписаност	stapisanɔst
стар	star
старец	staɾɛt͡s
старешинство	starɛʃinstvɔ
старолик	staɾɔlik
староликост	starɔlikɔst
старче	start͡ʃɛ
статичност	statit͡ʃnɔst
стврднатост	stvr̩dnatɔst
стена	stɛna
стенографија	stɛnɔɡrafija
степенува	stɛpɛnuva
стерилизациски	stɛɾilizat͡siski
стерилизација	stɛɾilizat͡sija
стетоскоп	stɛtɔskɔp
стилизација	stilizat͡sija
стиснатост	stisnatɔst
стиснува	stisnuva
стија	stija
сто	stɔ
стокхолм	stɔkxɔɫm̩
стокхолмски	stɔkxɔɫm̩ski
столарство	stɔɫarstvɔ
столица	stɔlit͡sa
столови	stɔɫɔvi
столче	stɔɫt͡ʃɛ
стомак	stɔmak
стоматологија	stɔmatɔɫɔɡija
стомна	stɔmna
стомничка	stɔmnit͡ʃka
стопеност	stɔpɛnɔst
стопува	stɔpuva
сторител	stɔɾitɛɫ
стравотен	stravɔtɛn
стравува	sɛstravuva
страда	strada
страдалник	stradaɫnik
стражарка	straʒarka
страница	stranit͡sa
страничка	stranit͡ʃka
стратег	stratɛk
стратификација	stratifikat͡sija
страчкин	strat͡ʃkin
страшливост	straʃlivɔst
стрви	str̩vi
стрвник	str̩vnik
стрела	strɛɫa
стреличарство	strɛlit͡ʃarstvɔ
стреличка	strɛlit͡ʃka
стринин	strinin
стрмност	str̩mnɔst
струга	struɡa
струи	strui
студен	studɛn
студент	studɛnt
студентка	studɛntka
студио	studijɔ
субвенција	subvɛnt͡sija
сублимација	sublimat͡sija
сува	suva
сувански	suvanski
суверен	suvɛɾɛn
сувост	suvɔst
сугестија	suɡɛstija
суд	sut
суеверие	suɛvɛɾijɛ
суетност	suɛtnɔst
сукало	sukaɫɔ
сукња	sukɲa
султанка	suɫtaŋka
султанов	suɫtanɔf
сулфурен	suɫfuɾɛn
сунѓер	sunɟɛr
сунѓерче	sunɟɛrt͡ʃɛ
супа	supa
супичка	supit͡ʃka
суптилност	suptiɫnɔst
сура	suɾa
сурат	suɾat
сурутка	suɾutka
сусамов	susamɔf
суфикс	sufiks
суштественост	suʃtɛstvɛnɔst
суштество	suʃtɛstvɔ
сферичност	sfɛɾit͡ʃnɔst
сценографија	st͡sɛnɔɡrafija
сценски	st͡sɛnski
сѐ	sɛ
сјајност	sjajnɔst
таа	taa
таблица	tablit͡sa
тавтологија	taftɔɫɔɡija
таинственост	tainstvɛnɔst
така	taka
такса	taksa
таксирлија	taksirlija
таксономија	taksɔnɔmija
тактичност	taktit͡ʃnɔst
талка	taɫka
таму	tamu
тантал	tantaɫ
танцов	tant͡sɔf
тапан	tapan
тапанарка	tapanarka
тапанче	tapant͡ʃɛ
тапија	tapija
тастатура	tastatuɾa
татенце	tatɛnt͡sɛ
таткоубиство	tatkɔubistvɔ
тахикардија	taxikardija
ташна	taʃna
ташничка	taʃnit͡ʃka
тајна	tajna
тајност	tajnɔst
таџикистан	tad͡ʒikistan
тбилиси	dbilisi
тбилисиски	dbilisiski
твид	tvit
твој	tvɔj
тврдоглавост	tvr̩dɔɡɫavɔst
тврдост	tvr̩dɔst
те	tɛ
тебе	tɛbɛ
тегав	tɛɡaf
тежок	tɛʒɔk
теза	tɛza
тексас	tɛksas
текстил	tɛkstiɫ
теленце	tɛlɛnt͡sɛ
телеологија	tɛlɛɔɫɔɡija
телесност	tɛlɛsnɔst
телефон	tɛlɛfɔn
теме	tɛmɛ
темница	tɛmnit͡sa
темноцрвен	tɛmnɔt͡sr̩vɛn
тенденција	tɛndɛnt͡sija
тенис	tɛnis
тениски	tɛniski
тенија	tɛnija
тенок	tɛnɔk
тенорски	tɛnɔrski
теократија	tɛɔkratija
тепач	tɛpat͡ʃ
тепих	tɛpix
термодинамика	tɛrmɔdinamika
тесар	tɛsar
теснински	tɛsninski
тесноградост	tɛsnɔɡradɔst
тесто	tɛstɔ
тетинов	tɛtinɔf
тетратче	tɛtratt͡ʃɛ
тефтерче	tɛftɛrt͡ʃɛ
техеран	tɛxɛɾan
техерански	tɛxɛɾanski
техничарка	tɛxnit͡ʃarka
технологија	tɛxnɔɫɔɡija
тешкичок	tɛʃkit͡ʃɔk
тешкотија	tɛʃkɔtija
ти	ti
тигарски	tiɡarski
тие	tijɛ
тиква	tikva
тикварник	tikvarnik
тикве	tikvɛ
тиквеник	tikvɛnik
тиквичка	tikvit͡ʃka
тим	tim
тимар	timar
тимбу	timbu
тимбуски	timbuski
типологија	tipɔɫɔɡija
тирана	tirana
тих	tix
тишина	tiʃina
ткае	tkaɛ
ткајач	tkajat͡ʃ
ткајачка	tkajat͡ʃka
тоа	tɔa
товар	tɔvar
токио	tɔkijɔ
токиски	tɔkiski
толеранција	tɔlɛrant͡sija
том	tɔm
топ	tɔp
топка	tɔpka
топкање	tɔpkaɲɛ
топличок	tɔplit͡ʃɔk
топот	tɔpɔt
топчест	tɔpt͡ʃɛst
торба	tɔrba
тореадорски	tɔɾɛadɔrski
торта	tɔrta
точак	tɔt͡ʃak
тој	tɔj
трагикомедија	traɡikɔmɛdija
трагикомичен	traɡikɔmit͡ʃɛn
трагичарка	traɡit͡ʃarka
трагичност	traɡit͡ʃnɔst
трактор	traktɔr
тракторски	traktɔrski
транзитен	tranzitɛn
транзиција	tranzit͡sija
трансакциски	transakt͡siski
трансакција	transakt͡sija
транспозиција	transpɔzit͡sija
трансфер	transfɛr
трансфобија	transfɔbija
трансформатор	transfɔrmatɔr
трансформација	transfɔrmat͡sija
трауматичност	traumatit͡ʃnɔst
трафика	trafika
трачар	trat͡ʃar
трајност	trajnɔst
трбушен	tr̩buʃɛn
трева	trɛva
тревичка	trɛvit͡ʃka
тревник	trɛvnik
трезвеник	trɛzvɛnik
трезорски	trɛzɔrski
трескот	trɛskɔt
тржество	tr̩ʒɛstvɔ
трзачки	tr̩zat͡ʃki
три	tri
тригонометрија	triɡɔnɔmɛtrija
триделен	tridɛlɛn
триесет	trijɛsɛt
трилогија	triɫɔɡija
тринаесет	trinaɛsɛt
триста	trista
трици	trit͡si
тркалце	tr̩kaɫt͡sɛ
тркачки	tr̩kat͡ʃki
трн	tr̩n̩
трнинка	tr̩niŋka
трнка	tr̩n̩ka
тровче	trɔft͡ʃɛ
трогателност	trɔɡatɛɫnɔst
трогнатост	trɔɡnatɔst
тромавост	trɔmavɔst
тромб	trɔmp
трошка	trɔʃka
трошочен	trɔʃɔt͡ʃɛn
тројка	trɔjka
тројца	trɔjt͡sa
тројче	trɔjt͡ʃɛ
трст	tr̩st
труд	trut
труден	trudɛn
труп	trup
трупа	trupa
трупче	trupt͡ʃɛ
трњак	tr̩ɲak
тужба	tuʒba
тужбен	tuʒbɛn
тужителка	tuʒitɛɫka
тука	tuka
тулиум	tulijum
туморски	tumɔrski
тунис	tunis
тупав	tupaf
турбуленција	turbulɛnt͡sija
турист	turist
туристка	turistka
турнува	turnuva
турчин	turt͡ʃin
турчинка	turt͡ʃiŋka
туткав	tutkaf
туш	tuʃ
туѓински	tuɟinski
у	u
убива	ubiva
убиец	ubijɛt͡s
убиство	ubistvɔ
убоден	ubɔdɛn
увезувач	uvɛzuvat͡ʃ
уверува	uvɛɾuva
уво	uvɔ
увод	uvɔt
угар	uɡar
угарење	uɡaɾɛɲɛ
угари	uɡaɾi
угледност	uɡlɛdnɔst
угнетеност	uɡnɛtɛnɔst
угодник	uɡɔdnik
угоре	uɡɔɾɛ
угостителство	uɡɔstitɛɫstvɔ
ударнички	udarnit͡ʃki
удобност	udɔbnɔst
удолу	udɔɫu
удопство	udɔpstvɔ
ужас	uʒas
узурпаторски	uzurpatɔrski
узурпација	uzurpat͡sija
указ	ukas
улица	ulit͡sa
уличарски	ulit͡ʃarski
ум	um
умее	umɛɛ
умереност	umɛɾɛnɔst
уметник	umɛtnik
уметница	umɛtnit͡sa
уметнички	umɛtnit͡ʃki
уметништво	umɛtniʃtvɔ
уметност	umɛtnɔst
умешност	umɛʃnɔst
умник	umnik
умотворба	umɔtvɔrba
умува	umuva
унгарија	unɡaɾija
унгарски	uŋɡarski
универзитет	univɛrzitɛt
уникатност	unikatnɔst
унија	unija
уплашеност	upɫaʃɛnɔst
управен	upravɛn
управничка	upravnit͡ʃka
управнички	upravnit͡ʃki
упропастеност	uprɔpastɛnɔst
урбанизација	urbanizat͡sija
ургентен	urɡɛntɛn
уредничка	urɛdnit͡ʃka
уреднички	urɛdnit͡ʃki
уредност	uɾɛdnɔst
урологија	uɾɔɫɔɡija
усвојлив	usvɔjlif
условност	usɫɔvnɔst
условува	usɫɔvuva
услужливост	usɫuʒlivɔst
услужува	usɫuʒuva
усмрденост	usmr̩dɛnɔst
усмртува	usmr̩tuva
усогласеност	usɔɡɫasɛnɔst
успаниченост	uspanit͡ʃɛnɔst
успех	uspɛx
успешност	uspɛʃnɔst
усрден	usr̩dɛn
усрдност	usr̩dnɔst
уста	usta
устав	ustaf
уставност	ustavnɔst
усте	ustɛ
устичка	ustit͡ʃka
устројство	ustrɔjstvɔ
утопија	utɔpija
утре	utrɛ
утрина	utrina
утро	utrɔ
утробен	utrɔbɛn
уфрлен	ufr̩lɛn
учебен	ut͡ʃɛbɛn
учебник	ut͡ʃɛbnik
учебнички	ut͡ʃɛbnit͡ʃki
ученик	ut͡ʃɛnik
учениче	ut͡ʃɛnit͡ʃɛ
учење	ut͡ʃɛɲɛ
учител	ut͡ʃitɛɫ
учителство	ut͡ʃitɛɫstvɔ
учкур	ut͡ʃkur
учкури	ut͡ʃkuɾi
уши	uʃi
ушле	uʃlɛ
фабрика	fabrika
фазанов	fazanɔf
факт	fakt
факултет	fakuɫtɛt
фала	faɫa
фаличност	falit͡ʃnɔst
фалсификаторски	faɫsifikatɔrski
фалсификација	faɫsifikat͡sija
фалта	faɫta
фанатичен	fanatit͡ʃɛn
фараон	faɾaɔn
фармација	farmat͡sija
фармерки	farmɛrki
фасцинација	fast͡sinat͡sija
фати	fati
фаќа	faca
февруари	fɛvruaɾi
федерација	fɛdɛrat͡sija
фелдмаршал	fɛɫdmarʃaɫ
фенер	fɛnɛr
фенерче	fɛnɛrt͡ʃɛ
фереџе	fɛɾɛd͡ʒɛ
ферментација	fɛrmɛntat͡sija
фетиш	fɛtiʃ
феудализам	fɛudalizam
фигаро	fiɡaɾɔ
физиологија	fizijɔɫɔɡija
физиономија	fizijɔnɔmija
физиотерапија	fizijɔtɛrapija
фиксација	fiksat͡sija
фиксност	fiksnɔst
филантропија	fiɫantrɔpija
филм	fiɫm̩
филмче	fiɫm̩t͡ʃɛ
филогенетски	fiɫɔɡɛnɛtski
филолог	fiɫɔɫɔk
филологија	fiɫɔɫɔɡija
филтерски	fiɫtɛrski
филтрација	fiɫtrat͡sija
филхармонија	fiɫxarmɔnija
фирма	firma
фитнес	fitnɛs
флејта	flɛjta
флејтист	flɛjtist
флорет	fɫɔrɛt
флорети	fɫɔrɛti
флоскула	fɫɔskuɫa
флуктуација	fɫuktuat͡sija
фобија	fɔbija
фондација	fɔndat͡sija
фондовски	fɔndɔfski
фонт	fɔnt
фонтови	fɔntɔvi
форма	fɔrma
формализација	fɔrmalizat͡sija
формациски	fɔrmat͡siski
формација	fɔrmat͡sija
формулација	fɔrmuɫat͡sija
формулира	fɔrmuliɾa
фосилен	fɔsilɛn
фотелја	fɔtɛlja
фотогеничност	fɔtɔɡɛnit͡ʃnɔst
фотоќелија	fɔtɔcɛlija
фреквенциски	frɛkvɛnt͡siski
фрижидер	friʒidɛr
фронт	frɔnt
фрустрација	frustrat͡sija
фстаци	fstat͡si
фудбал	fudbaɫ
фунафути	funafuti
фунафутиски	funafutiski
фурна	furna
фурнаџија	furnad͡ʒija
фустан	fustan
фустанче	fustant͡ʃɛ
фушерски	fuʃɛrski
халуцинација	xaɫut͡sinat͡sija
хамбургер	xamburɡɛr
хаос	xaɔs
хаотичност	xaɔtit͡ʃnɔst
харзувал	xarzuvaɫ
харизматичност	xaɾizmatit͡ʃnɔst
хармонизација	xarmɔnizat͡sija
хармонично	xarmɔnit͡ʃnɔ
хартивче	xartift͡ʃɛ
хартија	xartija
хафниум	xafnijum
хајка	xajka
хеликоптер	xɛlikɔptɛr
хеликоптери	xɛlikɔptɛɾi
хелсиншки	xɛɫsinʃki
хемичарски	xɛmit͡ʃarski
хемотерапија	xɛmɔtɛrapija
хералд	xɛɾaɫt
хералди	xɛɾaɫdi
хералдика	xɛraɫdika
херцег	xɛrt͡sɛk
херцеговина	xɛrt͡sɛɡɔvina
хибернација	xibɛrnat͡sija
хидрант	xidrant
хипопотомонстросесквипедалиофобија	xipɔpɔtɔmɔnstrɔsɛskvipɛdalijɔfɔbija
хировитост	xirɔvitɔst
хистерија	xistɛɾija
хистологија	xistɔɫɔɡija
хит	xit
хлороформ	xɫɔɾɔfɔrm̩
хмељ	xmɛl
хомонимија	xɔmɔnimija
хомофонија	xɔmɔfɔnija
хонијара	xɔnijaɾa
хонијарски	xɔnijarski
хотел	xɔtɛɫ
хотелски	xɔtɛɫski
храбар	xrabar
храм	xram
храна	xrana
хранливост	xranlivɔst
хрват	xr̩vat
хрватка	xr̩vatka
хрватски	xr̩vatski
хроника	xrɔnika
хроничарски	xrɔnit͡ʃarski
ц	ǀ
цаблан	t͡sabɫan
цап	t͡sap
цар	t͡sar
царица	t͡saɾit͡sa
царство	t͡sarstvɔ
царува	t͡saɾuva
цвет	t͡svɛt
цветче	t͡svɛtt͡ʃɛ
цвеќарски	t͡svɛcarski
цвеќарство	t͡svɛcarstvɔ
цвеќе	t͡svɛcɛ
цвеќенце	t͡svɛcɛnt͡sɛ
цвеќуле	t͡svɛculɛ
целисходност	t͡sɛlisxɔdnɔst
целовит	t͡sɛɫɔvit
целосен	t͡sɛɫɔsɛn
целосност	t͡sɛɫɔsnɔst
целувка	t͡sɛɫufka
цензор	t͡sɛnzɔr
цензорски	t͡sɛnzɔrski
централизација	t͡sɛntralizat͡sija
центрира	t͡sɛntriɾa
центурија	t͡sɛntuɾija
цеца	t͡sɛt͡sa
цеѓ	tsɛc
цигара	t͡siɡaɾa
цигари	t͡siɡaɾi
цигарче	t͡siɡart͡ʃɛ
циглен	t͡siɡlɛn
цикличност	t͡siklit͡ʃnɔst
циметов	t͡simɛtɔf
цимоли	t͡simɔli
циник	t͡sinik
циничност	t͡sinit͡ʃnɔst
цинков	t͡siŋkɔf
циркулација	t͡sirkuɫat͡sija
циркуски	t͡sirkuski
цифра	t͡sifra
цица	t͡sit͡sa
цицач	t͡sit͡sat͡ʃ
циција	t͡sit͡sija
цол	t͡sɔɫ
црвен	t͡sr̩vɛn
црвена	t͡sr̩vɛna
црви	t͡sr̩vi
црвило	t͡sr̩viɫɔ
црвливост	t͡sr̩vlivɔst
црева	t͡srɛva
црево	t͡srɛvɔ
црешов	t͡srɛʃɔf
црква	t͡sr̩kva
црквичка	t͡sr̩kvit͡ʃka
црн	t͡sr̩n̩
црногорец	t͡sr̩nɔɡɔɾɛt͡s
црногорка	t͡sr̩nɔɡɔrka
црнокос	t͡sr̩nɔkɔs
цртичка	t͡sr̩tit͡ʃka
цутка	t͡sutka
цутне	t͡sutnɛ
ццц	ǀǀǀ
чавкин	t͡ʃafkin
чаеви	t͡ʃaɛvi
чамец	t͡ʃamɛt͡s
чамче	t͡ʃamt͡ʃɛ
чанта	t͡ʃanta
чаршаф	t͡ʃarʃaf
чаршафче	t͡ʃarʃaft͡ʃɛ
час	t͡ʃas
часовничарски	t͡ʃasɔvnit͡ʃarski
чај	t͡ʃaj
чајник	t͡ʃajnik
чајче	t͡ʃajt͡ʃɛ
чајџилница	t͡ʃajd͡ʒiɫnit͡sa
чајџилници	t͡ʃajd͡ʒiɫnit͡si
чевел	t͡ʃɛvɛɫ
чевличка	t͡ʃɛvlit͡ʃka
чедност	t͡ʃɛdnɔst
чедо	t͡ʃɛdɔ
чедоубиство	t͡ʃɛdɔubistvɔ
чека	t͡ʃɛka
чекан	t͡ʃɛkan
чеканче	t͡ʃɛkant͡ʃɛ
чекмеџе	t͡ʃɛkmɛd͡ʒɛ
челенка	t͡ʃɛlɛŋka
челенки	t͡ʃɛlɛŋki
чело	t͡ʃɛɫɔ
чембала	t͡ʃɛmbaɫa
чембалист	t͡ʃɛmbalist
чембалисти	t͡ʃɛmbalisti
чембалистка	t͡ʃɛmbalistka
чембалистки	t͡ʃɛmbalistki
чембало	t͡ʃɛmbaɫɔ
чепорест	t͡ʃɛpɔɾɛst
черга	t͡ʃɛrɡa
череп	t͡ʃɛɾɛp
чесност	t͡ʃɛsnɔst
честина	t͡ʃɛstina
често	t͡ʃɛstɔ
честољубивост	t͡ʃɛstɔlubivɔst
четворица	t͡ʃɛtvɔɾit͡sa
четворче	t͡ʃɛtvɔrt͡ʃɛ
четврток	t͡ʃɛtvr̩tɔk
четири	t͡ʃɛtiɾi
четириесет	t͡ʃɛtirijɛsɛt
четиринаесет	t͡ʃɛtiɾinaɛsɛt
четиристотини	t͡ʃɛtiɾistɔtini
четка	t͡ʃɛtka
четкичка	t͡ʃɛtkit͡ʃka
четник	t͡ʃɛtnik
чешел	t͡ʃɛʃɛɫ
чешелче	t͡ʃɛʃɛɫt͡ʃɛ
чешки	t͡ʃɛʃki
чешма	t͡ʃɛʃma
чешмен	t͡ʃɛʃmɛn
чешмиче	t͡ʃɛʃmit͡ʃɛ
чешмичка	t͡ʃɛʃmit͡ʃka
чивит	t͡ʃivit
чивија	t͡ʃivija
чизмичка	t͡ʃizmit͡ʃka
чим	t͡ʃim
чиниче	t͡ʃinit͡ʃɛ
чинија	t͡ʃinija
чиновништво	t͡ʃinɔvniʃtvɔ
число	t͡ʃisɫɔ
чистачки	t͡ʃistat͡ʃki
чистосрдечност	t͡ʃistɔsr̩dɛt͡ʃnɔst
чистота	t͡ʃistɔta
чистотник	t͡ʃistɔtnik
читанка	t͡ʃitaŋka
читател	t͡ʃitatɛɫ
читателка	t͡ʃitatɛɫka
читање	t͡ʃitaɲɛ
чифлиг	t͡ʃiflik
чичков	t͡ʃit͡ʃkɔf
чиј	t͡ʃij
чкрапа	t͡ʃkrapa
чкрапав	t͡ʃkrapaf
чкрта	t͡ʃkr̩ta
чкртне	t͡ʃkr̩tnɛ
член	t͡ʃlɛn
членува	t͡ʃlɛnuva
човек	t͡ʃɔvɛk
човека	t͡ʃɔvɛka
човеков	t͡ʃɔvɛkɔf
човекон	t͡ʃɔvɛkɔn
човекот	t͡ʃɔvɛkɔt
човекоубиство	t͡ʃɔvɛkɔubistvɔ
човекољубивост	t͡ʃɔvɛkɔlubivɔst
човеку	t͡ʃɔvɛku
човештво	t͡ʃɔvɛʃtvɔ
чорап	t͡ʃɔɾap
чорапче	t͡ʃɔɾapt͡ʃɛ
чорба	t͡ʃɔrba
чорбичка	t͡ʃɔrbit͡ʃka
чотра	t͡ʃɔtra
чоха	t͡ʃɔxa
чпп	t͡ʃəpəpə
чува	t͡ʃuva
чуварка	t͡ʃuvarka
чуден	t͡ʃudɛn
чудесија	t͡ʃudɛsija
чудесно	t͡ʃudɛsnɔ
чудесност	t͡ʃudɛsnɔst
чудно	t͡ʃudnɔ
чудност	t͡ʃudnɔst
чудо	t͡ʃudɔ
чукало	t͡ʃukaɫɔ
чума	t͡ʃuma
чумен	t͡ʃumɛn
чупе	t͡ʃupɛ
чури	t͡ʃuɾi
чутура	t͡ʃutuɾa
шал	ʃaɫ
шаман	ʃaman
шамивче	ʃamift͡ʃɛ
шанец	ʃanɛt͡s
шапка	ʃapka
шапкарка	ʃapkarka
шапкарски	ʃapkarski
шарпланинец	ʃarpɫaninɛt͡s
шарпланинка	ʃarpɫaniŋka
шарпланинки	ʃarpɫaniŋki
шарпланинци	ʃarpɫanint͡si
шарпланинче	ʃarpɫanint͡ʃɛ
шарпланинчиња	ʃarpɫanint͡ʃiɲa
шатка	ʃatka
шаткин	ʃatkin
шаторски	ʃatɔrski
шаховски	ʃaxɔfski
шашавост	ʃaʃavɔst
шајка	ʃajka
шверцер	ʃvɛrt͡sɛr
шверцерка	ʃvɛrt͡sɛrka
шегаџиски	ʃɛɡad͡ʒiski
шегобиство	ʃɛɡɔbistvɔ
шеговит	ʃɛɡɔvit
шеесет	ʃɛɛsɛt
шерифов	ʃɛɾifɔf
шеријат	ʃɛɾijat
шеснаесет	ʃɛsnaɛsɛt
шест	ʃɛst
шестар	ʃɛstar
шестмина	ʃɛstmina
шестнаесет	ʃɛstnaɛsɛt
шестотини	ʃɛstɔtini
шефовство	ʃɛfɔfstvɔ
шешир	ʃɛʃir
шеширче	ʃɛʃirt͡ʃɛ
шејтан	ʃɛjtan
шеќер	ʃɛcɛr
шеќерче	ʃɛcɛrt͡ʃɛ
шилеже	ʃilɛʒɛ
шилест	ʃilɛst
шинтер	ʃintɛr
шиптар	ʃiptar
шише	ʃiʃɛ
шишуле	ʃiʃulɛ
шија	ʃija
шкафче	ʃkaft͡ʃɛ
шкембе	ʃkɛmbɛ
школа	ʃkɔɫa
шлака	ʃɫaka
шлапа	ʃɫapa
шмат	ʃmat
шмата	ʃmata
шминка	ʃmiŋka
шнајдер	ʃnajdɛr
шнајдерка	ʃnajdɛrka
шокираност	ʃɔkiɾanɔst
шот	ʃɔt
шпионски	ʃpijɔnski
шпионство	ʃpijɔnstvɔ
шпорет	ʃpɔɾɛt
шпоретче	ʃpɔɾɛtt͡ʃɛ
шраф	ʃraf
шрафче	ʃraft͡ʃɛ
штава	ʃtava
штави	ʃtavi
штедар	ʃtɛdar
штедливост	ʃtɛdlivɔst
штедрост	ʃtɛdrɔst
штекер	ʃtɛkɛr
штетност	ʃtɛtnɔst
штеточинец	ʃtɛtɔt͡ʃinɛt͡s
штитеничка	ʃtitɛnit͡ʃka
штитенички	ʃtitɛnit͡ʃki
штица	ʃtit͡sa
штичка	ʃtit͡ʃka
штрафче	ʃtraft͡ʃɛ
штрајк	ʃtrajk
штрајкувач	ʃtrajkuvat͡ʃ
штрк	ʃtr̩k
штурец	ʃtuɾɛt͡s
штурче	ʃturt͡ʃɛ
шума	ʃuma
шуми	ʃumi
шумичка	ʃumit͡ʃka
шумолење	ʃumɔlɛɲɛ
шумоли	ʃumɔli
шупа	ʃupa
шупливост	ʃuplivɔst
шура	ʃuɾa
шушкав	ʃuʃkaf
шушкавост	ʃuʃkavɔst
ѓавол	ɟavɔɫ
ѓаволест	ɟavɔlɛst
ѓаволка	ɟavɔɫka
ѓаволов	ɟavɔɫɔf
ѓаволски	ɟavɔɫski
ѓаволче	ɟavɔɫt͡ʃɛ
ѓаволштина	ɟavɔɫʃtina
ѓакон	ɟakɔn
ѓаконски	ɟakɔnski
ѓаконство	ɟakɔnstvɔ
ѓаур	ɟaur
ѓаурка	ɟaurka
ѓеврек	ɟɛvrɛk
ѓеврече	ɟɛvrɛt͡ʃɛ
ѓезве	ɟɛzvɛ
ѓердан	ɟɛrdan
ѓерданче	ɟɛrdant͡ʃɛ
ѓоа	ɟɔa
ѓомлезе	ɟɔmlɛzɛ
ѓомлезец	ɟɔmlɛzɛt͡s
ѓон	ɟɔn
ѓонови	ɟɔnɔvi
ѓубре	ɟubrɛ
ѓубренце	ɟubrɛnt͡sɛ
ѓубри	ɟubri
ѓубриво	ɟubrivɔ
ѓуле	ɟulɛ
ѓум	ɟum
ѓумбир	ɟumbir
ѓумови	ɟumɔvi
ѓуптин	ɟuptin
ѓуптинка	ɟuptiŋka
ѕвезда	d͡zvɛzda
ѕвездалија	d͡zvɛzdalija
ѕвезден	d͡zvɛzdɛn
ѕвездест	d͡zvɛzdɛst
ѕвезди	d͡zvɛzdi
ѕвездичка	d͡zvɛzdit͡ʃka
ѕвездолик	d͡zvɛzdɔlik
ѕвек	d͡zvɛk
ѕвекне	d͡zvɛknɛ
ѕвекнува	d͡zvɛknuva
ѕвекот	d͡zvɛkɔt
ѕвер	d͡zvɛr
ѕвери	d͡zvɛɾi
ѕверка	d͡zvɛrka
ѕверови	d͡zvɛɾɔvi
ѕверски	d͡zvɛrski
ѕверство	d͡zvɛrstvɔ
ѕверче	d͡zvɛrt͡ʃɛ
ѕвечалка	d͡zvɛt͡ʃaɫka
ѕвечало	d͡zvɛt͡ʃaɫɔ
ѕвечарка	d͡zvɛt͡ʃarka
ѕвечи	d͡zvɛt͡ʃi
ѕвечка	d͡zvɛt͡ʃka
ѕвечлив	d͡zvɛt͡ʃlif
ѕвонар	d͡zvɔnar
ѕвонарски	d͡zvɔnarski
ѕвони	d͡zvɔni
ѕвонлив	d͡zvɔnlif
ѕвоно	d͡zvɔnɔ
ѕвонче	d͡zvɔnt͡ʃɛ
ѕвончест	d͡zvɔnt͡ʃɛst
ѕврцне	d͡zvr̩t͡snɛ
ѕе	d͡zæ
ѕевгар	d͡zɛvɡar
ѕемне	d͡zɛmnɛ
ѕенѕа	d͡zɛnd͡za
ѕиври	d͡zivri
ѕид	d͡zit
ѕида	d͡zida
ѕидар	d͡zidar
ѕидарски	d͡zidarski
ѕидарство	d͡zidarstvɔ
ѕиден	d͡zidɛn
ѕидина	d͡zidina
ѕидови	d͡zidɔvi
ѕирка	d͡zirka
ѕирне	d͡zirnɛ
ѕрцки	d͡zr̩t͡ski
ѕуница	d͡zunit͡sa
ѕунлив	d͡zunlif
ѕури	d͡zuɾi
ја	ja
јабанџија	jaband͡ʒija
јаболкница	jabɔɫknit͡sa
јаболко	jabɔɫkɔ
јаболков	jabɔɫkɔf
јаболче	jabɔɫt͡ʃɛ
јаболчест	jabɔɫt͡ʃɛst
јаболчница	jabɔɫt͡ʃnit͡sa
јава	java
јаваскрипт	javaskript
јавач	javat͡ʃ
јавачка	javat͡ʃka
јавачки	javat͡ʃki
јаве	javɛ
јавен	javɛn
јави	javi
јавне	javnɛ
јавност	javnɔst
јавор	javɔr
јавува	javuva
јаглен	jaɡlɛn
јаглениса	jaɡlɛnisa
јагленисува	jaɡlɛnisuva
јагленов	jaɡlɛnɔf
јагленче	jaɡlɛnt͡ʃɛ
јаглерод	jaɡlɛɾɔt
јагне	jaɡnɛ
јагненце	jaɡnɛnt͡sɛ
јагнешки	jaɡnɛʃki
јагнуле	jaɡnulɛ
јагода	jaɡɔda
јагодичка	jaɡɔdit͡ʃka
јагодов	jaɡɔdɔf
јаготче	jaɡɔtt͡ʃɛ
јагуар	jaɡuar
јагула	jaɡuɫa
јад	jat
јаде	jadɛ
јадеж	jadɛʃ
јаден	jadɛn
јадец	jadɛt͡s
јадење	jadɛɲɛ
јадица	jadit͡sa
јадничок	jadnit͡ʃɔk
јадови	jadɔvi
јадрен	jadrɛn
јадро	jadrɔ
јадровит	jadrɔvit
јажарски	jaʒarski
јаже	jaʒɛ
јаженце	jaʒɛnt͡sɛ
јаз	jas
јазик	jazik
јазици	jazit͡si
јазичар	jazit͡ʃar
јазиче	jazit͡ʃɛ
јазичен	jazit͡ʃɛn
јазичест	jazit͡ʃɛst
јазичиште	jazit͡ʃiʃtɛ
јазичник	jazit͡ʃnik
јазлест	jazlɛst
јазовец	jazɔvɛt͡s
јазовичар	jazɔvit͡ʃar
јазол	jazɔɫ
јаловост	jaɫɔvɔst
јамајка	jamajka
јаничар	janit͡ʃar
јануари	januaɾi
јанѕа	jand͡za
јаренце	jaɾɛnt͡sɛ
јас	jas
јасминов	jasminɔf
јасновидство	jasnɔvitstvɔ
јатрвин	jatr̩vin
јахта	jaxta
јајник	jajnik
јајце	jajt͡sɛ
јајцев	jajt͡sɛf
јајцевод	jajt͡sɛvɔt
јајценце	jajt͡sɛnt͡sɛ
јајцест	jajt͡sɛst
јајчен	jajt͡ʃɛn
јајчест	jajt͡ʃɛst
јајчник	jajt͡ʃnik
јер	jɛr
јогурт	jɔɡurt
јогуртче	jɔɡurtt͡ʃɛ
јок	jɔk
јон	jɔn
јорган	jɔrɡan
јоргански	jɔrɡanski
јорганче	jɔrɡant͡ʃɛ
јоргованов	jɔrɡɔvanɔf
јотација	jɔtat͡sija
јубилеј	jubilɛj
југославија	juɡɔsɫavija
јужњак	juʒɲak
јули	juli
јунаштво	junaʃtvɔ
јунаштина	junaʃtina
јунешки	junɛʃki
јуни	juni
јуница	junit͡sa
јурнува	jurnuva
љубител	lubitɛɫ
љубителка	lubitɛɫka
љубителски	lubitɛɫski
љубов	ʎubɔf
љубовник	lubɔvnik
љубовџиски	lubɔvd͡ʒiski
љубовџија	lubɔvd͡ʒija
љубопитност	ʎubɔpitnɔst
љубљана	lublana
љубљански	lublanski
њоки	ɲɔki
њуделхиски	ɲudɛɫxiski
њутн	ɲutn̩
њујорк	ɲujɔrk
њујорчанец	ɲujɔrt͡ʃanɛt͡s
њујорчанка	ɲujɔrt͡ʃaŋka
њујоршки	ɲujɔrʃki
ќебап	cɛbap
ќебапче	cɛbapt͡ʃɛ
ќелави	cɛɫavi
ќелавост	cɛɫavɔst
ќерка	cɛrka
ќерки	cɛrki
ќеркичка	cɛrkit͡ʃka
ќесичка	cɛsit͡ʃka
ќефови	cɛfɔvi
ќешки	cɛʃki
ќилим	cilim
ќос	cɔs
ќофте	cɔftɛ
ќофтенце	cɔftɛnt͡sɛ
ќошеви	cɔʃɛvi
ќумур	cumur
ќуп	cup
ќупови	cupɔvi
ќупче	cupt͡ʃɛ
ќуќур	cucur
ѝ	i
џабе	d͡ʒabɛ
џаболебарка	d͡ʒabɔlɛbarka
џагор	d͡ʒaɡɔr
џакарта	d͡ʒakarta
џакартски	d͡ʒakartski
џамови	d͡ʒamɔvi
џбунови	d͡ʒbunɔvi
џвакање	d͡ʒvakaɲɛ
џеб	d͡ʒɛp
џебови	d͡ʒɛbɔvi
џелат	d͡ʒɛɫat
џем	d͡ʒɛm
џемови	d͡ʒɛmɔvi
џемпер	d͡ʒɛmpɛr
џемперче	d͡ʒɛmpɛrt͡ʃɛ
џепче	d͡ʒɛpt͡ʃɛ
џигер	d͡ʒiɡɛr
џигерче	d͡ʒiɡɛrt͡ʃɛ
џилит	d͡ʒilit
џимиринка	d͡ʒimiɾiŋka
џимиринки	d͡ʒimiɾiŋki
џин	d͡ʒin
џинови	d͡ʒinɔvi
џиновски	d͡ʒinɔfski
џип	d͡ʒip
џипови	d͡ʒipɔvi
џиџе	d͡ʒid͡ʒɛ
џогер	d͡ʒɔɡɛr
џогерка	d͡ʒɔɡɛrka
џокер	d͡ʒɔkɛr
џунгла	d͡ʒuŋɡɫa
џуџе	d͡ʒud͡ʒɛ
џуџенце	d͡ʒud͡ʒɛnt͡sɛ
’рбет	r̩bɛt
’рбетен	r̩bɛtɛn
’рбетник	r̩bɛtnik
’рдоква	r̩dɔkva
’рж	r̩ʃ
’рка	r̩ka
’рскавица	r̩skavit͡sa
’рскавичен	r̩skavit͡ʃɛn
’рт	r̩t
’рти	r̩ti
’рчи	r̩t͡ʃi
’рѓа	r̩ɟa
’рѓав	r̩ɟaf
