abeceda	abɛt͡sɛda
adam	adam
adama	adama
adamami	adamami
adamoch	adamɔx
adamom	adamɔm
adamov	adamɔu̯
adamovi	adamɔvi
adamovia	adamɔvi̯a
adela	adeɫa
adelka	adɛɫka
adjektívum	adjɛktiːvum
ado	adɔ
adolf	adoɫf
adrián	adriaːn
adriána	adriaːna
afrika	afrika
afrike	afrikɛ
afrikou	afrikɔu̯
afriku	afriku
afriky	afriki
afrikánec	afrikaːɲɛt͡s
agnesa	aɡnɛsa
agáta	aɡaːta
ahoj	aɦɔj
aids	ajt͡s
aids	aːiːdɛːɛs
aids	ɛjt͡s
ak	ak
akcia	akt͡sia
ako	akɔ
akonáhle	akɔnaːɦlɛ
aktivovať	aktivovac
aktualizovaný	aktualizovaniː
aktualizovať	aktualizovac
aktualizácia	aktualizaːt͡sia
aktínium	aktiːnium
akuzatív	akuzatiːu̯
aký	akiː
akýkoľvek	akiːkɔʎvɛk
alah	aɫax
alan	aɫan
alandy	aɫandi
albert	aɫbɛrt
albánsky	aɫbaːnski
albánčina	aɫbaːnt͡ʃina
albín	aɫbiːn
albína	aɫbiːna
alebo	alɛbɔ
alena	alɛna
alexander	alɛksandɛr
alexandra	alɛksandra
alexej	alɛksɛj
aleš	alɛʃ
alfonz	aɫfɔns
alfréd	aɫfrɛːt
alibi	alibi
alica	alit͡sa
aljaška	alʲaʃka
alka	aɫka
alkohol	aɫkɔɦɔɫ
alkoholický	alkɔhɔlit͡skiː
alkoholik	aɫkɔɦɔlik
almanach	almanax
alojz	aɫɔjs
alpy	alpi
altruizmus	aɫtruizmus
alánd	aɫaːnt
alžbeta	aɫʒbɛta
ambróz	ambrɔs
americký	amɛrit͡skiː
američan	amɛrit͡ʃan
američanka	amɛrit͡ʃaŋka
amerícium	amɛriːt͡sium
amnézia	amnɛːzia
amália	amaːlia
anabela	anabɛɫa
anamnéza	anamnɛːza
ananás	ananaːs
anaxagoras	anaksaɡoras
andrea	andrɛa
andrej	andrɛj
andulka	anduɫka
anežka	aɲɛʃka
angela	aŋɡɛɫa
angelika	aŋɡɛlika
anglicko	aŋɡlit͡skɔ
angličtina	aŋɡlit͡ʃcina
angström	aŋɡstrœm
angström	aŋɡstrɛm
ani	aɲi
anjel	aɲi̯ɛɫ
anna	anna
annu	annu
antimón	antimɔːn
antisemita	antisɛmita
anton	antɔn
antónia	antɔːnia
aperitív	apɛritiːw
apríl	apriːɫ
arabčina	arapt͡ʃina
aragonit	araɡɔnit
archeológia	arxɛɔɫɔːɡia
architektúra	arxitɛktuːra
arcibiskup	art͡sibiskup
argón	arɡɔːn
aristoteles	aristɔtɛlɛs
arménsko	armɛːnskɔ
arménčina	armɛːnt͡ʃina
arnold	arnɔld
arpád	arpaːt
artritída	artritiːda
artúr	artuːr
arzén	arzɛːn
astronóm	astrɔnɔːm
astronómia	astrɔnɔːmia
astát	astaːt
ateizmus	atɛizmus
atrament	atramɛnt
atény	atɛːni
atóm	atɔːm
atómový	atɔːmɔviː
augustín	au̯ɡustiːn
aurel	au̯rɛːɫ
aurélia	au̯rɛːlia
auta	au̯ta
autami	au̯tami
aute	au̯cɛ
auto	au̯tɔ
autobus	au̯tɔbus
autom	au̯tɔm
autostráda	au̯tɔstraːda
autu	au̯tu
autách	au̯taːx
autám	au̯taːm
azda	azda
baba	baba
babona	babɔna
baht	baːt
baktéria	baktɛːria
baktérie	baktɛːriɛ
baleáry	balɛaːri
bambus	bambus
bambusový	bambusɔviː
banka	banka
bankami	baŋkami
banke	baŋkɛ
bankovka	bankɔu̯ka
banku	baŋku
banky	baŋki
banán	banaːn
baníctvo	baɲiːt͡svɔ
baník	baɲiːk
bara	bara
barbara	barbara
barbora	barbɔra
bartolomej	bartɔɫɔmɛj
bača	bat͡ʃa
baňa	baɲa
bažant	baʒant
bedminton	bɛːdmintɔn
bedro	bɛːdrɔ
beh	bɛx
behať	bɛɦac
bejrút	bɛjruːt
belasý	belasiː
belgicko	bɛɫɡit͡ʃkɔ
belo	bɛɫɔ
benjamín	bɛnjamiːn
benzín	bɛnziːn
benzínka	bɛnziːnka
berkélium	bɛrkɛːlium
berlín	bɛrliːn
bernard	bɛrnard
berta	bɛrta
berýlium	bɛriːlium
beskydy	bɛskidi
betón	bɛtɔːn
bez	bɛs
bezcharakterný	bɛsxaraktɛrniː
beznádej	bɛznaːɟɛj
bezo	bɛzɔ
bezpečnosť	bɛspɛt͡ʃnɔsc
beáta	bɛaːta
beátka	bɛaːtka
beňadik	bɛɲaɟik
beňo	bɛɲɔ
bežať	bɛʒac
bianka	bi̯aŋka
bibiána	bibiaːna
bicykel	bit͡sikɛɫ
bielizeň	bi̯ɛlizɛɲ
bielizník	bi̯ɛlizɲiːk
bielorusko	bi̯ɛɫɔruskɔ
bieloruština	bi̯ɛɫɔruʃcina
biely	bi̯ɛli
biológia	biɔɫɔːɡia
biotit	biotit
birmovanie	birmɔvaɲi̯ɛ
birmovka	birmɔu̯ka
bisexualita	bisɛksualita
biskup	biskup
bislama	bisɫama
bizmut	bizmut
blahoslav	bɫaɦɔsɫau̯
blamáž	blamaːʃ
blanka	bɫaŋka
blažej	bɫaʒɛj
blažena	bɫaʒɛna
blcha	bɫ̩xa
bližší	bliʃʃiː
blázon	bɫaːzɔn
bobona	bɔbɔna
bocian	bɔt͡si̯an
bodka	bɔtka
bodkočiarka	bɔtkɔt͡ʃi̯arka
bodliak	bɔdli̯ak
bodnúť	bɔdnuːc
boh	bɔx
bohatý	bɔɦatiː
bohdan	bɔɦdan
bohdana	bɔɦdana
bohemizmus	bɔɦɛmizmus
bohrium	bɔrium
bohumil	bɔɦumiɫ
bohumír	bɔɦumiːr
bohuslav	bɔɦuslau̯
bohuslava	bɔɦuslava
bohuš	bɔɦuʃ
bohužiaľ	bɔɦuʒi̯aʎ
bohyňa	boɦiɲa
boháč	bɔɦaːt͡ʃ
bojovať	bɔjɔvac
boleslav	bɔlɛslau̯
bolesť	bɔlɛsc
bologna	boloɲa
bomba	bɔmba
bombardovať	bɔmbardɔvac
bonifác	bɔnifaːt͡s
borec	bɔrɛt͡s
boris	bɔris
borovicový	bɔrɔvit͡sɔviː
bosorák	bɔsɔraːk
botanika	bɔtanika
botanizovať	bɔtanizɔvac
bozk	bɔsk
bozkať	bɔskac
bože	bɔʒɛ
božena	bɔʒɛna
božica	bɔʒit͡sa
božidara	bɔʒidara
božtek	bɔʃcɛk
brada	brada
bradatý	bradatiː
branislav	braɲisɫau̯
branislava	braɲislava
brat	brat
brata	brata
bratislave	bracisɫavɛ
bratislavou	bracisɫavɔu̯
bratislavu	bracisɫavu
bratislavy	bracisɫavi
bratislavčan	bracislau̯t͡ʃan
bratranec	bratranet͡s
brazílski	braziːɫski
braček	brat͡ʃɛk
braňa	braɲa
braňo	braɲɔ
brdo	br̩dɔ
breh	brɛx
breza	brɛza
brečtan	brɛt͡ʃtan
briadka	bri̯atka
brigita	briɡita
brita	brita
bronislava	brɔɲislava
broskyňa	brɔskiɲa
brucho	bruxɔ
bruchomluvec	bruxɔmluvɛt͡s
bruno	brunɔ
brusel	brusɛɫ
bruško	bruʃkɔ
bryndza	brind͡za
brány	braːni
brázda	braːzda
bróm	brɔːm
budova	budɔva
budyšín	budiʃiːn
budúci	buduːt͡si
bukurešť	bukurɛʃc
bulharsko	buɫɦarskɔ
bulharčina	buɫɦart͡ʃina
bunda	bunda
bystrica	bistrit͡sa
bystrík	bistriːk
bystrý	bistriː
byt	bit
byť	bic
báb	baːp
bábika	baːbika
bábka	baːbka
bárium	baːrium
báseň	baːsɛɲ
básnik	baːsɲik
bór	bɔːr
bôľ	bu̯ɔʎ
cadik	t͡sadik
cap	t͡sap
capina	t͡sapina
carihrad	t͡ʃariɦrat
cech	t͡sɛx
cecília	tse̞tsiːɫia
celebrita	t͡sɛlɛbrita
celiakia	t͡sɛliakia
celý	t͡sɛliː
cena	t͡sɛna
cencúľ	t͡sɛnt͡suːʎ
cenník	t͡sɛnɲiːk
cep	t͡sɛp
ceruza	tsɛruza
ceruzka	t͡sɛruska
cesnak	t͡sɛsnak
cesta	t͡sɛsta
cesto	t͡sɛstɔ
cestovateľ	t͡sɛstɔvacɛʎ
cestovina	t͡sɛstɔvina
cestár	t͡sɛstaːr
cez	t͡sɛs
cez	t͡sɛz
ch	x
chalan	xaɫan
chameleón	xamɛlɛɔːn
charakter	xaraktɛr
chladný	xɫadniː
chlap	xlap
chlapa	xɫapa
chlapec	xɫapɛt͡s
chlapi	xɫapi
chlapmi	xɫapmi
chlapoch	xɫapɔx
chlapom	xɫapɔm
chlapov	xɫapɔu̯
chlapovi	xɫapɔvi
chleba	xlɛba
chlm	xɫ̩m
chlór	xɫɔːr
chmeľ	xmɛʎ
chodidlo	xɔɟidɫɔ
chodiť	xɔɟic
chodník	xɔdɲiːk
cholera	xɔlɛra
choroba	xɔrɔba
chorobný	xɔrɔbniː
chorou	xɔrɔu̯
chorvatistika	xɔrvatistika
chorvátsko	xɔrvaːtskɔ
chorý	xɔriː
chrabrý	xrabriː
chrbtica	xr̩pcit͡sa
chrbát	xr̩baːt
chren	xrɛn
chrobák	xrɔbaːk
chromozóm	xrɔmɔzɔːm
chrumkavý	xrumkaviː
chrípka	xriːpka
chróm	xroːm
chrúst	xruːst
chrček	xr̩t͡ʃɛk
chudnúť	xʊdnuːc
chudobný	xudɔbniː
chudý	xudiː
chuj	xuj
chujovina	xujɔvina
chuligán	xuliɡaːn
chvastúň	xvastuːɲ
chvost	xvɔst
chvíľa	xviːʎa
chvíľka	xviːʎka
chvíľočka	xviːʎɔt͡ʃka
chyža	xiʒa
chémia	xɛːmia
chí	xiː
chýr	xiːr
cibuľa	t͡sibuʎa
cica	t͡sit͡sa
cicavec	t͡sit͡savɛt͡s
cicka	t͡sit͡ska
cieľ	t͡si̯ɛʎ
cigara	t͡siɡara
cigareta	t͡siɡarɛta
cikať	t͡sikac
cintorín	t͡sintɔriːn
cirkev	t͡sirke̞u̯
cisár	t͡sisaːr
cisárstvo	t͡sisaːrstvɔ
citoslovce	t͡sitɔsɫɔvt͡sɛ
cmar	t͡smar
cnosť	t͡snɔsc
ctibor	t͡scibɔr
ctí	t͡sciː
cuda	t͡suda
cudová	t͡sudɔvaː
cudzina	t͡sud͡zina
cudzinec	t͡sud͡ziɲɛt͡s
cudzinka	t͡sud͡ziŋka
cudzí	t͡sud͡ziː
cukor	t͡sukɔr
cunami	t͡sunami
curium	kyrium
cvikla	t͡svikla
cyprián	t͡sipriaːn
cyril	t͡siriɫ
cár	t͡saːr
cárovič	t͡saːrɔvit͡ʃ
cér	t͡sɛːr
cézium	tseːzium
cín	t͡siːn
cól	t͡sɔːɫ
dabing	dabiŋɡ
dagmara	daɡmara
dalibor	dalibɔr
dalimil	dalimiɫ
damask	damask
dana	dana
dani	daɲi
danica	daɲit͡sa
daniel	daniɛɫ
daniela	daɲiela
danka	daŋka
dano	danɔ
danuta	danuta
dar	dar
dardanely	dardanɛli
darina	darina
darmstadtium	darmʃtatium
databáza	databaːza
dav	daw
daň	daɲ
daňo	daɲɔ
dať	dac
dcéra	t͡sɛːra
dcérenka	t͡sɛːrɛŋka
dcérečka	t͡sɛːrɛt͡ʃka
dcérka	t͡sɛːrka
dcérsky	t͡sɛːrski
deaktivovať	dɛaktivɔvac
debna	ɟɛbna
debrecín	ɟɛbrɛt͡siːn
december	dɛt͡sɛmbɛr
dedina	ɟɛɟina
dedinka	ɟɛɟiŋka
dedinôčka	ɟɛɟinu̯ɔt͡ʃka
dedinčan	ɟɛɟɪntʃan
dedinčanka	ɟɛɟint͡ʃaŋka
dedko	ɟɛtkɔ
dedo	ɟɛdɔ
deista	dɛista
deizmus	dɛizmus
dej	ɟɛj
dejepis	ɟɛjɛpis
dejiny	ɟɛjini
delfín	dɛlfiːn
demeter	dɛmɛtɛr
denis	dɛnis
denisa	dɛnisa
denník	ɟɛnɲiːk
denný	ɟɛnniː
derviš	dɛrviʃ
desať	ɟɛsac
desiaty	ɟɛsi̯ati
determinant	dɛtɛrminant
deti	ɟɛci
detstvo	ɟɛt͡stvɔ
detí	ɟɛciː
deva	ɟɛva
deviaty	ɟɛvi̯ati
devätnásť	ɟɛvætnaːsc
devätnásť	ɟɛvɛtnaːsc
deväť	ɟevæc
dezider	dɛzidɛr
deň	ɟɛɲ
dežo	dɛʒɔ
diabol	ɟi̯abɔɫ
diana	diana
diaľnica	ɟi̯aʎɲit͡sa
dielo	ɟi̯ɛɫɔ
diera	ɟi̯ɛra
dievča	ɟi̯ɛu̯t͡ʃa
dievčinka	ɟi̯ɛu̯t͡ʃiŋka
dionýz	dioniːs
diéta	diɛːta
dlaň	dɫaɲ
dlhý	dl̩ɦiː
dlátko	dɫaːtkɔ
dláto	dɫaːtɔ
dne	dɲɛ
dnes	dɲɛs
dni	dɲi
dní	dɲiː
do	dɔ
dobre	dɔbrɛ
dobrej	dɔbrɛj
dobro	dobro
dobrom	dɔbrɔm
dobromil	dɔbrɔmiɫ
dobromila	dɔbrɔmiɫa
dobroslav	dɔbrɔsɫau̯
dobroslava	dɔbrɔsɫava
dobrou	dɔbrɔu̯
dobruša	dɔbruʃa
dobrá	dɔbraː
dobré	dɔbrɛː
dobrého	dɔbrɛːɦɔ
dobrému	dɔbrɛːmu
dobrí	dɔbriː
dobrú	dɔbruː
dobrý	dɔbriː
dobrých	dɔbriːx
dobrým	dɔbriːm
dobrými	dɔbriːmi
dojča	dɔjt͡ʃa
doktor	dɔktɔr
doktora	dɔktɔra
doktormi	dɔktɔrmi
doktoroch	dɔktɔrɔx
doktorom	dɔktɔrɔm
doktorov	dɔktɔrɔu̯
doktorovi	dɔktɔrɔvi
dokázať	dɔkaːzac
dolinôčka	dɔlinu̯ɔt͡ʃka
dom	dɔm
doma	dɔma
dominik	dɔminik
dominika	dɔminika
dominikánsky	dɔminikaːnski
domorodec	dɔmɔrɔɟɛt͡s
domov	dɔmɔu̯
domáci	dɔmaːt͡si
domček	dɔmt͡ʃɛk
dopyt	dɔpit
dorota	dɔrɔta
dosiaľ	dɔsi̯aʎ
dostať	dɔstac
doteraz	dɔtɛras
dovolenka	dɔvɔlɛŋka
draha	draɦa
drahokam	draɦɔkam
drahomír	draɦɔmiːr
drahomíra	draɦɔmiːra
drahoslav	draɦɔsɫau̯
drahoslava	draɦɔsɫava
drahoš	draɦɔʃ
drahuša	drahuʃa
draslík	drasliːk
drevo	drɛvɔ
driev	dri̯eu̯
drozd	drɔst
drozdí	drɔzɟiː
druhý	druɦiː
drumbľa	drumbʎa
drviť	dr̩vic
dráčik	draːt͡ʃik
dráždec	draːʒɟɛt͡s
drážďany	draːʒɟani
drôt	dru̯ɔt
držať	dr̩ʒac
držgroš	dr̩ʒɡrɔʃ
dub	dup
duba	duba
dube	dubɛ
dubmi	dubmi
dubnium	dubnium
duboch	dubɔx
dubom	dubɔm
dubov	dubɔu̯
dubu	dubu
duby	dubi
dudy	dudi
dunaj	dunaj
dunajec	dunajɛt͡s
dunajskí	dunajskiː
dunajský	dunajskiː
dunčo	dunt͡ʃɔ
dusík	dusiːk
duša	duʃa
dušan	duʃan
dušana	duʃana
duše	duʃɛ
dva	dva
dvadsať	dvatsac
dvaja	dvaja
dvakrát	dvakraːt
dvanásť	dvanaːsc
dvanásťročný	dvanaːscrɔt͡ʃniː
dve	dvɛ
dvere	dvɛrɛ
dvojbodka	dvɔjbɔtka
dvojitý	dvɔjitiː
dym	dim
dymami	dimami
dyme	dimɛ
dymoch	dimɔx
dymom	dimɔm
dymov	dimɔu̯
dymu	dimu
dymy	dimi
dysprózium	disprɔːzium
dáma	daːma
dán	daːn
dánka	daːŋka
dánsko	daːnskɔ
dánsky	daːnski
dánčina	daːnt͡ʃina
dávid	daːvit
dáša	daːʃa
dážď	daːʃc
dážďovka	daːʒɟɔu̯ka
dôležitý	du̯ɔlɛʒitiː
dôstojný	du̯ostojniː
dúha	duːɦa
dýchať	diːxac
dĺžeň	dɫ̩ːʒɛɲ
dĺžka	dɫ̩ːʃka
dŕžava	dr̩ːʒava
dŕžavní	dr̩ːʒavniː
dž	d͡ʒ
džamija	d͡ʒamija
džbán	d͡ʒbaːn
džem	d͡ʒɛm
džez	d͡ʒɛs
džin	d͡ʒin
džudo	dʒudo
džungľa	d͡ʒuŋɡʎa
džíp	d͡ʒiːp
džús	d͡ʒuːs
edita	ɛdita
edmund	ɛdmund
eduard	ɛduard
egreš	ɛɡrɛʃ
egypt	ɛɡipt
egyptský	ɛɡiptskiː
egypťan	ɛɡipcan
egypťanka	ɛɡipcanka
einsteinium	ajnʃtajnium
ejakulácia	ejakulaːt͡sia
ela	ɛɫa
elektrina	ɛlɛktrina
električka	ɛlɛktrit͡ʃka
elektromagnetický	ɛlɛktrɔmaɡnɛtit͡skiː
elena	ɛlɛna
eleonóra	ɛlɛɔnɔːra
eliška	ɛliʃka
elvíra	ɛlviːra
em	ɛm
ema	ɛma
emanuel	ɛmanuɛɫ
embólia	ɛmbɔːlia
embólie	ɛmbɔːliɛ
emil	ɛmiɫ
emília	ɛmiːlia
encyklopédia	ɛnt͡siklɔpɛːdia
epikuros	ɛpikurɔs
epir	ɛpir
erb	ɛrb
erbium	ɛrbium
erik	ɛrik
erika	ɛrika
ernest	ɛrnɛst
erno	ɛrnɔ
ervín	ɛrviːn
esbjerg	ɛzbjɛr
esbjerg	ɛzbjɛrk
esej	ɛsɛj
ester	ɛstɛr
estera	ɛstɛra
estónsko	ɛstɔːnskɔ
estónčina	ɛstɔːnt͡ʃina
eta	ɛta
etela	ɛtɛɫa
etymológia	ɛtimɔɫɔːɡia
eufrat	ɛu̯frat
eugen	ɛu̯ɡɛn
eugénia	ɛu̯ɡɛːnia
euro	ɛu̯rɔ
európa	ɛu̯rɔːpa
európe	ɛu̯rɔːpɛ
európium	ɛu̯rɔːpium
európou	ɛu̯rɔːpɔu̯
európsky	ɛu̯rɔːpski
európu	ɛu̯rɔːpu
európy	ɛu̯rɔːpi
eutanázia	ɛu̯tanaːzia
eva	ɛva
evanjelium	ɛvaɲi̯ɛlium
exodus	ɛksɔdus
extáza	ɛkstaːza
extáze	ɛkstaːzɛ
ezdráš	ɛzdraːʃ
ešte	ɛʃcɛ
faerský	faɛrskiː
faerčan	faɛrt͡ʃan
faerčanka	faɛrt͡ʃaŋka
faerčina	faɛrt͡ʃina
fagot	faɡɔt
fajka	fajka
fajočka	fajɔt͡ʃka
fajčenie	fajt͡ʃɛɲi̯ɛ
fajčiar	fajt͡ʃi̯ar
fakt	fakt
faktami	faktami
fakte	fakce
faktoch	faktox
faktom	faktom
faktov	faktou̯
faktu	faktu
fakty	fakti
fakľa	fakʎa
faraón	faraoːn
farba	farba
farbu	farbu
farmakológia	farmakɔlɔːɡia
fazuľa	fazuʎa
fašistický	faʃistit͡skiː
fašizmus	faʃizmus
február	fɛbruaːr
fedor	fɛdɔr
fenícia	feniːt͡sia
ferdinand	fɛrdinand
fermium	fɛrmium
fero	fɛrɔ
feudalizmus	fɛu̯dalizmus
fidži	fid͡ʒi
figa	fiɡa
figovník	fiɡɔu̯ɲiːk
filip	filip
film	fiɫm
filoména	filɔmɛːna
filozofia	filɔzɔfia
finančný	finant͡ʃniː
finále	finaːlɛ
fjord	fjɔrd
flauta	fɫau̯ta
flerovium	flɛrɔvium
fliačik	fʎi̯at͡ʃik
florida	florida
florián	fɫɔriaːn
fluór	fluɔːr
fonéma	fɔnɛːma
fosfor	fɔsfɔr
fotogenický	fɔtɔɡɛnit͡skiː
fotograf	fɔtɔɡraf
fotografia	fɔtɔɡrafia
fotografiami	fɔtɔɡrafiami
fotografista	fɔtɔɡrafista
fotografií	fɔtɔɡrafiiː
foxtrot	fɔkstrɔt
foyer	fɔajɛː
francium	frant͡sium
francúzština	frant͡suːsʃcina
františek	franciʃɛk
františka	francɪʃka
frederik	frɛdɛrik
fridrich	fridrix
fruštik	fruʃcik
fruštik	fruʃtik
fujara	fujara
fujarôčka	fujaru̯ɔt͡ʃka
futbal	fudbaɫ
fyzik	fizik
fyzika	fizika
fyzikálni	fizikaːɫni
fyzikálny	fizikaːlni
fám	faːm
félix	fɛːliks
fén	fɛːn
fí	fiː
fín	fiːn
fínsko	fiːnskɔ
fínsky	fiːnski
fínčina	fiːnt͡ʃina
föhn	føn
fön	føn
fúkať	fuːkac
fľaša	fʎaʃa
gaba	ɡaba
gabriel	ɡabriɛɫ
gabriela	ɡabriɛɫa
gadolínium	ɡadɔliːnium
gajdy	ɡajdi
galaktický	ɡaɫaktit͡skiː
galaxiami	ɡalaksiami
galaxie	ɡalaksie
galaxiou	ɡalaksiou̯
galaxiu	ɡalaksiu
galaxiách	ɡalaksiaːx
galaxiám	ɡalaksiaːm
galaxií	ɡalaksiiː
galina	ɡalina
garbiar	ɡarbi̯ar
garáž	ɡaraːʃ
gaskonsko	ɡaskɔnskɔ
gauč	ɡau̯t͡ʃ
gazda	ɡazda
gazdinka	ɡazɟiŋka
gazdiná	ɡazɟinaː
gašpar	ɡaʃpar
gdansk	ɡdansk
gdynia	ɡdiɲa
gejza	ɡɛjza
genovéva	ɡɛnɔvɛːva
geológia	ɡɛɔlɔːɡia
georgína	ɡɛɔrɡiːna
germánium	ɡɛrmaːnium
gertrúda	ɡɛrtruːda
gibon	ɡibɔn
gizela	ɡizɛɫa
glóbus	ɡɫɔːbus
golier	ɡɔʎi̯ɛr
gombík	ɡɔmbiːk
graz	ɡrat͡s
gregor	ɡrɛɡɔr
grinda	ɡrinda
grinde	ɡrinɟɛ
groznyj	ɡrɔzni
grécky	ɡrɛːtski
grék	ɡrɛːk
grékyňa	ɡrɛːkiɲa
gréčtina	ɡrɛːt͡ʃcina
grínd	ɡriːnt
grónsko	ɡrɔːnskɔ
gunár	ɡunaːr
guru	ɡuru
gustáv	ɡustaːu̯
guľa	ɡuʎa
guľôčka	ɡuʎu̯ɔt͡ʃka
győr	ɟøːr
győr	ɟɛːr
győrsky	ɟeːrski
győrsky	ɟøːrski
gálium	ɡaːlium
gól	ɡoːɫ
gýč	ɡiːt͡ʃ
had	ɦat
hadž	ɦat͡ʃ
hafnium	ɦafnium
hajzel	ɦajzɛɫ
hala	ɦaɫa
halier	ɦaʎi̯ɛr
hana	ɦana
handra	ɦandra
hanoj	ɦanɔj
harfa	ɦarfa
harmanček	ɦarmant͡ʃɛk
haruspex	ɦaruspeks
hassium	ɦasium
havaj	ɦavaj
havran	ɦavran
hašiš	ɦaʃiʃ
hebrejčina	ɦɛbrɛjt͡ʃina
heda	ɦɛda
hedviga	ɦɛdviɡa
hej	ɦɛj
helena	ɦɛlɛna
helga	ɦɛɫɡa
heliometer	ɦɛliɔmɛtɛr
helsinki	ɦɛɫsiŋki
hematológia	ɦɛmatɔlɔːɡɪja
hemendex	ɦɛmɛndɛks
henrich	ɦɛnrix
henrieta	ɦɛnri̯ɛta
hentam	ɦɛntam
henten	ɦɛntɛn
herakles	ɦɛraklɛs
heraldika	ɦɛraɫdika
herec	ɦɛrɛt͡s
herečka	ɦɛrɛt͡ʃka
herkules	ɦɛrkulɛs
hermína	ɦɛrmiːna
heterosexualita	ɦɛtɛrɔsɛksualita
hier	ɦi̯er
hierarchia	ɦi̯ɛrarxia
hilda	ɦiɫda
historický	ɦistɔrit͡skiː
hlad	ɦɫat
hlahol	ɦɫaɦɔɫ
hlaholika	ɦɫaɦɔlit͡sa
hlas	ɦɫas
hlava	ɦɫava
hlavní	ɦɫavniː
hlavný	ɦɫavniː
hlboký	ɦɫ̩bɔkiː
hlina	ɦlina
hliník	ɦliɲiːk
hloh	ɦɫɔx
hmla	ɦmɫa
hmotnosť	ɦmɔtnɔsc
hnačka	ɦnat͡ʃka
hnedý	ɦɲɛdiː
hnida	ɦɲida
hniezdo	ɦɲi̯ɛzdɔ
hnilý	ɦɲiliː
hnoj	ɦnɔj
hnutie	ɦnuci̯ɛ
hnutí	ɦnuciː
hoci	ɦɔt͡si
hod	ɦɔt
hodina	ɦɔɟina
hodža	hɔd͡ʒa
hodža	ɦɔd͡ʒa
hodžová	hɔd͡ʒɔvaː
hojdačka	ɦɔjdat͡ʃka
holandsko	ɦɔɫandskɔ
holandsky	ɦɔɫandski
holandský	ɦɔɫandskiː
holandčina	ɦɔɫandt͡ʃina
holmium	ɦɔɫmium
holub	ɦɔɫup
holubí	ɦɔɫubiː
holí	ɦɔliː
holí	ɦɔʎiː
holúbä	ɦɔɫuːbæ
holúbä	ɦɔɫuːbɛ
holý	ɦɔɫiː
homosexualita	ɦɔmɔsɛksualita
homár	homaːr
horký	ɦɔrkiː
hortenzia	ɦɔrtɛnzia
horúci	ɦɔruːt͡si
horúčava	ɦɔruːt͡ʃava
horčica	ɦɔrt͡ʃit͡sa
horčík	ɦɔrt͡ʃiːk
horší	ɦɔrʃiː
hosť	ɦɔsc
hovno	ɦɔvnɔ
hovoriť	ɦɔvɔric
hovädina	ɦɔvæɟina
hovädina	ɦɔvɛɟina
hovädo	ɦɔvædɔ
hovädo	ɦɔvɛdɔ
hovädzie	ɦɔvæd͡zi̯ɛ
hovädzie	ɦɔvɛd͡zi̯ɛ
hovädzí	ɦɔvæd͡ziː
hovädzí	ɦɔvɛd͡ziː
hoľa	ɦoʎa
hra	ɦra
hrab	ɦrap
hrach	ɦrax
hrad	ɦrat
hradba	ɦradba
hranica	ɦraɲit͡sa
hranice	ɦraɲit͡sɛ
hrať	ɦrac
hrdina	ɦr̩ɟina
hrdinami	ɦr̩ɟinami
hrdinka	ɦr̩ɟiŋka
hrdinoch	ɦr̩ɟinɔx
hrdinom	ɦr̩ɟinɔm
hrdinov	ɦr̩ɟinɔu̯
hrdinovi	ɦr̩ɟinɔvi
hrdinovia	ɦr̩ɟinɔvi̯a
hrdinu	ɦr̩ɟinu
hrdlo	ɦr̩dɫɔ
hrdzavý	ɦr̩d͡zaviː
hrdý	ɦr̩diː
hrianka	ɦr̩i̯aŋka
hriech	ɦri̯ex
hriva	ɦriva
hrivna	ɦrivna
hrob	ɦrɔp
hroch	ɦrɔx
hrozienko	ɦrɔzi̯ɛŋkɔ
hrozný	ɦrɔzniː
hrudní	ɦrudniː
hruď	ɦruc
hruška	ɦruʃka
hrôza	ɦru̯ɔza
hrýzť	ɦriːsc
hubert	ɦubɛrt
hudba	ɦudba
hugo	ɦuɡɔ
hurka	ɦurka
hus	ɦus
husi	ɦusi
husle	ɦuslɛ
hustý	ɦustiː
husí	ɦusiː
hviezda	ɦvi̯ɛzda
hybný	ɦibniː
hydina	ɦiɟina
hypnos	ɦipnɔs
hystéria	ɦistɛːria
hákelling	hɔɑt͡ʃʰɛtlɪŋk
hélium	ɦɛːlium
hôrka	ɦu̯ɔrka
hôľ	ɦu̯oʎ
hĺbkomer	ɦɫ̩ːpkɔmɛr
hŕstka	ɦr̩ːstka
iba	iba
ich	ix
ida	ida
idea	idɛa
ideológia	idɛɔɫɔːɡia
idiot	idiɔt
ignác	iɡnaːt͡s
igor	iɡɔr
ihla	iɦɫa
ihličnan	iɦɫit͡ʃnan
ihrisko	iɦriskɔ
ikra	ikra
imidž	imit͡ʃ
imrich	imrix
indium	indium
infantka	infantka
informovať	infɔrmɔvac
informácia	infɔrmaːt͡sia
inga	iŋɡa
ingrida	iŋɡrida
iný	iniː
inštrumentál	inʃtrumɛntaːɫ
irak	irak
iračanka	irat͡ʃaŋka
irena	irɛna
irma	irma
irán	iraːn
iránsky	iraːnski
irídium	iriːdium
iskerník	iskɛrɲiːk
iskierka	iski̯ɛrka
iskra	iskra
iskrička	iskrit͡ʃka
islam	isɫam
island	islant
islande	isɫanɟɛ
islandský	isɫandskiː
islandčina	islandt͡ʃina
istý	istiː
ivan	ivan
ivana	ivana
ivica	ivit͡sa
ivona	ivɔn
iza	iza
izabela	izabɛɫa
izba	izba
izidor	izidɔr
izis	izis
izo	izɔ
izák	izaːk
iľja	iʎja
ja	ja
jablko	jabɫ̩ko
jablkový	jabɫ̩kɔviː
jablkách	jabɫ̩kaːx
jablčný	jabɫ̩t͡ʃniː
jabĺk	jabɫ̩ːk
jabĺčko	jabɫ̩ːt͡ʃko
jabĺčok	jabɫ̩ːt͡ʃok
jachta	jaxta
jadro	jadrɔ
jahoda	jaɦɔda
jahodami	jaɦɔdami
jahňa	jaɦɲa
jak	jak
jakub	jakup
jamôčka	jamu̯ɔt͡ʃka
jana	jana
janko	jaŋkɔ
jano	janɔ
janov	janɔu̯
jantár	jantaːr
jantárový	jantaːrɔviː
január	januaːr
japončina	japɔnt͡ʃina
jar	jar
jarabica	jarabit͡sa
jarmila	jarmiɫa
jarmo	jarmɔ
jarmulka	jarmuɫka
jaro	jarɔ
jarok	jarok
jarolím	jarɔliːm
jaromír	jarɔmiːr
jaroslav	jarɔsɫau̯
jaroslava	jarɔsɫava
jaseň	jasɛɲ
jaskyňa	jaskiɲa
jastrab	jastrap
jaternica	jacɛrɲit͡sa
javor	javor
jazda	jazda
jazdec	jazɟɛt͡s
jazera	jazɛra
jazero	jazɛrɔ
jazerá	jazɛraː
jazier	jazi̯er
jazierko	jazi̯ɛrkɔ
jazvec	jazvɛt͡s
jazyk	jazik
jazykovedec	jazikɔvɛɟɛt͡s
jazyky	jaziki
jazýček	jaziːt͡ʃɛk
jačmeň	jat͡ʃmɛɲ
jačí	jat͡ʃiː
jašterica	jaʃcɛrit͡sa
jašterička	jaʃcɛrit͡ʃka
jebačka	jɛbat͡ʃka
jebať	jɛbac
jed	jɛt
jedenásť	jɛdɛnaːsc
jediný	jeɟɪniː
jedlo	jɛdɫɔ
jedna	jedna
jednako	jeːdnako
jednej	jednej
jedno	jedno
jednoduchý	jɛdnɔduxiː
jednom	jednom
jednorožec	jɛdnɔrɔʒɛt͡s
jednou	jednou̯
jednu	jednu
jedny	jedni
jedného	jedneːɦo
jednému	jedneːmu
jedných	jedniːx
jedným	jedniːm
jednými	jedniːmi
jedový	jɛdɔviː
jeho	jɛɦɔ
jej	jɛj
jela	jɛɫa
jeleň	jɛlɛɲ
jelša	jɛɫʃa
jen	jɛn
jeremiáš	jɛrɛmiaːʃ
jerguš	jɛrɡuʃ
jeruzalem	jɛruzalɛm
jesenný	jɛsɛnniː
jeseter	jɛsɛcɛr
jeseň	jɛsɛɲ
jesienka	jɛsi̯ɛŋka
jestvovať	jɛstvɔvac
jesť	jɛsc
ježiš	jɛʒiʃ
jidiš	jidiʃ
joga	jɔɡa
jogurt	jɔɡurt
jogurtu	jɔɡurtu
jolana	jɔɫana
jozef	jɔzɛf
jozefína	jɔzɛfiːna
jozue	jɔzuɛ
jožo	jɔʒɔ
jrd	jɛːɛrdɛː
judaizmus	judaizmus
judita	judita
juh	jux
juliana	juliana
juliána	juliaːna
julo	juɫɔ
juno	junɔ
junák	junaːk
jupiter	jupiter
juraj	juraj
juro	jurɔ
justa	justa
justína	justiːna
južný	juʒniː
ján	jaːn
jánov	jaːnɔu̯
jób	jɔːp
jód	joːt
júl	juːɫ
júlia	juːlia
július	juːlius
jún	juːn
jüan	jian
jüan	jyan
kaderník	kaɟɛrɲiːk
kaderníčka	kaɟɛrɲiːt͡ʃka
kadmium	kadmium
kajak	kajak
kakao	kakaɔ
kalamár	kaɫamaːr
kaleráb	kaleraːp
kalifornium	kalifɔrnium
kalypso	kalipsɔ
kambodža	kambɔd͡ʒa
kameň	kamɛɲ
kamil	kamiɫ
kamila	kamiɫa
kanada	kanada
kandidóza	kandidɔːza
kanton	kantɔn
kapilára	kapiɫaːra
kapitalistický	kapitalisciskiː
kapitalizmus	kapitalizmus
kapsula	kapsula
kapusta	kapusta
kapverdy	kapvɛrdi
karina	karina
karol	karɔɫ
karolína	karɔliːna
karpaty	karpati
karta	karta
karí	kariː
kasíno	kasiːnɔ
kat	kat
kata	kata
katapult	katapult
katapultami	katapuɫtami
katapulte	katapuɫcɛ
katapultoch	katapuɫtɔx
katapultom	katapuɫtɔm
katapultov	katapuɫtɔu̯
katapultu	katapuɫtu
katapulty	katapuɫti
katarína	katariːna
katedrála	katedraːɫa
katovice	katovit͡se
kaviareň	kavi̯arɛɲ
kaviarnička	kavi̯arɲit͡ʃka
kazachstan	kazaxstan
kazateľ	kazacɛʎ
kazimír	kazimiːr
kača	kat͡ʃa
kaša	kaʃa
kaše	kaʃɛ
kašeľ	kaʃɛʎ
kašlať	kaʃɫac
kaštieľ	kaʃci̯ɛʎ
kašľať	kaʃlac
kde	ɡɟɛ
kel	kɛɫ
ker	kɛr
kečup	kɛt͡ʃup
keď	kɛc
keďže	kɛd͡ʒɛ
keňa	kɛɲa
kila	kiɫa
kile	kilɛ
kilo	kiɫɔ
kilogram	kiɫɔɡram
kipa	kipa
klamať	kɫamac
klamstvo	kɫamstvɔ
klamár	kɫamaːr
klas	kɫas
klaudia	kɫau̯dia
klement	klɛmɛnt
klenoty	klɛnɔti
klietka	kʎi̯ɛtka
klinec	kʎiɲɛt͡s
klišé	kliʃɛː
klobása	kɫɔbaːsa
klobúk	klɔbuːk
klobúčik	kɫɔbuːt͡ʃik
klus	kɫus
kluž	kluʃ
klára	kɫaːra
klárka	kɫaːrka
klávesnica	kɫavɛsɲit͡sa
kmene	kmɛɲɛ
kmeni	kmɛɲi
kmeň	kmɛɲ
kmeňa	kmɛɲa
kmeňmi	kmɛɲmi
kmeňoch	kmɛɲɔx
kmeňom	kmɛɲɔm
kmeňov	kmɛɲɔu̯
kmeňu	kmɛɲu
kmotor	kmɔtɔr
kmotra	kmɔtra
knieža	kɲi̯ɛʒa
kniha	kɲiɦa
knižnica	kɲɪʒɲɪt͡sa
knižočka	kɲiʒɔt͡ʃka
knižôčka	kɲiʒu̯ɔt͡ʃka
kníhkupec	kɲiːxkupɛt͡s
kníhkupectvo	kɲiːxkupɛt͡stvɔ
kobalt	kɔbaɫt
koberec	kɔbɛrɛt͡s
kobier	kɔbi̯ɛr
kobra	kɔbra
kobrami	kɔbrami
kobru	kɔbru
kobry	kɔbri
kobrách	kɔbraːx
kobyla	kɔbiɫa
kobza	kɔbza
kocka	kɔt͡ska
kocôčka	kɔt͡su̯ɔt͡ʃka
kocúr	kot͡suːr
kohút	kɔɦuːt
kohútik	kɔɦuːcik
kokot	kɔkɔt
kolega	kɔlɛɡa
kolegyňa	kɔlɛɡiɲa
koleno	kɔlɛnɔ
koliba	kɔliba
kolibrík	kɔlibriːk
koloman	kɔɫɔman
koláč	koɫaːt͡ʃ
koláčový	kɔɫaːt͡ʃɔviː
komunistický	kɔmuniscit͡skiː
komunizmus	kɔmunizmus
konfirmácia	kɔnfirmaːt͡sia
kongres	kɔŋɡrɛs
koniec	kɔɲi̯ɛt͡s
konár	kɔnaːr
končiť	kɔnt͡ʃic
konštantín	kɔnʃtantiːn
kopa	kɔpa
kopernikium	kɔpɛrnikium
kopija	kɔpija
kopije	kɔpijɛ
korene	kɔrɛɲɛ
koreni	kɔrɛɲi
koreň	kɔrɛɲ
koreňa	kɔrɛɲa
koreňmi	kɔrɛɲmi
koreňoch	kɔrɛɲɔx
koreňom	kɔrɛɲɔm
koreňov	kɔrɛɲɔu̯
koreňu	kɔrɛɲu
kornel	kɔrnɛɫ
kornélia	kɔrnɛːlia
koruna	koruna
korytnačka	kɔritnat͡ʃka
korčule	kɔrt͡ʃulɛ
korčuľovať	kɔrt͡ʃuʎɔvac
kosa	kɔsa
kostol	kɔstɔɫ
kostra	kɔstra
kostrová	kɔstrɔvaː
kosť	kɔsc
kotol	kɔtɔɫ
kov	kɔu̯
kovu	kɔvu
kováč	kɔvaːt͡ʃ
kováčová	kɔvaːt͡ʃɔvaː
koza	kɔza
kozmológia	kɔzmɔɫɔːɡia
kozí	koziː
koč	kɔt͡ʃ
kočiš	kɔt͡ʃiʃ
kočišová	kɔt͡ʃiʃɔvaː
koľaj	kɔʎaj
koľko	kɔʎkɔ
košeľa	kɔʃɛʎa
koža	kɔʒa
kožuch	kɔʒux
kožušina	kɔʒuʃina
kožušník	kɔʒuʃɲiːk
kožušníčka	kɔʒuʃɲit͡ʃka
kraj	kraj
kraje	kraje
kraji	kraji
krajina	krajina
krajinami	krajinami
krajine	krajiɲe
krajinou	krajinou̯
krajinu	krajinu
krajiny	krajini
krajinách	krajinaːx
krajinám	krajinaːm
krajmi	krajmi
krajoch	krajox
krajom	krajom
krajov	krajou̯
kraju	kraju
krajín	krajiːn
krajčír	krajt͡ʃiːr
krakov	krakou̯
krava	krava
kravata	kravata
kremeň	krɛmɛɲ
kremácia	krɛmaːt͡sia
kremík	krɛmiːk
kreslo	krɛsɫɔ
kreveta	krɛvɛta
krhla	kr̩ɦla
kristadelfián	kristadɛɫfiaːn
kristián	kristiaːn
kristo	kristɔ
kristína	kristiːna
krištof	kriʃtɔf
krk	kr̩k
krm	kr̩m
krokodíl	krɔkɔdiːɫ
krone	krɔnɛ
krvavnica	kr̩vau̯ɲit͡sa
krvi	kr̩vi
krvou	kr̩vɔu̯
kryptón	kriptɔːn
králica	kralit͡sa
králice	kraːlit͡sɛ
králik	kraːʎik
krása	kraːsa
krásne	kraːsnɛ
krásne	kraːsɲɛ
krásny	kraːsni
krátky	kraːtki
kráčať	kraːt͡ʃac
kráľ	kraːʎ
kráľovstvo	kraːʎɔvstvɔ
kráľová	kraːʎɔvaː
krídlo	kriːdɫɔ
krívať	kriːvac
kríz	kriːs
kríza	kriːza
kríž	kriːʃ
króna	kroːna
krôčik	kru̯ɔt͡ʃik
krúžok	kruːʒɔk
kto	kto̞
kuba	kuba
kubo	kubɔ
kubánec	kubaːɲɛt͡s
kuchyňa	kuxiɲa
kukulienka	kukuli̯ɛŋka
kukurica	kukurit͡sa
kukučka	kukut͡ʃka
kuli	kuli
kulturistika	kuɫturistika
kuna	kuna
kunda	kunda
kupec	kupɛt͡s
kupola	kupɔɫa
kupovať	kupɔvac
kura	kura
kurence	kurɛnt͡sɛ
kurva	kurva
kurča	kurt͡ʃa
kus	kus
kučeravý	kut͡ʃɛraviː
kvapeľ	kvapɛʎ
kvapka	kvapka
kvapôčka	kvapu̯ɔt͡ʃka
kvark	kvark
kvas	kvas
kvasnice	kvasɲit͡sɛ
kvet	kvɛt
kvetoslava	kvɛtɔsɫava
kvisling	kvisliŋɡ
kyjev	kijɛu̯
kyselina	kisɛlina
kysličník	kislit͡ʃɲiːk
kyslík	kisliːk
kábel	kaːbɛɫ
káhira	kaːɦira
káva	kaːva
kíl	kiːɫ
kórea	kɔːrɛa
kórejčina	kɔːrɛjt͡ʃina
kôpor	ku̯ɔpɔr
kôra	ku̯ora
kôrka	ku̯orka
kôrovec	ku̯ɔrɔvɛt͡s
kôstka	ku̯ɔstka
kôstkovina	ku̯ɔstkɔvina
kôstkoviny	ku̯ɔstkɔvini
kôš	ku̯oʃ
kúpeľ	kuːpɛʎ
kúpiť	kuːpic
kúty	kuːti
kýl	kiːɫ
kým	kiːm
kľuka	kʎuka
kľúč	kʎuːt͡ʃ
kľúčik	kʎuːt͡ʃik
kňaz	kɲas
kŕdeľ	kr̩ːɟɛʎ
labe	ɫabɛ
labutí	ɫabuciː
labuť	ɫabuc
laco	ɫat͡so
ladislav	ɫaɟisɫau̯
ladislava	ɫaɟisɫava
lakeť	ɫakɛc
lama	ɫama
lamí	ɫamiː
landgróf	ɫandɡrɔːf
lano	ɫanɔ
lantán	ɫantaːn
lastovička	ɫastɔvit͡ʃka
lastúrnik	ɫastuːrɲik
lastúrničiar	ɫastuːrɲit͡ʃi̯ar
latrína	ɫatriːna
laura	ɫau̯ra
lawrencium	ɫau̯rɛnt͡sium
lea	lɛa
lebo	lɛbɔ
lechický	lɛxit͡skiː
lei	lɛi
lekorica	lɛkɔrit͡sa
lekár	lekaːr
lenka	lɛŋka
lenže	lɛnʒɛ
leo	lɛɔ
leonard	lɛɔnard
leopold	lɛɔpɔld
leou	lɛɔu̯
lepší	lɛpʃiː
les	lɛs
lesana	lɛsana
lesbický	lɛzbit͡skiː
lesbička	lɛzbit͡ʃka
lesť	lɛsc
letieť	lɛci̯ɛc
letisko	lɛciskɔ
letište	lɛciʃcɛ
letný	lɛtniː
leto	lɛtɔ
leu	lɛu
leu	lɛu̯
lev	lɛu̯
levitikus	lɛvitikus
levoslav	lɛvɔsɫau̯
lexikálny	lɛksikaːlni
ley	lɛi
lečo	lɛt͡ʃɔ
liana	liana
libuša	libuʃa
lichtenštajnsko	lixtɛnʃtajnskɔ
lienka	li̯ɛŋka
lietadlo	li̯ɛtadɫɔ
lietať	li̯ɛtac
lievik	li̯ɛvik
lift	lift
ligotať	liɡɔtac
ligurček	liɡurt͡ʃɛk
liknavý	liknaviː
linda	linda
lipsko	lipskɔ
list	list
lista	lista
listami	listami
liste	liscɛ
listoch	listɔx
listom	listɔm
listov	listɔu̯
listu	listu
litava	litava
liter	litɛr
literatúra	literatuːra
litovčina	litɔu̯t͡ʃina
litva	litva
liva	liva
livermorium	livɛrmɔrium
lišiacky	liʃi̯at͡ski
lodž	ɫɔd͡ʒ
logik	ɫɔɡik
logika	ɫɔɡika
lokomotíva	ɫɔkɔmɔtiːva
londýn	ɫɔndiːn
lopata	ɫɔpata
lopta	ɫɔpta
losos	ɫɔsɔs
lotyšsko	ɫɔtiʃskɔ
lotyština	ɫɔtiʃcina
loviť	ɫɔvic
loď	ɫɔc
lož	lɔʃ
lucia	ɫut͡sia
lujza	ɫujza
luk	ɫuk
lukostrelec	ɫukɔstrɛlɛt͡s
lukáš	ɫukaːʃ
luna	luna
lutécium	ɫutɛːt͡sium
luxembursko	ɫuksɛmburskɔ
lužica	ɫuʒit͡sa
lyža	liʒa
láma	ɫaːma
lángoš	ɫaːŋɡɔʃ
láska	ɫaːska
láva	ɫaːva
léno	lɛːnɔ
líce	liːt͡sɛ
líder	liːder
lídra	liːdra
lídrami	liːdrami
lídri	liːdri
lídroch	liːdrɔx
lídrom	liːdrɔm
lídrov	liːdrɔu̯
lídrovi	liːdrɔvi
lítium	liːtium
lívia	liːvia
líška	liːʃka
líštička	liʃcit͡ʃka
lóve	ɫɔːvɛ
lúka	ɫuːka
lúč	ɫuːt͡ʃ
lýdia	liːdia
lýra	liːra
lýtko	liːtkɔ
macedónsko	mat͡sɛdɔːnskɔ
mach	max
machiavelizmus	makiavɛlizmus
machiavellizmus	makiavɛlizmus
machuľa	maxuʎa
magdaléna	maɡdalɛːna
magnetický	maɡnɛtit͡skiː
majonéza	majɔnɛːza
mak	mak
malachiáš	maɫaxiaːʃ
malajec	maɫajɛt͡s
malajčina	maɫajt͡ʃina
maliar	mali̯ar
malina	malina
malinový	malinɔviː
malta	maɫta
maltčina	maɫtt͡ʃina
malvér	maɫvɛːr
malvína	maɫviːna
malý	maliː
mama	mama
manažment	manaʒmɛnt
mandarínka	mandariːŋka
mandarínkovník	mandariːŋkɔvɲiːk
mangán	maŋɡaːn
mantinel	mantinɛɫ
mapa	mapa
marcel	mart͡sɛɫ
marcela	mart͡sɛɫa
marec	marɛt͡s
marek	marɛk
margaréta	marɡare̞ːta
margarétka	marɡareːtka
margita	marɡita
marhuľa	marɦuʎa
marianna	mariana
marián	mariaːn
maroko	marɔkɔ
maroš	marɔʃ
marta	marta
martina	martina
marína	mariːna
maslo	masɫɔ
masť	masc
mat	mat
matej	matɛj
matematik	matɛmatik
matematika	matɛmatika
matematička	matɛmatit͡ʃka
mater	macɛr
materinský	macɛrinskiː
materský	macɛrskiː
matica	macit͡sa
matilda	matiɫda
matka	matka
matkin	matkin
matúš	matuːʃ
maximilián	maksimiliaːn
mačka	mat͡ʃka
maďar	maɟar
maďarka	maɟarka
maďarsko	maɟarskɔ
maďarčina	maɟart͡ʃina
maňuška	maɲuʃka
mašina	maʃina
mať	mac
maťo	matɔ
mech	mɛx
med	mɛt
medard	mɛdard
medovina	mɛdɔvina
medvedica	mɛdvɛɟit͡sa
medvedice	mɛdvɛɟit͡sɛ
medveď	mɛdvɛc
medzi	mɛd͡zi
medzinárodný	mɛd͡zinaːrɔdniː
meitnerium	mai̯tnɛrium
melánia	mɛɫaːnia
melódia	mɛɫɔːdia
mena	mɛna
mendelevium	mɛndɛlɛvium
mene	mɛɲɛ
menej	meɲej
meniny	mɛɲini
meno	mɛnɔ
menu	mɛnu
meny	mɛni
menší	mɛnʃiː
meranie	mɛraɲi̯ɛ
merkúr	mɛrkuːr
mesiac	mɛsi̯at͡s
mesiačik	mɛsi̯at͡ʃik
mestečko	mɛscɛt͡ʃkɔ
mesto	me̞sto̞
metajazyk	mɛtajazik
metamorfóza	mɛtamɔrfɔːza
meteorológia	mɛtɛɔrɔlɔːɡia
metla	mɛtɫa
metro	mɛtrɔ
mexický	mɛksit͡skiː
mezopotámia	mɛzɔpɔtaːmia
meč	mɛt͡ʃ
meď	mɛc
mešita	mɛʃita
mias	mi̯as
miazga	mi̯azɡa
michal	mixaɫ
micheáš	mixɛaːʃ
mien	mi̯ɛn
mier	mi̯ɛr
miest	mi̯est
miesto	mi̯ɛstɔ
miezd	mi̯est
mikrobus	mikrɔbus
mikroskop	mikrɔskɔp
mikuláš	mikuɫaːʃ
milada	miɫada
milan	miɫan
milena	milɛna
milica	milit͡sa
miloslav	miɫɔsɫau̯
miloslava	miɫɔsɫava
milota	miɫɔta
milovať	miɫɔvac
miloš	miɫɔʃ
milý	miliː
minca	mint͡sa
mineralógia	minɛraɫɔːɡia
minsk	minsk
minúta	minuːta
miriam	miriam
miriama	miriama
miro	mirɔ
miroslav	mirɔsɫau̯
miroslava	mirɔsɫava
mitra	mitra
miškovec	miʃkɔvɛt͡s
mištička	miʃcit͡ʃka
mladá	mɫadaː
mladý	mɫadiː
mledzivo	mlɛd͡zivɔ
mlieko	mli̯ɛkɔ
mliečko	mli̯ɛt͡ʃkɔ
mliečny	mli̯ɛt͡ʃni
mlyn	mlin
mládež	mɫaːɟɛʃ
mláďa	mɫaːɟa
mláďatko	mɫaːɟatkɔ
mnoho	mnɔɦɔ
množina	mnɔʒina
mních	mɲiːx
mníchov	mɲiːxɔu̯
modlivka	mɔdliu̯ka
modrý	mɔdriː
moja	mɔja
mojmír	mɔjmiːr
mojžíš	mɔjʒiːʃ
molybdén	mɔlibdɛːn
monarcha	mɔnarxa
monarchia	mɔnarxia
monika	mɔnika
monoteistický	mɔnɔtɛistit͡skiː
monoteizmus	mɔnɔtɛizmus
mops	mɔps
morava	mɔrava
morave	mɔravɛ
moravský	mɔrau̯skiː
more	mɔrɛ
morfeus	mɔrfɛus
moriak	mɔri̯ak
morka	mɔrka
morča	mɔrt͡ʃa
moskva	mɔskva
mostík	mo̞sciːk
motorka	mɔtɔrka
motýlí	mɔtiːʎiː
motýľ	mɔtiːʎ
mozog	mɔzɔk
moľ	mɔʎ
možno	mɔʒnɔ
možnosť	mɔʒnɔsc
mrav	mrau̯
mravec	mravɛt͡s
mrkva	mr̩kva
mrlí	mr̩liː
mráz	mraːs
mráčik	mraːt͡ʃik
mucha	muxa
muche	muxɛ
muchotrávka	muxɔtraːu̯ka
mudrc	mudr̩t͡s
murár	muraːr
musieť	musi̯ɛc
muška	muʃka
muži	mʊʒɪ
mužský	muʃskiː
my	mi
mydlo	midɫɔ
myslieť	misli̯ɛc
myš	miʃ
myšiu	miʃi̯u
myšlienka	miʃli̯ɛŋka
myší	miʃiː
mzda	mzda
máj	maːj
mária	maːria
mário	maːriɔ
márnica	maːrɲit͡sa
márnomyseľný	maːrnɔmisɛʎniː
mäkký	mekiː
mäkký	mækiː
mäkkýš	mækiːʃ
mäkkýš	mɛkiːʃ
mäkčeň	mækt͡ʃeɲ
mäsiar	mæsi̯ar
mäsiar	mɛsi̯ar
mät	mæt
mät	mɛt
mäta	mæta
mäta	mɛta
mäte	mæcɛ
mäte	mɛcɛ
móda	mɔːda
módny	mɔːdni
móric	mɔːrit͡s
môcť	mu̯ɔt͡sc
môj	mu̯ɔj
múch	muːx
múdrosť	muːdrɔsc
múdry	muːdri
múr	muːr
múzeum	muːzɛum
mýto	miːtɔ
mĺzť	mɫ̩ːsc
mŕtvola	mr̩ːtvɔɫa
mŕtvy	mr̩ːtvɪ
na	na
nacionalista	nat͡siɔnalista
nacionalistický	nat͡siɔnalistit͡skiː
nacionalistka	nat͡siɔnalistka
nacionalizmus	nat͡siɔnalizmus
nacista	nat͡sista
nacistický	nat͡sistit͡skiː
nactiutŕhač	nat͡sciutr̩ːɦat͡ʃ
nadlak	nadɫak
nadšený	natʃeniː
nahou	naɦɔu̯
nahum	naɦum
nahí	naɦiː
nahý	naɦiː
najlepší	najlɛpʃiː
najmenej	najmeɲej
najmenší	najmɛnʃiː
najmä	najmæ
najmä	najmɛ
najnižší	najɲiʃʃiː
najstarší	najstarʃiː
najužší	najuʃʃiː
najviac	najvjat͡s
najvyšší	najviʃʃiː
najväčší	najvɛt͡ʃʃiː
nakoľko	nakɔʎkɔ
naozaj	naɔzaj
napokon	napokon
napríklad	napriːkɫat
napätie	napæci̯ɛ
napätie	napɛci̯ɛ
naraňajkovať	naraɲajkɔvac
narkoman	narkɔman
narkomanka	narkɔmaŋka
narodeniny	narɔɟɛɲini
nataša	nataʃa
natália	nataːlia
nauru	nauru
nazdar	nazdar
načervenkasto	nat͡ʃɛrvɛŋkastɔ
naďalej	naɟalɛj
nebo	ɲɛbɔ
nebohý	ɲɛbɔɦiː
necht	ɲɛxt
nedele	ɲɛɟɛʎɛ
nedeľa	ɲeɟelʲa
negližé	nɛɡliʒɛː
nehemiáš	ɲɛɦɛmiaːʃ
nehnuteľnosť	ɲɛɦnucɛʎnɔsc
nemec	ɲɛmɛt͡s
nemecko	ɲɛmɛt͡skɔ
nemecky	ɲɛmɛt͡ski
nemecký	ɲɛmɛt͡skiː
nemka	ɲɛmka
nemý	ɲɛmiː
nemčina	ɲɛmt͡ʃina
neodým	nɛɔdiːm
nepriateľ	ɲɛpri̯acɛʎ
neptúnium	nɛptuːnium
nepárnokopytník	ɲɛpaːrnɔkɔpitɲiːk
nepárny	ɲɛpaːrni
nero	nɛrɔ
nerozumiem	ɲɛrɔzumi̯ɛm
neskôr	ɲɛsku̯ɔr
nesčíselný	ɲɛst͡ʃiːsɛlniː
netopier	ɲɛtɔpi̯ɛr
neuróza	nɛu̯rɔːza
nevädza	ɲɛvæd͡za
nevädza	ɲɛvɛd͡za
nezmysel	ɲɛzmisɛɫ
nezábudka	ɲɛzaːbutka
neón	nɛɔːn
nečujný	ɲɛt͡ʃujniː
niekoľko	ɲi̯ɛkɔʎkɔ
niekto	ɲi̯ɛktɔ
nielen	ɲi̯ɛlɛn
niesť	ɲi̯ɛsc
nijaký	ɲijakiː
nika	nika
nikel	nikɛɫ
nikola	nikɔɫa
nikto	ɲiktɔ
nina	ɲina
nitra	ɲitra
niób	niɔːp
nič	ɲit͡ʃ
nižší	ɲiʃʃiː
nobelium	nɔbɛlium
noc	nɔt͡s
noe	nɔɛ
noha	nɔɦa
nohavica	nɔɦavit͡sa
nohavice	nɔɦavit͡sɛ
nominatív	nɔminatiːu̯
nora	nɔra
norbert	nɔrbɛrt
nosiť	nɔsic
novak	nɔvak
november	nɔvɛmbɛr
noviny	nɔvini
novák	nɔvaːk
nováčik	nɔvaːt͡ʃik
nové	nɔvɛː
nový	nɔviː
nočný	nɔt͡ʃniː
nádcha	naːtxa
nádherný	naːdɦɛrniː
nádražia	naːdraʒi̯a
nádražiach	naːdraʒi̯ax
nádražiam	naːdraʒi̯am
nádražiami	naːdraʒi̯ami
nádražie	naːdraʒi̯ɛ
nádražiu	naːdraʒi̯u
nádraží	naːdraʒiː
nádražím	naːdraʒiːm
nájsť	naːjsc
námesačníctvo	naːmɛsat͡ʃɲiːt͡svɔ
námestie	naːmɛsci̯ɛ
námestíčko	naːmɛsciːt͡ʃkɔ
náreky	naːrɛki
nárečie	naːrɛt͡ʃi̯ɛ
národ	naːrɔt
národný	naːrɔdniː
nás	naːs
náter	naːcɛr
návrh	naːvr̩x
návrhy	naːvr̩ɦi
názov	naːzɔu̯
níreďháza	ɲiːrɛɟɦaːza
nízky	ɲiːski
nížina	ɲiːʒina
nór	nɔːr
nórsko	nɔːrskɔ
nórsky	nɔːrski
nórčina	nɔːrt͡ʃina
nôh	nu̯ox
nôž	nu̯oʃ
nôžka	nu̯ɔʃka
obdobie	ɔbdɔbi̯ɛ
obdĺžnik	ɔbdɫ̩ːʒɲik
obed	ɔbɛt
oblasť	ɔbɫasc
oblečenie	ɔblɛt͡ʃɛɲi̯ɛ
oblička	ɔblit͡ʃka
oblok	ɔbɫɔk
obláčik	ɔbɫaːt͡ʃik
obor	ɔbɔr
obraz	ɔbras
obrus	ɔbrus
obtiažny	ɔbci̯aʒni
obyvateľ	ɔbivacɛʎ
občiansky	ɔpt͡ʃi̯anski
obťažný	ɔpcaʒniː
oco	ɔt͡sɔ
od	ɔd
odborníčka	ɔdbɔrɲiːt͡ʃka
odhodlaný	odɦodlaniː
odo	ɔdɔ
odpoludnie	ɔtpɔɫudɲi̯ɛ
oheň	ɔɦɛɲ
ohovárať	ɔɦɔvaːrac
ohúriť	ɔɦuːric
ohňostroj	ɔɦɲɔstrɔj
oje	ɔjɛ
okabátiť	ɔkabaːcic
okna	ɔkna
okno	ɔknɔ
okná	ɔknaː
oko	ɔkɔ
okrem	ɔkrɛm
október	ɔktɔːbɛr
okuliare	ɔkuʎi̯arɛ
okuliarnik	ɔkuʎi̯arɲik
oldrich	ɔɫdrix
oleg	ɔlɛk
oligarchia	ɔliɡarxia
oliva	oliva
olivami	ɔlivami
olive	ɔlivɛ
oliver	ɔlivɛr
olivou	ɔlivɔu̯
olivu	ɔlivu
olivy	ɔlivi
olivách	ɔlivaːx
olivám	ɔlivaːm
olomouc	ɔɫɔmɔu̯t͡s
olomoucký	olomou̯t͡skiː
olovo	ɔɫɔvɔ
olovrant	ɔɫɔvrant
oltár	oɫtaːr
olympia	ɔlimpia
olympiáda	ɔlimpiaːda
olív	ɔliːu̯
olívia	ɔliːvia
on	ɔn
ona	ɔna
ondrej	ɔndrɛj
oni	ɔɲi
ontogenéza	ɔntɔɡɛnɛːza
ony	ɔni
opica	ɔpit͡sa
opilec	ɔpilɛt͡s
opitý	ɔpitiː
opustiť	ɔpuscic
opát	ɔpaːt
opúšťať	ɔpuːʃcac
orgazmu	ɔrɡazmu
orgazmus	ɔrɡazmus
orgován	orɡovaːn
orlej	ɔrʎɛj
orlí	ɔrliː
ornitológia	ɔrnitɔɫɔːɡia
orol	ɔrɔɫ
os	ɔs
osa	ɔsa
osem	ɔsɛm
osemnásť	ɔsɛmnaːsc
oskár	ɔskaːr
osla	ɔsɫa
oslo	ɔsɫɔ
oslobodiť	ɔsɫɔbɔɟic
osmium	ɔsmium
osoba	ɔsɔba
osoby	ɔsɔbi
osol	ɔsɔɫ
ostriež	ɔstri̯ɛʃ
ostrihom	ɔstriɦɔm
ostrov	ostrou̯
osôb	ɔsu̯op
osľa	ɔsʎa
otcov	ɔtt͡sɔu̯
otcovský	ɔtt͡sɔu̯skiː
otec	ɔcɛt͡s
otecko	ɔcɛt͡skɔ
oto	ɔtɔ
otrok	ɔtrɔk
otráviť	ɔtraːvic
otázka	ɔtaːska
otázny	ɔtaːzni
otázočka	ɔtaːzɔt͡ʃka
otília	ɔtiːlia
ovca	ɔu̯t͡sa
ovocie	ɔvɔt͡si̯ɛ
ovčí	ɔu̯t͡ʃiː
ozajstný	ɔzajstniː
ozeáš	ɔzɛaːʃ
očko	ɔt͡ʃkɔ
oľga	ɔʎɡa
ožran	ɔʒran
palacinka	palatsiŋka
palác	paɫaːt͡s
paládium	paɫaːdium
pamäť	pamæc
pamäť	pamɛc
pandeizmus	pandɛizmus
pane	paɲɛ
panenský	paɲɛnskiː
pani	paɲi
panic	paɲit͡s
pankrác	paŋkraːt͡s
panna	panna
panpsychizmus	panpsixizmus
panteizmus	panteizmus
pančucha	pant͡ʃuxa
papraď	paprac
paprika	paprika
paradajka	paradajka
paris	paris
parochňa	parɔxɲa
parole	parɔɫ
partizán	partizaːn
paríž	pariːʃ
pastier	pasci̯ɛr
pat	pat
patrik	patrik
patriť	patric
patrícia	patriːt͡sia
paulína	pau̯liːna
pavol	pavɔɫ
pavúk	pavuːk
pavúčí	pavuːt͡ʃiː
pazucha	pazuxa
paľo	paʎɔ
pažerák	paʒɛraːk
pec	pɛt͡s
pedagogika	pɛdaɡɔɡika
pederastia	pɛdɛrastia
peha	pɛɦa
pehe	pɛɦɛ
peklo	pɛkɫɔ
pekný	pɛkniː
pekáreň	pɛkaːrɛɲ
pena	pɛna
peniaze	pɛɲi̯azɛ
perinka	pɛriŋka
perla	pɛrɫa
persefona	pɛrsɛfɔna
perspektíva	pɛrspɛktiːva
perzia	pɛrzia
peržan	pɛrʒan
pes	pɛs
pestrý	pɛstriː
peter	pɛtɛr
petra	pɛtra
petronela	pɛtrɔnɛɫa
pečeň	pɛtʃɛɲ
pečiatka	pɛt͡ʃi̯atka
peň	pɛɲ
pešiak	pɛʃi̯ak
peťo	pɛcɔ
piano	pianɔ
piatok	pi̯atok
piaty	pi̯ati
piepor	pi̯ɛpɔr
pieseň	pi̯eseɲ
pieskovisko	pi̯ɛskɔviskɔ
pieskoviská	pi̯ɛskɔviskaː
piesok	pi̯ɛsɔk
piešťany	pi̯ɛʃcani
pijan	pijan
pilier	pili̯ɛr
pipka	pipka
pipík	pipiːk
pitjantjatjara	picancacara
pivnica	pivɲit͡sa
pivo	pivo
pivá	pivaː
pizda	pizda
piť	pic
plamenček	pɫamɛnt͡ʃɛk
plameň	pɫamɛɲ
plamienok	pɫami̯ɛnɔk
planéta	pɫanɛːta
plat	pɫat
platina	pɫatina
platiť	pɫacic
plece	plet͡se
plece	pʎet͡se
plecniak	plɛt͡sɲi̯ak
plný	pl̩niː
plukovník	pɫukɔvɲiːk
plutónium	pɫutɔːnium
plzeň	pɫ̩zɛɲ
plávať	pɫaːvac
pláž	plaːʃ
pneumatika	pnɛumatika
pochodovať	pɔxɔdɔvac
pod	pɔt
podmet	pɔdmɛt
podmienka	pɔdmi̯ɛŋka
podnikateľ	pɔdɲikacɛʎ
podpazušie	pɔtpazuʃi̯ɛ
podprsenka	pɔtpr̩sɛŋka
podpňovka	pɔtpɲɔu̯ka
podujatie	pɔdujaci̯ɛ
podľa	pɔdʎa
pohlavie	pɔɦɫavi̯ɛ
pohár	pɔɦaːr
pohľad	pɔɦʎat
pokoj	pɔkɔj
pokračovať	pɔkrat͡ʃɔvac
pokrievka	pɔkri̯ɛu̯ka
pokým	pɔkiːm
polabčina	pɔɫapt͡ʃina
policajt	pɔlit͡sajt
police	pɔlit͡sɛ
polievka	pɔli̯ɛu̯ka
polievočka	pɔli̯ɛvɔt͡ʃka
politik	pɔlitik
politika	pɔlitika
poloostrov	pɔɫɔɔstrɔu̯
polostrov	pɔɫɔstrɔu̯
polícia	pɔliːt͡sia
polónium	pɔɫɔːnium
pomalý	pɔmaliː
pomaranč	pɔmarant͡ʃ
pomoc	pɔmɔt͡s
pomorník	pɔmɔrɲiːk
pomôcť	pɔmu̯ɔt͡sc
pondelok	pɔnɟɛɫɔk
ponorka	pɔnɔrka
pontifex	po̞ntife̞ks
ponuka	pɔnuka
ponáhľať	pɔnaːɦʎac
pop	pop
popol	pɔpɔɫ
popoludnie	pɔpɔɫudɲi̯ɛ
pornografia	pɔrnɔɡrafia
pornografický	pɔrnɔɡrafit͡skiː
portugalsko	pɔrtuɡaɫskɔ
portugalčina	pɔrtuɡaɫt͡ʃina
posledný	pɔslɛdniː
posteľ	pɔscɛʎ
potok	pɔtɔk
potravina	pɔtravina
potrebný	pɔtrɛbniː
potrebovať	pɔtrɛbɔvac
potôčik	pɔtu̯ɔt͡ʃik
používateľ	pɔuʒiːvacɛʎ
povaha	pɔvaɦa
povedať	pɔvɛdac
povraz	pɔvras
pozdĺž	pɔzdɫ̩ːʃ
poznaň	pɔznaɲ
poznať	pɔznac
počas	pɔt͡ʃas
počasie	pɔt͡ʃasi̯ɛ
počet	pɔt͡ʃɛt
počty	pɔt͡ʃti
počuť	pɔt͡ʃuc
počúvať	pɔt͡ʃuːvac
poľnohospodárstvo	pɔʎnɔɦɔspɔdaːrstvɔ
poľsko	pɔʎskɔ
poľština	pɔʎʃcina
pošta	poʃta
požiar	pɔʒi̯ar
požičať	pɔʒit͡ʃac
pracháč	praxaːt͡ʃ
praha	praɦa
prajazyk	prajazik
prasa	prasa
pravda	prau̯da
pravdami	pravdami
pravde	prau̯ɟɛ
pravdou	pravdou̯
pravdu	pravdu
pravdy	pravdi
pravdách	pravdaːx
pravdám	pravdaːm
pravoslav	pravɔsɫau̯
pravý	praviː
prazeodým	prazɛɔdiːm
pražan	praʒan
pražský	praʃskiː
prdieť	pr̩ɟi̯ɛc
predať	prɛdac
predkožka	prɛtkɔʃka
predložka	prɛdɫɔʃka
predmestie	prɛdmɛsci̯ɛ
predsa	prɛtsa
predseda	prɛtsɛda
premiéra	prɛmiɛːra
premávka	prɛmaːu̯ka
prepáčiť	prɛpaːt͡ʃic
pretekať	prɛcɛkac
preteky	prɛcɛki
pretekár	prɛcɛkaːr
pretože	prɛtɔʒɛ
preukaz	preukaz
preukázať	prɛukaːzac
prezident	prɛzidɛnt
prezývka	prɛziːu̯ka
preč	prɛt͡ʃ
prečo	pretʃo
prešov	prɛʃɔu̯
prešporok	prɛʃpɔrɔk
prežúvavec	prɛʒuːvavɛt͡s
priateľ	pri̯acɛʎ
priateľka	pri̯acɛʎka
priehlavok	pri̯ɛɦɫavɔk
priestor	pri̯ɛstɔr
priezvisko	pri̯ɛzviskɔ
priečinok	pri̯ɛt͡ʃinɔk
primusieť	primusi̯ɛc
princ	print͡s
princezná	print͡sɛznaː
prinútiť	prinuːcic
program	prɔɡram
prokop	prɔkɔp
prométium	prɔmɛːtium
prostredie	prɔstrɛɟi̯ɛ
protaktínium	prɔtaktiːnium
protirečiť	prɔcirɛt͡ʃic
protivný	prɔcivniː
protojazyk	prɔtɔjazik
prozódia	prɔzɔːdia
prsia	pr̩si̯a
prsník	pr̩sɲiːk
prsteň	pr̩scɛɲ
prvosienka	pr̩vɔsi̯ɛŋka
prvočíslo	pr̩vɔt͡ʃiːsɫɔ
prvý	pr̩viː
práca	praːt͡sa
právd	praːvd
práve	praːvɛ
prázdniny	praːzdɲini
prázdny	praːzdni
príchod	priːxɔt
príklad	priːkɫat
prímerie	priːmɛri̯ɛ
prípad	priːpat
príroda	priːrɔda
príslovia	priːsɫɔvi̯a
príslovie	priːsɫɔvi̯ɛ
príslovka	priːsɫɔu̯ka
prísudok	priːsudɔk
prísť	priːsc
próza	pro̞ːza
pršať	pr̩ʃac
psica	psit͡sa
psiemu	psi̯ɛmu
psychológia	psixɔɫɔːɡia
psí	psiː
puma	puma
puška	puʃka
pytón	pitɔːn
pyžamo	piʒamɔ
pálenka	paːlɛŋka
páliť	paːlic
pán	paːn
pápež	paːpɛʃ
párnokopytník	paːrnɔkɔpitɲiːk
párny	paːrni
pásavka	paːsau̯ka
pásomnica	paːsɔmɲit͡sa
páv	paːu̯
páví	paːviː
päsť	pæsc
päsť	pɛsc
päta	pæta
päta	pɛta
pätica	pæcit͡sa
pätica	pɛcit͡sa
pätnásť	pætnaːsc
pätnásť	pɛtnaːsc
päť	pæc
päť	pɛc
písať	piːsac
písmeno	piːsmɛnɔ
píšťalôčka	piːʃcaɫu̯ɔt͡ʃka
pôvod	pu̯ɔvɔt
pôžička	pu̯ɔʒit͡ʃka
púpava	puːpava
púšť	puːʃc
pýcha	piːxa
pľuť	pʎuc
pľúca	pʎuːt͡sa
pŕhľavka	pr̩ːɦʎau̯ka
pšenica	pʃɛɲit͡sa
pšenice	pʃɛɲit͡sɛ
pštros	pʃtrɔs
pštrosí	pʃtrɔsiː
rabín	rabiːn
rad	rat
radoslav	radɔsɫau̯
radovan	radɔvan
radón	radɔːn
radúz	raduːs
rajčina	rajt͡ʃina
rak	rak
rakúsko	rakuːskɔ
rakúsky	rakuːski
rameno	ramɛnɔ
rasca	rast͡sa
rastislav	rascisɫau̯
rastlina	rastlina
rasťo	rascɔ
raz	ras
raňajkovať	raɲajkɔvac
raňajky	raɲajki
raž	raʃ
rebro	rɛbrɔ
regína	rɛɡiːna
renáta	rɛnaːta
rené	rɛnɛː
republika	rɛpublika
revue	rɛvy
rezance	rɛzant͡sɛ
reč	rɛt͡ʃ
reštaurácia	rɛʃtau̯raːt͡sia
riad	ri̯at
riaditeľ	ri̯aɟicɛʎ
riadiť	ri̯aɟic
richard	rixart
riedky	ri̯ɛtki
rieka	ri̯ɛka
riečka	ri̯ɛt͡ʃka
rimanom	rimanɔm
ringlota	riŋɡɫɔta
riti	rici
rití	riciː
riziko	rizikɔ
riť	ric
robota	rɔbɔta
robotník	rɔbɔtɲiːk
rodina	rɔɟina
rodinný	rɔɟinniː
roentgenium	rœnɡɛnium
roentgenium	rɛnɡɛnium
roh	rɔx
roj	rɔj
rok	rɔk
rokov	rɔkɔu̯
roland	rɔɫant
roman	rɔman
rovnaký	rɔvnakiː
rozdeliť	rɔzɟɛlic
rozhodnutie	rɔzɦɔdnuci̯ɛ
rozhodnúť	rɔzɦɔdnuːc
rozmarín	rɔzmariːn
rozmaznaný	rɔzmaznaniː
rozmaznať	rɔzmaznac
rozsobáš	rɔssɔbaːʃ
roztomilý	rɔstɔmiliː
rozum	rɔzum
rozumieť	rɔzumi̯ɛc
rozumný	rɔzumniː
rozália	rɔzaːlia
roční	rɔt͡ʃniː
ročný	rɔt͡ʃniː
roľa	rɔʎa
rožok	rɔʒɔk
rubídium	rubiːdium
ruda	ruda
rudo	rudɔ
rudolf	rudɔɫf
ruka	ruka
ruksak	ruksak
rumanček	rumant͡ʃɛk
rumunsko	rumunskɔ
rumunčina	rumunt͡ʃina
runa	runa
rus	rus
ruska	ruska
rusko	ruskɔ
ruský	ruskiː
rutherfordium	radzɛfɔrdium
ruténium	rutɛːnium
ručička	rut͡ʃit͡ʃka
rušeň	ruʃɛɲ
ruština	ruʃcina
ruža	ruʒa
ružena	ruʒɛna
ryba	riba
rybár	ribaːr
rybí	ribiː
rys	ris
rysy	risi
rytier	rici̯ɛr
ryšavec	riʃavɛt͡s
ryšiak	riʃi̯ak
ryža	riʒa
ráb	raːp
rád	raːd
rádium	raːdium
rátať	raːtac
ráz	raːs
rénium	rɛːnium
ríbezľa	riːbɛzʎa
rím	riːm
rímsky	riːmski
róbert	rɔːbɛrt
ródium	rɔːdium
róm	rɔːm
rómka	rɔːmka
röntgen	rœntɡɛn
röntgen	rɛntɡɛn
röntgenovať	rœntɡɛnɔvac
röntgenovať	rɛntɡɛnɔvac
rúno	ruːnɔ
rút	ruːt
rúčka	ruːt͡ʃka
rúž	ruːʃ
rýchlosť	riːxlɔsc
rýchly	riːxli
s	s
sa	sa
sabína	sabiːna
sad	sad
sakristia	sakristia
samoa	samɔa
samodruhý	samɔdruɦiː
samovražda	samɔvraʒda
samuel	samuɛɫ
samuraj	samuraj
samurajka	samurajka
samárium	samaːrium
sardínia	sardiːnia
saša	saʃa
sať	sac
schod	sxɔt
schody	sxɔdi
schopnosť	sxɔpnɔsc
schopný	sxɔpniː
schudnúť	sxudnuːc
schéma	sxɛːma
scípio	st͡siːpiɔ
seaborgium	siːbɔrɡium
seba	sɛba
sebe	sɛbɛ
sebec	sɛbɛt͡s
sedem	sɛɟɛm
sedemnásť	sɛɟɛmnaːsc
segedín	sɛɡɛdiːn
segment	seɡment
sekera	sɛkɛra
sekunda	sɛkunda
sekúnd	sɛkuːnt
selén	sɛlɛːn
semeno	sɛmɛnɔ
sen	sɛn
sendvič	sɛndvit͡ʃ
seno	sɛnɔ
sepsa	sɛpsa
september	sɛptɛmbɛr
sergej	sɛrɡɛj
servus	sɛrvus
servác	sɛrvaːt͡s
sestra	sɛstra
sestrin	sɛstrin
sestrička	sɛstrit͡ʃka
severín	sɛvɛriːn
sex	sɛks
sexu	sɛksu
shetland	ʃɛtlɛnt
shetlandský	ʃɛtlɛndskiː
shetlandy	ʃɛtlɛndi
siaha	si̯aɦa
sidónia	sidɔːnia
siedmy	si̯ɛdmi
silvia	siɫvia
simona	simɔna
sirôtka	siru̯ɔtka
sirôtočka	siru̯ɔtɔt͡ʃka
situácia	situaːt͡sia
skala	skaɫa
skald	skaɫt
sklo	skɫɔ
skorocel	skɔrɔt͡sɛɫ
skratka	skratka
skrutka	skrutka
skrutkovač	skrutkɔvat͡ʃ
skrutkovať	skrutkɔvac
skuhroš	skuɦrɔʃ
skupáň	skupaːɲ
slabý	sɫabiː
sladký	sɫatkiː
slanina	sɫaɲina
slavomír	sɫavɔmiːr
slavomíra	sɫavɔmiːra
slavónsko	sɫavɔːnskɔ
slepý	slɛpiː
sliepka	sli̯ɛpka
sliepočka	sli̯ɛpɔt͡ʃka
sliezsko	sli̯ɛsskɔ
slimák	slimaːk
slivka	sliu̯ka
slivovica	slɪvovɪtsa
slnce	sɫ̩nt͡sɛ
slnečný	sɫ̩ɲɛt͡ʃniː
slniečko	sɫ̩ɲi̯ɛt͡ʃkɔ
slnko	sɫ̩ŋkɔ
sloboda	sɫɔbɔda
sloj	sɫɔj
slon	sɫɔn
slonica	slɔnit͡sa
sloní	sɫɔɲiː
slovan	sɫɔvan
slovanský	sɫɔvanskiː
slovenka	sɫɔvɛŋka
slovensky	sɫɔvɛnski
slovenskí	sɫɔvɛnskiː
slovenský	sɫɔvɛnskiː
slovenčina	sɫɔvɛnt͡ʃina
sloveso	sɫɔvɛsɔ
slovinec	sɫɔviɲɛt͡s
slovinka	sɫɔviŋka
slovinsko	sɫɔvinskɔ
slovinský	sɫɔvinskiː
slovinčina	sɫɔvint͡ʃina
slovník	sloʋɲiːk
slovníka	sɫoʋɲiːka
slovníkmi	sɫoʋɲiːkmi
slovníkoch	sɫoʋɲiːkox
slovníkom	sɫoʋɲiːkom
slovníkov	sɫoʋɲiːkou̯
slovníku	sɫoʋɲiːku
slovníky	sɫoʋɲiːki
slovo	sɫɔvɔ
slováci	sɫɔvaːt͡si
slovák	sɫɔvaːk
sluch	sɫux
sluha	sɫuɦa
slzička	sɫ̩zit͡ʃka
sláva	sɫaːva
slávka	sɫaːu̯ka
sláčik	sɫaːt͡ʃik
smetiar	smɛci̯ar
smiech	smi̯ɛx
smotana	smɔtana
smrekovec	smrɛkɔvɛt͡s
smrti	smr̩ci
smrtonosný	smr̩tɔnɔsniː
smutný	smutniː
smäd	smæt
smäd	smɛt
smädiť	smæɟic
smädiť	smɛɟic
smädný	smedniː
smädný	smædniː
snežiť	sɲɛʒic
snob	snɔp
snáď	snaːc
so	sɔ
sobota	sɔbɔta
sobáš	sɔbaːʃ
socha	sɔxa
socialistický	sɔt͡sialistit͡skiː
socializmus	sɔt͡sializmus
sociálny	sɔt͡siaːɫni
sodík	sɔɟiːk
sofoniáš	sɔfɔniaːʃ
softvér	sɔftvɛːr
sojka	sɔjka
sokol	so̞ko̞l
sokrates	sɔkratɛs
som	sɔm
somarina	sɔmarina
somár	sɔmaːr
sopka	sɔpka
sova	sɔva
sovietsky	sɔvi̯ɛtski
soľ	sɔʎ
soňa	sɔɲa
spajvér	spajvɛːr
spať	spac
spln	spɫ̩n
spojka	spɔjka
spoločnosť	spɔɫɔt͡ʃnɔsc
spraviť	spravic
sprcha	spr̩xa
správa	spraːva
správať	spraːvac
spyware	spajvɛːr
spálňa	spaːɫɲa
spôsob	spu̯ɔsɔp
spŕška	spr̩ːʃka
srať	srac
srbsko	sr̩pskɔ
srbský	sr̩pskiː
srdca	sr̩t͡sa
srdcia	sr̩t͡si̯a
srdciach	sr̩t͡si̯ax
srdciam	sr̩t͡si̯am
srdciami	sr̩t͡si̯ami
srdcom	sr̩t͡sɔm
srdcu	sr̩t͡su
srdiečko	sr̩ɟi̯ɛt͡ʃkɔ
srna	sr̩na
srvátka	sr̩vaːtka
stalaktit	staɫaktit
stan	stan
stanislav	staɲisɫau̯
stanislava	staɲisɫava
starec	starɛt͡s
starena	starɛna
starká	starkaː
starký	starkiː
starogréčtina	starɔɡrɛːt͡ʃcina
starostlivosť	starɔstlivɔsc
starý	stariː
starček	start͡ʃɛk
starší	starʃiː
ste	scɛ
stehlík	scɛɦʎiːk
stela	stɛɫa
stena	scɛna
sto	stɔ
stolička	stɔlit͡ʃka
storočie	storot͡ʃi̯e
strach	strax
strachmi	straxmi
strachoch	straxox
strachom	straxom
strachov	straxou̯
strachu	straxu
strachy	straxi
straka	straka
strana	strana
strategický	stratɛɡit͡skiː
strecha	strɛxa
streda	streda
stredník	strɛdɲiːk
strela	strɛɫa
strelec	strɛlɛt͡s
stretnutie	strɛtnuci̯ɛ
stretnúť	strɛtnuːc
striebro	stri̯ɛbrɔ
striga	striɡa
strmý	str̩miː
stroj	strɔj
stroja	strɔja
stroje	strɔjɛ
stroji	strɔji
strojmi	strɔjmi
strojoch	strɔjɔx
strojom	strɔjɔm
strojov	strɔjɔu̯
stroju	strɔju
strom	strɔm
stromami	strɔmami
strome	strɔmɛ
stromoch	strɔmɔx
stromom	strɔmɔm
stromov	strɔmɔu̯
stromu	strɔmu
stromy	strɔmi
stroncium	strɔnt͡sium
struk	struk
strukovina	strukɔvina
strukoviny	strukɔvini
struna	struna
stryná	strinaː
strážiť	straːʒic
strúčik	struːt͡ʃik
strýc	striːt͡s
stupidita	stupɪdɪta
stále	staːlɛ
stáť	staːc
stôl	stu̯ɔɫ
suchý	suxiː
sudca	sutt͡sa
sudetský	sʊdɛtskiː
sudety	sudɛti
sujet	suʒɛt
sujet	syʒɛ
sujet	syʒɛt
suka	suka
sukienka	suki̯ɛŋka
sukne	sukɲɛ
sukničkár	sukɲit͡ʃkaːr
sukňa	sukɲa
sup	sup
sušič	suʃit͡ʃ
sušička	suʃit͡ʃka
svadobný	svadɔbniː
svahilčina	svaɦiɫt͡ʃina
svastika	svastika
svastiku	svastiku
svedomie	svɛdɔmi̯e
svedomí	svɛdɔmiː
svet	svɛt
sveta	svɛta
svete	svɛcɛ
svetlana	svɛtɫana
svetlo	svɛtɫɔ
svetmi	svɛtmi
svetoch	svɛtɔx
svetom	svɛtɔm
svetov	svɛtɔu̯
svetový	svɛtɔviː
svetozár	svɛtɔzaːr
svetu	svɛtu
svety	svɛti
sveťo	svɛcɔ
svieca	svi̯ɛt͡sa
sviečka	svi̯ɛt͡ʃka
sviečkach	svi̯ɛt͡ʃkax
sviečkam	svi̯ɛt͡ʃkam
sviečkami	svi̯ɛt͡ʃkami
sviečke	svi̯ɛt͡ʃkɛ
sviečkou	svi̯ɛt͡ʃkɔu̯
sviečku	svi̯ɛt͡ʃku
sviečky	svi̯ɛt͡ʃki
sviečok	svi̯ɛt͡ʃɔk
sviečočka	svi̯ɛt͡ʃɔt͡ʃka
svoj	svɔj
svokor	svɔkɔr
svokra	svɔkra
svätopluk	svætɔpɫuk
svätopluk	svɛtɔpɫuk
svätyňa	svɛtiɲa
svätý	svetiː
svätý	svætiː
synergia	sinɛrɡia
synovia	sinovi̯a
syntax	sintaks
syntaxe	sintaksɛ
syntéza	sintɛːza
synáčik	sinaːt͡ʃik
synček	sint͡ʃɛk
syr	sir
sága	saːɡa
sára	saːra
sídlo	siːdɫɔ
síra	siːra
sôch	su̯ox
sôvä	su̯ɔvæ
sôvä	su̯ɔvɛ
súd	suːt
súdruh	suːdrux
súkromný	suːkrɔmniː
súlož	suːɫɔʃ
súostrovie	suːɔstrɔvi̯ɛ
súper	suːpɛr
súrne	suːrnɛ
súrne	suːrɲɛ
súrny	suːrni
sústava	suːstava
súčasný	suːt͡ʃasniː
súťaž	suːcaʃ
sýkorka	siːkɔrka
sýria	siːria
sýrsky	siːrski
sŕňa	sr̩ːɲa
tabak	tabak
tabu	tabu
tadžik	tad͡ʒik
tadžikistan	tad͡ʒikistan
takmer	takmɛr
taký	takiː
takýto	takiːtɔ
taliansko	tali̯anskɔ
taliansky	tali̯anski
taliančina	tali̯ant͡ʃina
tam	tam
tamara	tamara
tamhľa	tamɦʎa
tanec	taɲet͡s
tango	taŋɡɔ
tangá	taŋɡaː
tanier	taɲi̯ɛr
tanierik	taɲi̯ɛrik
tantal	tantaɫ
tapeta	tapɛta
tatiana	tati̯ana
tatry	tatri
technológia	tɛxnɔɫɔːɡia
technécium	tɛxnɛːt͡sium
tehla	cɛɦɫa
tehlička	cɛɦʎit͡ʃka
teizmus	tɛizmus
tekvica	cɛkvit͡sa
tela	cɛɫa
telami	cɛɫami
tele	cɛlɛ
telefón	tɛlɛfɔːn
teleskop	tɛlɛskɔp
telo	cɛɫɔ
telom	cɛɫɔm
telu	cɛɫu
telá	cɛɫaː
telách	cɛɫaːx
telám	cɛɫaːm
telíčko	cɛʎiːt͡ʃkɔ
telúr	tɛɫuːr
temešvár	tɛmɛʃvaːr
temnota	cɛmnɔta
temný	cɛmniː
ten	tɛn
tenký	cɛŋkiː
teodor	tɛɔdɔr
teológia	tɛɔɫɔːɡia
tepať	cɛpac
teplý	cɛpliː
teraz	tɛras
terbium	tɛrbium
terminológia	tɛrminɔɫɔːɡia
terst	tɛrst
terézia	tɛrɛːzia
testosterón	tɛstɔstɛrɔːn
tesť	cɛsc
teta	cɛta
teľa	cɛʎa
tiahnuť	ci̯aɦnuc
tibetčina	tibɛtt͡ʃina
tibor	cibɔr
tichomír	cixɔmiːr
tiel	ci̯ɛɫ
tieň	ci̯ɛɲ
tiež	ci̯ɛʃ
tigris	tiɡris
tigriňa	tiɡriɲa
timotej	timɔtɛj
tisa	cisa
tisíc	cisiːt͡s
tisíci	cisiːt͡si
titán	titaːn
tkáč	tkaːt͡ʃ
tkáčka	tkaːt͡ʃka
tlač	tɫat͡ʃ
tlačiť	tɫat͡ʃic
tlačovka	tɫat͡ʃɔu̯ka
tlmač	tɫ̩mat͡ʃ
tlmočník	tɫ̩mɔt͡ʃɲiːk
tlstý	tɫ̩stiː
tma	tma
tmavý	tmaviː
tobôž	tɔbu̯ɔʃ
toho	tɔɦɔ
tok	tɔk
tokio	tɔkiɔ
tokoferol	tɔkɔfɛrɔɫ
tomáš	tɔmaːʃ
topánka	tɔpaːŋka
topánky	tɔpaːŋki
topánočka	tɔpaːnɔt͡ʃka
totalitarizmus	tɔtalitarizmus
tovar	tɔvar
toxický	toksit͡skiː
traktor	traktɔr
treba	trɛba
tretí	trɛciː
trhu	tr̩ɦu
tri	tri
tridsať	trit͡sac
triesočka	tri̯ɛsɔt͡ʃka
triezvy	tri̯ɛzvi
trinásť	trinaːsc
trolejbus	trɔlɛjbus
trona	trɔna
tráva	traːva
tráviaci	traːvi̯at͡si
trávička	traːvit͡ʃka
tuk	tuk
tuleň	tulɛɲ
tupý	tupiː
tur	tur
turecko	turɛt͡skɔ
turek	turɛk
turista	turista
turistika	turistika
turizmus	turizmus
turkyňa	turkiɲa
turnaj	turnaj
tučniak	tut͡ʃɲi̯ak
tužka	tuʃka
tvaroh	tvarɔx
tvoj	tvɔj
tvrdza	tvr̩d͡za
tvár	tvaːr
ty	ti
tábor	taːbɔr
tágo	taːɡɔ
tálium	taːlium
téma	te̞ːma
tórium	tɔːrium
túlium	tuːlium
týždeň	tiːʒɟɛɲ
tŕnie	tr̩ːɲi̯ɛ
ubehlík	ubɦɛliːk
ucho	uxɔ
udrieť	udri̯ɛc
ufňukaný	ufɲukaniː
uhlie	uhʎi̯ɛ
uhličitý	uɦʎit͡ʃitiː
uhlík	uɦʎiːk
uhol	uɦɔɫ
uhorka	uɦɔrka
ujec	ujɛt͡s
ujo	ujɔ
ujček	ujt͡ʃɛk
ukrajina	ukrajina
ukrajinský	ukrajinskiː
ukrajinčina	ukrajint͡ʃina
ulica	uɫit͡sa
ulica	uʎit͡sa
ulicami	uɫit͡sami
ulicami	uʎit͡sami
ulice	uɫit͡se
ulice	uʎit͡se
ulici	uɫit͡si
ulici	uʎit͡si
uliciach	uɫit͡si̯ax
uliciach	uʎit͡si̯ax
uliciam	uɫit͡si̯am
uliciam	uʎit͡si̯am
ulicou	uɫit͡sɔw
ulicou	uʎit͡sɔw
ulicu	uɫit͡su
ulicu	uʎit͡su
ulíc	uɫiːt͡s
ulíc	uʎiːt͡s
um	um
umenie	umɛɲi̯ɛ
umrieť	umri̯ɛc
univerzita	univɛrzita
univerzitný	univɛrzitniː
upratať	upratac
upír	upiːr
urban	urban
urgentný	urɡɛntniː
urobiť	urɔbic
urtikárie	urtikaːriɛ
uruguaj	uruɡvaj
urán	uraːn
určite	urt͡ʃicɛ
uršuľa	urʃuʎa
utečenec	ucɛt͡ʃɛɲɛt͡s
utešený	ucɛʃɛniː
utorok	utɔrɔk
uzbek	uzbek
uzbekistan	uzbɛkistan
uško	uʃkɔ
ušnica	uʃɲit͡sa
užitočnosť	uʒitɔt͡ʃnɔsc
užitočný	uʒitɔt͡ʃniː
užovka	uʒɔu̯ka
užívateľ	uʒiːvacɛʎ
užší	uʃiː
vagína	vaɡiːna
vajce	vajt͡sɛ
valach	vaɫax
valaška	vaɫaʃka
valašsko	vaɫaʃskɔ
valašský	vaɫaʃskiː
valentín	valɛntiːn
valentína	valɛntiːna
valkýra	vaɫkiːra
valér	valɛːr
valéria	valɛːria
valčík	vaɫt͡ʃiːk
vanda	vanda
vankúš	vaŋkuːʃ
vanuatu	vanuatu
vanád	ʋanaːt
varšava	ʋarʃaʋa
vasil	vasiɫ
vavrinec	vavriɲɛt͡s
vaňa	vaɲa
vaše	ʋaʃe
vdov	vdɔu̯
vdovami	vdɔvami
vdove	vdɔvɛ
vdovou	vdɔvɔu̯
vdovu	vdɔvu
vdovy	vdɔvi
vdovách	vdɔvaːx
vdovám	vdɔvaːm
vec	vɛt͡s
vedec	vɛɟɛt͡s
vedieť	vɛɟi̯ɛc
vedro	vɛdrɔ
vedľa	vɛdʎa
veko	vɛkɔ
vendelín	vɛndɛliːn
verejný	vɛrɛjniː
veronika	vɛrɔɲiːka
ves	ʋes
vestibul	vɛstibuɫ
veternica	vɛcɛrɲit͡sa
vetva	vɛtva
veverica	vɛvɛrit͡sa
večer	vɛt͡ʃɛr
večera	vɛt͡ʃɛra
večes	ʋetʃes
veľa	vɛʎa
veľký	vɛʎkiː
veľmi	vɛʎmi
veža	vɛʒa
vežička	vɛʒit͡ʃka
viac	vi̯at͡s
vianoce	vi̯anɔt͡sɛ
viať	vi̯ac
vidiecky	viɟi̯ɛt͡ski
vidieť	viɟi̯ɛc
vidlička	vidʎit͡ʃka
viedenský	vi̯ɛɟɛnskiː
viedeň	vi̯ɛɟɛɲ
viera	vi̯ɛra
vieroslava	vi̯ɛrɔsɫava
viesť	vi̯ɛsc
vietnam	vi̯ɛtnam
vietor	vi̯ɛtɔr
viezť	vi̯ɛsc
viking	vikiŋɡ
viktor	viktɔr
viktória	viktɔːria
viliam	viliam
vilma	viɫma
vilnius	viɫɲi̯us
vincent	vint͡sɛnt
vinš	vinʃ
viola	viɔɫa
visla	visɫa
vitamín	vitamiːn
vitráž	ʋitraːʃ
vladimír	vɫaɟimiːr
vladimíra	vɫaɟimiːra
vladislav	vɫaɟisɫau̯
vlaha	vɫaɦa
vlajočka	vɫajɔt͡ʃka
vlani	vɫaɲi
vlas	vɫas
vlasta	vɫasta
vlastimil	vɫascimiɫ
vlastný	vɫastniː
vlasť	ʋɫasc
vlha	ʋɫ̩ɦa
vlkolak	vɫ̩kɔɫak
vlna	vɫ̩na
vlásočnica	vɫaːsɔt͡ʃɲit͡sa
vláčik	vɫaːt͡ʃik
vlčica	vɫ̩t͡ʃit͡sa
vnuk	vnuk
vnučka	ʋnut͡ʃka
vnútornosti	vnuːtɔrnɔsc
vnúčik	ʋnuːt͡ʃik
voda	vɔda
vodca	ʋɔt͡sːa
vodič	vɔɟit͡ʃ
vodiť	vɔɟic
vodka	vɔtka
vodopád	vɔdɔpaːt
vodík	vɔɟiːk
vojak	vɔjak
vojačik	vɔjat͡ʃik
vojtech	ʋɔjcex
vola	vɔɫa
volavka	vɔɫau̯ka
volfrám	vɔɫfraːm
volov	vɔɫɔu̯
volt	vɔɫt
voz	vɔs
voziť	vɔzic
voš	vɔʃ
vplyv	fpɫiw
vrabec	vrabɛt͡s
vracať	vrat͡sac
vrah	vrax
vraj	vraj
vrana	vrana
vraní	vraɲiː
vratislav	vracisɫau̯
vratko	vratkɔ
vravieť	vravi̯ɛc
vražda	vraʒda
vrece	vrɛt͡sɛ
vrecko	vrɛt͡skɔ
vretenica	vrɛcɛɲit͡sa
vrkoč	vr̩kɔt͡ʃ
vroclav	ʋrɔt͡sɫaw
vrtuľník	vr̩tuʎɲiːk
vrátane	vraːtanɛ
vrátiť	vraːcic
vrša	vr̩ʃa
vstupenka	fstupɛŋka
vtedy	ftɛdi
vták	ftaːk
vtákopysk	ftaːkɔpisk
vtáčik	ftaːt͡ʃik
vulkán	vuɫkaːn
vuvuzela	ʋuʋuzeɫa
vy	vi
vychádzka	vixaːt͡ska
vydra	vidra
vyhodnotiť	viɦɔdnɔcic
vypnúť	vipnuːc
vypínať	vipiːnac
vysvedčenie	ʋisʋett͡ʃeni̯e
vzal	vzaɫ
vzduch	vzdux
vziať	vzi̯ac
václav	ʋaːt͡sɫaw
váh	vaːx
vápnik	ʋaːpɲik
váš	vaːʃ
vážka	vaːʃka
vädnúť	vædnuːc
vädnúť	vɛdnuːc
väčšina	væt͡ʃʃina
väčšina	vɛt͡ʃʃina
väčší	væt͡ʃʃi
väčší	vɛt͡ʃʃi
víchor	viːxɔr
víkend	ʋiːkent
víla	ʋiːɫa
víno	viːnɔ
vít	viːt
víťaz	viːcas
víťazoslav	viːcazɔsɫau̯
víťazoslava	viːcazɔsɫava
víťazstvo	viːcasstvɔ
vôl	vu̯ɔɫ
vôľa	vu̯ɔʎa
výbuch	viːbux
východ	viːxɔt
výnos	viːnɔs
výskum	viːskum
výsledok	viːslɛdɔk
vývojka	viːvɔjka
výťah	viːcax
včela	ft͡ʃɛɫa
včera	ft͡ʃɛra
vďaka	vɟaka
vďačnosť	vɟat͡ʃnɔsc
vďačný	vɟat͡ʃniː
všade	fʃaɟɛ
všetci	fʃɛtt͡si
všetok	fʃɛtɔk
whisky	ʋiski
wikipédia	vikipɛːdia
xantipa	ksantipa
xenofón	ksɛnɔfɔːn
xylofón	ksilɔfɔːn
xylograf	ksiɫɔɡraf
xénia	kseːnia
yeti	jeti
ypsilon	ipsiɫɔn
yterbium	itɛrbium
ytrium	itrium
yzop	izɔp
z	z
zabudnúť	zabudnuːc
zachariáš	zaxariaːʃ
zachmúrený	zaxmuːrɛniː
zajac	zajat͡s
zajačik	zajat͡ʃik
zajtra	zajtra
zapnúť	zapnuːc
zapínať	zapiːnac
zastaralý	zastaraɫiː
zatiaľ	zaci̯aʎ
začať	zat͡ʃac
začiatok	zat͡ʃi̯atɔk
zať	zac
zažať	zaʒac
zbohom	zbɔɦɔm
zbožie	zbɔʒi̯ɛ
zboží	zbɔʒiː
zdenka	zɟɛŋka
zdravie	zdravi̯ɛ
zdraví	zdraviː
zdravý	zdraviː
zdrobnenina	zdrɔbɲɛɲina
zelenina	zɛlɛɲina
zelená	zɛlɛnaː
zelený	ze̞ɫe̞niː
zelený	ze̞ʎe̞niː
zem	zɛm
zemepis	zɛmɛpis
zemetrasenie	zɛmɛtrasɛɲi̯ɛ
zemi	zemi
zemiak	zɛmi̯ak
zemiakový	zɛmi̯akɔviː
zemiaky	zɛmi̯aki
zemí	zɛmiː
zeus	ze̞us
zhodnotiť	zɦɔdnɔcic
zima	zima
zina	zina
zlatica	zɫacit͡sa
zlatko	zɫatkɔ
zlato	zɫatɔ
zlatý	zɫatiː
zlo	zɫɔ
zlodej	zɫɔɟɛj
zlí	zɫiː
zlý	zɫiː
zmes	zmɛs
zmija	zmija
zmluva	zmɫuva
zmrzlina	zmr̩zɫina
zmrzlina	zmr̩zʎina
znamenať	znamɛnac
znať	znac
znezrady	zɲɛzradi
zo	zɔ
zobáčik	zɔbaːt͡ʃik
zoja	zɔja
zoltán	zɔɫtaːn
zombi	zɔmbi
zombia	zɔmbia
zomrieť	zɔmri̯ɛc
zoológia	zɔɔɫɔːɡia
zoom	zuːm
zora	zɔra
zoznam	zɔznam
zrak	zrak
zrelý	zrɛliː
zrenica	zrɛɲit͡sa
zrkadlo	zr̩kadɫɔ
zrniečko	zr̩ɲi̯ɛt͡ʃkɔ
zrno	zr̩nɔ
zröntgenovať	zrœntɡɛnɔvac
zröntgenovať	zrɛntɡɛnɔvac
zub	zup
zubár	zubaːr
zubáč	zubaːt͡ʃ
zunovaný	zunɔvaniː
zunovať	zunɔvac
zuzana	zuzana
zuzanka	zuzaŋka
zuzka	zuska
zviera	zvi̯ɛra
zvuk	zvuk
zvyšný	zviʃniː
zvyšok	zviʃɔk
zväz	zʋes
zväz	zʋæs
zvýšiť	zviːʃic
záhada	zaːɦada
záhrada	zaːɦrada
záhreb	zaːɦrɛp
základný	zaːkɫadniː
záležitosť	zaːɫeʒitɔsc
záležitosť	zaːʎeʒitɔsc
zámeno	zaːmɛnɔ
zámok	zaːmɔk
zápal	zaːpaɫ
zápcha	zaːpxa
zápražka	zaːpraʃka
zásaditý	zaːsaɟitiː
zátvorka	zaːtvɔrka
závisť	zaːʋisc
zázrak	zaːzrak
zázračný	zaːzrat͡ʃniː
zázvor	zaːzvɔr
zľava	zʎava
ábel	aːbɛɫ
áno	aːnɔ
áut	aːu̯t
ázia	aːzia
ázijský	aːzijskiː
ä	e
ä	æ
ålandy	ɔɫandi
ångström	ankstrem
ír	iːr
íri	iːri
íris	iːris
írsko	iːrskɔ
írčina	iːrt͡ʃina
ísť	iːsc
íver	iːvɛr
óda	ɔːda
ôsmy	u̯osmi
úbohý	uːbɔɦiː
údolie	uːdɔʎi̯ɛ
úrad	uːrat
ústa	uːsta
útroba	uːtrɔba
územie	uːzɛmi̯ɛ
území	uːzɛmiː
úzky	uːski
úžitok	uːʒitɔk
ý	iː
č	t͡ʃ
čad	t͡ʃat
čaj	t͡ʃaj
čajka	t͡ʃajka
čakať	t͡ʃakac
čaro	t͡ʃarɔ
čas	t͡ʃas
časti	t͡ʃasci
častica	t͡ʃascit͡sa
častí	t͡ʃasciː
časť	t͡ʃasc
čau	t͡ʃau̯
čaša	t͡ʃaʃa
čech	t͡ʃɛx
čechizmus	t͡ʃɛxizmus
čechy	t͡ʃɛxi
čej	t͡ʃɛj
čelo	t͡ʃɛɫɔ
čerešňa	t͡ʃɛrɛʃɲa
černica	t͡ʃɛrɲit͡sa
černoch	t͡ʃɛrnɔx
červ	t͡ʃɛrw
červený	t͡ʃɛrvɛniː
česko	t͡ʃɛskɔ
československo	t͡ʃɛskɔsɫɔvɛnskɔ
český	t͡ʃeskiː
česť	t͡ʃɛsc
čečensko	t͡ʃet͡ʃenskɔ
čečenský	t͡ʃɛt͡ʃɛnskiː
čeština	t͡ʃɛʃcina
či	t͡ʃi
čiapka	t͡ʃi̯apka
čiapočka	t͡ʃi̯apɔt͡ʃka
čiaročka	t͡ʃi̯arɔt͡ʃka
čierny	t͡ʃi̯erni
čin	t͡ʃin
činnosť	t͡ʃinnɔsc
čipka	t͡ʃipka
čistej	t͡ʃiscɛj
čistý	t͡ʃistiː
čivava	t͡ʃivava
čiže	t͡ʃiʒɛ
čižma	t͡ʃiʒma
čižmička	t͡ʃiʒmit͡ʃka
členok	t͡ʃlɛnɔk
čln	t͡ʃɫ̩n
človek	t͡ʃɫɔvɛk
človiečik	t͡ʃɫɔvi̯ɛt͡ʃik
čmeľ	t͡ʃmɛʎ
čo	t͡ʃɔ
čokoláda	t͡ʃɔkɔɫaːda
čomu	t͡ʃɔmu
čoskoro	t͡ʃɔskɔrɔ
čpavok	t͡ʃpavɔk
črep	t͡ʃrɛp
črevo	t͡ʃrɛvɔ
črieda	t͡ʃri̯ɛda
črta	t͡ʃr̩ta
čssr	t͡ʃɛːɛsɛsɛr
čuchať	t͡ʃuxac
čudný	t͡ʃudniː
čujný	t͡ʃujniː
čučoriedka	t͡ʃut͡ʃɔri̯ɛtka
čím	t͡ʃiːm
čína	t͡ʃiːna
čínsky	t͡ʃiːnski
číselný	t͡ʃiːsɛɫniː
číslo	t͡ʃiːsɫɔ
číslovka	t͡ʃiːsɫɔu̯ka
číslovky	t͡ʃiːsɫɔu̯ki
čítať	t͡ʃiːtac
číňan	t͡ʃiːɲan
číňanka	t͡ʃiːɲaŋka
ďakujúci	ɟakujuːt͡si
ďalekohľad	ɟalɛkɔɦʎat
ďalší	ɟaɫʃiː
ďatelina	ɟacɛlina
ďateľ	ɟacɛʎ
ĺ	ɫ̩ː
ľad	ʎat
ľadnička	ʎadɲit͡ʃka
ľadoborec	ʎadɔbɔrɛt͡s
ľadvina	ʎadvina
ľahký	ʎaxkiː
ľstivý	ʎsciviː
ľuba	ʎuba
ľubica	ʎubit͡sa
ľubo	ʎubɔ
ľubomír	ʎubɔmiːr
ľubomíra	ʎubɔmiːra
ľubor	ʎubɔr
ľuboslav	ʎubɔsɫau̯
ľuboslava	ʎubɔsɫava
ľuboš	ʎubɔʃ
ľubľana	lʲublʲana
ľuda	ʎuda
ľudia	ʎuɟi̯a
ľudmila	ʎudmiɫa
ľudo	ʎudɔ
ľudomil	ʎudɔmiɫ
ľudomila	ʎudɔmiɫa
ľudovít	ʎudɔviːt
ň	ɲ
ŕ	r̩ː
šach	ʃax
šachovnica	ʃaxɔu̯ɲit͡sa
šakal	ʃakaɫ
šamlík	ʃamliːk
šampión	ʃampiɔːn
šatka	ʃatka
šaty	ʃati
šatôčka	ʃatu̯ɔt͡ʃka
šestnásť	ʃɛstnaːsc
šesť	ʃɛst
šiesty	ʃi̯ɛsti
šija	ʃija
šimpanz	ʃimpans
šiška	ʃiʃka
škandinávia	ʃkandinaːvia
škandinávie	ʃkandinaːviɛ
škandál	ʃkandaːɫ
škatuľa	ʃkatuʎa
škoda	ʃkɔda
škola	ʃkɔɫa
škorec	ʃkɔrɛt͡s
škorica	ʃkɔrit͡sa
škorpión	ʃkɔrpiɔːn
škorčí	ʃkɔrt͡ʃiː
škovránok	ʃkɔvraːnɔk
škrečok	ʃkrɛt͡ʃɔk
škrupina	ʃkrupina
škrupinka	ʃkrupiŋka
škvrna	ʃkvr̩na
škál	ʃkaːɫ
škála	ʃkaːɫa
škáročka	ʃkaːrɔt͡ʃka
škót	ʃkɔːt
škóti	ʃkɔːci
škótsko	ʃkɔːtskɔ
škótsky	ʃkɔːtski
škótština	ʃkɔːtʃcina
šofér	ʃɔfɛːr
šok	ʃɔk
šopron	ʃɔprɔn
šou	ʃɔw
šošovica	ʃɔʃɔvit͡sa
šošovka	ʃɔʃɔu̯ka
špageta	ʃpaɡɛta
špagety	ʃpaɡɛti
španielsko	ʃpaɲi̯ɛɫskɔ
španielčina	ʃpaɲi̯ɛɫt͡ʃina
špekulácia	ʃpekuɫaːt͡sia
špenát	ʃpɛnaːt
špicbergy	ʃpit͡sbɛrɡi
štart	ʃtart
štefan	ʃcɛfan
štefánia	ʃcɛfaːnia
štiny	ʃcini
štopeľ	ʃtɔpɛʎ
štrajk	ʃtrajk
štrajkovať	ʃtrajkɔvac
štrkáč	ʃtr̩kaːt͡ʃ
štrnásť	ʃtr̩naːsc
študent	ʃtudɛnt
štvrtok	ʃtvr̩tɔk
štvrtý	ʃtvr̩tiː
štyri	ʃtiri
štyridsať	ʃtirit͡sac
štát	ʃtaːt
štátny	ʃtaːtni
štóla	ʃtɔːɫa
švagor	ʃvaɡɔr
švajčiarsko	ʃvajt͡ʃi̯arskɔ
švéd	ʃʋeːt
švédka	ʃʋeːtka
švédsko	ʃvɛːtskɔ
švédsky	ʃvɛːtski
švédčina	ʃvɛːtt͡ʃina
šálka	ʃaːɫka
šáločka	ʃaɫɔt͡ʃka
šíp	ʃiːp
šípka	ʃiːpka
šógun	ʃɔːɡun
šľachtic	ʃʎaxcit͡s
šťúr	ʃcuːr
ťarchavý	carxaviː
ťava	cava
ťažký	caʃkiː
ž	ʒ
žaba	ʒaba
žalmy	ʒaɫmi
žalúdok	ʒaɫuːdɔk
žaneta	ʒanɛta
žať	ʒac
žbrnda	ʒbr̩nda
že	ʒɛ
želanie	ʒɛɫaɲi̯ɛ
želať	ʒɛɫac
železo	ʒeɫezɔ
železo	ʒeʎezɔ
želmíra	ʒɛɫmiːra
žemlička	ʒɛmlit͡ʃka
žemľa	ʒɛmʎa
ženami	ʒɛnami
ženatý	ʒɛnatiː
žene	ʒɛɲɛ
ženou	ʒenɔu̯
ženu	ʒenu
ženy	ʒeni
ženách	ʒɛnaːx
ženám	ʒɛnaːm
žeriav	ʒɛri̯au̯
žerucha	ʒɛruxa
žgrloš	ʒɡr̩ɫɔs
žiak	ʒi̯ak
žiačik	ʒi̯at͡ʃik
žiačík	ʒi̯at͡ʃiːk
žid	ʒit
žien	ʒi̯en
žigmund	ʒiɡmund
žihľavka	ʒiɦʎau̯ka
žila	ʒiɫa
žiletka	ʒilɛtka
žinčica	ʒint͡ʃit͡sa
žirafa	ʒirafa
žirafí	ʒirafiː
život	ʒivɔt
životopis	ʒivɔtɔpis
živočích	ʒivɔt͡ʃiːx
živý	ʒiviː
žičiť	ʒit͡ʃic
žiť	ʒic
žlna	ʒɫ̩na
žltý	ʒɫ̩tiː
žmýkačka	ʒmiːkat͡ʃka
žni	ʒɲi
žofia	ʒɔfia
žreb	ʒrɛp
žriebä	ʒri̯ebe
žriebä	ʒri̯ebæ
žriebäcí	ʒri̯bɛt͡siː
žriebäcí	ʒri̯ɛbæt͡siː
žubrienka	ʒubri̯ɛŋka
žurnalista	ʒurnalista
žurnalistika	ʒurnalistika
žurnál	ʒurnaːɫ
žuvačka	ʒuvat͡ʃka
žuvať	ʒuvac
žíla	ʒiːɫa
žĺtkový	ʒɫ̩ːtkɔviː
žĺtok	ʒɫ̩ːtɔk
