'day	daɪ̯
'y	ɪ
aa	ʔaʔɐʔ
aa	ʔɐɐ
aa	ʔɐʔaʔ
aaa	ʔɐʔɐʔaʔ
aaaban	ʔaʔɐʔɐban
aab	ʔɐʔab
aaban	ʔɐʔɐban
aabisuhan	ʔɐɐbɪsuhɐn
aak	ʔɐʔak
aakyat	ʔɐʔɐkjat
aam	ʔɐʔam
aamendyahan	ʔɐʔɐmjendɐhan
aap	ʔaʔɐp
aap	ʔɐʔap
aawat	ʔɐʔawɐt
aba	ʔɐba
aba	ʔɐbaʔ
abad	ʔɐbad
abahin	ʔɐbɐhin
abain	ʔɐbɐʔin
abaka	ʔɐbɐxa
abakada	ʔɐbɐxadɐ
abako	ʔɐbɐxo
abakus	ʔabɐxus
abala	ʔɐbalɐ
abala	ʔɐbɐla
abalahin	ʔɐbɐlahɪn
abaloryo	ʔɐbɐloɾjo
abalos	ʔabɐlos
abanderado	ʔɐbɐndeɾado
abandonado	ʔɐbɐndonado
abang	ʔɐbaŋ
abangan	ʔabaŋɐn
abangan	ʔɐbɐŋan
abaniko	ʔɐbɐnixo
abante	ʔɐbante
abat	ʔɐbat
abatan	ʔabatɐn
abatan	ʔɐbɐtan
abay	ʔabaɪ̯
abay	ʔɐbaɪ̯
abayan	ʔɐbajɐn
abayan	ʔɐbɐjan
abdikasyon	ʔɐbdɪxɐʃon
abdurahman	ʔɐbdʊɾahmɐn
abejuela	ʔɐbehuelɐ
abelgas	ʔɐbelɡɐs
abella	ʔɐbellɐ
abellera	ʔɐbeljeɾɐ
abenida	ʔɐbenidɐ
abentura	ʔɐbentuɾɐ
abenturero	ʔɐbentʊɾeɾo
aber	ʔɐbeɾ
aberya	ʔɐbeɾja
abestrus	ʔɐbestɾus
abilaw	ʔɐbɪlaʊ̯
abilidad	ʔɐbɪlɪdad
abilo	ʔɐbilo
abing	ʔabɪŋ
abiso	ʔɐbiso
abisuhan	ʔɐbɪsuhɐn
abitsuwela	ʔɐbɪt͡ʃʊelɐ
abitsuwelas	ʔɐbɪt͡ʃʊelɐs
abla	ʔablɐ
abla	ʔɐbla
abno	ʔɐbnoʔ
abnormal	ʔɐbnoɾmal
abnormal	ʔɐbnoɾmɐl
abnormalidad	ʔɐbnoɾmɐlɪdad
abnoy	ʔɐbnoɪ̯
abo	ʔɐbo
abobot	ʔɐbobot
abog	ʔɐboɡ
abogada	ʔɐboɰadɐ
abogado	ʔɐboɰado
abogasya	ʔɐboɰɐʃa
abok	ʔɐbok
abokado	ʔɐboxado
abolisyon	ʔɐbolɪʃon
abono	ʔɐbono
aborsiyon	ʔɐboɾʃon
aborsiyonista	ʔɐboɾsɪonistɐ
aborsyonista	ʔɐboɾʃonistɐ
abot	ʔɐbot
aboy	ʔɐboɪ̯
abra	ʔabɾɐ
abrasador	ʔɐbɾɐsɐdoɾ
abrasete	ʔɐbɾɐsete
abrasyete	ʔɐbɾɐʃete
abrazado	ʔɐbɾɐsado
abrelata	ʔɐbɾelatɐ
abrenica	ʔɐbɾenixɐ
abrigo	ʔɐbɾiɰo
abril	ʔɐbɾil
absik	ʔɐbsik
abuab	ʔɐbʊʔab
abubot	ʔɐbubot
abucay	ʔɐbuxaɪ̯
abueg	ʔɐbweɡ
abuhan	ʔabuhɐn
abuhan	ʔɐbʊhan
abuhin	ʔabʊhin
abuhin	ʔɐbʊhin
abukado	ʔɐbʊxado
abukanin	ʔɐbʊxanɪn
abukay	ʔɐbuxaɪ̯
abukay	ʔɐbʊxaɪ̯
abulencia	ʔɐbʊlenʃɐ
abuloy	ʔɐbuloɪ̯
abuluyan	ʔabʊlʊjan
abuluyan	ʔɐbʊlujɐn
aburido	ʔɐbʊɾido
aburido	ʔɐbʊɾɪdo
abusado	ʔɐbʊsado
abuso	ʔɐbuso
abusuhin	ʔɐbʊsuhɪn
abutab	ʔɐbʊtab
abutan	ʔabutɐn
abutan	ʔɐbutɐn
abutan	ʔɐbʊtan
abutin	ʔɐbutɪn
abutin	ʔɐbʊtin
abuwab	ʔɐbwab
abwab	ʔɐbwab
abyad	ʔɐbjad
abyador	ʔɐbjɐdoɾ
abyarin	ʔɐbjɐɾin
abyasyon	ʔɐbjɐʃon
abyog	ʔɐbjoɡ
abyugin	ʔɐbjʊɰin
acebedo	ʔɐsebedo
acierto	ʔɐʃeɾto
acorda	ʔɐxoɾdɐ
acosta	ʔɐxostɐ
acuzar	ʔɐxusɐɾ
acuña	ʔɐxuɲɐ
ada	ʔadɐ
adajar	ʔɐdɐhaɾ
adan	ʔɐdan
adberbiyo	ʔɐdbeɾbɪo
adbiyento	ʔɐdbjento
adbokasiya	ʔɐdboxɐsiɐ
adelanto	ʔɐdelanto
adelpa	ʔɐdelpɐ
adhika	ʔɐdhɪxaʔ
adhikain	ʔɐdhɪxaʔɪn
adidas	ʔɐdidɐs
adik	ʔadɪk
adiksiyon	ʔɐdɪkʃon
adiksyon	ʔɐdɪkʃon
adikto	ʔɐdikto
adisyunal	ʔɐdɪʃʊnal
adlaw	ʔɐdlaʊ̯
adlawan	ʔɐdlawɐn
administrador	ʔɐdmɪnɪstɾɐdoɾ
administrasyon	ʔɐdmɪnɪstɾɐʃon
administratibo	ʔɐdmɪnɪstɾɐtibo
admiral	ʔadmɪɾal
adobe	ʔɐdobe
adobo	ʔɐdobo
adopsiyon	ʔɐdopʃon
adopsyon	ʔɐdopʃon
adorador	ʔɐdoɾɐdoɾ
adorno	ʔɐdoɾno
adres	ʔɐdɾes
adrias	ʔadɾɪɐs
adulto	ʔɐdulto
aduwana	ʔɐdwɐnɐ
adwa	ʔɐdwaʔ
adwana	ʔɐdwanɐ
adya	ʔɐd͡ʒa
adyenda	ʔɐd͡ʒendɐ
adyo	ʔɐd͡ʒo
adyo	ʔɐd͡ʒoʔ
aga	ʔaɰɐ
agaas	ʔaɰɐɐs
agaas	ʔɐɰɐʔas
agad	ʔɐɰad
agahan	ʔɐɰahɐn
agahas	ʔɐɰahɐs
agahas	ʔɐɰɐhas
agalya	ʔɐɰaljɐ
agam	ʔaɰɐm
agamahan	ʔaɰɐmɐhɐn
agap	ʔaɰɐp
agapay	ʔɐɰapaɪ̯
agaran	ʔaɰaɾɐn
agas	ʔaɰɐs
agas	ʔɐɰas
agata	ʔaɰɐta
agatat	ʔɐɰɐtat
agaw	ʔaɰaʊ̯
agaw	ʔɐɰaʊ̯
agbarog	ʔɐɡbaɾoɡ
agbarugan	ʔɐɡbɐɾuɰɐn
agham	ʔɐɡham
aghambuhay	ʔɐɡhambuhaɪ̯
aghamwika	ʔɐɡhamwixɐʔ
aghimo	ʔɐɡhimoʔ
aghimuan	ʔɐɡhimʊɐn
aghimuin	ʔɐɡhimʊɪn
agihap	ʔɐɰihɐp
agila	ʔaɰɪla
agimat	ʔɐɰimɐt
agimatan	ʔɐɰɪmatɐn
agingay	ʔɐɰiŋaɪ̯
agipo	ʔɐɰɪpo
agiw	ʔaɰɪʊ̯
aglahi	ʔɐɡlahɪʔ
agnas	ʔɐɡnas
agnos	ʔɐɡnos
agong	ʔaɰoŋ
agos	ʔaɰos
agosto	ʔɐɰosto
agoy	ʔaɰoɪ̯
agpang	ʔɐɡpaŋ
agrabyado	ʔɐɡɾɐbjado
agresibo	ʔɐɡɾesibo
agrikultura	ʔɐɡɾɪxʊltuɾɐ
agrimensor	ʔɐɡɾɪmensoɾ
agsikap	ʔɐɡsixɐp
agsikapan	ʔɐɡsɪxapɐn
agta	ʔɐɡta
aguas	ʔaɰʊɐs
aguda	ʔɐɰudɐ
aguha	ʔɐɰuhɐ
aguhilya	ʔɐɰʊhiljɐ
aguho	ʔɐɰuhoʔ
aguho	ʔɐɰʊhoʔ
aguhon	ʔɐɰʊhon
aguilar	ʔɐɰɪlaɾ
aguilera	ʔɐɰɪleɾɐ
aguirre	ʔɐɰiɾe
agulo	ʔɐɰulo
agusan	ʔɐɰusɐn
agusil	ʔɐɰʊsil
agustin	ʔɐɰʊstin
agustino	ʔɐɰʊstino
agwa	ʔaɡwɐ
agwa	ʔɐɡwa
agwahe	ʔɐɡwahe
agwamarina	ʔɐɡwɐmɐɾinɐ
agwaras	ʔɐɡwɐɾas
agwardiyente	ʔɐɡwɐɾd͡ʒente
agwardyente	ʔɐɡwɐɾd͡ʒente
agwas	ʔaɡwɐs
agwas	ʔɐɡwas
agwat	ʔɐɡwat
agwela	ʔɐɡwelɐ
agwelo	ʔɐɡwelo
ahang	ʔahɐŋ
ahang	ʔɐhaŋ
ahas	ʔahɐs
ahedres	ʔɐhedɾes
ahensiya	ʔɐhenʃa
ahente	ʔɐhente
ahit	ʔahɪt
ahit	ʔɐhit
ahiya	ʔɐhiɐ
ahunin	ʔɐhunɪn
akademya	ʔɐxɐdemjɐ
akala	ʔɐxalɐ
akala	ʔɐxalɐʔ
akap	ʔaxɐp
akasya	ʔɐxaʃɐ
akawntant	ʔɐxaʊ̯ntɐnt
akay	ʔaxaɪ̯
akayin	ʔɐxajɪn
akayin	ʔɐxɐjin
akba	ʔakbɐ
akba	ʔɐkba
akbay	ʔɐkbaɪ̯
akda	ʔɐkdaʔ
akibat	ʔɐxibɐt
akiko	ʔɐxiko
akin	ʔaxɪn
akit	ʔaxɪt
akit	ʔɐxit
aklan	ʔɐklan
aklas	ʔɐklas
aklat	ʔɐklat
aklatan	ʔɐklatɐn
akma	ʔɐkma
akma	ʔɐkmaʔ
ako	ʔaxoʔ
ako	ʔɐxo
akom	ʔaxom
akom	ʔɐxom
akompanya	ʔɐxumpɐɲa
akordeon	ʔɐxoɾdeon
akordeon	ʔɐxoɾd͡ʒon
akreditasyon	ʔɐkɾedɪtɐʃon
akrostik	ʔɐkɾostɪk
aksaya	ʔɐksɐja
aksayado	ʔɐksɐjado
aksibal	ʔɐksibɐl
aksidente	ʔɐksɪdente
aksiyon	ʔɐkʃon
aksyon	ʔɐkʃon
aktibidad	ʔɐktɪbɪdad
aktibidades	ʔɐktɪbɪdades
aktibismo	ʔɐktɪbismo
aktibista	ʔɐktɪbistɐ
aktibo	ʔɐktibo
aktor	ʔɐktoɾ
aktres	ʔɐktɾes
aktuwal	ʔɐktwal
akuin	ʔɐxuʔɪn
akumulasyon	ʔɐxʊmʊlɐʃon
akurdiyon	ʔɐxʊɾd͡ʒon
akusa	ʔɐxʊsa
akusado	ʔɐxʊsado
akwarela	ʔɐkwɐɾelɐ
akwaryum	ʔɐkwaɾjʊm
akyat	ʔɐkjat
akyatan	ʔɐkjatɐn
akyatan	ʔɐkjɐtan
akyatin	ʔɐkjɐtin
alaala	ʔɐlɐʔalɐ
alaala	ʔɐlɐʔɐla
alabastro	ʔɐlɐbastɾo
alabok	ʔɐlɐbok
alabwab	ʔɐlɐbwab
alaga	ʔɐlaɰɐʔ
alaga	ʔɐlɐɰaʔ
alagad	ʔɐlɐɰad
alagaw	ʔɐlɐɰaʊ̯
alahas	ʔɐlahɐs
alahero	ʔɐlɐheɾo
alak	ʔalɐk
alakdan	ʔɐlɐkdan
alala	ʔɐlalɐ
alala	ʔɐlɐla
alalahanin	ʔalɐlɐhɐnin
alalahanin	ʔɐlɐlɐhanɪn
alalawa	ʔalɐlɐwɐʔ
alalay	ʔɐlalaɪ̯
alalay	ʔɐlɐlaɪ̯
alam	ʔalɐm
alam	ʔɐlam
alamang	ʔɐlɐmaŋ
alamat	ʔɐlɐmat
alambre	ʔɐlambɾe
alambrera	ʔɐlɐmbɾeɾɐ
alamid	ʔɐlɐmid
alamin	ʔɐlɐmin
alampay	ʔɐlɐmpaɪ̯
alangaang	ʔɐlɐŋaʔɐŋ
alangan	ʔɐlɐŋan
alanganin	ʔɐlɐŋanɪn
alangilan	ʔɐlɐŋilɐn
alapaw	ʔɐlapaʊ̯
alarma	ʔɐlaɾmɐ
alas	ʔɐlas
alaskador	ʔɐlɐskɐdoɾ
alat	ʔalɐt
alay	ʔalaɪ̯
alba	ʔalbɐ
albahaka	ʔɐlbɐhaxɐ
albakora	ʔɐlbɐxoɾɐ
albanya	ʔɐlbaɲɐ
albarikoke	ʔɐlbɐɾɪxoke
albay	ʔɐlbaɪ̯
alberto	ʔɐlbeɾto
alboroto	ʔɐlboɾoto
albularyo	ʔɐlbʊlaɾjo
alcaide	ʔɐlkaɪ̯de
aldover	ʔɐldobeɾ
alegre	ʔɐleɡɾe
aleman	ʔɐleman
alemanya	ʔɐlemaɲɐ
algodon	ʔɐlɡodon
alguwasil	ʔɐlɡʊɐsil
alibadbad	ʔɐlɪbɐdbad
alibugha	ʔɐlɪbʊɡhaʔ
aligaga	ʔɐlɪɰɐɡaʔ
aligi	ʔɐlɪɰi
alikabok	ʔɐlɪxɐbok
alila	ʔɐlilɐʔ
alilis	ʔɐlilɪs
alilis	ʔɐlɪlis
alilisan	ʔalɪlɪsan
alimango	ʔɐlɪmaŋo
alimasag	ʔɐlɪmasɐɡ
alimis	ʔɐlɪmis
alimpayawan	ʔɐlɪmpɐjawɐn
alimpungat	ʔɐlɪmpʊŋat
alimpuyo	ʔɐlɪmpʊjo
alimuom	ʔɐlɪmuʔom
alimuom	ʔɐlɪmʊʔom
alimuran	ʔɐlɪmʊɾan
alin	ʔɐlin
alindog	ʔɐlɪndoɡ
aling	ʔalɪŋ
aling	ʔɐliŋ
alingasaw	ʔɐlɪŋasaʊ̯
alingasngas	ʔɐlɪŋɐsŋas
alingawngaw	ʔɐlɪŋaʊ̯ŋaʊ̯
alinlangan	ʔɐlɪnlaŋɐn
alinman	ʔɐlɪmman
alinsunod	ʔɐlɪnsunod
alintana	ʔɐlɪntanɐ
alipato	ʔɐlɪpato
alipin	ʔɐlipɪn
alipunga	ʔɐlɪpʊŋa
alipusta	ʔɐlɪpʊstaʔ
alis	ʔɐlis
alisagsag	ʔɐlɪsɐɡsaɡ
alisangsang	ʔɐlɪsɐŋsaŋ
alisin	ʔɐlɪsin
alisto	ʔɐlisto
alit	ʔalɪt
alitan	ʔɐlitɐn
alitangya	ʔɐlɪtɐŋja
alitaptap	ʔɐlɪtɐptap
aliw	ʔalɪʊ̯
aliw	ʔɐliʊ̯
alkabus	ʔɐlkɐbus
alkabusero	ʔɐlkɐbʊseɾo
alkalde	ʔɐlkalde
alkaldesa	ʔɐlkɐldesɐ
alkansiya	ʔɐlkɐnsiɐ
alkansiya	ʔɐlkɐnʃa
alkansya	ʔɐlkanʃɐ
alkatsopas	ʔɐlkɐt͡ʃopɐs
alkitran	ʔɐlkɪtɾan
alkohol	ʔɐlkohol
alma	ʔɐlma
almaden	ʔɐlmɐden
almarez	ʔɐlmɐɾes
almario	ʔɐlmaɾɪo
almasiga	ʔɐlmasɪɰa
almasiga	ʔɐlmɐsiɰɐ
almeha	ʔɐlmehɐ
almendrala	ʔɐlmendɾalɐ
almirante	ʔɐlmɪɾante
almirol	ʔɐlmɪɾol
almohadilya	ʔɐlmohɐdiljɐ
almon	ʔɐlmon
almoranas	ʔɐlmoɾanɐs
almusal	ʔɐlmʊsal
almuwada	ʔɐlmwɐdɐ
alog	ʔɐloɡ
alok	ʔɐlok
alonte	ʔɐlonte
alonto	ʔɐlonto
aloy	ʔaloɪ̯
alpa	ʔɐlpa
alpabeto	ʔɐlpɐbeto
alpaka	ʔɐlpaxɐ
alpapa	ʔɐlpapɐ
alpay	ʔalpaɪ̯
alpay	ʔɐlpaɪ̯
alperes	ʔɐlpeɾes
alsa	ʔɐlsa
altapresyon	ʔɐltɐpɾeʃon
altar	ʔɐltaɾ
alternatibo	ʔɐlteɾnɐtibo
alugin	ʔɐlʊɰin
alulod	ʔɐlʊlod
alulong	ʔɐlʊloŋ
aluminyo	ʔɐlʊmiɲo
alupag	ʔɐlupɐɡ
alupag	ʔɐlʊpaɡ
alupihan	ʔɐlʊpihɐn
alusema	ʔɐlʊsemɐ
alusitha	ʔɐlʊsɪthaʔ
alvarez	ʔalbɐɾes
alviar	ʔɐlbjaɾ
alwagi	ʔɐlwaɰɪ
alyansa	ʔɐljansɐ
alyas	ʔaljɐs
alyas	ʔɐljas
am	ʔɐm
ama	ʔamɐ
ama	ʔɐma
amag	ʔamɐɡ
amain	ʔɐmain
amak	ʔamɐk
amak	ʔɐmak
amam	ʔamɐm
amama	ʔɐmamɐ
amansinaya	ʔɐmɐnsɪnajɐʔ
amante	ʔɐmante
amapola	ʔɐmɐpolɐ
amaranto	ʔɐmɐɾanto
amarilyo	ʔɐmɐɾiljo
amas	ʔɐmas
amatista	ʔɐmɐtistɐ
amba	ʔɐmbaʔ
ambag	ʔɐmbaɡ
ambi	ʔɐmbiʔ
ambisyon	ʔɐmbɪʃon
ambisyosa	ʔɐmbɪʃosɐ
ambisyoso	ʔɐmbɪʃoso
ambon	ʔɐmbon
ambubuyog	ʔɐmbʊbujoɡ
ambulansiya	ʔɐmbʊlanʃa
ambuwang	ʔɐmbwaŋ
amen	ʔɐmen
amerika	ʔɐmeɾɪxa
amerikana	ʔɐmeɾɪxanɐ
amerikano	ʔɐmeɾɪxano
amihan	ʔɐmihɐn
amil	ʔamɪl
amil	ʔɐmil
amilyar	ʔɐmɪljaɾ
amilyaramyento	ʔɐmɪljɐɾɐmjento
amin	ʔamɪn
aminado	ʔɐmɪnado
aminin	ʔɐminɪn
amis	ʔamɪs
amis	ʔɐmis
amnestiya	ʔɐmnestiɐ
amo	ʔɐmoʔ
amogis	ʔɐmoɰɪs
amonya	ʔɐmoɲɐ
amoranto	ʔɐmoɾanto
amoritis	ʔɐmoɾitɪs
amorseko	ʔɐmoɾsexo
amorsiko	ʔɐmoɾsixo
amos	ʔɐmos
amoy	ʔɐmoɪ̯
ampalaya	ʔɐmpɐlɐja
ampang	ʔɐmpaŋ
ampaw	ʔampaʊ̯
ampaw	ʔɐmpaʊ̯
amperyo	ʔɐmpeɾjo
ampibyan	ʔɐmpibjɐn
ampiteatro	ʔɐmpɪteɐtɾo
ampon	ʔɐmpon
ampunan	ʔɐmpunɐn
ampunan	ʔɐmpʊnan
amugis	ʔɐmuɰɪs
amurao	ʔɐmʊɾaʊ̯
amuyong	ʔɐmujoŋ
amyenda	ʔɐmjendɐ
amyendahan	ʔɐmjendɐhan
anahaw	ʔɐnahaʊ̯
anak	ʔanɐk
anak	ʔɐnak
anakroniko	ʔɐnɐkɾonɪxo
anakronismo	ʔɐnɐkɾonismo
analisador	ʔɐnɐlɪsɐdoɾ
analisis	ʔɐnalɪsis
analitika	ʔɐnɐlitɪxa
analitiko	ʔɐnɐlitɪxo
analohiya	ʔɐnɐlohiɐ
anaman	ʔɐnɐman
ananapla	ʔɐnɐnɐpla
anarkiya	ʔɐnɐɾkiɐ
anas	ʔɐnas
anasan	ʔanasɐn
anatomista	ʔɐnɐtomistɐ
anatomiya	ʔɐnɐtomiɐ
anatomiya	ʔɐnɐtomja
anay	ʔanaɪ̯
anayad	ʔɐnajɐd
anayin	ʔɐnajɪn
anayo	ʔɐnajo
anayo	ʔɐnajoʔ
anda	ʔandɐ
andaderas	ʔɐndɐdeɾɐs
andal	ʔɐndal
andam	ʔɐndam
andap	ʔɐndap
andar	ʔɐndaɾ
andaya	ʔɐndajɐ
andora	ʔɐndoɾɐ
anga	ʔɐŋa
anga	ʔɐŋaʔ
angal	ʔaŋɐl
angal	ʔɐŋal
angas	ʔaŋɐs
angas	ʔɐŋas
angat	ʔɐŋat
angaw	ʔaŋaʊ̯
anggo	ʔɐŋɡo
anggulo	ʔaŋɡʊlo
anghang	ʔɐŋhaŋ
anghel	ʔɐŋhel
anghit	ʔɐŋhit
angi	ʔɐŋi
angis	ʔɐŋis
angkak	ʔɐŋkak
angkan	ʔɐŋkan
angkas	ʔɐŋkas
angkat	ʔɐŋkat
angkin	ʔɐŋkin
angkla	ʔaŋklɐ
angkop	ʔɐŋkop
ango	ʔɐŋo
angot	ʔɐŋot
angpao	ʔaŋpaʊ̯
anhin	ʔɐŋhin
ani	ʔanɪ
ani	ʔɐni
anib	ʔanɪb
anibersaryo	ʔɐnɪbeɾsaɾjo
anila	ʔanɪla
anila	ʔɐnilɐ
anim	ʔanɪm
animal	ʔɐnɪmal
animnapu	ʔɐnɪmnɐpuʔ
animnaraan	ʔɐnɪmnɐɾɐʔan
aninag	ʔɐninɐɡ
aninaw	ʔɐninaʊ̯
aninaw	ʔɐnɪnaʊ̯
anino	ʔɐnino
anis	ʔɐnis
anislag	ʔɐnislɐɡ
anit	ʔanɪt
anit	ʔɐnit
anito	ʔɐnito
anito	ʔɐnɪto
aniya	ʔɐɲa
anlaw	ʔɐnlaʊ̯
anluwagi	ʔɐnlwɐɰɪ
ano	ʔɐno
anomalya	ʔɐnomɐlja
anonang	ʔɐnonɐŋ
anonas	ʔɐnonɐs
anor	ʔɐnoɾ
anos	ʔɐnos
anot	ʔɐnot
anta	ʔantɐ
anta	ʔɐnta
antabay	ʔɐntabaɪ̯
antak	ʔɐntak
antala	ʔɐntalɐ
antanda	ʔɐntɐndaʔ
antas	ʔɐntas
antay	ʔɐntaɪ̯
antena	ʔɐntenɐ
antibiyotiko	ʔɐntɪbjotɪxo
antig	ʔɐntiɡ
antik	ʔɐntik
antilope	ʔɐntilope
antipalo	ʔɐntɪpalo
antipolo	ʔɐntɪpolo
antipona	ʔɐntipona
antique	ʔɐntixe
antok	ʔɐntok
antot	ʔɐntot
antraks	ʔantɾɐks
antropolohiya	ʔɐntɾopolohiɐ
antukin	ʔɐntuxɪn
antukin	ʔɐntʊxin
anubing	ʔɐnubɪŋ
anuhin	ʔɐnʊhin
anunsiyo	ʔɐnunʃo
anunsyo	ʔɐnunʃo
anwang	ʔɐnwaŋ
anyaya	ʔɐɲɐjɐ
anyaya	ʔɐɲɐjɐʔ
anyayahan	ʔɐɲɐjahɐn
anyo	ʔaɲo
anyo	ʔɐɲoʔ
apa	ʔapɐ
apa	ʔɐpaʔ
apahap	ʔɐpahɐp
apak	ʔapɐk
apak	ʔɐpak
apalit	ʔɐpalɪt
apalya	ʔɐpɐlja
aparador	ʔɐpɐɾɐdoɾ
aparato	ʔɐpɐɾato
apat	ʔapɐt
apatnapu	ʔɐpɐtnɐpuʔ
apatnaraan	ʔɐpɐtnɐɾɐʔan
apaw	ʔapaʊ̯
apaw	ʔɐpaʊ̯
apaya	ʔɐpajɐ
apayao	ʔɐpajɐo
apayao	ʔɐpɐjaʊ̯
apdo	ʔɐpdo
apektado	ʔɐpektado
apekto	ʔɐpekto
apela	ʔɐpela
apelyido	ʔɐpeljido
apendisitis	ʔɐpendɪsitɪs
apganistan	ʔɐpɡɐnɪstan
api	ʔɐpi
apid	ʔɐpid
apihin	ʔɐpɪhin
apila	ʔɐpɪla
apilado	ʔɐpɪlado
apir	ʔɐpiɾ
apitong	ʔɐpitoŋ
aplaya	ʔɐplajɐ
aplikante	ʔɐplɪxante
aplikasyon	ʔɐplɪxɐʃon
apo	ʔɐpo
apokripos	ʔɐpokɾɪpos
apolo	ʔɐpolo
apolonio	ʔɐpolonɪo
apostasiya	ʔɐpostɐsiɐ
apostata	ʔɐpostɐta
apostol	ʔɐpostol
apostolado	ʔɐpostolado
apostoliko	ʔɐpostolɪxo
apoy	ʔɐpoɪ̯
apresasyon	ʔɐpɾesɐʃon
apresyasyon	ʔɐpɾeʃɐʃon
aprika	ʔapɾɪxɐ
aprikana	ʔɐpɾɪxanɐ
aprikano	ʔɐpɾɪxano
aprikot	ʔapɾɪxot
apritada	ʔɐpɾɪtadɐ
aproba	ʔɐpɾoba
aprobado	ʔɐpɾobado
apula	ʔɐpulɐʔ
apula	ʔɐpʊlaʔ
apura	ʔɐpʊɾa
apurado	ʔɐpʊɾado
apuybilos	ʔɐpʊɪbilos
apyak	ʔɐpjak
apyan	ʔɐpjan
aquino	ʔɐxino
arabe	ʔɐɾɐbe
arabo	ʔɐɾabo
arabya	ʔɐɾabjɐ
aral	ʔaɾɐl
aral	ʔɐɾal
aralin	ʔɐɾalɪn
aralin	ʔɐɾɐlin
aranda	ʔɐɾandɐ
arangkada	ʔɐɾɐŋkadɐ
aranya	ʔɐɾaɲɐ
aranya	ʔɐɾɐɲa
arap	ʔaɾɐp
araro	ʔɐɾaɾo
araru	ʔɐɾɐɾu
aras	ʔaɾɐs
aratiles	ʔɐɾatɪles
aratilis	ʔɐɾatɪlis
araw	ʔaɾaʊ̯
araw	ʔɐɾaʊ̯
arawan	ʔɐɾawɐn
arawan	ʔɐɾɐwan
aray	ʔɐɾaɪ̯
arañas	ʔɐɾaɲɐs
arcega	ʔɐɾseɰɐ
arcilla	ʔɐɾsillɐ
arcillas	ʔɐɾsillɐs
arcinas	ʔɐɾsinɐs
ardilya	ʔɐɾdiljɐ
are	ʔɐɾe
areglo	ʔɐɾeɡlo
arellano	ʔɐɾeljɐno
arenas	ʔɐɾenɐs
arestado	ʔɐɾestado
aresto	ʔɐɾesto
arevalo	ʔɐɾebɐlo
argente	ʔɐɾhente
argolya	ʔɐɾɡoljɐ
argumento	ʔɐɾɡʊmento
arhentina	ʔɐɾhentinɐ
ari	ʔaɾɪʔ
ari	ʔɐɾe
ari	ʔɐɾi
arilyos	ʔɐɾiljos
arina	ʔɐɾinɐ
aristoteles	ʔɐɾɪstoteles
arkanghel	ʔɐɾkaŋhel
arkanghel	ʔɐɾkɐŋhel
arkeologo	ʔɐɾkeoloɰo
arkeolohiya	ʔɐɾkeolohiɐ
arkila	ʔaɾkɪla
arkitekto	ʔɐɾkɪtekto
arkitektura	ʔɐɾkɪtektuɾɐ
armadilyo	ʔɐɾmɐdiljo
armado	ʔɐɾmado
armalayt	ʔaɾmɐlaɪ̯t
armas	ʔaɾmɐs
armas	ʔɐɾmas
armenya	ʔɐɾmeɲɐ
arminyo	ʔɐɾmiɲo
armonika	ʔɐɾmonɪxa
arnibal	ʔɐɾnibɐl
arnis	ʔɐɾnis
arogante	ʔɐɾoɰante
aroma	ʔɐɾomɐ
aroskaldo	ʔɐɾoskaldo
arpiya	ʔɐɾpiɐ
arquiza	ʔɐɾkisɐ
arriola	ʔɐɾiolɐ
arrogante	ʔɐɾoɰante
arroyo	ʔɐɾojo
arseniko	ʔɐɾsenɪxo
arsilya	ʔɐɾsiljɐ
arsobispado	ʔɐɾsobɪspado
arsobispo	ʔɐɾsobispo
artiaga	ʔɐɾʃɐɰɐ
artikulo	ʔɐɾtixʊlo
artipisyal	ʔɐɾtɪpɪʃal
artista	ʔɐɾtistɐ
arwa	ʔɐɾwaʔ
arya	ʔaɾjɐ
arzadon	ʔɐɾsadon
asa	ʔasɐ
asada	ʔɐsadɐ
asahan	ʔɐsahɐn
asal	ʔasɐl
asam	ʔɐsam
asamblea	ʔɐsɐmblejɐ
asambleista	ʔɐsɐmbleʔistɐ
asanorya	ʔɐsɐnoɾjɐ
asap	ʔasɐp
asap	ʔɐsap
asar	ʔɐsaɾ
asarol	ʔɐsɐɾol
asawa	ʔɐsawɐ
asbesto	ʔɐsbesto
asbok	ʔɐsbok
asendero	ʔɐsendeɾo
asenso	ʔɐsenso
aserbayan	ʔɐseɾbɐjan
asido	ʔasɪdo
asignatura	ʔɐsɪɡnɐtuɾɐ
asikaso	ʔɐsɪxaso
asilo	ʔɐsilo
asim	ʔasɪm
asin	ʔɐsin
asindero	ʔɐsɪndeɾo
asinta	ʔɐsɪnta
asiwa	ʔɐsiwɐʔ
asiwa	ʔɐsɪwaʔ
askal	ʔaskɐl
asngal	ʔɐsŋal
aso	ʔɐso
asog	ʔɐsoɡ
asoge	ʔɐsoɰe
asosasyon	ʔɐsosɐʃon
aspalto	ʔɐspalto
aspekto	ʔɐspekto
aspeto	ʔɐspeto
aspile	ʔɐspɪle
aspin	ʔaspɪn
aspirina	ʔɐspɪɾinɐ
asta	ʔastɐ
asta	ʔɐstaʔ
astaka	ʔɐstaxɐʔ
astaka	ʔɐstɐxaʔ
astig	ʔɐstiɡ
astinggal	ʔɐstɪŋɡal
astrolohiya	ʔɐstɾolohiɐ
astronomiya	ʔɐstɾonomiɐ
astropisika	ʔɐstɾopisɪxɐ
asukal	ʔɐsuxɐl
asukarera	ʔɐsʊxɐɾeɾɐ
asul	ʔɐsul
asungot	ʔɐsuŋot
asunto	ʔɐsunto
asupre	ʔɐsupɾe
asusena	ʔɐsʊsenɐ
aswang	ʔɐswaŋ
asya	ʔaʃɐ
asyano	ʔɐʃɐno
asyenda	ʔɐʃendɐ
at	ʔɐt
ata	ʔatɐ
ata	ʔatɐʔ
atake	ʔɐtaxe
atang	ʔatɐŋ
atang	ʔɐtaŋ
atangya	ʔɐtɐŋja
atas	ʔatɐs
atas	ʔɐtas
atat	ʔɐtat
ataud	ʔɐtɐʔud
ataul	ʔɐtɐʔul
atay	ʔataɪ̯
atay	ʔɐtaɪ̯
atayin	ʔɐtɐjin
ate	ʔɐte
ate	ʔɐteʔ
atenas	ʔɐtenɐs
atendido	ʔɐtendido
atensiyon	ʔɐtenʃon
athanasia	ʔɐthɐnasɪɐ
atig	ʔɐtiɡ
atigin	ʔɐtɪɰin
atik	ʔɐtik
atikha	ʔɐtɪkhaʔ
atin	ʔatɪn
atip	ʔɐtip
atis	ʔatɪs
atlantiko	ʔɐtlantɪxo
atleta	ʔɐtletɐ
atras	ʔɐtɾas
atraso	ʔɐtɾaso
atrebida	ʔɐtɾebidɐ
atrebido	ʔɐtɾebido
atribida	ʔɐtɾɪbidɐ
atribido	ʔɐtɾɪbido
atribusyon	ʔɐtɾɪbʊʃon
atsara	ʔɐt͡ʃaɾɐ
atsi	ʔat͡ʃɪ
atsi	ʔɐt͡ʃi
atsoy	ʔɐt͡ʃoɪ̯
atsuwete	ʔɐt͡ʃʊete
atubili	ʔɐtʊbilɪʔ
atubili	ʔɐtʊbɪli
atubili	ʔɐtʊbɪliʔ
atungal	ʔɐtuŋɐl
atupag	ʔɐtupɐɡ
audrey	ʔaʊ̯dɾeɪ̯
aurora	ʔaʊ̯ɾoɾɐ
avanceña	ʔɐbɐnseɲɐ
avendaño	ʔɐbendaɲo
aw	ʔaʊ̯
awa	ʔawɐʔ
awak	ʔawɐk
awak	ʔɐwak
awang	ʔɐwaŋ
awanggan	ʔɐwɐŋɡan
awat	ʔawɐt
awat	ʔɐwat
away	ʔawaɪ̯
awayan	ʔɐwɐjan
awayin	ʔɐwajɪn
awit	ʔawɪt
awstralya	ʔaʊ̯stɾɐljɐ
awstriya	ʔaʊ̯stɾɪɐ
awtismo	ʔaʊ̯tismo
awtomatiko	ʔaʊ̯tomatɪxo
awtonomiya	ʔaʊ̯tonomiɐ
awtopsiya	ʔaʊ̯topʃa
awtor	ʔaʊ̯toɾ
awtoridad	ʔaʊ̯toɾɪdad
awtoridad	ʔotoɾɪdad
awtorisado	ʔaʊ̯toɾɪsado
awtorisado	ʔotoɾɪsado
awtorisasyon	ʔaʊ̯toɾɪsɐʃon
awtorisasyon	ʔotoɾɪsɐʃon
ay	ʔaɪ̯
aya	ʔajɐ
aya	ʔajɐʔ
ayako	ʔɐjaxo
ayam	ʔajɐm
ayan	ʔɐjan
ayangaw	ʔɐjɐŋaʊ̯
ayaw	ʔajaʊ̯
ayaw	ʔɐjaʊ̯
ayon	ʔɐjon
ayos	ʔɐjos
aysing	ʔaɪ̯sɪŋ
ayson	ʔaɪ̯son
ayta	ʔaɪ̯ta
ayuda	ʔɐjudɐ
ayumi	ʔɐjumɪ
ayungin	ʔɐjuŋɪn
ayuno	ʔɐjuno
ayusin	ʔɐjusɪn
ayusin	ʔɐjʊsin
ayuyang	ʔɐjʊjaŋ
aywan	ʔaɪ̯wan
aywan	ʔewɐn
azaña	ʔɐsaɲɐ
azucena	ʔɐsʊsenɐ
añonuevo	ʔɐɲonuebo
ba	bɐ
ba't	bɐt
baang	baʔɐŋ
baang	bɐʔaŋ
baat	bɐʔat
baba	babɐʔ
baba	bɐba
baba	bɐbaʔ
babaan	babaʔɐn
babaan	babɐʔan
babaan	bɐbɐʔan
babad	babɐd
babad	bɐbad
babae	bɐbaʔe
babaero	bɐbɐʔeɾo
babag	babɐɡ
babag	bɐbaɡ
babaihin	bɐbɐʔihɪn
babala	bɐbɐlaʔ
babao	babaʊ̯
babasa	bɐbasɐ
babasagin	bɐbɐsaɰɪn
babasagin	bɐbɐsɐɰin
babasahin	bɐbɐsahɪn
babasahin	bɐbɐsɐhin
babat	babɐt
babaw	babaʊ̯
babay	babaɪ̯
babayaran	bɐbɐjaɾɐn
babayaran	bɐbɐjɐɾan
babaye	bɐbaje
babaylan	bɐbaɪ̯lan
babero	bɐbeɾo
baboy	baboɪ̯
babuyan	bɐbujɐn
babuyan	bɐbʊjan
babuyin	bɐbujɪn
bacani	bɐxanɪ
bacas	bɐxas
baclad	bɐklad
baclig	baklɪɡ
bacoor	bɐxoʔoɾ
bacsa	baksɐ
baculi	bɐxulɪ
badaho	bɐdaho
badayos	bɐdajos
bading	bɐdiŋ
badminton	badmɪnton
badminton	bɐdmɪnton
baduy	bɐduɪ
badya	bɐd͡ʒa
badyet	bad͡ʒet
bag	bɐɡ
baga	baɰɐ
baga	baɰɐʔ
baga	bɐɰa
baga	bɐɰaʔ
bagabag	bɐɰabɐɡ
bagabag	bɐɰɐbaɡ
bagahe	bɐɰahe
bagal	baɰɐl
bagalan	bɐɰalɐn
bagama't	bɐɰɐmat
bagaman	bɐɰɐman
bagamat	bɐɰɐmat
bagang	bɐɡʔaŋ
bagang	bɐɰaŋ
bagansiya	bɐɰanʃa
bagaoisan	bɐɰɐwisɐn
bagay	baɰaɪ̯
bagbag	bɐɡbaɡ
bagets	bɐɰet͡s
baging	baɰɪŋ
bagito	bɐɰito
bagko	bɐɡkoʔ
bagkos	bɐɡkos
bagkus	bɐɡkus
bagnet	bɐɡnet
bago	baɰo
bagok	bɐɰok
bagol	bɐɰol
bagon	bɐɰon
bagoong	bɐɰoʔoŋ
bagot	bɐɰot
bagsak	bɐɡsak
bagsik	bɐɡsik
bagsit	baɡsɪt
bagtas	bɐɡtas
bagting	bɐɡtiŋ
baguhan	bɐɰuhɐn
bagunsakupin	bɐɰʊnsaxʊpɪn
baguntao	bɐɰʊntaʔo
bagwis	bɐɡwis
bagyo	bɐɡjo
bagyuhin	bɐɡjʊhin
baha	bɐhaʔ
bahag	bɐhaɡ
bahagan	bɐhɐɰan
bahaghari	bɐhɐɡhaɾɪ
bahaghari	bɐhɐɡhaɾɪʔ
bahagi	bɐhaɰɪʔ
bahagsubay	bɐhɐɡsubaɪ̯
bahagya	bɐhɐɡjaʔ
bahala	bɐhalɐʔ
bahasa	bɐhasɐ
bahaw	bahaʊ̯
bahaw	bɐhaʊ̯
bahay	bahaɪ̯
bahid	bahɪd
bahin	bɐhin
bahin	bɐhiŋ
bahing	bɐhiŋ
bahon	bɐhon
baiki	bɐʔixɪʔ
baino	bɐʔɪno
baisan	bɐʔɪsan
bait	bɐʔit
baitang	bɐʔitɐŋ
baitang	bɐʔɪtaŋ
baiya	bɐʔiɐ
baka	baxɐ
baka	bɐxaʔ
bakahan	bɐxɐhan
bakal	baxɐl
bakal	bɐxal
bakalaw	bɐxɐlaʊ̯
bakam	bɐxam
bakante	bɐxante
bakas	baxɐs
bakas	bɐxas
bakasyon	bɐxɐʃon
bakasyonista	bɐxɐʃonistɐ
bakasyunista	bɐxɐʃʊnistɐ
bakat	baxɐt
bakat	bɐxat
bakaw	baxaʊ̯
bakaw	bɐxaʊ̯
bakawan	bɐxawɐn
bakay	baxaɪ̯
bakbak	bɐkbak
baket	baxet
bakin	baxɪn
bakit	baxet
bakit	baxɪt
bakit	bɐt
bakla	bɐkla
bakla	bɐklaʔ
baklad	bɐklad
baklain	bɐklaʔɪn
baklain	bɐklɐʔin
baklas	bɐklas
bakli	bɐkliʔ
baklita	bɐklitɐ
bako	bɐxoʔ
bakod	baxod
bakod	bɐxod
bakokang	bɐxokɐŋ
bakol	baxol
baksa	bɐksa
baksa	bɐksaʔ
baktaw	bɐktaʊ̯
bakterya	bɐkteɾjɐ
bakulaw	bɐxulaʊ̯
bakulo	baxʊlo
bakuna	bɐxunɐ
bakunado	bɐxʊnado
bakunahan	bɐxʊnahɐn
bakuran	bɐxuɾɐn
bakwit	bɐkwit
bakya	bɐkjaʔ
bala	balɐ
bala	balɐʔ
balaan	balɐɐn
balabag	bɐlɐbaɡ
balabal	bɐlabɐl
balabiga	bɐlɐbiɰɐʔ
balae	bɐlaʔe
balag	balɐɡ
balag	bɐlaɡ
balagat	bɐlaɰɐt
balaghan	bɐlɐɡhan
balaglawas	bɐlaɡlawɐs
balagtas	bɐlɐɡtas
balaguer	bɐlɐɰeɾ
balahak	bɐlahɐk
balahakan	balɐhɐxan
balahibo	bɐlɐhibo
balaho	bɐlɐhoʔ
balahura	bɐlɐhuɾɐ
balai	bɐlaʔɪ
balaid	bɐlɐʔid
balak	balɐk
balakang	bɐlɐxaŋ
balakat	bɐlaxɐt
balakbak	bɐlɐkbak
balakid	bɐlaxɪd
balakid	bɐlɐxid
balakil	bɐlaxɪl
balakilan	bɐlɐxilɐn
balaksila	bɐlɐksilɐʔ
balakubak	bɐlɐxubɐk
balakyot	bɐlɐkjot
balam	balɐm
balam	bɐlam
balana	balɐna
balana	bɐlanɐʔ
balana	bɐlɐnaʔ
balanan	bɐlanɐn
balandra	bɐlandɾɐ
balang	balɐŋ
balanga	bɐlɐŋaʔ
balangaw	bɐlɐŋaʊ̯
balangay	bɐlaŋaɪ̯
balangay	bɐlɐŋaɪ̯
balangkas	bɐlɐŋkas
balani	bɐlanɪʔ
balanoy	bɐlanoɪ̯
balanse	bɐlanse
balaong	bɐlaʔoŋ
balaraw	bɐlɐɾaʊ̯
balarila	bɐlɐɾilɐʔ
balas	balɐs
balas	bɐlas
balasa	bɐlasɐ
balasabas	bɐlɐsabɐs
balasubas	bɐlɐsubɐs
balat	balɐt
balat	bɐlat
balatik	bɐlatɪk
balatkayo	bɐlɐtkɐjoʔ
balato	bɐlato
balatong	bɐlatoŋ
balaw	balaʊ̯
balaw	bɐlaʊ̯
balaye	bɐlaje
balayi	bɐlajɪ
balbal	bɐlbal
balbas	bɐlbas
balbon	bɐlbon
balbula	balbʊla
balbula	balbʊlɐ
balda	baldɐ
balda	bɐlda
baldado	bɐldado
baldahin	bɐldɐhin
balde	bɐlde
baldonado	bɐldonado
baldosa	bɐldosɐ
balete	bɐlete
balewala	bɐlewɐlaʔ
balewalain	bɐlewɐlɐʔin
baley	bɐleɪ̯
bali	balɪ
bali	balɪʔ
bali	bɐliʔ
balian	bɐliʔɐn
balibag	bɐlibɐɡ
balibag	bɐlɪbaɡ
balibago	bɐlɪbaɰo
balibat	bɐlibɐt
balibat	bɐlɪbat
balibol	balɪbol
balibol	bɐlibol
balidasyon	bɐlɪdɐʃon
balido	balɪdo
baligho	bɐlɪɡhoʔ
baligtad	bɐlɪɡtad
baligtarin	bɐlɪɡtaɾɪn
baligtarin	bɐlɪɡtɐɾin
baliin	bɐliʔɪn
balik	bɐlik
balikan	balixɐn
balikan	bɐlɪxan
balikat	bɐlixɐt
balikbayan	bɐlɪkbajɐn
baliko	bɐlɪxoʔ
baliktad	bɐlɪktad
balikutsa	bɐlɪxʊt͡ʃa
balikwas	bɐlɪkwas
baliling	bɐlilɪŋ
baliling	bɐlɪliŋ
balimbing	bɐlɪmbiŋ
balindang	bɐlɪndaŋ
balindas	bɐlɪndas
baling	balɪŋ
balinghat	bɐlɪŋhat
balinghoy	bɐlɪŋhoɪ̯
balingit	bɐliŋɪt
balingkinitan	bɐlɪŋkɪnitɐn
balingot	bɐliŋot
balingot	bɐlɪŋot
balinguyngoy	bɐlɪŋʊɪŋoɪ̯
balino	bɐlino
balino	bɐlɪno
balino	bɐlɪnoʔ
balinsasayaw	bɐlinsɐsɐjaʊ̯
balintataw	bɐlɪntɐtaʊ̯
balintataw	bɐlɪntɐtɐʔo
balintawak	bɐlɪntɐwak
balintong	bɐlɪntoŋ
balintuna	bɐlɪntunɐʔ
balintunay	bɐlɪntunaɪ̯
balipik	bɐlipɪk
balisa	bɐlisɐ
balisa	bɐlɪsa
balisacan	bɐlɪsaxɐn
balisakang	bɐlɪsɐxaŋ
balisawsaw	bɐlɪsaʊ̯saʊ̯
baliskad	bɐlɪskad
balisong	bɐlisoŋ
balisong	bɐlɪsoŋ
balisungsong	bɐlɪsʊŋsoŋ
balisuplingan	bɐlɪsʊpliŋɐn
balisuso	bɐlɪsʊsoʔ
balita	bɐlitɐʔ
balitado	bɐlɪtado
balite	bɐlite
baliw	balɪʊ̯
baliw	bɐliʊ̯
baliwag	bɐliwɐɡ
balkon	bɐlkon
balkonahe	bɐlkonahe
balngawsipat	bɐlŋaʊ̯sipɐt
balngawsukat	bɐlŋaʊ̯suxɐt
balnian	bɐlniʔɐn
balnibalngawsipatan	bɐlnɪbɐlŋaʊ̯sɪpatɐn
balnibulog	bɐlnɪbʊloɡ
balnidagitab	bɐlnɪdɐɰitɐb
balnikapnayan	bɐlnɪxɐpnajɐn
balnisukat	bɐlnɪsuxɐt
balon	bɐlon
balot	bɐlot
balota	bɐlotɐ
balsa	bɐlsa
balsahan	bɐlsɐhan
balubad	bɐlubɐd
baluga	bɐluɰɐ
baluga	bɐluɰɐʔ
balukay	balʊxaɪ̯
baluktot	bɐlʊktot
balumbalunan	bɐlumbɐlunɐn
balut	bɐlut
baluti	bɐlutɪʔ
baluyot	bɐlujot
balwarte	bɐlwaɾte
balyan	bɐljan
balyena	bɐljenɐ
bamban	bɐmban
bambang	bɐmbaŋ
bambo	bɐmbo
bami	bamɪ
bami	bamɪʔ
bampira	bɐmpiɾɐ
bamus	bamʊs
bana	banɐ
bana	banɐʔ
bana	bɐnaʔ
banaag	banɐɐɡ
banaag	bɐnaʔɐɡ
banaba	bɐnɐba
banal	bɐnal
banas	bɐnas
banat	banɐt
banat	bɐnat
banawa	bɐnawɐ
banayad	bɐnajɐd
banban	bɐnban
banda	bandɐ
banda	bɐnda
bandalismo	bɐndɐlismo
banday	bandaɪ̯
bandeha	bɐndehɐ
bandido	bɐndido
bandila	bɐndilɐʔ
bandurya	bɐnduɾjɐ
bandyo	band͡ʒo
banga	baŋɐʔ
banga	bɐŋaʔ
bangag	bɐŋaɡ
bangan	baŋɐn
bangan	bɐŋan
bangas	baŋɐs
bangas	bɐŋas
bangaw	baŋaʊ̯
bangaw	bɐŋaʊ̯
bangcay	bɐŋkaɪ̯
bangga	bɐŋɡaʔ
banggit	bɐŋɡit
banghay	bɐŋhaɪ̯
bangin	bɐŋin
bangis	bɐŋis
bangka	bɐŋkaʔ
bangkal	bɐŋkal
bangkarote	bɐŋkɐɾote
bangkas	bɐŋkas
bangkay	bɐŋkaɪ̯
bangketa	bɐŋketɐ
bangkete	bɐŋkete
bangkilas	bɐŋkilɐs
bangkiling	bɐŋkɪliŋ
bangkito	bɐŋkitoʔ
bangkiwi	bɐŋkɪwiʔ
bangko	bɐŋkoʔ
bangkoro	bɐŋkoɾo
bangkukang	bɐŋkuxɐŋ
bangkuro	bɐŋkuɾo
bangkuta	bɐŋkutɐʔ
bango	bɐŋo
bangon	bɐŋon
bangungot	bɐŋuŋot
bangus	bɐŋus
baniaga	bɐɲɐɰɐ
baniaga	bɐɲɐɰɐʔ
banig	bɐniɡ
banlaw	bɐnlaʊ̯
banli	bɐnliʔ
banlian	bɐnlɪʔan
banoglawin	bɐnoɡlawɪn
banos	bɐnos
banoy	banoɪ̯
bansa	bɐnsa
bansa	bɐnsaʔ
bansag	bɐnsaɡ
bansi	bɐnsiʔ
bansiw	bɐnsiʊ̯
bansot	bɐnsot
banta	bantɐʔ
banta	bɐntaʔ
bantas	bɐntas
bantay	bɐntaɪ̯
bantayan	bɐntajɐn
bantayan	bɐntɐjan
bantayog	bɐntajoɡ
bantil	bɐntil
banting	bɐntiŋ
bantiti	bɐntitɪʔ
bantiti	bɐntɪtiʔ
banto	bɐntoʔ
bantod	bɐntod
bantog	bɐntoɡ
bantok	bɐntok
bantot	bɐntot
bantuan	bɐntʊʔan
bantulot	bɐntulot
bantulot	bɐntʊlot
banyaga	bɐɲɐɰɐʔ
banyas	bɐɲas
banyera	bɐɲeɾɐ
banyo	baɲo
banyos	bɐɲos
banyuhay	bɐɲʊhaɪ̯
baog	bɐʔoɡ
baon	bɐʔon
bapor	bɐpoɾ
baquiran	bɐxiɾɐn
bara	baɾɐ
bara	bɐɾa
barado	bɐɾado
baraha	bɐɾahɐ
baraka	bɐɾaxɐ
barakilan	bɐɾɐxilɐn
barako	bɐɾaxo
barangay	bɐɾɐŋɡaɪ̯
barat	bɐɾat
barbero	bɐɾbeɾo
barberya	bɐɾbeɾja
barbosa	bɐɾbosɐ
barcelona	bɐɾselonɐ
bardagol	bɐɾdɐɰol
barena	bɐɾenɐ
barera	bɐɾeɾɐ
bareta	bɐɾetɐ
barha	baɾhɐ
barik	baɾɪk
barik	bɐɾik
barikada	bɐɾɪxadɐ
barikod	bɐɾɪxod
baril	bɐɾil
bariles	bɐɾiles
baritono	bɐɾitono
baritono	bɐɾɪtono
barkada	bɐɾkadɐ
barkilyos	bɐɾkiljos
barko	bɐɾko
barnis	bɐɾnis
barok	bɐɾok
baron	bɐɾon
barong	bɐɾoŋ
barquilla	bɐɾkiljɐ
bartender	bɐɾtendeɾ
bartolina	bɐɾtolinɐ
bartolome	bɐɾtolome
barumbada	bɐɾumbadɐ
barumbado	bɐɾumbado
barya	bɐɾja
basa	basɐ
basa	bɐsa
basa	bɐsaʔ
basag	basɐɡ
basag	bɐsaɡ
basagin	bɐsaɰɪn
basagulero	bɐsɐɰʊleɾo
basahan	bɐsahɐn
basahin	bɐsahɪn
basakay	bɐsaxaɪ̯
basangal	bɐsaŋɐl
basanlot	bɐsɐnlot
basar	bɐsaɾ
basbas	bɐsbas
basbasan	bɐsbɐsan
bascoguin	bɐskoɰɪn
basehan	bɐsehan
basi	basɪʔ
basig	basɪɡ
basilan	bɐsilɐn
basilika	bɐsilɪxa
basisig	bɐsisɪɡ
baskag	bɐskaɡ
baskagan	bɐskaɰɐn
basketbolista	bɐsketbolistɐ
baso	bɐso
bassig	bassɪɡ
basta	bastɐ
basta	bɐsta
basta	bɐstaʔ
bastardo	bɐstaɾdo
bastos	bɐstos
basuka	bɐsuxɐ
basura	bɐsuɾɐ
basurahan	bɐsʊɾahɐn
basurahan	bɐsʊɾɐhan
basurera	bɐsʊɾeɾɐ
basurero	bɐsʊɾeɾo
basyo	bɐʃo
basyuhin	bɐʃʊhin
bata	batɐ
bata	batɐʔ
bata	bɐta
bataan	bɐtaʔɐn
bataan	bɐtɐʔan
batad	bɐtad
batag	batɐɡ
batag	bɐtaɡ
batak	batɐk
batak	bɐtak
batallones	bɐtɐllones
batalyon	bɐtɐljon
batanes	bɐtanes
batangas	bɐtaŋɡɐs
batangueño	bɐtɐŋɡeɲo
batar	bɐtaɾ
bataraza	bɐtɐɾasɐ
batas	bɐtas
batasan	batasɐn
bataw	bataʊ̯
bataw	bɐtaʊ̯
batay	bataɪ̯
batayan	bɐtajɐn
batayan	bɐtɐjan
batchoy	bɐt͡ʃoɪ̯
baterya	bɐteɾja
bathala	bɐthalɐʔ
bathalaan	bɐthɐlaʔɐn
bati	batɪʔ
bati	bɐti
bati	bɐtiʔ
batia	bɐt͡ʃaʔ
batid	bɐtid
batidor	bɐtɪdoɾ
batik	bɐtik
batikano	bɐtɪxano
batikos	bɐtixos
batikusin	bɐtɪxusɪn
batingaw	bɐtɪŋaʊ̯
batingawan	bɐtɪŋawɐn
batingting	bɐtɪŋtiŋ
batis	batɪs
batiti	bɐtitɪʔ
bato	bɐto
batsilyer	bɐt͡ʃɪljeɾ
batsoy	bɐt͡ʃoɪ̯
batugan	bɐtuɰɐn
batukan	bɐtuxɐn
batuktok	batʊktok
batulang	bɐtʊlaŋ
batuta	bɐtutɐʔ
batutay	bɐtutaɪ̯
batya	bɐt͡ʃaʔ
batyaw	bɐt͡ʃaʊ̯
baunan	baʔunɐn
baunan	baʔʊnan
baunan	bɐʔʊnan
bauzon	baʊ̯son
bawa	bawɐ
bawal	bawɐl
bawang	bawɐŋ
bawang	bɐwaŋ
bawas	bawɐs
bawas	bɐwas
bawat	bawɐt
bawaw	bawaʊ̯
baway	bawaɪ̯
bawi	bawɪʔ
bawi	bɐwiʔ
bawian	bɐwiʔɐn
bawtisteryo	baʊ̯tɪsteɾjo
baya	bajɐ
baya	bajɐʔ
bayabas	bɐjabɐs
bayabasan	bajɐbɐsan
bayabasan	bɐjɐbasɐn
bayad	bajɐd
bayad	bɐjad
bayag	bɐjaɡ
bayan	bajɐn
bayani	bɐjanɪ
bayanihan	bɐjɐnihɐn
bayar	bajɐɾ
bayaran	bɐjaɾɐn
bayaran	bɐjɐɾan
bayarin	bajɐɾɪn
bayarin	bɐjɐɾin
bayaw	bajaʊ̯
bayaw	bɐjaʊ̯
bayawak	bɐjawɐk
baybay	baɪ̯baɪ̯
baybayin	baɪ̯bajɪn
baybayin	baɪ̯bɐjin
bayki	baɪ̯xɪ
bayna	baɪ̯na
bayna	baɪ̯nɐ
baynilya	baɪ̯niljɐ
bayno	baɪ̯no
bayo	bɐjo
bayolente	bɐjolente
bayoneta	bɐjonetɐ
bayong	baɪ̯ʔoŋ
bayong	bɐjoŋ
bayugo	bɐjuɰo
baywang	baɪ̯waŋ
baywang	bewɐŋ
bañaga	bɐɲɐɰɐ
beatipikasyon	beɐtɪpɪxɐʃon
bejasa	behasɐ
beke	bexeʔ
beki	bexɪ
belarus	belaɾʊs
belarusya	belɐɾuʃɐ
belat	belɐt
belhika	belhɪxɐ
belhiko	belhɪxo
belosidad	belosɪdad
bendisyon	bendɪʃon
benepisyaryo	benepɪʃɐɾjo
benepisyo	benepiʃo
beneswela	beneswelɐ
benesyana	beneʃɐnɐ
benggala	beŋɡalɐ
benipayo	benɪpajo
benta	bentɐ
bentaha	bentahɐ
bentilador	bentɪlɐdoɾ
bentilasyon	bentɪlɐʃon
benus	benʊs
berdugo	beɾduɰo
bergonia	beɾɡoɲɐ
beripika	beɾɪpɪxa
beripikahin	beɾɪpɪxɐhin
beripikasyon	beɾɪpɪxɐʃon
bernabe	beɾnɐbe
bernakulo	beɾnaxʊlo
bersikulo	beɾsixʊlo
bersiyon	beɾʃon
bertdey	beɾtdeɪ̯
bestida	bestidɐ
beterinaryo	beteɾɪnaɾjo
betis	betɪs
betsin	bet͡ʃɪn
bewang	bewɐŋ
beynte	beɪ̯nte
beysbol	beɪ̯sbol
biak	bɪʔak
biaya	biɐjɐʔ
bibig	bɪbiɡ
bibilis	bɪbɪlis
bibingka	bɪbiŋkɐ
bibliya	biblja
bida	bidɐ
bidbid	bɪdbid
bidbiran	bɪdbiɾɐn
bidbiran	bɪdbɪɾan
bigamiya	bɪɰɐmiɐ
bigamya	bɪɰamjɐ
bigamya	bɪɰɐmja
bigas	bɪɰas
bigasan	biɰasɐn
bigat	bɪɡʔat
bigat	bɪɰat
bigaw	bɪɰaʊ̯
bigay	bɪɰaɪ̯
bigha	bɪɡhaʔ
bighani	bɪɡhanɪʔ
bigkas	bɪɡkas
bigkis	bɪɡkis
bigla	bɪɡlaʔ
biglaan	bɪɡlaʔɐn
bignay	bɪɡnaɪ̯
bigo	bɪɰoʔ
bigonya	bɪɰoɲɐ
bigote	bɪɰote
bigotilyo	bɪɰotiljo
bigti	bɪɡti
bigti	bɪɡtiʔ
bigtihin	bɪɡtɪhin
bigtiin	bɪɡtɪʔin
bigting	bɪɡtiŋ
biguin	bɪɰʊʔin
bigwas	bɪɡwas
bigyan	bɪɡjan
biha	bihɐ
bihag	bihɐɡ
bihag	bɪhaɡ
bihasa	bɪhasɐ
bihasa	bɪhasɐʔ
bihasa	bɪhɐsa
bihasa	bɪhɐsaʔ
bihilante	bɪhɪlante
bihilya	bɪhiljɐ
bihira	bɪhiɾɐʔ
bihis	bihɪs
bihis	bɪhis
biik	bɪʔik
bika	bɪxaʔ
bikaryo	bɪxaɾjo
bikas	bixɐs
bikas	bɪxas
bikat	bixɐt
biki	bixɪʔ
bikig	bɪxiɡ
biko	bixo
bikolana	bɪxolanɐ
bikolano	bɪxolano
biktima	biktɪma
bila	bilɐ
bilabila	bɪlɐbɪla
bilad	bɪlad
bilang	bilɐŋ
bilang	bɪlaŋ
bilangan	bɪlaŋɐn
bilangan	bɪlɐŋan
bilanggo	bɪlɐŋɡoʔ
bilangguan	bɪlɐŋɡuʔɐn
bilangin	bilɐŋin
bilangin	bɪlaŋɪn
bilao	bɪlaʔo
bilaok	bɪlaʔok
bilas	bɪlas
bilasa	bɪlasɐʔ
bilasa	bɪlɐsaʔ
bilauo	bɪlawo
bilbil	bɪlbil
bilhan	bɪlhan
bilhin	bɪlhin
bili	bɪli
bilibid	bɪlibɪd
bilig	bɪliɡ
bilin	bilɪn
biliran	bɪliɾɐn
bilis	bɪlis
bilisan	bɪlɪsan
bilog	bɪloɡ
bilot	bɪlot
biloy	biloɪ̯
bilubilo	bɪlubɪlo
bilugan	bɪluɰɐn
bilugan	bɪlʊɰan
bilugin	bɪluɰɪn
bilulo	bɪlulo
biluslawas	bɪlʊslawɐs
bilyar	bɪljaɾ
bilyaran	bɪljaɾɐn
bilyon	bɪljon
bilyonarya	bɪljonaɾjɐ
bilyonaryo	bɪljonaɾjo
bimbin	bɪmbin
bimol	bɪmol
binabae	bɪnɐbaʔe
binabae	bɪnɐbɐʔe
binabasa	bɪnɐbasɐ
binabayi	bɪnɐbajɪ
binago	bɪnaɰo
binagre	bɪnaɡɾe
binalalak	bɪnɐlalɐk
binasa	bɪnasɐ
binat	binɐt
binata	bɪnatɐʔ
binatilyo	bɪnɐtiljo
binaysok	bɪnaɪ̯sok
bingguhan	bɪŋɡuhɐn
bingi	bɪŋi
bingi	bɪŋiʔ
bingit	biŋɪt
bingot	bɪŋot
bingwit	bɪŋwit
binhay	bɪŋhaɪ̯
binhi	bɪŋhiʔ
bini	binɪʔ
binibini	bɪnɪbinɪ
biniboy	bɪniboɪ̯
binili	bɪnɪli
binokulo	bɪnoxʊlo
binsa	bɪnsaʔ
binta	bintɐ
bintag	bɪntaɡ
bintana	bɪntanɐʔ
bintang	bɪntaŋ
binti	bɪntiʔ
binting	bɪntiŋ
bintog	bɪntoɡ
binundok	bɪnʊndok
binutil	bɪnutɪl
binuya	bɪnujɐ
binyag	bɪɲaɡ
biray	biɾaɪ̯
biray	bɪɾaɪ̯
bireta	bɪɾetɐ
birey	biɾeɪ̯
birimbaw	bɪɾɪmbaʊ̯
biruin	bɪɾuʔɪn
birus	biɾʊs
bisa	bisɐ
bisa	bisɐʔ
bisagra	bɪsaɡɾɐ
bisaklat	bɪsɐklat
bisaya	bɪsajɐʔ
biscocho	bɪskot͡ʃo
bisig	bisɪɡ
bisikleta	bɪsɪkletɐ
bisiro	bɪsiɾo
bisita	bɪsitɐ
bisitahin	bɪsɪtahɪn
biskonde	bɪskonde
biskondesa	bɪskondesɐ
biskuwit	bɪskwit
biso	bɪsoʔ
bisor	bɪsoɾ
bista	bistɐ
bistado	bɪstado
bisyesto	bɪʃesto
bisyo	biʃo
bitad	bɪtad
bitag	bitɐɡ
bitak	bɪtak
bitamina	bɪtɐminɐ
bitaog	bɪtaʔoɡ
bitas	bitɐs
bitaw	bɪtaʊ̯
bitay	bitaɪ̯
bitayan	bɪtɐjan
bitbit	bɪtbit
bithay	bɪthaɪ̯
bitig	bitɪɡ
bitig	bɪtiɡ
bitin	bitɪn
bitin	bɪtin
bitiw	bɪtiʊ̯
bito	bɪtoʔ
bitsin	bɪt͡ʃin
bitso	bɪt͡ʃo
bitsuwelas	bɪt͡ʃʊelɐs
bituin	bɪtuin
bituin	bɪtuʔɪn
bituin	bɪtwin
bituin	bɪtʊʔin
bituka	bɪtuxɐ
biya	biɐ
biya	bjaʔ
biyahe	bjɐhe
biyahero	bɪɐheɾo
biyak	bjak
biyanan	bɪenan
biyanan	bɪɐnan
biyas	bjas
biyatiko	bjatɪxo
biyay	bjaɪ̯
biyaya	bjɐjɐʔ
biyenan	bɪenan
biyernes	bjeɾnes
biyetnam	bɪetnam
biyola	bjolɐ
biyolento	bɪolento
biyolin	bɪolin
biyolohiya	bɪolohiɐ
biyolon	bɪolon
biyopisika	bɪopisɪxa
biyuda	bjʊdɐ
biyudo	bjʊdo
bloke	bloxe
blusa	blusɐ
boac	boʔɐk
boba	bobɐ
bobadilla	bodɐbiljɐ
bodabil	bodɐbil
bodega	bodeɰɐ
bodka	bodkɐ
bogota	boɰota
bohaghag	bohɐɡhaɡ
bokabularyo	boxɐbʊlaɾjo
bokal	boxal
bokasyon	boxɐʃon
boksing	boksɪŋ
boksingero	boksɪŋeɾo
bokya	bokjɐʔ
bola	bolɐ
bolera	boleɾɐ
boling	bolɪŋ
bolta	boltɐ
boltiyo	bolt͡ʃo
boluntaryo	bolʊntaɾjo
bomba	bumbɐ
bombay	bumbaɪ̯
bombero	bumbeɾo
bombilya	bumbiljɐ
bondying	bond͡ʒiŋ
bongga	boŋɡɐ
bonifacio	bonɪpaʃo
bonilla	boniljɐ
boongaling	booŋɡalɪŋ
borlas	boɾlɐs
borlaza	boɾlasɐ
bosing	bosɪŋ
bosniya	bosɲa
bosnya	bosɲɐ
bosyo	boʃoʔ
bota	botɐ
botanika	botanɪxa
botas	botɐs
botelya	boteljɐ
botika	botixɐ
botohan	botohɐn
bottomesa	botomesɐ
boya	bojɐ
boykot	boɪ̯xot
brad	bɾɐd
brandi	bɾandɪ
brasil	bɾɐsil
breslavia	bɾeslabjɐ
bretanya	bɾetaɲɐ
brillantes	bɾɪljantes
brilyante	bɾɪljante
brip	bɾɪp
britanya	bɾɪtaɲɐ
brodkast	bɾodkɐst
brodkaster	bɾodkɐsteɾ
brokuli	bɾoxʊli
brotsa	bɾot͡ʃɐ
bruha	bɾuhɐ
bruselas	bɾʊselɐs
brutal	bɾʊtal
buan	bʊɐn
buang	bʊʔaŋ
bubo	bʊbo
bubo	bʊboʔ
bubong	bʊboŋ
buboy	buboɪ̯
bubuli	bʊbʊli
bubungan	bʊbʊŋan
bubuwit	bʊbwit
bubuyog	bʊbujoɡ
bubwit	bʊbwit
buda	budɐ
budbod	bʊdbod
budhi	bʊdhiʔ
budismo	bʊdismo
budista	bʊdistɐ
buenafe	bʊenɐpe
buga	buɰɐʔ
buga	bʊɰa
bugarin	bʊɰaɾɪn
bugat	bʊɰat
bugaw	buɰaʊ̯
bugayong	bʊɰajoŋ
bugbog	bʊɡboɡ
bughaw	bʊɡhaʊ̯
bugnit	bʊɡnit
bugnitbugnit	bʊɡnitbʊɡnit
bugnot	bʊɡnot
bugok	bʊɰok
bugso	bʊɡsoʔ
bugtong	bʊɡtoŋ
buhag	buhɐɡ
buhag	bʊhaɡ
buhaghag	bʊhaɡhaɡ
buhagsigan	bʊhɐɡsiɰɐn
buhagsigwasan	bʊhɐɡsɪɡwasɐn
buhagtigilan	bʊhɐɡtɪɰilɐn
buhangin	bʊhaŋɪn
buhat	buhɐt
buhat	bʊhat
buhawi	bʊhawɪʔ
buhay	buhaɪ̯
buhay	bʊhaɪ̯
buhok	bʊhok
buhol	bʊhol
buka	bʊxa
bukad	bʊxad
bukadkad	bʊxɐdkad
bukaka	bʊxakɐʔ
bukaka	bʊxɐkaʔ
bukal	bʊxal
bukalkal	bʊxɐlkal
bukambibig	bʊxɐmbɪbiɡ
bukana	bʊxanɐ
bukas	buxɐs
bukas	bʊxas
bukayo	bʊxajoʔ
bukbok	bʊkbok
bukid	buxɪd
bukidnon	bʊxɪdnon
buking	bʊxiŋ
buklat	bʊklat
buklaw	bʊklaʊ̯
buklod	bʊklod
buko	buxo
buko	bʊxo
bukod	bʊxod
bukol	buxol
bukong	buxoŋ
bukong	bʊxoŋ
bukot	buxot
bukot	bʊxot
buksan	bʊksan
bula	bulɐ
bula	bulɐʔ
bula	bʊla
bula	bʊlaʔ
bulaan	bʊlaʔɐn
bulacan	bʊlɐxan
bulag	bulɐɡ
bulag	bʊlaɡ
bulaga	bʊlɐɰaʔ
bulagta	bʊlɐɡtaʔ
bulahaw	bʊlahaʊ̯
bulahaw	bʊlɐhaʊ̯
bulak	bulɐk
bulak	bʊlak
bulakan	bʊlaxɐn
bulakan	bʊlɐxan
bulakbol	bʊlɐkbol
bulakenyo	bʊlɐxeɲo
bulaklak	bʊlɐklak
bulalakaw	bʊlɐlaxaʊ̯
bulalato	bʊlɐlato
bulalay	bʊlalaɪ̯
bulalayak	bulɐlɐjak
bulalo	bʊlɐloʔ
bulanadi	bʊlɐnadɪ
bulandal	bʊlɐndal
bulanglang	bʊlɐŋlaŋ
bulanhagui	bʊlɐŋhaɰɪ
bulaos	bʊlaʔos
bulastog	bʊlɐstoɡ
bulate	bʊlate
bulati	bʊlate
bulati	bʊlatɪ
bulatlat	bʊlɐtlat
bulaw	bʊlaʊ̯
bulawan	bʊlawɐn
bulay	bulaɪ̯
bulbol	bʊlbol
bulgar	bʊlɡaɾ
bulgaro	bʊlɡɐɾo
bulgarya	bʊlɡaɾjɐ
buli	bulɪ
buli	bʊli
bulig	bʊliɡ
bulihala	bʊlɪhalɐʔ
bulilit	bʊlilɪt
bulilit	bʊlɪlit
bulilyaso	bʊlɪljaso
buling	bulɪŋ
bulingbuling	bʊlɪŋbulɪŋ
bulkan	bʊlkan
bulo	bʊlo
bulo	bʊloʔ
bulok	bʊlok
bulol	bʊlol
bulon	bʊlon
bulong	bʊloŋ
bulsa	bʊlsa
bulubundukin	bʊlʊbʊnduxɪn
bulugan	bʊluɰɐn
bululos	bʊlʊlos
bulutong	bʊlutoŋ
bulutunggo	bʊlʊtʊŋɡo
bulwak	bʊlwak
bulwang	bʊlwaŋ
bulyaw	bʊljaʊ̯
bumaba	bʊmabɐʔ
bumaba	bʊmɐba
bumaba	bʊmɐbaʔ
bumagal	bʊmaɰɐl
bumagsak	bʊmɐɡsak
bumagyo	bʊmɐɡjo
bumaha	bʊmɐhaʔ
bumahin	bʊmɐhin
bumahing	bʊmɐhiŋ
bumali	bʊmalɪʔ
bumalik	bʊmɐlik
bumalikwas	bʊmɐlɪkwas
bumalintong	bʊmɐlɪntoŋ
bumasa	bʊmasɐ
bumasa	bʊmɐsaʔ
bumata	bʊmatɐʔ
bumatak	bʊmatɐk
bumatik	bʊmɐtik
bumbunan	bumbunɐn
bumbunan	bumbʊnan
bumerang	bʊmeɾaŋ
bumigay	bʊmɪɰaɪ̯
bumili	bʊmɪli
bumilis	bʊmɪlis
bumisita	bʊmɪsitɐ
bumitiw	bʊmɪtiʊ̯
bumiyahe	bʊmjɐhe
bumoto	bʊmoto
bumulong	bʊmʊloŋ
bumuo	bʊmʊʔoʔ
bumuwelta	bʊmweltɐ
bunag	bunɐɡ
bundok	bʊndok
bundol	bʊndol
bunga	buŋɐ
bungal	bʊŋal
bunganga	bʊŋaŋɐʔ
bungangera	bʊŋɐŋeɾɐ
bungangero	bʊŋɐŋeɾo
bungangkahoy	bʊŋɐŋkahoɪ̯
bungaw	bʊŋaʊ̯
bungbong	bʊŋboŋ
bunggabilya	bʊŋɡɐbiljɐ
bunggalo	bʊŋɡɐlo
bunggo	bʊŋɡoʔ
bungi	buŋɪʔ
bungi	bʊŋiʔ
bungisngis	bʊŋɪsŋis
bungkos	bʊŋkos
bungkugan	bʊŋkuɰɐn
bungo	bʊŋoʔ
bungot	bʊŋot
buni	bunɪ
buno	bʊnoʔ
bunot	bʊnot
bunso	bʊnso
bunso	bʊnsoʔ
bunso	bʊŋso
bunso	bʊŋsoʔ
bunsod	bʊnsod
buntala	bʊntalɐʔ
buntis	bʊntis
bunto	bʊnto
bunton	bʊnton
buntonghininga	bʊntoŋhɪnɪŋa
buntot	bʊntot
buntutan	bʊntʊtan
bunyag	bʊɲaɡ
bunyi	buɲɪ
bunyi	bʊɲiʔ
buod	bʊʔod
buol	bʊʔol
buot	bʊʔot
buquid	buxɪd
bura	buɾɐ
bura	bʊɾa
burado	bʊɾado
burahin	bʊɾɐhin
burak	buɾɐk
buraot	bʊɾaʔot
burara	bʊɾaɾɐʔ
burara	bʊɾɐɾaʔ
burat	bʊɾat
burda	bʊɾda
burges	bʊɾɡes
burges	bʊɾɡis
burgis	bʊɾɡis
burias	buɾjɐs
buriko	bʊɾixo
burloloy	bʊɾloloɪ̯
burma	buɾmɐ
burol	bʊɾol
burukinto	bʊɾʊxɪnto
burundi	bʊɾundɪ
buryong	bʊɾjoŋ
bus	bɐs
bus	bʊs
busabos	bʊsabos
busal	busɐl
busal	bʊsal
busangot	bʊsaŋot
busangot	bʊsɐŋot
busay	bʊsaɪ̯
busbos	bʊsbos
busilak	bʊsilɐk
busina	bʊsinɐ
busisi	bʊsisɪʔ
busisi	bʊsɪsiʔ
buslo	bʊsloʔ
buslot	bʊslot
busog	bʊsoɡ
busol	bʊsol
buson	bʊson
buswang	bʊswaŋ
butac	butɐk
butaka	bʊtaxɐ
butaka	bʊtaxɐʔ
butal	bʊtal
butanding	bʊtɐndiŋ
butang	bʊtaŋ
butangero	bʊtɐŋeɾo
butas	butɐs
butas	bʊtas
butaw	butaʊ̯
butaw	bʊtaʊ̯
butete	bʊtete
butete	bʊteteʔ
buti	butɪ
butig	bʊtiɡ
butigan	bʊtɪɰan
butiki	bʊtɪxiʔ
butil	butɪl
butlig	bʊtliɡ
buto	bʊto
butod	bʊtod
butse	bʊt͡ʃe
butse	bʊt͡ʃi
butsi	bʊt͡ʃi
butudkaphay	bʊtudkɐphaɪ̯
butudkilos	bʊtudkilos
buturan	butʊɾan
buuin	bʊʔʊʔin
buumbilang	bʊʔumbilɐŋ
buurin	bʊʔʊɾin
buwa	buɐʔ
buwa	bwaʔ
buwag	bwaɡ
buwagin	bʊɐɰin
buwakaw	bwɐxaʊ̯
buwal	bwal
buwan	bwan
buwanan	bwanɐn
buwang	bwaŋ
buwaya	bwɐjɐ
buwelo	bwelo
buwelta	bweltɐ
buweltahan	bweltɐhan
buwenamano	bʊenɐmano
buwik	bwik
buwis	bwis
buwisan	bwisɐn
buwisan	bʊɪsan
buwisit	bwɪsɪt
buwitre	bwɪtɾe
buya	bujɐʔ
buyaya	bʊjajɐʔ
buyaya	bʊjɐjaʔ
buyo	bʊjo
buyon	bʊjon
buyunin	bujunɪn
buyunin	bʊjʊnin
bwisit	bwisɪt
c	sɪ
cabahug	kxɐbahʊɡ
caballero	kxɐbɐljeɾo
cabanatuan	kxɐbɐnɐtuʔɐn
cabanayan	kxɐbɐnajɐn
cabanlit	kxɐbanlɪt
cabasag	kxɐbasɐɡ
cabiling	kxɐbilɪŋ
cabral	kxabɾɐl
cabrera	kxɐbɾeɾɐ
cabuhat	kxɐbuhɐt
cabungcal	kxɐbuŋkɐl
cabuti	kxɐbʊti
cacdac	kxakdɐk
cadano	kxɐdano
cadapan	kxɐdapɐn
cadayona	kxɐdɐjonɐ
cagalingan	kxɐɰɐliŋɐn
cagao	kxaɰaʊ̯
cagayan	kxɐɰɐjan
caguiat	kxaɡjɐt
caguioa	kxɐɰiwɐ
cahinaan	kxɐhɪnaʔɐn
cainta	kxɐʔɪntaʔ
calalo	kxɐlalo
calamba	kxɐlɐmba
calamba	kxɐlɐmbaʔ
calan	kxɐlan
calauang	kxɐlawɐŋ
calaunan	kxɐlɐʔunɐn
calayan	kxɐlajɐn
calaycay	kxɐlaɪ̯xaɪ̯
calinawan	kxɐlɪnawɐn
calingasan	kxɐlɪŋasɐn
calinisan	kxɐlɪnisɐn
calis	kxalɪs
calixto	kxɐliksto
callao	kaʎaʊ
calma	kxalmɐ
calumpang	kxɐlumpɐŋ
caluya	kxɐlujɐ
camacho	kxɐmat͡ʃo
camarines	kxɐmɐɾines
camiguin	kxɐmɪɰin
campo	kxampo
cancio	kxansɪo
candila	kxɐndilɐ
canicosa	kxɐnɪxosɐ
canilao	kxɐnilaʊ̯
canina	kxɐninɐ
cantiveros	kxɐntɪbeɾos
cantos	kxantos
caparas	kxɐpaɾɐs
capinpin	kxɐpinpɪn
capitan	kxɐpɪtan
capiz	kxapɪs
cardiño	kxɐɾdiɲo
cariaso	kxɐɾjaso
carillo	kxɐɾiljo
cariñosa	kxɐɾɪɲosɐ
carrillo	kxɐɾɾillo
casal	kxasɐl
casanova	kxɐsɐnobɐ
casao	kxasaʊ̯
caseda	kxɐsedɐ
castañeda	kxɐstɐɲedɐ
castrence	kxɐstɾense
catanduanes	kxɐtɐndwɐnes
catapang	kxɐtapɐŋ
catibog	kxɐtiboɡ
catimbang	kxɐtimbɐŋ
catipon	kxɐtipon
cato	kxɐto
catral	kxatɾɐl
cauilan	kxɐwilɐn
cavan	kxɐban
cavite	kxɐbite
cayetano	kxɐjetano
cañete	kxɐɲete
cenizal	senisɐl
chan	t͡ʃɐn
chang	t͡ʃɐŋ
charot	t͡ʃɐɾot
ching	t͡ʃɪŋ
chiong	t͡ʃɪoŋ
chiyoko	t͡ʃɪoxo
choi	t͡ʃoɪ̯
cinco	siŋko
closa	kxlosɐ
collado	kxoljado
cometa	kxometɐ
comia	kxomɪɐ
condez	kxondes
consolacion	kxonsolɐʃon
coo	kxʊ
coquia	kxoxɪɐ
corazon	kxoɾɐson
corcuera	kxoɾkweɾɐ
cornejo	kxoɾneho
coronel	kxoɾonel
corpus	kxoɾpʊs
corrales	kxoɾɾales
correa	kxoɾeɐ
corro	kxoɾɾo
cosico	kxosixo
cotabato	kxotɐbato
coting	kxotiŋ
cpp	sɪpɪpi
crisostomo	kxɾɪsostomo
cruzat	kxɾʊsɐt
cuasay	kwɐsaɪ̯
cubacub	kxʊbaxʊb
cuizon	kxuɪson
custodio	kxʊstod͡ʒo
daan	daʔɐn
daan	dɐʔan
daantaon	dɐʔantɐʔon
dabarkads	dabɐɾkads
dabaw	dabaʊ̯
dabdab	dɐbdab
dacanay	dɐxanaɪ̯
dadaanin	dɐdɐʔanɪn
dadaanin	dɐdɐʔɐnin
daga	daɰɐ
daga	dɐɰaʔ
dagabdab	dɐɰɐbdab
dagadagaan	dɐɰɐdɐɰaʔɐn
dagalwak	dɐɰɐlwak
dagan	dɐɰan
dagas	dɐɰas
dagasdas	dɐɰɐsdas
dagat	daɰɐt
dagatan	dɐɰatɐn
dagdag	dɐɡdaɡ
dagibulog	dɐɰɪbʊloɡ
dagihaynayan	dɐɰɪhaɪ̯najɐn
dagikapnayan	dɐɰɪxɐpnajɐn
dagil	daɰɪl
dagilusaw	dɐɰɪlʊsaʊ̯
dagim	dɐɰim
dagindas	dɐɰɪndas
daginding	dɐɰɪndiŋ
dagipik	dɐɰipɪk
dagisdis	dɐɰɪsdis
dagisik	dɐɰisɪk
dagisik	dɐɰɪsik
dagisikan	daɰɪsɪxan
dagison	dɐɰison
dagit	daɰɪt
dagitab	dɐɰitɐb
dagitban	dɐɰɪtban
dagitigilan	dɐɰɪtiɰɪlan
dagitsigan	dɐɰɪt͡ʃiɰɐn
daglat	dɐɡlat
dagli	dɐɡliʔ
dagok	daɰok
dagos	daɰos
dagsa	dɐɡsaʔ
dagsin	dɐɡsin
dagta	dɐɡtaʔ
dagubang	dɐɰʊbaŋ
dagubdob	dɐɰʊbdob
daguldol	dɐɰʊldol
dagundong	dɐɰʊndoŋ
dagupan	dɐɰupɐn
dagusdos	dɐɰʊsdos
dahak	dahɐk
dahan	dahɐn
dahas	dɐhas
dahil	dahɪl
dahilan	dɐhɪlan
dahilig	dɐhilɪɡ
dahilig	dɐlɪhiɡ
dahop	dɐhop
daig	daʔɪɡ
daig	dɐʔiɡ
daigdig	dɐʔɪɡdiɡ
daing	daʔɪŋ
daing	dɐʔiŋ
dais	dɐʔis
daisuke	daɪ̯suxe
daka	daxɐ
dakdak	dɐkdak
dakila	dɐxilɐʔ
dakip	dɐxip
dakma	dɐkmaʔ
dako	daxo
dakol	dɐxol
dakot	dɐxot
dakota	dɐxotɐ
daks	dɐks
daktao	dɐktaʔo
daktinig	dɐktinɪɡ
dakutin	dɐxʊtin
dala	dalɐ
dala	dɐla
dala	dɐlaʔ
dalag	dɐlaɡ
dalaga	dɐlaɰɐ
dalaginday	dɐlaɰɪndaɪ̯
dalaginding	dɐlaɰɪndiŋ
dalagita	dɐlɐɰitɐ
dalahik	dɐlahɪk
dalahikan	dɐlɐhixɐn
dalamhati	dɐlɐmhatɪʔ
dalampasigan	dɐlɐmpɐsiɰɐn
dalandan	dɐlɐndan
dalang	dalɐŋ
dalangat	dɐlaŋɐt
dalangat	dɐlɐŋat
dalanghita	dɐlɐŋhitɐ
dalangin	dɐlaŋɪn
dalao	dalaʊ̯
dalas	dɐlas
dalatan	dɐlatɐn
dalaw	dalaʊ̯
dalawa	dɐlɐwa
dalawampu	dɐlɐwɐmpuʔ
dalawandaan	dɐlɐwɐndɐʔan
dalawin	dɐlawɪn
dalawit	dɐlawɪt
daldal	dɐldal
daldalera	dɐldɐleɾɐ
daldalero	dɐldɐleɾo
dalhin	dɐlhin
dali	dalɪ
dali	dalɪʔ
dali	dɐliʔ
dalikdik	dɐlikdɪk
daliri	dɐliɾɪʔ
dalisay	dɐlisaɪ̯
dalit	dalɪt
dalit	dɐlit
dalita	dɐlɪtaʔ
dalmasya	dɐlmaʃɐ
dalmatika	dɐlmatɪxa
dalo	dɐlo
dalok	dɐlok
daloy	daloɪ̯
dalubbanwa	dɐlubbɐnwa
dalubbanwahan	dɐlubbɐnwahɐn
dalubguro	dɐlubɡuɾoʔ
dalubhalman	dɐlubhɐlman
dalubhalmanan	dɐlubhɐlmanɐn
dalubhasa	dɐlʊbhasɐʔ
dalubhasaan	dɐlʊbhɐsaʔɐn
dalubhayop	dɐlubhajop
dalubhayupan	dɐlubhɐjupɐn
dalubituinan	dɐlubɪtʊʔɪnan
dalubkabibihan	dɐlubkabɪbɪhan
dalubkatawan	dɐlubkɐtɐwan
dalubkulisap	dɐlubkʊlisɐp
dalubkulisapan	dɐlubkulɪsapɐn
dalublahi	dɐlublahɪʔ
dalublahian	dɐlublahɪʔan
dalublasunan	dɐlublasʊnan
dalublumutan	dɐlublumʊtan
dalubsugaan	dɐlubsuɰaan
dalubtala	dɐlubtalɐʔ
dalubtalaan	dɐlubtalɐʔan
dalubtalain	dɐlʊbtalain
dalubtao	dɐlubtaʔo
dalubtauhan	dɐlubtaʔʊhan
dalubwika	dɐlubwixɐʔ
dalubwikaan	dɐlubwixɐʔan
daluhong	dɐluhoŋ
dalumat	dɐlumɐt
daluro	dɐluɾoʔ
daluro	dɐlʊɾoʔ
dalurok	dɐluɾok
dalusong	dɐlusoŋ
daluyong	dɐlujoŋ
dalwa	dɐlwa
dalya	daljɐ
dama	damɐ
dama	dɐma
damag	damɐɡ
damag	dɐmaɡ
damahan	dɐmahɐn
damahan	dɐmɐhan
damak	dɐmak
damay	damaɪ̯
dambana	dɐmbanɐʔ
dambong	dɐmboŋ
dambuhala	dɐmbʊhalɐʔ
damdam	dɐmdam
damdamin	dɐmdamɪn
damikay	dɐmixaɪ̯
damit	dɐmit
damo	dɐmo
dampa	dɐmpaʔ
dampalit	dɐmpɐlit
dampi	dɐmpiʔ
dampot	dɐmpot
damsiha	dɐmsihɐʔ
damuhan	dɐmʊhan
damuho	dɐmuhoʔ
damulag	dɐmulɐɡ
danas	danɐs
danaw	danaʊ̯
danay	danaɪ̯
danes	dɐnes
danesa	dɐnesɐ
dangal	dɐŋal
danggit	dɐŋɡit
dangkal	dɐŋkal
dani	dɐniʔ
daniw	danɪʊ̯
daniw	dɐniʊ̯
dansay	dɐnsaɪ̯
dantaon	dɐntɐʔon
dantay	dɐntaɪ̯
danum	dɐnum
danumbiling	danumbɪliŋ
danumbulog	danumbʊloɡ
danumhaynayan	dɐnʊmhaɪ̯najɐn
danumkapnayan	dɐnʊmkɐpnajɐn
danumsigwasan	dɐnʊmsɪɡwasɐn
danumtigilan	dɐnʊmtiɰɪlan
danyos	daɲos
dao	dɐʔo
daong	dɐʔoŋ
dapa	dɐpaʔ
dapal	dapɐl
dapat	dapɐt
dapdap	dɐpdap
dapit	dapɪt
dapitan	dɐpitɐn
dapithapon	dɐpɪthapon
daplis	dɐplis
dapog	dɐpoɡ
dapulak	dɐpulɐk
dara	dɐɾa
darak	dɐɾak
daras	dɐɾas
darasigsukat	dɐɾɐsɪɡsuxɐt
dasal	dɐsal
dasmariñas	dɐsmɐɾiɲɐs
daspan	daspɐn
daspanin	daspɐnin
datal	dɐtal
datapuwa	dɐtɐpwaʔ
datapwa	dɐtɐpwaʔ
datapwat	datɐpwat
dati	datɪ
datiles	datɪles
dating	dɐtiŋ
datinguinoo	datɪŋɡɪnoʔo
datu	datʊ
daulat	dɐʔʊlat
daungan	daʔuŋɐn
dausdos	dɐʔʊsdos
davao	dabaʊ̯
daw	daʊ̯
dawdaw	daʊ̯daʊ̯
dawi	dawɪ
dawis	dawɪs
dawit	dawɪt
day	daɪ̯
daya	dajɐʔ
dayag	dajɐɡ
dayalekto	dɐjɐlekto
dayalogo	dɐjaloɰo
dayami	dɐjamɪ
dayan	dɐjan
dayang	dajɐŋ
dayang	dɐjaŋ
dayanghirang	dɐjɐŋhiɾɐŋ
dayap	dajɐp
dayrit	daɪ̯ɾɪt
dayuhan	dɐjuhɐn
dayuhan	dɐjʊhan
dayukyok	dɐjʊkdok
dayungon	dɐjuŋon
deang	d͡ʒɐŋ
debatista	debɐtistɐ
debosyon	deboʃon
decena	desenɐ
dedikado	dedɪxado
dedikasyon	dedɪxɐʃon
dedma	dedmɐ
dee	dɪ
dehins	dehɪns
dehins	deɪ̯ns
dekada	dexadɐ
dekametro	dexametɾo
dekametro	dexɐmetɾo
dekana	dexanɐ
dekano	dexano
deklara	deklɐɾa
deklarasyon	deklɐɾɐʃon
dekorasyon	dexoɾɐʃon
dekwat	dekwɐt
dekwatin	dekwɐtin
delata	delatɐ
delegado	deleɰado
delegasyon	deleɰɐʃon
deliberasyon	delɪbeɾɐʃon
delikadesa	delɪxɐdesɐ
delikado	delɪxado
demanda	demandɐ
demandado	demɐndado
demokrasya	demokɾaʃɐ
demolisyon	demolɪʃon
demonio	demoɲo
demonstrasyon	demonstɾɐʃon
demonyo	demoɲo
demostrasyon	demostɾɐʃon
denggoy	deŋɡoɪ̯
dentista	dentistɐ
dentisteriya	dentɪsteɾiɐ
departamento	depɐɾtɐmento
depensa	depensɐ
depensahan	depensɐhan
deportasyon	depoɾtɐʃon
deposito	deposɪto
depresasyon	depɾesɐʃon
depresyon	depɾeʃon
deregulasyon	deɾeɰʊlɐʃon
desbentaha	desbentahɐ
desesperada	desespeɾadɐ
desesperasyon	desespeɾɐʃon
desgrasya	desɡɾaʃɐ
desidido	desɪdido
desilitro	desɪlitɾo
desimetro	desɪmetɾo
desimpeksiyon	desɪmpekʃon
desisyon	desɪʃon
deskripsiyon	deskɾɪpʃon
deskubri	deskʊbɾi
deskuwento	deskwento
desmaya	desmɐja
desmayado	desmɐjado
despedida	despedidɐ
desperada	despeɾadɐ
desperasyon	despeɾɐʃon
despertador	despeɾtɐdoɾ
destabilisasyon	destɐbɪlɪsɐʃon
destinasyon	destɪnɐʃon
destiyero	dest͡ʃeɾo
destruksiyon	destɾʊkʃon
desyerto	deʃeɾto
detalyado	detɐljado
determinasyon	deteɾmɪnɐʃon
detonasyon	detonɐʃon
diamante	dɪɐmante
dian	dɪʔan
diba	dɪba
dibdib	dɪbdib
dibisyon	dɪbɪʃon
diblinig	dɪblɪniɡ
diborsiyo	dɪboɾʃo
dighal	dɪɡhal
dighay	dɪɡhaɪ̯
diglap	dɪɡlap
digma	dɪɡmaʔ
digmaan	dɪɡmaʔɐn
dignidad	dɪɡnɪdad
digos	diɰos
digtalain	dɪɡtalɐʔin
diigkasin	dɪʔɪɡkasɪn
diin	dɪin
diit	dɪʔit
diitan	diʔɪtɐn
diitan	dɪʔɪtan
dijamco	dɪd͡ʒamko
dikdik	dɪkdik
dike	dixe
dikiam	dɪkjam
dikit	dɪxit
diklap	dɪklap
diko	dixo
diksiyonaryo	dɪkʃonaɾjo
dikta	dɪkta
diktador	dɪktɐdoɾ
diktadora	dɪktɐdoɾɐ
diktadura	dɪktɐduɾɐ
diktadurya	dɪktɐduɾjɐ
dikya	dɪkja
dikya	dɪkjaʔ
dikyam	dɪkjam
dila	dilɐʔ
dilaan	dɪlaʔɐn
dilaan	dɪlɐʔan
dilag	dɪlaɡ
dilambuwaya	dilɐmbwajɐ
dilambuwaya	dɪlambwajɐ
dilat	dilɐt
dilat	dɪlat
dilaw	dɪlaʊ̯
dilawan	dɪlawɐn
dilawan	dɪlɐwan
dilawdinsol	dɪlaʊ̯dɪnsol
dili	dilɪ
dili	dilɪʔ
dilig	dɪliɡ
dilihensiya	dɪlɪhenʃa
dilikas	dɪlɪxas
dilim	dɪlim
dilis	dilɪs
dilis	dɪlis
dilubyo	dɪlubjo
dimaala	dɪmaɐlɐ
dimaandal	dɪmaɐndɐl
dimaapi	dɪmaɐpɪ
dimacali	dɪmɐxalɪ
dimagiba	dɪmɐɰibɐ
dimailig	dɪmaɪ̯lɪɡ
dimalaluan	dɪmɐlalʊɐn
dimalanta	dɪmɐlantɐ
dimapilis	dɪmɐpilɪs
dimaranan	dɪmɐɾanɐn
dimarim	dɪmaɾɪm
dimatatac	dɪmɐtatɐk
dimig	dimɪɡ
dimig	dɪmiɡ
din	dɪn
dinagat	dɪnaɰɐt
dinagipik	dɪnɐɰipɪk
dinamarka	dɪnɐmaɾkɐ
dinamita	dɪnɐmitɐ
dinastiya	dɪnɐstiɐ
dinding	dɪndiŋ
dingal	diŋɐl
dingding	dɪŋdiŋ
dinggin	dɪŋɡin
dingig	dɪŋiɡ
dini	dinɪ
dinig	dɪniɡ
dinosawro	dɪnosaʊ̯ɾo
dinsol	dɪnsol
dinsulan	dɪnsulɐn
dinuguan	dɪnʊɰʊʔan
dipa	dɪpa
dipasupil	dɪpɐsupɪl
dipende	dɪpende
diperensiya	dɪpeɾenʃa
diplomasya	dɪplomaʃɐ
diplomata	dɪplomɐta
diplomatiko	dɪplomɐtɪxo
dipolog	dɪpoloɡ
dipterya	dɪpteɾjɐ
direksiyon	dɪɾekʃon
direkta	dɪɾektɐ
direktiba	dɪɾektibɐ
direktor	dɪɾektoɾ
direktora	dɪɾektoɾɐ
direktoryo	dɪɾektoɾjo
diretso	dɪɾet͡ʃo
diri	diɾɪ
dirihible	dɪɾɪhible
diris	diɾɪs
disaluyan	dɪsɐlujɐn
disente	dɪsente
disenteriya	dɪsenteɾiɐ
disenyo	dɪseɲo
disgrasya	dɪsɡɾaʃɐ
disinuwebe	dɪsɪnwebe
disiotso	dɪsɪʔot͡ʃo
disiplina	dɪsɪplinɐ
disiplinado	dɪsɪplɪnado
disiplinahin	dɪsɪplɪnahɪn
disipulo	dɪsipʊlo
disisais	dɪsɪsɐʔis
disiseis	dɪsɪseʔis
disiseis	dɪsɪsɐʔis
disisiyete	dɪsɪʃete
diskarte	dɪskaɾte
diskita	dɪskɪta
diskompiyado	dɪskumpjɐdo
diskriminasyon	dɪskɾɪmɪnɐʃon
diskumpiyado	dɪskumpjɐdo
diskusyon	dɪskʊʃon
diskuwalipika	dɪskʊɐlɪpɪxa
diskuwalipikado	dɪskʊɐlɪpɪxado
diskuwalipikasyon	dɪskʊɐlɪpɪxɐʃon
dismayado	dɪsmɐjado
diso	dɪso
dispatser	dɪspat͡ʃeɾ
dispensa	dɪspensɐ
distansiya	dɪstanɪʃa
distinggido	dɪstɪŋɡido
distribusyon	dɪstɾɪbʊʃon
distrito	dɪstɾito
disyembre	dɪʃembɾe
dita	ditɐʔ
dita	dɪtaʔ
ditdit	dɪtdit
ditse	dɪt͡ʃe
diwa	diwɐ
diwa	diwɐʔ
diwang	diwɐŋ
diwata	dɪwatɐʔ
diyabetes	dɪɐbetes
diyabetes	d͡ʒɐbetɪs
diyabetiko	dɪɐbetɪxo
diyablo	d͡ʒablo
diyakono	d͡ʒaxono
diyalekto	dɪɐlekto
diyalogo	d͡ʒaloɰo
diyamante	dɪɐmante
diyametro	dɪɐmetɾo
diyametro	d͡ʒametɾo
diyan	dɪʔan
diyan	d͡ʒan
diyan	d͡ʒɐʔan
diyaryo	d͡ʒaɾjo
diyes	d͡ʒes
diyes	d͡ʒɪs
diyeta	d͡ʒetɐ
diyos	d͡ʒos
diyosa	d͡ʒosɐ
diyosesis	d͡ʒosesis
doktora	doktoɾɐ
doktrina	doktɾinɐ
dokumentado	doxʊmentado
dokumentaryo	doxʊmentaɾjo
dokumentasyon	doxʊmentɐʃon
dokumento	doxʊmento
dolar	dolɐɾ
domantay	domantaɪ̯
dominado	domɪnado
dominante	domɪnante
dominikano	domɪnɪxano
domino	domɪno
donasyon	donɐʃon
donat	donɐt
dormitoryo	doɾmɪtoɾjo
dosena	dosenɐ
dosis	dosɪs
dosyentos	doʃentos
dragon	dɾɐɰon
drakula	dɾaxʊlɐ
drama	dɾamɐ
dramatiko	dɾɐmatɪxo
droga	dɾoɰɐ
drowing	dɾowɪŋ
duag	dwaɡ
dubdob	dʊbdob
duda	dudɐ
dueñas	dueɲɐs
dugas	duɰɐs
dugo	dʊɰoʔ
dugong	duɰoŋ
dugso	dʊɡsoʔ
dugtong	dʊɡtoŋ
duguan	dʊɰʊʔan
dugyot	dʊɡjot
duhagi	dʊhaɰɪ
duhagi	dʊhɐɰi
duhakay	dʊhaxaɪ̯
duhambindahon	dʊhɐmbɪndahon
duhandas	dʊhɐndas
duhansipat	dʊhɐnsipɐt
duhasik	dʊhasɪk
duhat	duhɐt
duhol	dʊhol
dukado	dʊxado
dukal	dʊxal
duke	duxe
dukesa	dʊxesɐ
dukha	dʊkhaʔ
dukot	duxot
dukwang	dʊkwaŋ
dukwangin	dʊkwɐŋin
dula	dulɐʔ
dula	dʊlaʔ
dulaan	dulaɐn
dulang	dulɐŋ
dulang	dʊlaŋ
dulas	dʊlas
dulay	dulaɪ̯
duldol	dʊldol
duling	dʊliŋ
dulis	dulɪs
dulit	dulɪt
dulog	dʊloɡ
dulos	dʊlos
dulugan	duluɰɐn
dulugan	dʊlʊɰan
duluhan	dʊluhɐn
dumaan	dʊmɐʔan
dumagit	dʊmaɰɪt
dumagsin	dʊmɐɡsin
dumaguete	dʊmɐɰete
dumaguing	dʊmaɰɪŋ
dumal	dumɐl
dumalaw	dʊmalaʊ̯
dumali	dʊmɐliʔ
dumapa	dʊmɐpaʔ
dumating	dʊmɐtiŋ
dumausdos	dʊmɐʔʊsdos
dumi	dʊmi
dumighay	dʊmɪɡhaɪ̯
dumihan	dumihɐn
dumihan	dʊmɪhan
dumilim	dʊmɪlim
dumlao	dumlɐo
dumog	dʊmoɡ
dumpit	dumpɪt
dumugo	dʊmʊɰoʔ
dumukot	dʊmuxot
dumulas	dʊmʊlas
dumumi	dʊmʊmi
dumungaw	dʊmuŋaʊ̯
dumura	dʊmʊɾaʔ
dungaw	duŋaʊ̯
dunggol	dʊŋɡol
dunggot	dʊŋɡot
dungis	duŋɪs
dungon	dʊŋon
dupa	dʊpaʔ
dupikal	dʊpɪxal
dupil	dupɪl
dura	dʊɾaʔ
durante	dʊɾante
durian	dʊɾjan
durog	dʊɾoɡ
durugista	dʊɾʊɰistɐ
durungawan	duɾʊŋɐwan
duryan	dʊɾjan
dusa	dusɐ
dusdos	dʊsdos
dusing	dusɪŋ
dusta	dʊstaʔ
dutaan	dutɐʔɐn
dutaliknayan	dʊtɐlɪknajɐn
dutdot	dʊtdot
dutdutin	dʊtdʊtin
duwag	dwaɡ
duwende	dwende
duyan	dujɐn
dy	dɪ
dyahe	d͡ʒahe
dyaket	d͡ʒaxet
dyanitor	d͡ʒanɪtoɾ
dyaryo	d͡ʒaɾjo
dyas	d͡ʒɐs
dyip	d͡ʒɪp
dyipni	d͡ʒipnɪ
dyologin	d͡ʒoloɰɪn
dyologs	d͡ʒoloɡs
dyudo	d͡ʒudo
dyumologs	d͡ʒʊmoloɡs
eba	ʔebɐ
ebak	ʔebɐk
ebakwasyon	ʔebɐkwɐʃon
ebanghelista	ʔebɐŋhelistɐ
ebanghelyo	ʔebɐŋheljo
ebaporada	ʔebɐpoɾadɐ
ebidensiya	ʔebɪdenʃa
ebidensya	ʔebɪdenʃɐ
ebolusyon	ʔebolʊʃon
echevarria	ʔet͡ʃebaɾjɐ
edipisyo	ʔedɪpiʃo
edisyon	ʔedɪʃon
editoryal	ʔedɪtoɾjal
edukada	ʔedʊxadɐ
edukado	ʔedʊxado
edukasyon	ʔedʊxɐʃon
ehekutibo	ʔehexʊtibo
ehersisyo	ʔeheɾsiʃo
ehersito	ʔeheɾsɪto
ekipahe	ʔexɪpahe
ekis	ʔexɪs
ekisan	ʔexisɐn
ekonomista	ʔexonomistɐ
ekonomiya	ʔexonomiɐ
eksaherado	ʔeksɐheɾado
eksaherasyon	ʔeksɐheɾɐʃon
eksaminador	ʔeksɐmɪnɐdoɾ
eksena	ʔeksenɐ
eksklusibo	ʔeksklʊsibo
eksklusyon	ʔeksklʊʃon
eksperimento	ʔekspeɾɪmento
eksplanasyon	ʔeksplɐnɐʃon
ekspresyon	ʔekspɾeʃon
ektarya	ʔektaɾjɐ
ekwador	ʔekwɐdoɾ
elaborasyon	ʔelɐboɾɐʃon
elamparo	ʔelɐmpaɾo
elastiko	ʔelastɪxo
elegansiya	ʔeleɰanʃa
elegante	ʔeleɰante
elehiya	ʔelehiɐ
eleksiyon	ʔelekʃon
elektrisidad	ʔelektɾɪsɪdad
elektrisista	ʔelektɾɪsistɐ
eliseo	ʔelɪsejo
elizaga	ʔelɪsaɰɐ
embahada	ʔembɐhadɐ
embahador	ʔembɐhɐdoɾ
embalsama	ʔembɐlsɐma
embalsamador	ʔembɐlsɐmɐdoɾ
emiko	ʔemixo
emosyon	ʔemoʃon
emosyonal	ʔemoʃonal
empake	ʔempaxe
emperador	ʔempeɾɐdoɾ
emperadora	ʔempeɾɐdoɾɐ
emperatris	ʔempeɾɐtɾis
encarnado	ʔeŋkɐɾnado
encinas	ʔensinɐs
endaya	ʔendajɐ
enerhiya	ʔeneɾhiɐ
engganyo	ʔeŋɡaɲo
engkuwentro	ʔeŋkwentɾo
ensaymada	ʔensaɪ̯madɐ
ensemada	ʔensemadɐ
ensiklopedya	ʔensɪkloped͡ʒɐ
entrada	ʔentɾadɐ
entusyasmo	ʔentʊʃɐsmo
epal	ʔepɐl
epidemia	ʔepɪdemjɐ
epidemya	ʔepɪdemjɐ
epiko	ʔepɪxo
epilepsiya	ʔepɪlepʃa
epistemolohiya	ʔepɪstemolohiɐ
episyente	ʔepɪʃente
eredera	ʔeɾedeɾɐ
erehiya	ʔeɾehiɐ
ermita	ʔeɾmitɐ
ermitanyo	ʔeɾmɪtaɲo
escalona	ʔeskɐlonɐ
esena	ʔesenɐ
esguerra	ʔesɡeɾɾɐ
eskabetse	ʔeskɐbet͡ʃe
eskalador	ʔeskɐlɐdoɾ
eskandalo	ʔeskandɐlo
eskandalosa	ʔeskɐndɐlosɐ
eskandaloso	ʔeskɐndɐloso
eskaparate	ʔeskɐpɐɾate
eskapularyo	ʔeskɐpʊlaɾjo
eskina	ʔeskinɐ
eskinita	ʔeskɪnitɐ
eskoba	ʔeskobɐ
eskosya	ʔeskoʃɐ
eskriba	ʔeskɾibɐ
eskrima	ʔeskɾimɐ
eskultor	ʔeskʊltoɾ
eskultura	ʔeskʊltuɾɐ
eskuwela	ʔeskwelɐ
eskuwelahan	ʔeskwelɐhan
eskwela	ʔeskwelɐ
eslobakya	ʔeslobakjɐ
eslobenya	ʔeslobeɲɐ
esmeralda	ʔesmeɾaldɐ
esmeril	ʔesmeɾɪl
esopago	ʔesopɐɰo
espada	ʔespadɐ
espadahan	ʔespɐdɐhan
espantaho	ʔespɐntaho
espanya	ʔespaɲɐ
espanyol	ʔespɐɲol
espanyola	ʔespɐɲolɐ
esparago	ʔespaɾɐɰo
espasol	ʔespɐsol
espasyo	ʔespaʃo
españa	ʔespaɲɐ
esperma	ʔespeɾmɐ
espesyal	ʔespeʃal
espesyalista	ʔespeʃɐlistɐ
espina	ʔespinɐ
espinaka	ʔespɪnaxɐ
espinoza	ʔespɪnosɐ
espiritu	ʔespiɾɪtu
espiritwalidad	ʔespɪɾɪtwɐlɪdad
espiya	ʔespiɐ
espiya	ʔespja
espongha	ʔespoŋhɐ
estabillo	ʔestɐbillo
establisimiyento	ʔestɐblɪsɪmjento
establisimyento	ʔestɐblɪsɪmjento
estampa	ʔestampɐ
estampita	ʔestɐmpitɐ
estapa	ʔestapɐ
estapador	ʔestɐpɐdoɾ
estasyon	ʔestɐʃon
estatwa	ʔestatwɐ
estola	ʔestolɐ
estonya	ʔestoɲɐ
estrada	ʔestɾadɐ
estratehiko	ʔestɾɐtehɪxo
estratehiya	ʔestɾɐtehiɐ
estratehiya	ʔestɾɐtehɪa
estrella	ʔestɾellɐ
estronsiyo	ʔestɾonʃo
estruktura	ʔestɾʊktuɾɐ
estudyante	ʔestʊd͡ʒante
etika	ʔetɪxa
etiyopiya	ʔetɪopiɐ
eugenio	jʊheɲo
eva	ʔebɐ
ewan	ʔewɐn
eyre	ʔeɪ̯ɾe
ezra	ʔesɾɐ
fabregas	fabɾeɰɐs
fajardo	pɐhaɾdo
faltado	fɐltado
felicidad	felɪsɪdad
ferriols	feɾɾɪols
figueras	pɪɰeɾɐs
figueroa	fɪɰeɾoɐ
filipina	fɪlɪpinɐ
filipinas	fɪlɪpinɐs
filipino	fɪlɪpino
flora	floɾɐ
fojas	pohɐs
fonacier	fonasɪeɾ
fontelera	fonteleɾɐ
fontillas	pontiljɐs
forteza	foɾtesɐ
franco	fɾaŋko
frias	fɾɪɐs
fronda	fɾondɐ
fuentebella	pʊentebeljɐ
fulgencio	fʊlhenʃo
fung	fʊŋ
furagganan	fʊɾɐɡɡanɐn
ga	ɡɐ
gaan	ɡɐʔan
gaano	ɡɐʔano
gaano	ɡɐʔɐno
gaas	ɡɐʔas
gaban	ɡɐban
gabay	ɡɐbaɪ̯
gabi	ɡabɪ
gabi	ɡɐbi
gabiana	ɡɐbiɐnɐ
gabinete	ɡɐbɪnete
gabok	ɡɐbok
gabon	ɡɐbon
gabriel	ɡɐbɾjel
gabrielle	ɡɐbɾielle
gabya	ɡabjɐ
gacula	ɡɐxulɐ
gacusan	ɡɐxusɐn
gacutan	ɡɐxutɐn
gadgad	ɡɐdɡad
gadya	ɡɐd͡ʒa
gaffud	ɡaffʊd
gaga	ɡaɰɐ
gaga	ɡɐɰa
gagad	ɡɐɰad
gagamba	ɡɐɰɐmba
gagapang	ɡɐɰapɐŋ
gagapang	ɡɐɰɐpaŋ
gago	ɡaɰo
gaguhin	ɡɐɰuhɪn
gahak	ɡahɐk
gahak	ɡɐhak
gahaman	ɡɐhamɐn
gahaman	ɡɐhɐman
gahasa	ɡɐhasɐʔ
gahasa	ɡɐhɐsaʔ
gahi	ɡahɪʔ
gahi	ɡɐhiʔ
gahol	ɡɐhol
gahum	ɡɐhum
gahumay	ɡɐhumaɪ̯
gakgak	ɡɐkɡak
gala	ɡalɐ
gala	ɡalɐʔ
gala	ɡɐlaʔ
galabok	ɡɐlɐbok
galagala	ɡɐlɐɰalɐ
galagala	ɡɐlɐɰɐla
galaiti	ɡɐlɐʔitɪ
galak	ɡɐlak
galakgak	ɡɐlɐkɡak
galalan	ɡɐlalɐn
galalan	ɡɐlɐlan
galamay	ɡɐlɐmaɪ̯
galang	ɡalɐŋ
galang	ɡɐlaŋ
galanggalangan	ɡɐlaŋɡɐlɐŋan
galante	ɡɐlante
galapong	ɡɐlɐpoŋ
galauran	ɡɐlɐʔuɾɐn
galaw	ɡalaʊ̯
galaw	ɡɐlaʊ̯
galawan	ɡɐlawɐn
galawgaw	ɡɐlaʊ̯ɰaʊ̯
galawin	ɡɐlɐwin
gales	ɡɐles
galgal	ɡɐlɡal
galing	ɡalɪŋ
galing	ɡɐliŋ
galis	ɡɐlis
galit	ɡalɪt
galit	ɡɐlit
galitin	ɡɐlitɪn
galon	ɡɐlon
galugad	ɡɐluɰɐd
galugad	ɡɐlʊɰad
galunggong	ɡɐlʊŋɡoŋ
galusgos	ɡɐlʊsɡos
gamay	ɡamaɪ̯
gamay	ɡɐmaɪ̯
gambagamba	ɡɐmbaɰɐmba
gambala	ɡɐmbalɐʔ
gambala	ɡɐmbɐlaʔ
gambang	ɡɐmbaŋ
gambi	ɡɐmbi
gamboa	ɡɐmboɐ
gambol	ɡɐmbol
gamit	ɡamɪt
gamit	ɡɐmit
gamot	ɡɐmot
gamugamo	ɡɐmuɰɐmo
gamutin	ɡɐmʊtin
gan	ɡɐn
gana	ɡanɐ
gana	ɡɐna
ganap	ɡɐnap
gancayco	ɡɐŋkaɪ̯xo
gangsa	ɡɐŋsa
gangsal	ɡɐŋsal
ganid	ɡanɪd
ganire	ɡɐnɪɾe
ganiri	ɡɐnɪɾi
ganito	ɡɐnɪto
ganiyan	ɡɐɲan
ganoon	ɡɐnon
ganoon	ɡɐnoʔon
gansa	ɡansɐ
gansa	ɡɐnsaʔ
gansal	ɡɐnsal
ganta	ɡantɐ
ganta	ɡɐnta
ganti	ɡɐnti
gantihan	ɡantihɐn
gantihan	ɡɐntɪhan
gantimpala	ɡɐntɪmpalɐʔ
ganyak	ɡɐɲak
ganyan	ɡɐɲan
gao	ɡɐo
gaong	ɡɐʔoŋ
gapang	ɡapɐŋ
gapang	ɡɐpaŋ
gapi	ɡapɪʔ
gapi	ɡɐpiʔ
gapo	ɡɐpo
gapo	ɡɐpoʔ
gapok	ɡɐpok
gapong	ɡɐpoŋ
gapos	ɡɐpos
gara	ɡaɾɐʔ
garahe	ɡɐɾahe
garalde	ɡɐɾalde
garapal	ɡɐɾɐpal
garapata	ɡɐɾɐpatɐ
garapon	ɡɐɾɐpon
garay	ɡaɾaɪ̯
garay	ɡɐɾaɪ̯
garbansos	ɡɐɾbansos
garchitorena	ɡɐɾt͡ʃɪtoɾenɐ
garcia	ɡɐɾsiɐ
garciano	ɡɐɾsiɐno
garil	ɡaɾɪl
garil	ɡɐɾil
garing	ɡaɾɪŋ
garote	ɡɐɾote
garupa	ɡɐɾupɐ
gas	ɡɐs
gascon	ɡɐskon
gasela	ɡɐselɐ
gasera	ɡɐseɾɐ
gaseta	ɡɐsetɐ
gasgas	ɡɐsɡas
gasino	ɡɐsino
gaslaw	ɡɐslaʊ̯
gaso	ɡɐso
gasolina	ɡɐsolinɐ
gasolinahan	ɡɐsolɪnɐhan
gaspang	ɡɐspaŋ
gasta	ɡɐsta
gastador	ɡɐstɐdoɾ
gastadora	ɡɐstɐdoɾɐ
gastusin	ɡastʊsin
gastusin	ɡɐstusɪn
gat	ɡɐt
gata	ɡɐtaʔ
gatang	ɡatɐŋ
gatas	ɡatɐs
gatbonton	ɡɐtbonton
gatchalian	ɡɐtt͡ʃaljɐn
gatid	ɡatɪd
gatilyo	ɡɐtiljo
gatlang	ɡɐtlaŋ
gatos	ɡɐtos
gawa	ɡɐwaʔ
gawad	ɡawɐd
gawain	ɡawaʔɪn
gawain	ɡɐwain
gawain	ɡɐwɐʔin
gawak	ɡawɐk
gawak	ɡɐwak
gawalagad	ɡɐwɐlɐɰad
gawan	ɡɐwan
gawangan	ɡɐwaŋɐn
gaway	ɡawaɪ̯
gawgaw	ɡaʊ̯ɰaʊ̯
gawi	ɡawɪʔ
gawi	ɡɐwi
gawi	ɡɐwiʔ
gawin	ɡɐwin
gawis	ɡawɪs
gaya	ɡajɐ
gayak	ɡɐjak
gayang	ɡajɐŋ
gayari	ɡɐjɐɾi
gayas	ɡajɐs
gayas	ɡɐjas
gayat	ɡajɐt
gayon	ɡɐjon
gayot	ɡɐjot
gayuma	ɡɐjumɐ
gayumahin	ɡɐjʊmahɪn
gayundin	ɡɐjʊndin
gayunman	ɡɐjʊmman
gera	ɡeɾɐ
gerilya	ɡeɾiljɐ
gerodias	d͡ʒeɾod͡ʒɐs
gets	ɡet͡s
giba	ɡɪbaʔ
gibang	ɡibɐŋ
gibay	ɡibaɪ̯
gibik	ɡɪbik
giggi	ɡɪɡɡiʔ
gigil	ɡiɰɪl
gigil	ɡɪɰil
giginto	ɡɪɰɪntoʔ
giit	ɡiɪt
giit	ɡɪit
gikla	ɡɪklaʔ
gilagid	ɡɪlaɰɪd
gilagiran	ɡɪlɐɰiɾɐn
gilas	ɡilɐs
gilgil	ɡɪlɡil
gili	ɡɪli
gilib	ɡɪlib
gilid	ɡilɪd
gilik	ɡilɪk
giling	ɡilɪŋ
giling	ɡɪliŋ
gilit	ɡilɪt
gilit	ɡɪlit
giliw	ɡilɪʊ̯
gilong	ɡɪloŋ
gilyotina	ɡɪljotinɐ
gimbal	ɡɪmbal
gimik	ɡimɪk
ginang	ɡinɐŋ
ginataan	ɡɪnɐtɐʔan
ginatan	ɡɪnɐtan
ginaw	ɡɪnaʊ̯
ginawin	ɡɪnɐwin
ginhawa	ɡɪŋhawɐ
gining	ɡinɪŋ
ginintuan	ɡɪnɪntʊʔan
ginip	ɡinɪp
ginisa	ɡɪnɪsa
ginoo	ɡɪnoʔo
ginto	ɡɪntoʔ
gipalpal	ɡɪpɐlpal
gipit	ɡɪpit
gipo	ɡɪpoʔ
gipos	ɡɪpos
girimpula	ɡɪɾɪmpʊla
gisa	ɡɪsa
gisado	ɡɪsado
gisahin	ɡɪsɐhin
gisantes	ɡɪsantes
gisi	ɡisɪʔ
gisi	ɡɪsiʔ
gising	ɡisɪŋ
gising	ɡɪsiŋ
gitang	ɡɪtaŋ
gitara	ɡɪtaɾɐ
gitarista	ɡɪtɐɾistɐ
gitata	ɡɪtatɐʔ
gitata	ɡɪtɐtaʔ
gitgit	ɡɪtɡit
giting	ɡitɪŋ
gitisig	ɡɪtisɪɡ
gitla	ɡɪtlaʔ
gitlapi	ɡɪtlapɪʔ
gitlawas	ɡɪtlawɐs
gitling	ɡɪtliŋ
gitna	ɡɪtnaʔ
gituldok	ɡɪtʊldok
giwa	ɡiwɐʔ
giwang	ɡewɐŋ
giwang	ɡiwɐŋ
giya	ɡiɐ
giyera	ɡjeɾɐ
gladyador	ɡlɐd͡ʒɐdoɾ
gliserina	ɡlɪseɾinɐ
gobernador	ɡobeɾnɐdoɾ
gobernadora	ɡobeɾnɐdoɾɐ
godoy	ɡodoɪ̯
golondrina	ɡolondɾinɐ
goma	ɡomɐ
gorilya	ɡoɾiljɐ
gotiko	ɡotɪxo
graba	ɡɾabɐ
gradweyt	ɡɾadweɪ̯t
gramatika	ɡɾɐmatɪxa
granada	ɡɾɐnadɐ
grapito	ɡɾɐpito
grasa	ɡɾasɐ
grasya	ɡɾaʃɐ
gresya	ɡɾeʃɐ
griyego	ɡɾjeɰo
grumadweyt	ɡɾʊmadweɪ̯t
guanzon	ɡuɐnson
gubat	ɡubɐt
guerra	ɡeɾɐ
gugo	ɡuɰoʔ
gugol	ɡuɰol
guham	ɡʊham
guhit	ɡuhɪt
guho	ɡʊhoʔ
guimaras	ɡɪmɐɾas
gukgok	ɡʊkɡok
gulaman	ɡʊlamɐn
gulang	ɡulɐŋ
gulangan	ɡʊlaŋɐn
gulangan	ɡʊlɐŋan
gulanit	ɡʊlɐnit
gulantang	ɡʊlɐntaŋ
gulat	ɡulɐt
gulat	ɡʊlat
gulay	ɡulaɪ̯
gulo	ɡʊlo
gulo	ɡʊloʔ
gulod	ɡʊlod
gulong	ɡʊloŋ
gulpi	ɡʊlpi
guluhin	ɡʊlʊhin
gulunggulungan	ɡʊlʊŋɡʊluŋɐn
gulyabaw	ɡʊljabaʊ̯
gulyasan	ɡʊljasɐn
gumagad	ɡʊmɐɰad
gumagapang	ɡʊmɐɰapɐŋ
gumala	ɡʊmalɐʔ
gumalaw	ɡʊmɐlaʊ̯
gumaling	ɡɐɰɐliŋ
gumamela	ɡʊmɐmelɐ
gumamit	ɡʊmamɪt
gumanap	ɡʊmɐnap
gumanda	ɡʊmɐnda
gumapac	ɡʊmapɐk
gumapang	ɡʊmapɐŋ
gumastos	ɡʊmɐstos
gumawa	ɡʊmɐwaʔ
gumayak	ɡʊmɐjak
gumi	ɡumɪ
gumi	ɡumɪʔ
gumi	ɡʊmi
gumilid	ɡʊmilɪd
gumimik	ɡʊmimɪk
gumiran	ɡʊmiɾɐn
gumising	ɡʊmisɪŋ
gumuho	ɡʊmuhoʔ
gumulang	ɡʊmulɐŋ
gumulo	ɡʊmʊlo
gumulong	ɡʊmuloŋ
gumuwapo	ɡʊmwɐpo
gunaw	ɡunaʊ̯
gunaw	ɡʊnaʊ̯
gunggong	ɡʊŋɡoŋ
guni	ɡʊni
guniguni	ɡʊniɰʊni
gunimbilang	ɡʊnɪmbilɐŋ
gunita	ɡʊnɪtaʔ
guno	ɡʊno
gunot	ɡʊnot
gunting	ɡʊntiŋ
gupiling	ɡʊpilɪŋ
gupit	ɡʊpit
gupo	ɡʊpoʔ
gurami	ɡʊɾamɪ
gurlis	ɡʊɾlis
guro	ɡʊɾoʔ
gusali	ɡʊsalɪʔ
gusgos	ɡʊsɡos
gusgusin	ɡʊsɡusɪn
gusi	ɡusɪʔ
gusilaw	ɡʊsilaʊ̯
gusot	ɡʊsot
gusto	ɡʊsto
gutay	ɡʊtaɪ̯
gutom	ɡʊtom
gutoy	ɡʊtoɪ̯
guwano	ɡwɐno
guwantes	ɡwɐntes
guwapa	ɡwɐpɐ
guwapo	ɡwɐpo
guwardakosta	ɡwaɾdɐxostɐ
guwardiya	ɡwaɾd͡ʒa
guwatemala	ɡʊɐtemalɐ
guya	ɡujɐʔ
guyabano	ɡʊjɐbano
guyam	ɡujɐm
guyana	ɡʊjanɐ
guzman	ɡʊsman
ha	hɐ
haba	habɐ
haba	habɐʔ
haba	hɐbaʔ
habag	hɐbaɡ
habagat	hɐbaɰɐt
habambuhay	hɐbɐmbuhaɪ̯
haban	hɐban
habang	habɐŋ
habang	hɐbaŋ
habhab	habhɐb
habi	habɪ
habi	habɪʔ
habi	hɐbi
habid	hɐbid
habilin	hɐbilɪn
habilog	hɐbɪloɡ
habitsuwelas	hɐbɪt͡ʃʊelɐs
habla	hɐbla
hablot	hɐblot
habol	hɐbol
habonera	hɐboneɾɐ
habonero	hɐboneɾo
habonete	hɐbonete
habubos	hɐbubos
habulin	hɐbulɪn
hadlang	hɐdlaŋ
hagad	haɰɐd
hagahas	hɐɰɐhas
hagak	haɰɐk
hagak	hɐɰak
hagakhak	hɐɰɐkhak
hagap	haɰɐp
hagdan	hɐɡdan
hagdanan	hɐɡdanɐn
hagdanan	hɐɡdɐnan
hagibis	hɐɰibɪs
hagibis	hɐɰɪbis
hagikgik	hɐɰɪkɡik
hagilap	hɐɰilɐp
hagip	hɐɰip
hagis	haɰɪs
hagkan	hɐɡkan
hagod	haɰod
hagod	hɐɰod
hagok	haɰok
hagonoy	hɐɰonoɪ̯
hagulgol	hɐɰʊlɡol
hagulhol	hɐɰʊlhol
hagunoy	hɐɰunoɪ̯
hagupit	hɐɰʊpit
haha	hahɐʔ
haha	hɐha
haha	hɐhaʔ
hahagkan	hahɐɡkan
hain	haʔɪn
haka	haxɐʔ
hakay	hɐxaɪ̯
hakbang	hɐkbaŋ
hakhak	hɐkhak
haklit	hɐklit
hakot	haxot
hakot	hɐxot
halaan	hɐlaʔɐn
halaan	hɐlɐʔan
halabos	hɐlɐbos
halaga	hɐlɐɰa
halak	hɐlak
halakhak	hɐlɐkhak
halal	hɐlal
halalan	hɐlalɐn
halaman	hɐlamɐn
halang	halɐŋ
halang	hɐlaŋ
halangan	hɐlaŋɐn
halari	hɐlaɾɪʔ
halas	halɐs
halasan	hɐlasɐn
halata	hɐlɐtaʔ
halay	halaɪ̯
halayhay	hɐlɐjhaɪ̯
halea	haleɐ
halea	hɐleja
halhal	hɐlhal
halibhib	hɐlɪbhib
haligi	hɐliɰɪ
haligutgot	hɐlɪɰʊtɡot
halihaw	hɐlihaʊ̯
halik	hɐlik
halika	hɐlixɐ
halika	hɐlɪxa
halikan	halixɐn
halikan	hɐlɪxan
halili	hɐlilɪ
halili	hɐlɪli
halimaw	hɐlimaʊ̯
halimbawa	hɐlɪmbawɐʔ
halimunmon	hɐlɪmʊmmon
halimuyak	hɐlɪmujɐk
halina	hɐlinɐ
haling	halɪŋ
haling	hɐliŋ
halintulad	hɐlɪntulɐd
halip	hɐlip
haliparot	hɐlɪpaɾot
haliparot	hɐlɪpɐɾot
haliryo	hɐlɪɾjo
halo	hɐlo
halo	hɐloʔ
haltak	hɐltak
halubid	hɐlʊbid
halubilo	hɐlʊbilo
halughog	hɐlʊɡhoɡ
halukay	hɐluxaɪ̯
halukay	hɐlʊxaɪ̯
halukipkip	hɐlʊxɪpkip
halumigmig	hɐlʊmɪɡmiɡ
halungkat	hɐlʊŋkat
hamak	hamɐk
hamayka	hɐmaɪ̯xɐ
hambalang	hɐmbalɐŋ
hambalos	hɐmbalos
hambaw	hɐmbaʊ̯
hambing	hɐmbiŋ
hambo	hɐmbo
hambog	hɐmboɡ
hamil	hamɪl
hamil	hɐmil
hamog	hɐmoɡ
hamon	hɐmon
hampas	hɐmpas
hampaslupa	hɐmpaslupɐʔ
hampol	hɐmpol
hanako	hɐnaxo
hanap	hanɐp
hanapbuhay	hɐnɐpbuhaɪ̯
hanapin	hɐnapɪn
hanay	hanaɪ̯
hanayan	hɐnajɐn
hanayan	hɐnɐjan
handa	hɐndaʔ
handak	hɐndak
handalapak	hɐndɐlɐpak
handog	hɐndoɡ
handusay	hɐndʊsaɪ̯
hanga	haŋɐ
hanga	haŋɐʔ
hangad	hɐŋad
hangal	haŋɐl
hangal	hɐŋal
hangarin	hɐŋaɾɪn
hangarin	hɐŋɐɾin
hanggan	hɐŋɡan
hangganan	hɐŋɡanɐn
hangganan	hɐŋɡɐnan
hanggang	hɐŋɡaŋ
hangin	haŋɪn
hanginsigan	hɐŋɪnsiɰɐn
hangintigilan	hɐŋɪntiɰilɐn
hango	hɐŋoʔ
hangos	hɐŋos
hanip	hanɪp
hantik	hɐntik
hantikan	hɐntixɐn
hantong	hɐntoŋ
hantungan	hɐntuŋɐn
hantungan	hɐntʊŋan
hanunuo	hanʊnuʔo
hapag	hɐpaɡ
hapak	hɐpak
hapdi	hɐpdiʔ
hapin	hɐpin
hapis	hapɪs
hapis	hɐpis
hapit	hapɪt
hapit	hɐpit
haplos	hɐplos
hapo	hɐpoʔ
hapon	hɐpon
hapones	hɐpones
haponesa	hɐponesɐ
hapunan	hɐpunɐn
hapunan	hɐpʊnan
harakiri	hɐɾɐxiɾɪ
harana	hɐɾanɐ
harang	haɾɐŋ
harang	hɐɾaŋ
harap	hɐɾap
harapan	haɾapɐn
harapan	hɐɾɐpan
haraya	hɐɾajɐʔ
hardin	hɐɾdin
hardinera	hɐɾdɪneɾɐ
hardinero	hɐɾdɪneɾo
hari	haɾɪ
hari	haɾɪʔ
haribon	haɾɪbon
harimanawari	haɾɪmɐnɐwaɾɪʔ
harina	hɐɾinɐ
haro	hɐɾo
harot	hɐɾot
haruko	hɐɾuxo
harurot	hɐɾuɾot
hasa	hasɐʔ
hasa	hɐsaʔ
hasain	hɐsaʔɪn
hasang	hasɐŋ
hasik	hɐsik
hasinto	hɐsinto
hasmin	hɐsmin
haso	hɐsoʔ
haspe	hɐspe
hatak	hatɐk
hatak	hɐtak
hataw	hataʊ̯
hati	hatɪʔ
hati	hɐtiʔ
hatid	hɐtid
hatiin	hɐtiʔɪn
hatiin	hɐtɪʔin
hatimbilang	hɐtɪmbilɐŋ
hatimbutod	hatɪmbʊtod
hatinggabi	hatɪŋɡɐbi
hatinig	hɐtinɪɡ
hatsing	hɐt͡ʃiŋ
hatsuko	hɐt͡ʃuxo
hawa	hawɐ
hawa	hawɐʔ
hawak	hawɐk
hawakan	hɐwaxɐn
hawakan	hɐwɐxan
haway	hɐwaɪ̯
hawayana	hɐwɐjanɐ
hawayano	hɐwɐjano
hawi	hawɪʔ
hawi	hɐwiʔ
hawig	hawɪɡ
hawig	hɐwiɡ
hawla	haʊ̯lɐ
hawong	hɐwoŋ
hawsyaw	haʊ̯ʃaʊ̯
haya	hajɐʔ
hayaan	hɐjaʔɐn
hayag	hajɐɡ
hayag	hɐjaɡ
hayan	hɐjan
haykap	haɪ̯xap
hayku	haɪ̯xʊ
haynayan	haɪ̯najɐn
hayok	hɐjok
hayon	hɐjon
hayskul	haɪ̯skʊl
hayto	haɪ̯to
heko	hexo
hektarya	hektaɾjɐ
helikoptero	helɪxopteɾo
henerala	heneɾalɐ
henerasyon	heneɾɐʃon
henetika	henetɪxa
henyo	heɲo
heograpiko	heoɡɾapɪxo
heograpiya	heoɡɾɐpiɐ
heolohiya	heolohiɐ
heranyo	heɾaɲo
herarkiya	heɾɐɾkiɐ
heringgilya	heɾɪŋɡiljɐ
heroglipiko	heɾoɡlipɪxo
herradura	ʔeɾɐduɾɐ
hesukristo	hesʊkɾisto
hesusmaryosep	hesusmɐɾjosep
heswita	heswitɐ
hibang	hibɐŋ
hibang	hɪbaŋ
hibaybay	hɪbaɪ̯baɪ̯
hibi	hibɪ
hibi	hɪbiʔ
hibla	hɪbla
hidwa	hɪdwaʔ
hidwaan	hɪdwaʔɐn
higa	hɪɰaʔ
higante	hɪɰante
higanti	hɪɰɐnti
higit	hɪɰit
higlikas	hɪɡlɪxas
higliknayan	hɪɡlɪknajɐn
higop	hiɰop
higsipnayan	hɪɡsɪpnajɐn
higtao	hɪɡtaʔo
hihip	hihɪp
hika	hixɐ
hika	hixɐʔ
hikab	hɪxab
hikahos	hɪxahos
hikahos	hɪxɐhos
hikaw	hixaʊ̯
hikayat	hɪxajɐt
hikbi	hɪkbi
hikbi	hɪkbiʔ
hiklas	hɪklas
hikmat	hɪkmat
hila	hilɐ
hilab	hilɐb
hilabigat	hilɐbɪɰat
hilaga	hɪlaɰɐʔ
hilahid	hɪlahɪd
hilahil	hɪlahɪl
hilahil	hɪlɐhil
hilako	hɪlɐxoʔ
hilam	hilɐm
hilam	hɪlam
hilamos	hɪlamos
hilata	hɪlatɐʔ
hilata	hɪlɐtaʔ
hilatsa	hɪlat͡ʃɐ
hilatsa	hɪlɐt͡ʃa
hilaw	hɪlaʊ̯
hilera	hɪleɾɐ
hilig	hilɪɡ
hilig	hɪliɡ
hilik	hɪlik
hiling	hɪliŋ
hilo	hɪlo
hilom	hɪlom
himagas	hɪmaɰɐs
himagsik	hɪmɐɡsik
himagsikan	hɪmɐɡsixɐn
himala	hɪmɐlaʔ
himanting	hɪmɐntiŋ
himas	himɐs
himas	hɪmas
himasmas	hɪmɐsmas
himasok	hɪmasok
himatay	hɪmɐtaɪ̯
himatayin	hɪmɐtɐjin
himay	himaɪ̯
himay	hɪmaɪ̯
himbabahay	hɪmbɐbahaɪ̯
himbak	hɪmbak
himbing	hɪmbiŋ
himig	himɪɡ
himlay	hɪmlaɪ̯
himnasta	hɪmnastɐ
himnasyo	hɪmnaʃo
himok	hɪmok
himpapawid	hɪmpɐpɐwid
himpil	hɪmpil
himpilan	hɪmpilɐn
himpilan	hɪmpɪlan
himuti	hɪmutɪ
himuti	hɪmʊtiʔ
himutok	hɪmʊtok
hina	hinɐʔ
hinagkan	hɪnɐɡkan
hinagpis	hɪnɐɡpis
hinahabol	hɪnɐhabol
hinahagkan	hɪnahɐɡkan
hinahon	hɪnahon
hinaing	hɪnɐʔiŋ
hinakdal	hɪnɐkdal
hinala	hɪnalɐʔ
hinanakit	hɪnɐnɐxit
hinang	hinɐŋ
hinas	hinɐs
hinaw	hinaʊ̯
hinaw	hɪnaʊ̯
hinay	hinaɪ̯
hinayang	hɪnajɐŋ
hinayupak	hɪnɐjupɐk
hindi	hɪndeʔ
hindi	hɪndiʔ
hindot	hɪndot
hinebra	hɪnebɾɐ
hinga	hɪŋa
hingal	hiŋɐl
hingal	hɪŋal
hingalin	hɪŋalɪn
hingalo	hɪŋɐloʔ
hingan	hɪŋan
hinggigitna	hɪŋɡɪɰɪtnaʔ
hinggil	hɪŋɡil
hingi	hɪŋiʔ
hinguto	hɪŋuto
hinhin	hɪŋhin
hininga	hɪnɪŋa
hinlalaki	hɪnlɐlɐxi
hinlalato	hɪnlɐlatoʔ
hinliliit	hɪnlɪlɪʔit
hinlog	hɪnloɡ
hinog	hɪnoɡ
hintay	hɪntaɪ̯
hinto	hɪntoʔ
hintutubi	hɪntʊtʊbi
hintuturo	hɪntʊtuɾoʔ
hinuha	hɪnuhɐʔ
hipag	hipɐɡ
hipan	hipɐn
hipig	hɪpiɡ
hipik	hɪpik
hipno	hɪpno
hipno	hɪpnoʔ
hipnosis	hɪpnosɪs
hipokrito	hɪpokɾɪto
hipolito	hɪpolito
hira	hiɾɐ
hira	hɪɾa
hira	hɪɾaʔ
hiram	hɪɾam
hirang	hiɾɐŋ
hirang	hɪɾaŋ
hirap	hiɾɐp
hirap	hɪɾap
hirasol	hɪɾɐsol
hirat	hiɾɐt
hiraya	hɪɾajɐʔ
hiringgilya	hɪɾɪŋɡiljɐ
hirit	hiɾɪt
hiroko	hɪɾoxo
hispanismo	hɪspɐnismo
historya	hɪstoɾjɐ
historyador	hɪstoɾjɐdoɾ
hita	hitɐʔ
hita	hɪtaʔ
hitad	hitɐd
hitad	hɪtad
hithit	hɪthit
hithitin	hɪthɪtin
hitso	hɪt͡ʃo
hitsura	hɪt͡ʃuɾɐ
hiwa	hiwɐʔ
hiwa	hɪwaʔ
hiwaga	hɪwaɰɐʔ
hiwalay	hɪwalaɪ̯
hiwalay	hɪwɐlaɪ̯
hiwas	hɪwas
hiwatig	hɪwatɪɡ
hiwis	hɪwis
hiya	hɪa
hiya	hɪaʔ
hiyas	hɪas
hiyaw	hɪaʊ̯
hiyo	hɪo
hiyo	hɪoʔ
holdap	holdɐp
homiliya	homɪliɐ
hopya	hopjɐʔ
hortaleza	hoɾtɐlesɐ
hototay	hototaɪ̯
hoy	hoɪ̯
hubad	hʊbad
hubo	hʊboʔ
hudas	hudɐs
hudikatura	hʊdɪxɐtuɾɐ
hudyat	hʊd͡ʒat
hudyo	hʊd͡ʒo
hugas	huɰɐs
hugasan	hʊɰasɐn
hugasan	hʊɰɐsan
hugis	huɰɪs
hugot	huɰot
hugot	hʊɰot
hugpong	hʊɡpoŋ
huk	hʊk
hukay	huxaɪ̯
hukbalahap	hʊkbɐlahɐp
hukbo	hʊkbo
hukbo	hʊkboʔ
hukom	hʊxom
hukot	huxot
hukot	hʊxot
hukuman	huxumɐn
hukuman	hʊxʊman
hula	hulɐʔ
hulagpos	hʊlɐɡpos
hulapi	hʊlapɪʔ
huli	hulɪ
huli	hulɪʔ
huli	hʊli
huli	hʊliʔ
hulma	hʊlma
hulog	hʊloɡ
huma	hʊma
humadlang	hʊmɐdlaŋ
humagikgik	hʊmɐɰɪkɡik
humagulgol	hʊmɐɰʊlɡol
humagulhol	hʊmɐɰʊlhol
humalakhak	hʊmɐlɐkhak
humalik	hʊmɐlik
humalili	hʊmɐlilɪ
humaling	hʊmalɪŋ
humanda	hʊmɐndaʔ
humandusay	hʊmɐndusaɪ̯
humatsing	hʊmɐt͡ʃiŋ
humawak	hʊmawɐk
humiga	hʊmɪɰaʔ
humigit	hʊmɪɰit
humilab	hʊmilɐb
humimas	hʊmimɐs
humina	hʊminɐʔ
humingi	hʊmɪŋiʔ
huminto	hʊmɪntoʔ
humiram	hʊmɪɾam
humirap	hʊmiɾɐp
humpay	humpaɪ̯
humuthot	hʊmʊthot
hung	hʊŋ
hunghang	hʊŋhaŋ
hungkag	hʊŋkaɡ
huni	hunɪ
hunos	hʊnos
hunta	huntɐ
hunyango	hʊɲɐŋoʔ
hunyo	huɲo
hupa	hʊpaʔ
hupiter	hupɪteɾ
hurado	hʊɾado
huramentado	hʊɾɐmentado
hurisdiksiyon	hʊɾɪsdɪkʃon
hurisdiksyon	hʊɾɪsdɪkʃon
husay	husaɪ̯
husay	hʊsaɪ̯
husga	hʊsɡa
husgado	hʊsɡado
husgahan	hʊsɡɐhan
husi	husɪ
hustisya	hʊstiʃɐ
husto	hʊsto
huthot	hʊthot
huwad	hʊad
huwag	hʊaɡ
huwag	wɐɡ
huwas	hʊas
huwebes	hʊebes
huwepe	hʊepe
huwes	hʊes
huweteng	hʊeteŋ
huwisyo	hʊɪʃo
huy	hʊɪ
huyad	hujɐd
huyong	hʊjoŋ
iba	ʔibɐ
iba	ʔibɐʔ
iba	ʔɪba
ibabaw	ʔɪbabaʊ̯
ibag	ʔibɐɡ
ibagsak	ʔɪbɐɡsak
ibahaw	ʔɪbahaʊ̯
ibahin	ʔɪbɐhin
ibalik	ʔɪbɐlik
ibaloy	ʔɪbɐloɪ̯
ibarra	ʔɪbaɾɐ
ibasco	ʔɪbasko
ibay	ʔibaɪ̯
ibayo	ʔɪbajo
ibayo	ʔɪbɐjo
ibenta	ʔɪbentɐ
ibig	ʔibɪɡ
ibili	ʔɪbɪli
ibis	ʔibɪs
ibis	ʔɪbis
iboto	ʔɪboto
iboykot	ʔɪboɪ̯xot
ibutod	ʔɪbʊtod
ichiro	ʔɪt͡ʃiɾo
idalum	ʔɪdalʊm
idea	ʔɪdeja
idea	ʔɪdejɐ
ideal	ʔɪdejal
idealismo	ʔɪdejɐlismo
idealista	ʔɪdejɐlistɐ
identidad	ʔɪdentɪdad
identipika	ʔɪdentɪpɪxa
identipikasyon	ʔɪdentɪpɪxɐʃon
ideolohiya	ʔɪdeolohiɐ
idlip	ʔɪdlip
idolatriya	ʔɪdolɐtɾiɐ
idroheno	ʔɪdɾoheno
idyota	ʔɪd͡ʒotɐ
ifugao	ʔɪpʊɰaʊ̯
igapos	ʔɪɰapos
igat	ʔiɰɐt
igera	ʔɪɰeɾɐ
igi	ʔiɰɪ
igib	ʔɪɰib
igik	ʔɪɰik
igkas	ʔɪɡkas
igkasin	ʔɪɡkasɪn
iglap	ʔɪɡlap
iglesya	ʔɪɡleʃɐ
ignacio	ʔɪɡnaʃo
ignoransiya	ʔɪɡnoɾanʃɐ
ignorante	ʔɪɡnoɾante
igop	ʔiɰop
igorot	ʔɪɰoɾot
igsi	ʔɪɡsiʔ
igting	ʔɪɡtiŋ
iha	ʔihɐ
ihagis	ʔɪhaɰɪs
ihalintulad	ʔɪhɐlɪntulɐd
ihambing	ʔɪhɐmbiŋ
ihap	ʔihɐp
ihaw	ʔihaʊ̯
ihi	ʔihɪʔ
ihi	ʔɪhiʔ
ihip	ʔihɪp
iilan	ʔɪʔɪlan
ika	ʔixɐʔ
ika	ʔɪxaʔ
ikaanim	ʔɪxɐʔanɪm
ikaapat	ʔɪxɐʔapɐt
ikabilanggo	ʔɪxɐbɪlɐŋɡoʔ
ikabit	ʔɪxɐbit
ikadalawampu	ʔɪxɐdɐlɐwɐmpuʔ
ikagalit	ʔɪxɐɰalɪt
ikaisa	ʔɪxɐʔɪsa
ikalabimpito	ʔɪxɐlɐbimpɪto
ikalabindalawa	ʔɪxɐlɐbindɐlɐwa
ikalabingwalo	ʔɪxɐlɐbiŋwɐlo
ikalabinlima	ʔɪxɐlɐbinlɪma
ikalabinsiyam	ʔɪxɐlɐbinʃam
ikalabintatlo	ʔɪxɐlɐbintɐtlo
ikalat	ʔɪxalɐt
ikalawa	ʔɪxɐlɐwa
ikalima	ʔɪxɐlɪma
ikapito	ʔɪxɐpɪto
ikasampu	ʔɪxɐsɐmpuʔ
ikasiyam	ʔɪxɐʃam
ikatlo	ʔɪxɐtlo
ikaw	ʔɪxaʊ̯
ikawalo	ʔɪxɐwɐlo
ikid	ʔixɪd
ikit	ʔixɪt
ikit	ʔɪxit
ikli	ʔɪkliʔ
ikmo	ʔɪkmo
iknat	ʔɪknat
ikog	ʔixoɡ
iksi	ʔɪksiʔ
ikuha	ʔɪxuhɐ
ikuko	ʔɪxuko
ilag	ʔilɐɡ
ilag	ʔɪlaɡ
ilagan	ʔɪlaɰɐn
ilagay	ʔɪlɐɰaɪ̯
ilalim	ʔɪlalɪm
ilan	ʔɪlan
ilang	ʔɪlaŋ
ilao	ʔilaʊ̯
ilap	ʔɪlap
ilat	ʔilɐt
ilaw	ʔilaʊ̯
ilay	ʔilaɪ̯
ilegal	ʔɪleɰal
ilegalidad	ʔɪleɰɐlɪdad
ilehitimo	ʔɪlehilɪmo
iligan	ʔɪliɰɐn
iliko	ʔɪlɪxoʔ
iling	ʔɪliŋ
iliw	ʔilɪʊ̯
ilocos	ʔɪloxos
ilohikal	ʔɪlohɪxal
ilohiko	ʔɪlohɪxo
iloilo	ʔɪloʔilo
ilokana	ʔɪloxanɐ
ilokano	ʔɪloxano
iloko	ʔɪloxo
ilong	ʔɪloŋ
ilot	ʔɪlot
iluminasyon	ʔɪlʊmɪnɐʃon
ilustre	ʔɪlustɾe
ilusyon	ʔɪlʊʃon
imahe	ʔɪmahe
imahen	ʔɪmahen
imahinasyon	ʔɪmɐhɪnɐʃon
imbalido	ʔɪmbalɪdo
imbentaryo	ʔɪmbentaɾjo
imbento	ʔɪmbento
imbes	ʔɪmbes
imbestigasyon	ʔɪmbestɪɰɐʃon
imbita	ʔɪmbɪta
imbitado	ʔɪmbɪtado
imbudo	ʔɪmbudo
imburnal	ʔɪmbʊɾnal
imigrasyon	ʔɪmɪɡɾɐʃon
imoral	ʔɪmoɾal
imoralidad	ʔɪmoɾɐlɪdad
impakto	ʔɪmpakto
impapawid	ʔɪmpɐpɐwid
imparsiyal	ʔɪmpɐɾʃal
impatso	ʔɪmpat͡ʃo
impeksiyon	ʔɪmpekʃon
imperensiya	ʔɪmpeɾenʃa
imperial	ʔɪmpeɾjɐl
imperyalismo	ʔɪmpeɾjɐlismo
imperyalista	ʔɪmpeɾjɐlistɐ
imperyo	ʔɪmpeɾjo
impilya	ʔɪmpiljɐ
impinitibo	ʔɪmpɪnɪtibo
impis	ʔɪmpis
impiyerno	ʔɪmpjeɾno
implamasyon	ʔɪmplɐmɐʃon
implasyon	ʔɪmplɐʃon
impluwensiya	ʔɪmplwenʃɐ
impluwensiya	ʔɪmplʊensiɐ
impo	ʔɪmpo
impormal	ʔɪmpoɾmal
impormante	ʔɪmpoɾmante
impormasyon	ʔɪmpoɾmɐʃon
importansiya	ʔɪmpoɾtanʃa
importante	ʔɪmpoɾtante
imposibilidad	ʔɪmposɪbɪlɪdad
imposible	ʔɪmposible
impraestruktura	ʔɪmpɾɐʔestɾʊktuɾɐ
imprastraktura	ʔɪmpɾɐstɾɐktuɾɐ
imprastruktura	ʔɪmpɾɐstɾʊktuɾɐ
imus	ʔimʊs
ina	ʔɪna
ina	ʔɪnaʔ
inaaaban	ʔɪnaʔɐʔɐban
inaaban	ʔɪnɐʔɐban
inaama	ʔɪnaʔɐma
inaanak	ʔɪnaʔɐnak
inaantok	ʔɪnɐʔɐntok
inag	ʔinɐɡ
inagurasyon	ʔɪnɐɰʊɾɐʃon
inahin	ʔɪnɐhin
inain	ʔɪnɐʔin
inakay	ʔɪnaxaɪ̯
inakay	ʔɪnɐxaɪ̯
inam	ʔinɐm
inampalan	ʔɪnampɐlan
inampalan	ʔɪnɐmpalɐn
inana	ʔɪnanɐ
inanak	ʔɪnɐnak
inang	ʔɪnaŋ
inangit	ʔɪnɐŋit
inano	ʔɪnanoʔ
inano	ʔɪnɐno
inapo	ʔɪnɐpo
inat	ʔinɐt
inat	ʔɪnat
inay	ʔɪnaɪ̯
inda	ʔɪnda
inda	ʔɪndaʔ
indahin	ʔɪndɐhin
indak	ʔɪndak
inday	ʔɪndaɪ̯
indayog	ʔɪndajoɡ
indemnisasyon	ʔɪndemnɪsɐʃon
independensiya	ʔɪndependenʃa
independiyente	ʔɪndepend͡ʒente
indesente	ʔɪndesente
indibidwal	ʔɪndɪbɪdwal
indibidwalidad	ʔɪndɪbɪdwɐlɪdad
indibidwalismo	ʔɪndɪbɪdwɐlismo
indignasyon	ʔɪndɪɡnɐʃon
indikasyon	ʔɪndɪxɐʃon
indiya	ʔindɪɐ
indiyan	ʔind͡ʒan
indiyana	ʔɪnd͡ʒanɐ
indiyano	ʔɪnd͡ʒano
indiyo	ʔɪnd͡ʒo
indones	ʔɪndones
indonesa	ʔɪndonesɐ
indonesya	ʔɪndoneʃɐ
indotsina	ʔɪndot͡ʃinɐ
indulhensiya	ʔɪndʊlhenʃa
indulto	ʔɪndulto
industriya	ʔɪndustɾja
industriyal	ʔɪndʊstɾjal
industriyalisasyon	ʔɪndustɾɪɐlɪsɐʃon
industriyalismo	ʔɪndʊstɾɪɐlismo
industriyalista	ʔɪndʊstɾɪɐlistɐ
ineng	ʔɪneŋ
infante	ʔɪmpante
ingat	ʔiŋɐt
ingay	ʔiŋaɪ̯
inggit	ʔɪŋɡit
inggitera	ʔɪŋɡɪteɾɐ
inggitero	ʔɪŋɡɪteɾo
inggo	ʔɪŋɡo
inggo	ʔɪŋɡoʔ
ingil	ʔiŋɪl
ingit	ʔɪŋit
ingkilino	ʔɪŋkɪlino
ingklinasyon	ʔɪŋklɪnɐʃon
ingklitik	ʔɪŋklitɪk
ingklusibo	ʔɪŋklʊsibo
ingklusyon	ʔɪŋklʊʃon
ingkong	ʔɪŋkoŋ
ingkorporasyon	ʔɪŋkoɾpoɾɐʃon
inglatera	ʔɪŋɡlɐteɾɐ
ingles	ʔɪŋɡles
inglesa	ʔɪŋɡlesɐ
inglesera	ʔɪŋɡleseɾɐ
inglesero	ʔɪŋɡleseɾo
ingrato	ʔɪŋɡɾato
ingreso	ʔɪŋɡɾeso
inhenyero	ʔɪŋheɲeɾo
inhinyero	ʔɪŋhɪɲeɾo
iniba	ʔɪnibɐʔ
iniba	ʔɪnɪba
iniina	ʔɪniʔɪna
ining	ʔɪniŋ
inip	ʔɪnip
inis	ʔɪnis
inisyatiba	ʔɪnɪʃɐtibɐ
inisyatibo	ʔɪnɪʃɐtibo
init	ʔinɪt
initan	ʔinitɐn
initan	ʔɪnitɐn
initan	ʔɪnɪtan
initdagitban	ʔinɪtdɐɰɪtban
initkapnayan	ʔinɪtkɐpnajɐn
initsigan	ʔinɪt͡siɰɐn
initsupil	ʔinɪt͡supɪl
inla	ʔɪnla
inmigrasyon	ʔɪmmɪɡɾɐʃon
inmigrasyon	ʔɪmɪɡɾɐʃon
inmoral	ʔɪmmoɾal
inmoral	ʔɪmoɾal
inmoralidad	ʔɪmmoɾɐlɪdad
inmoralidad	ʔɪmoɾɐlɪdad
ino	ʔɪno
inodoro	ʔɪnodoɾo
inom	ʔɪnom
inosente	ʔɪnosente
insekto	ʔɪnsekto
insensaryo	ʔɪnsensaɾjo
insensitibo	ʔɪnsensɪtibo
insenso	ʔɪnsenso
insentibo	ʔɪnsentibo
insesto	ʔɪnsesto
insidente	ʔɪnsɪdente
inskripsiyon	ʔɪnskɾɪpʃon
inso	ʔɪnso
inspeksiyon	ʔɪnspekʃon
inspeksiyunin	ʔɪnspeksɪʊ̯nin
inspektor	ʔɪnspektoɾ
inspirado	ʔɪnspɪɾado
inspirasyon	ʔɪnspɪɾɐʃon
instalasyon	ʔɪnstɐlɐʃon
instansiya	ʔɪnstanʃa
instigador	ʔɪnstɪɰɐdoɾ
institusyon	ʔɪnstɪtʊʃon
instituto	ʔɪnstɪtuto
instruksiyon	ʔɪnstɾʊkʃon
instruktor	ʔɪnstɾʊktoɾ
instrumento	ʔɪnstɾʊmento
insubordinasyon	ʔɪnsʊboɾdɪnɐʃon
insulares	ʔɪnsʊlaɾes
insulto	ʔɪnsulto
insupisyente	ʔɪnsʊpɪʃente
insureksiyon	ʔɪnsʊɾekʃon
insurekto	ʔɪnsʊɾekto
insurhensiya	ʔɪnsʊɾhenʃa
integral	ʔɪnteɡɾal
integrasyon	ʔɪnteɡɾɐʃon
integridad	ʔɪnteɡɾɪdad
intelihensiya	ʔɪntelɪhenʃa
intelihente	ʔɪntelɪhente
intensibo	ʔɪntensibo
intensiyon	ʔɪntenʃon
intensiyonal	ʔɪntensɪonal
interbensiyon	ʔɪnteɾbenʃon
interbiyu	ʔinteɾbju
interes	ʔɪnteɾes
interesado	ʔɪnteɾesado
intermisyon	ʔɪnteɾmɪʃon
interogasyon	ʔɪnteɾoɰɐʃon
interpretasyon	ʔɪnteɾpɾetɐʃon
interprete	ʔɪnteɾpɾete
interseksiyon	ʔɪnteɾsekʃon
interyor	ʔɪnteɾjoɾ
intimidasyon	ʔɪntɪmɪdɐʃon
intindi	ʔɪntɪndi
intindihin	ʔɪntɪndɪhin
intoksikasyon	ʔɪntoksɪxɐʃon
intriga	ʔɪntɾiɰɐ
introduksiyon	ʔɪntɾodʊkʃon
intrusyon	ʔɪntɾʊʃon
intsik	ʔɪnt͡ʃik
intuwisyon	ʔɪntʊɪʃon
inugsukat	ʔɪnʊɡsuxɐt
inuman	ʔinumɐn
inuman	ʔɪnʊman
inumin	ʔinumɪn
inumin	ʔɪnʊmin
inunan	ʔɪnunɐn
inundasyon	ʔɪnʊndɐʃon
inupas	ʔɪnupɐs
inutil	ʔɪnutɪl
inyo	ʔɪɲo
ip	ʔɪp
ipa	ʔɪpa
ipaayos	ʔɪpɐʔajos
ipabasa	ʔɪpɐbasɐ
ipabasa	ʔɪpɐbɐsaʔ
ipadala	ʔɪpɐdɐla
ipagawa	ʔɪpɐɰɐwaʔ
ipagbilin	ʔɪpɐɡbilɪn
ipagmalaki	ʔɪpɐɡmɐlɐxi
ipagsanggalang	ʔɪpɐɡsɐŋɡɐlaŋ
ipaintindi	ʔɪpɐʔɪntɪndi
ipakausap	ʔɪpɐxɐʔusɐp
ipakita	ʔɪpɐxitɐ
ipakita	ʔɪpɐxitɐʔ
ipakuha	ʔɪpɐxuhɐ
ipakuha	ʔɪpɐxuhɐʔ
ipalinis	ʔɪpɐlinɪs
ipamigay	ʔɪpɐmɪɰaɪ̯
ipangako	ʔɪpɐŋaxoʔ
ipantakip	ʔɪpɐntɐxip
iparusa	ʔɪpɐɾusɐ
ipasagot	ʔɪpɐsɐɰot
ipasok	ʔɪpasok
ipatanggal	ʔɪpɐtɐŋɡal
ipatapon	ʔɪpɐtapon
ipatong	ʔɪpatoŋ
ipil	ʔipɪl
ipis	ʔipɪs
ipit	ʔipɪt
ipodromo	ʔɪpodɾomo
ipokrisiya	ʔɪpokɾɪsiɐ
ipokrita	ʔɪpokɾɪta
ipon	ʔɪpon
iprint	ʔɪpɾint
ipuipo	ʔɪpʊʔipo
ipunin	ʔɪpunɪn
irak	ʔɪɾak
iran	ʔɪɾan
irebisa	ʔɪɾebɪsa
iregular	ʔɪɾeɰʊlaɾ
iregularidad	ʔɪɾeɰʊlɐɾɪdad
irekomenda	ʔɪɾexomenda
iriga	ʔɪɾɪɰa
iritable	ʔɪɾɪtable
iritasyon	ʔɪɾɪtɐʃon
irlanda	ʔɪɾlandɐ
irlandes	ʔɪɾlɐndes
irlandesa	ʔɪɾlɐndesɐ
isa	ʔɪsa
isabela	ʔɪsɐbelɐ
isagani	ʔɪsɐɰanɪ
isakay	ʔɪsaxaɪ̯
isakay	ʔɪsɐxaɪ̯
isalba	ʔɪsɐlba
isama	ʔɪsamɐ
isama	ʔɪsɐma
isama	ʔɪsɐmaʔ
isanggalang	ʔɪsɐŋɡɐlaŋ
isangkot	ʔɪsɐŋkot
isangla	ʔɪsɐnlaʔ
isangla	ʔɪsɐŋlaʔ
isantabi	ʔɪsɐntɐbi
isara	ʔɪsɐɾa
isauli	ʔɪsolɪʔ
isauli	ʔɪsɐʔulɪʔ
isaulo	ʔɪsɐʔulo
isaw	ʔisaʊ̯
isda	ʔɪsdaʔ
isdantuko	ʔɪsdantʊxoʔ
iset	ʔɪset
ishay	ʔishaɪ̯
ishinare	ʔɪshɪneɾ
isidro	ʔɪsidɾo
isig	ʔisɪɡ
isigan	ʔisiɰɐn
isigan	ʔɪsiɰɐn
isil	ʔisɪl
isip	ʔisɪp
isipin	ʔɪsipɪn
isipin	ʔɪsɪpin
isisi	ʔɪsisɪ
iskandalo	ʔɪskandɐlo
iskaparate	ʔɪskɐpɐɾate
iskedyul	ʔɪsked͡ʒʊl
iskolar	ʔɪskolɐɾ
iskor	ʔɪskoɾ
iskrip	ʔɪskɾip
iskul	ʔɪskul
iskultor	ʔɪskʊltoɾ
iskultura	ʔɪskʊltuɾɐ
iskuwater	ʔɪskwɐteɾ
iskwater	ʔɪskwɐteɾ
isla	ʔislɐ
islam	ʔislɐm
islam	ʔɪslam
islandiya	ʔɪsland͡ʒa
islang	ʔɪslaŋ
islobenya	ʔɪslobeɲɐ
islogan	ʔɪsloɰɐn
ismagler	ʔɪsmaɡleɾ
ismid	ʔɪsmid
isnab	ʔɪsnab
isnabera	ʔɪsnɐbeɾɐ
isnabero	ʔɪsnɐbeɾo
isnabin	ʔɪsnɐbin
iso	ʔɪso
iso	ʔɪsoʔ
isoli	ʔɪsolɪʔ
ispageti	ʔɪspɐɰetɪ
ispanismo	ʔɪspɐnismo
isputing	ʔɪsputɪŋ
israel	ʔɪsɾɐʔel
israelita	ʔɪsɾɐʔelitɐ
istambay	ʔɪstambaɪ̯
istante	ʔɪstante
istapador	ʔɪstɐpɐdoɾ
istatuwa	ʔɪstatwa
istatwa	ʔɪstatwɐ
istorbo	ʔɪstoɾbo
istorya	ʔɪstoɾjɐ
istoryador	ʔɪstoɾjɐdoɾ
istratehiya	ʔɪstɾɐtehiɐ
istres	ʔɪstɾes
istrikto	ʔɪstɾikto
isuksok	ʔɪsʊksok
isulat	ʔɪsulɐt
isumbong	ʔɪsumboŋ
isuot	ʔɪsʊʔot
iswad	ʔɪswad
isyu	ʔiʃʊ
ita	ʔitɐ
itaas	ʔɪtɐʔas
itaboy	ʔɪtɐboɪ̯
itago	ʔɪtaɰoʔ
itak	ʔɪtak
itali	ʔɪtalɪʔ
italya	ʔɪtaljɐ
italyana	ʔɪtɐljanɐ
italyano	ʔɪtɐljano
itanim	ʔɪtɐnim
itapon	ʔɪtapon
itapon	ʔɪtɐpon
itawit	ʔɪtawɪt
itay	ʔɪtaɪ̯
itey	ʔɪteɪ̯
iti	ʔitɪ
itik	ʔitɪk
itim	ʔɪtim
itineraryo	ʔɪtɪneɾaɾjo
iting	ʔitɪŋ
itlog	ʔɪtloɡ
itmo	ʔɪtmo
ito	ʔɪto
itsa	ʔɪt͡ʃa
itsura	ʔɪt͡ʃuɾɐ
itulog	ʔɪtuloɡ
iuwi	ʔɪʔʊiʔ
iwak	ʔiwɐk
iwal	ʔiwɐl
iwan	ʔiwɐn
iwanan	ʔɪwanɐn
iwang	ʔiwɐŋ
iwas	ʔiwɐs
iwi	ʔiwɪ
iwi	ʔɪwi
iyag	ʔɪaɡ
iyak	ʔɪak
iyakin	ʔiaxɪn
iyan	jɐn
iyan	ʔɪan
iyo	ʔɪo
iyon	ʔɪon
jacinto	hɐsinto
jalandoni	d͡ʒɐlɐndonɪ
jamisola	d͡ʒɐmɪsolɐ
jara	d͡ʒaɾɐ
jaramillo	hɐɾɐmiljo
jimenez	hɪmenes
juarez	hwɐɾes
jumarang	d͡ʒʊmaɾɐŋ
jumbag	d͡ʒumbɐɡ
junichi	d͡ʒʊnit͡ʃɪ
juntilla	d͡ʒʊntillɐ
jurado	hʊɾado
jusi	d͡ʒusɪ
justiniano	hʊstɪɲɐno
k	kx
k	kxeɪ̯
k	kxɐ
k	x
ka	kxɐ
kaagaw	kxaɐɰaʊ̯
kaagulo	kxɐʔɐɰulo
kaagulo	kxɐʔɐɰuloʔ
kaakuhan	kxɐʔɐxuhɐn
kaalit	kxaɐlɪt
kaanib	kxɐʔanɪb
kaaway	kxaɐwaɪ̯
kababaan	kxɐbɐbaʔɐn
kababaihan	kxɐbɐbɐʔihɐn
kabag	kxabɐɡ
kabaka	kxɐbaxɐ
kabaktan	kxɐbɐktan
kabaligtaran	kxɐbɐlɪɡtɐɾan
kaban	kxɐban
kabanata	kxɐbɐnatɐʔ
kabaong	kxɐbaoŋ
kabarkada	kxɐbɐɾkadɐ
kabaro	kxɐbaɾoʔ
kabastusan	kxɐbɐstʊsan
kabatuganan	kxɐbɐtʊɰanɐn
kabayanihan	kxɐbɐjɐnihɐn
kabayo	kxɐbajo
kaberdehan	kxɐbeɾdehan
kabig	kxabɪɡ
kabiguan	kxɐbiɰuʔɐn
kabiguan	kxɐbɪɰʊʔan
kabihasnan	kxɐbɪhɐsnan
kabikulan	kxɐbixʊlan
kabikulan	kxɐbɪxulɐn
kabiling	kxɐbilɪŋ
kabinet	kxabɪnet
kabinian	kxɐbɪniʔɐn
kabisado	kxɐbɪsado
kabisayaan	kxɐbɪsɐjaʔɐn
kabit	kxɐbit
kabo	kxabo
kabukiran	kxɐbʊxiɾɐn
kabuluhan	kxɐbʊlʊhan
kabute	kxɐbʊte
kabuwanan	kxɐbwɐnɐn
kada	kxadɐ
kadena	kxɐdenɐ
kadete	kxɐdete
kadugo	kxɐdʊɰoʔ
kadyos	kxɐd͡ʒos
kaedad	kxɐʔedad
kagalingan	kxɐɰɐliŋɐn
kagaw	kxaɰaʊ̯
kagawaran	kxɐɰɐwɐɾan
kagitingan	kxɐɰɪtiŋɐn
kaha	kxahɐ
kahabagan	kxɐhɐbɐɰan
kahalagahan	kxɐhɐlɐɰɐhan
kahalayan	kxɐhɐlajɐn
kahandaan	kxɐhɐndɐʔan
kahel	kxɐhel
kahero	kxɐheɾo
kahihiyan	kxahɪhɪan
kahinaan	kxɐhɪnaʔɐn
kahoy	kxahoɪ̯
kahulugan	kxɐhʊlʊɰan
kaibigan	kxaibɪɰan
kaibigan	kxaɪ̯biɰɐn
kaibigan	kxaɪ̯bɪɰan
kaibigan	kxaɪ̯bɪɰɐn
kaibuturan	kxaʔɪbʊtuɾɐn
kaibuturan	kxɐʔɪbʊtuɾɐn
kailan	kxelɐn
kailan	kxɐʔɪlan
kailangan	kxaɪ̯laŋɐn
kailangan	kxelaŋɐn
kailangan	kxɐʔɪlaŋɐn
kainan	kxɐʔɪnan
kakahuyan	kxɐxɐhʊjan
kakanin	kxɐxɐnin
kakaphay	kxɐxɐphaɪ̯
kakapitan	kxaxɐpitɐn
kakarampot	kxɐxɐɾɐmpot
kakayahan	kxɐxɐjɐhan
kakilala	kxɐxɪlalɐ
kaklase	kxɐklase
kaktus	kxaktʊs
kakulangan	kxɐxʊlɐŋan
kalabog	kxɐlɐboɡ
kaladkad	kxɐlɐdkad
kalagitnaan	kxɐlɐɰitnɐʔɐn
kalaguyo	kxɐlɐɰujoʔ
kalakaran	kxɐlɐxɐɾan
kalaliman	kxɐlɐlimɐn
kalamansanay	kxɐlɐmɐnsanaɪ̯
kalamansi	kxɐlɐmɐnsiʔ
kalamba	kxɐlɐmbaʔ
kalambre	kxɐlambɾe
kalamidad	kxɐlɐmɪdad
kalamunding	kxɐlɐmʊndiŋ
kalan	kxɐlan
kalandak	kxɐlɐndak
kalangay	kxɐlaŋaɪ̯
kalansay	kxɐlɐnsaɪ̯
kalantas	kxɐlɐntas
kalapati	kxɐlɐpatɪ
kalaswaan	kxɐlɐswɐʔan
kalat	kxalɐt
kalat	kxɐlat
kalatas	kxɐlɐtas
kalatsutsi	kxɐlɐt͡ʃut͡ʃɪʔ
kalawang	kxɐlawɐŋ
kalawangin	kxɐlɐwaŋɪn
kalawangin	kxɐlɐwɐŋin
kalbaryo	kxɐlbaɾjo
kaldero	kxɐldeɾo
kalendaryo	kxɐlendaɾjo
kalibre	kxɐlibɾe
kalibugan	kxɐlɪbuɰɐn
kalidad	kxɐlɪdad
kaligayahan	kxɐlɪɰɐjahɐn
kaligkig	kxɐlɪɡkiɡ
kalinisan	kxɐlɪnisɐn
kalis	kxalɪs
kaliskis	kxɐlɪskis
kaliwanagan	kxɐlɪwɐnaɰɐn
kaliwete	kxɐlɪwete
kaloob	kxɐloʔob
kalooban	kxɐloʔoban
kalooban	kxɐloʔobɐn
kalookan	kxaloʔoxan
kalookan	kxɐloʔoxɐn
kalso	kxɐlso
kalumbibit	kxɐlumbɪbit
kalungsuran	kxɐlʊŋsʊɾan
kaluntian	kxɐlʊntɪʔan
kalusugan	kxɐlusuɰɐn
kalusugan	kxɐlʊsuɰɐn
kalusugan	kxɐlʊsʊɰan
kaluwalhatian	kxɐlʊlʊɐlhɐtiʔɐn
kalyo	kxaljo
kamagong	kxɐmɐɰoŋ
kamandag	kxɐmɐndaɡ
kamangmangan	kxɐmɐŋmɐŋan
kamatayan	kxɐmɐtajɐn
kambal	kxambɐl
kambas	kxambɐs
kambing	kxɐmbiŋ
kambyo	kxambjo
kampana	kxɐmpanɐʔ
kampanaryo	kxɐmpɐnaɾjo
kampante	kxɐmpante
kampanya	kxɐmpɐɲa
kampeon	kxɐmpeon
kampeonato	kxɐmpeonato
kampyon	kxɐmpjon
kamukha	kxɐmʊkhaʔ
kamunduhan	kxɐmʊndʊhan
kamyas	kxɐmjas
kana	kxɐnaʔ
kanada	kxɐnɐda
kandidato	kxɐndɪdato
kandidatura	kxɐndɪdɐtuɾɐ
kandila	kxɐndilɐʔ
kanduli	kxɐndulɪʔ
kangkungan	kxɐŋkuŋɐn
kanina	kxɐninɐ
kanino	kxɐnino
kanisid	kxɐnisɪd
kaniyugan	kxɐɲʊɰɐn
kanlong	kxɐnloŋ
kanlungan	kxɐnluŋɐn
kanluran	kxɐnluɾɐn
kanselasyon	kxɐnselɐʃon
kanser	kxanseɾ
kanta	kxɐnta
kantahin	kxɐntɐhin
kantot	kxɐntot
kanyon	kxɐɲon
kaopisina	kxɐopɪsinɐ
kapabayaan	kxɐpɐbɐjaan
kapag	kxɐpaɡ
kapagka	kxɐpɐɡkaʔ
kapakanan	kxɐpɐxɐnan
kapakanan	kxɐpɐxɐnʔan
kapalaran	kxɐpɐlaɾɐn
kapalit	kxɐpɐlit
kapanahunan	kxɐpɐnɐhunɐn
kapangyarihan	kxɐpɐŋjɐɾihɐn
kapatawaran	kxɐpɐtɐwɐɾan
kaphay	kxɐphaɪ̯
kapiraso	kxɐpɪɾaso
kapisanan	kxɐpɪsanɐn
kapitan	kxɐpitɐn
kapitan	kxɐpɪtan
kaplastikan	kxɐplɐstɪxan
kapok	kxapok
kapon	kxɐpon
kapre	kxapɾe
kapsula	kxapsʊla
kaputsino	kxɐpʊt͡ʃino
karakter	kxaɾɐkteɾ
karakter	kxɐɾakteɾ
karambola	kxɐɾɐmbolɐ
karamihan	kxɐɾɐmihɐn
karampatan	kxɐɾɐmpatɐn
karanasan	kxɐɾɐnɐsan
karayom	kxɐɾajom
karbon	kxɐɾbon
karburador	kxɐɾbʊɾɐdoɾ
karerahan	kxaɾeɾɐhan
karibal	kxɐɾɪbal
karitela	kxɐɾɪtelɐ
kariton	kxɐɾɪton
karo	kxaɾo
karpintero	kxɐɾpɪnteɾo
kartero	kxɐɾteɾo
karton	kxɐɾton
karunungan	kxɐɾʊnuŋɐn
karupukan	kxɐɾʊpʊxan
karuwagan	kxɐɾʊɐɰan
kasabihan	kxɐsɐbɪhan
kasabwat	kxɐsɐbwat
kasalanan	kxɐsɐlanɐn
kasalungat	kxɐsɐlʊŋat
kasambahay	kxɐsɐmbɐhaɪ̯
kasaysayan	kxɐsaɪ̯sajɐn
kasera	kxɐseɾɐ
kasero	kxɐseɾo
kaserola	kxɐseɾolɐ
kasiguraduhan	kxɐsɪɰʊɾɐduhɐn
kasingkahulugan	kxɐsɪŋkɐhʊlʊɰan
kasintahan	kxɐsɪntahɐn
kasinungalingan	kxɐsɪnʊŋɐliŋɐn
kasoy	kxɐsoɪ̯
kastigo	kxɐstiɰo
kastiguhin	kxɐstɪɰuhɪn
kastila	kxɐstilɐʔ
kasubha	kxɐsubhaʔ
kasuy	kxɐsuɪ
kata	kxɐta
kata	kxɐtaʔ
kataga	kxɐtɐɰaʔ
katagalugan	kxɐtɐɰɐluɰɐn
katakawan	kxɐtɐxawɐn
katang	kxatɐŋ
katang	kxɐtaŋ
katangahan	kxɐtɐŋɐhan
katarata	kxɐtɐɾatɐ
katarungan	kxɐtɐɾuŋɐn
katawan	kxɐtaʊ̯ʔan
katawan	kxɐtɐwan
katedral	kxɐtedɾɐl
katha	kxɐthaʔ
katibayan	kxɐtɪbajɐn
katigbak	kxɐtiɡbɐk
katiwalian	kxɐtɪwɐlian
kato	kxɐtoʔ
katoliko	kxɐtolɪxo
katolisismo	kxɐtolɪsismo
katungkulan	kxɐtʊŋkulɐn
katuray	kxɐtuɾaɪ̯
katuwang	kxɐtwaŋ
kautusan	kxaʊ̯tʊsan
kawad	kxawɐd
kay	kxaɪ̯
kayamanan	kxɐjɐmanɐn
keiko	kxeɪ̯xo
kelan	kxelɐn
kemikal	kxemɪxal
kemistri	kxemɪstɾi
kendi	kxendɪ
kenji	kxend͡ʒɪ
kenzo	kxenso
kerida	kxeɾidɐ
kerosin	kxeɾosin
kerry	kxeɾɾɪ
kerubin	kxeɾʊbin
keso	kxeso
kesyo	kxeʃo
ketong	kxetoŋ
ketongin	kxetoŋɪn
ketsap	kxet͡ʃɐp
keyk	kxeɪ̯k
kiamzon	kxiɐmson
kidlat	kxɪdlat
kidnaper	kxɪdnapeɾ
kidya	kxɪd͡ʒa
kikil	kxixɪl
kiko	kxixo
kiko	kxixoʔ
kikuko	kxɪxuko
kikyam	kxikjɐm
kikyam	kxɪkjam
kilabot	kxɪlabot
kilates	kxɪlates
kilay	kxilaɪ̯
kilikili	kxɪlɪxilɪ
kilikiti	kxɪlɪxɪtiʔ
kiling	kxilɪŋ
kiling	kxɪliŋ
kilitis	kxɪlɪtis
kilo	kxilo
kilo	kxɪloʔ
kilogramo	kxɪloɡɾamo
kilometrahe	kxɪlometɾahe
kilometro	kxɪlometɾo
kilusan	kxilʊsan
kilusan	kxɪlusɐn
kilusan	kxɪlʊsan
kimika	kximɪxa
kimiko	kximɪxo
kimkim	kxɪmkim
kimona	kxɪmonɐ
kimono	kxɪmono
kinabukasan	kxɪnabʊxasɐn
kinakapatid	kxɪnaxɐpɐtid
kinalabasan	kxɪnalɐbɐsan
kinalaman	kxɪnalɐman
kinang	kxɪnaŋ
kinatawan	kxɪnɐtɐwan
kinauukulan	kxɪnaʊ̯ʊxulɐn
king	kxɪŋ
kingpin	kxiŋpɪn
kinina	kxɪninɐ
kintsay	kxɪnt͡ʃaɪ̯
kita	kitɐ
kita	kɪta
kitikiti	kxɪtɪxɪti
kiyampong	kjɐmpoŋ
kiyoko	kjoxo
klaro	kxlɐɾo
klima	kxlimɐ
klinik	kxlɪnɪk
klinika	kxlinɪxɐ
kliyente	kljente
kloropila	kxloɾopilɐ
koalisyon	kxoɐlɪʃon
kobra	kxobɾɐ
kobrador	kxobɾɐdoɾ
kodigo	kxodɪɰo
kodipikasyon	kxodɪpɪxɐʃon
koji	kxod͡ʒɪ
kolado	kxolado
kolateral	kxolɐteɾal
kolera	kxoleɾɐ
kolombiya	kxolumbɪɐ
kolonya	kxoloɲɐ
kolonyalismo	kxoloɲɐlismo
komadrona	kxomɐdɾonɐ
kombinasyon	kxumbɪnɐʃon
komedya	kxomed͡ʒɐ
komedyante	kxomed͡ʒante
komentarista	kxomentɐɾistɐ
komento	kxomento
kometa	kxometɐ
kompanya	kxumpɐɲa
kompartment	kxumpaɾtment
kompleto	kxumpleto
komplikasyon	kxumplɪxɐʃon
komposisyon	kxumposɪʃon
kompositor	kxumposɪtoɾ
kompresor	kxumpɾesoɾ
komunidad	kxomʊnɪdad
komunikasyon	kxomʊnɪxɐʃon
komunismo	kxomʊnismo
komunista	kxomʊnistɐ
komunyon	kxomʊɲon
kondenahin	kxondenɐhin
kondensada	kxondensadɐ
kondimento	kxondɪmento
kondisyon	kxondɪʃon
kondisyoner	kxondɪʃoneɾ
kondom	kxondom
kondominyum	kxondomiɲʊm
konduktor	kxondʊktoɾ
koneksiyon	kxonekʃon
kongregasyon	kxoŋɡɾeɰɐʃon
konotasyon	kxonotɐʃon
konsehal	kxonsehal
konseho	kxonseho
konsensiya	kxonsenʃa
konsensya	kxonsenʃɐ
konsentidor	kxonsentɪdoɾ
konsentihin	kxonsentɪhin
konsentrasyon	kxonsentɾɐʃon
konserbatibo	kxonseɾbɐtibo
konserbatismo	kxonseɾbɐtismo
konserbatoryo	kxonseɾbɐtoɾjo
konsiyensiya	kxonʃenʃa
konstelasyon	kxonstelɐʃon
konstitusyon	kxonstɪtʊʃon
konsul	kxonsʊl
konsulado	kxonsʊlado
konsultant	kxonsultɐnt
konsumido	kxonsʊmido
konsumisyon	kxonsʊmɪʃon
konsumo	kxonsumo
kontador	kxontɐdoɾ
kontak	kxontɐk
kontakin	kxontaxɪn
kontento	kxontento
kontestant	kxontestɐnt
kontorsiyonista	kxontoɾsɪonistɐ
kontrabando	kxontɾɐbando
kontrobersiya	kxontɾobeɾsiɐ
kontrobersiya	kxontɾobeɾʃɐ
konyo	kxoɲo
kopya	kxopjɐ
korap	kxoɾap
korea	kxoɾeɐ
koredor	kxoɾedoɾ
koreograpiya	kxoɾeoɡɾɐpiɐ
korinto	kxoɾinto
korola	kxoɾolɐ
korona	kxoɾonɐ
koronahan	kxoɾonahɐn
korporasyon	kxoɾpoɾɐʃon
korte	kxoɾte
kortina	kxoɾtinɐ
korupsiyon	kxoɾʊpʃon
kosta	kxostɐ
kostado	kxostado
kotilyon	kxotɪljon
kotse	kxot͡se
kotse	kxot͡ʃe
kredensiyal	kxɾedenʃal
krimen	kxɾɪmen
kriminal	kxɾɪmɪnal
krisantemo	kxɾɪsɐntemo
krisma	kxɾismɐ
kristiyanismo	kxɾɪstɪɐnismo
kristiyano	kxɾɪst͡ʃano
kristo	kxɾisto
kritiko	kxɾitɪxo
kritisismo	kxɾɪtɪsismo
kroni	kxɾonɪ
kroniyismo	kxɾonɪjismo
kronolohiya	kxɾonolohiɐ
krus	kxɾʊs
krusipiho	kxɾʊsɪpiho
kuba	kxubɐʔ
kubeta	kxʊbetɐ
kubo	kxubo
kubrekama	kxʊbɾexamɐ
kudkurin	kxʊdkʊɾin
kugon	kxʊɰon
kuha	kxuhɐ
kuha	kxuhɐʔ
kulambo	kxʊlɐmboʔ
kulangi	kxʊlaŋɪʔ
kulangot	kxʊlaŋot
kulantro	kxʊlantɾo
kulasi	kxʊlase
kulasi	kxʊlasɪ
kulasisi	kxʊlɐsisɪ
kulay	kxulaɪ̯
kuliglig	kxʊlɪɡliɡ
kulilipaw	kxʊlɪlipaʊ̯
kulimlim	kxʊlɪmlim
kulisap	kxʊlisɐp
kuliti	kxʊlitɪʔ
kulog	kxʊloɡ
kulugo	kxʊlʊɰo
kulungan	kxʊluŋɐn
kumabig	kxʊmabɪɡ
kumanta	kxʊmɐnta
kumbensiyon	kxumbenʃon
kumbensiyonal	kxumbensɪonal
kumbento	kxumbento
kumbulsiyon	kxumbʊlʃon
kumiko	kxʊmixo
kumpas	kxumpas
kumpederasyon	kxumpedeɾɐʃon
kumpirmasyon	kxumpɪɾmaʃon
kumpisal	kxumpɪsal
kumpiska	kxumpɪska
kumuha	kxʊmuhɐ
kumulang	kxʊmulɐŋ
kumunoy	kxʊmʊnoɪ̯
kumupas	kxʊmupɐs
kumuyakoy	kxʊmʊjaxoɪ̯
kunan	kxunɐn
kunat	kxunɐt
kundena	kxʊndena
kuneho	kxʊneho
kung	kxʊŋ
kungyari	kxʊŋjaɾɛ
kungyari	kxʊŋjaɾɪ
kuniko	kxʊnixo
kunwari	kxʊnwaɾɪʔ
kunwari	kxʊnwɐɾeʔ
kunwari	kxʊnwɐɾiʔ
kupad	kxupɐd
kupas	kxupɐs
kupas	kxʊpas
kupido	kxupɪdo
kupit	kxupɪt
kupon	kxʊpon
kural	kxʊɾal
kurap	kxʊɾap
kurba	kxʊɾba
kurbata	kxʊɾbatɐ
kurikong	kxʊɾɪxoŋ
kuripot	kxʊɾipot
kurot	kxʊɾot
kursonada	kxʊɾsonadɐ
kusa	kxusɐʔ
kusina	kxʊsinɐ
kustodiya	kxʊstodiɐ
kuting	kxʊtiŋ
kutis	kxutɪs
kuto	kxuto
kuto	kxʊtoʔ
kutsara	kxʊt͡sɐɾɐ
kutsara	kxʊt͡ʃaɾɐ
kutson	kxʊt͡ʃon
kutya	kxʊt͡ʃaʔ
kuwadra	kwadɾɐ
kuwan	kwan
kuwapaw	kwapaʊ̯
kuya	kxujɐ
kyoko	kjoxo
la	lɐ
laab	lɐba
laan	lɐʔan
laas	laʔɐs
laas	lɐʔas
laba	labɐ
laba	labɐʔ
laba	lɐba
laba	lɐbaʔ
lababo	lɐbabo
labada	lɐbadɐ
labadora	lɐbɐdoɾɐ
labag	lɐbaɡ
labahan	labahɐn
labahan	lɐbɐhan
labahin	labahɪn
labak	lɐbak
labakara	lɐbɐxaɾɐ
laban	labɐn
labandera	lɐbɐndeɾɐ
labandero	lɐbɐndeɾo
labanos	labɐnos
labas	labɐs
labas	lɐbas
labasan	labasɐn
labasan	lɐbɐsan
labaskaphay	lɐbɐskɐphaɪ̯
labastida	lɐbɐstidɐ
labatiba	lɐbɐtibɐ
labaw	labaʊ̯
labawsugnayan	lɐbaʊ̯sʊɡnajɐn
laberinto	lɐbeɾinto
labhan	lɐbhan
labi	labɪʔ
labi	lɐbi
labi	lɐbiʔ
labimpito	lɐbimpɪto
labimpito	lɐbɪmpɪto
labindalawa	lɐbindɐlɐwa
labindalawa	lɐbɪndɐlɐwa
labing	lɐbiŋ
labingwalo	lɐbiŋwɐlo
labingwalo	lɐbɪŋwɐlo
labinlima	lɐbinlɪma
labinlima	lɐbɪnlɪma
labinsiyam	lɐbinʃam
labinsiyam	lɐbɪnʃam
labintador	lɐbɪntɐdoɾ
labintatlo	lɐbintɐtlo
labintatlo	lɐbntɐtlo
labis	labɪs
lablab	lɐblab
labnaw	lɐbnaʊ̯
labnot	lɐbnot
labo	lɐbo
labo	lɐboʔ
labon	lɐbon
labong	lɐboŋ
laboratoryo	lɐboɾɐtoɾjo
laboy	laboɪ̯
labso	lɐbsoʔ
labtik	lɐbtik
labuyo	lɐbujoʔ
lacambra	lɐxambɾɐ
lacap	laxɐp
ladlad	lɐdlad
ladrilyo	lɐdɾiljo
ladya	lad͡ʒɐ
ladya	lɐd͡ʒaʔ
laga	laɰɐʔ
lagabag	lɐɰɐbaɡ
lagablab	lɐɰɐblab
lagabog	lɐɰɐboɡ
lagak	lɐɰak
lagaklak	lɐɰɐklak
lagalag	lɐɰalɐɡ
lagalag	lɐɰɐlaɡ
laganap	lɐɰanɐp
laganas	lɐɰɐnas
lagap	lɐɰap
lagapak	lɐɰɐpak
lagari	lɐɰaɾɪʔ
lagari	lɐɰɐɾiʔ
lagas	laɰɐs
lagas	lɐɰas
lagasaw	lɐɰɐsaʊ̯
lagaslas	lɐɰɐslas
lagay	lɐɰaɪ̯
lagayan	laɰajɐn
lagayan	lɐɰɐjan
lagaylay	lɐɰaɪ̯laɪ̯
lagda	lɐɡdaʔ
lagdameo	lɐɡdameo
lagi	laɰɪ
lagi	laɰɪʔ
lagibas	lɐɰɪbas
lagikway	lɐɰɪkwaɪ̯
lagim	lɐɰim
laginit	lɐɰɪnit
lagis	lɐɰis
lagislis	lɐɰɪslis
lagitik	lɐɰɪtik
lagitlit	lɐɰɪtlit
lagkit	lɐɡkit
laglag	lɐɡlaɡ
lagmak	lɐɡmak
lagmay	laɡmaɪ̯
lagnat	lɐɡnat
lagnatin	laɡnatɪn
lagnatin	lɐɡnɐtin
lago	laɰo
lago	lɐɰoʔ
lagod	laɰod
lagod	lɐɰod
lagok	lɐɰok
lagom	laɰom
lagong	laɰoŋ
lagos	lɐɰos
lagot	lɐɰot
lagpak	lɐɡpak
lagpas	lɐɡpas
lagsang	lɐɡsaŋ
lagumba	lɐɰumba
lagumlalangin	lɐɰʊmlalaŋɪn
lagumlalangin	lɐɰʊmlɐlɐŋin
laguna	lɐɰunɐ
lagundi	lɐɰʊndiʔ
lagusan	laɰusɐn
lagusan	lɐɰʊsan
laguslos	lɐɰʊslos
lagutok	lɐɰʊtok
laguyo	lɐɰujoʔ
lagwat	lɐɡwat
lagwerta	lɐɡweɾtɐ
lagyo	lɐɡjoʔ
lahad	lahɐd
lahad	lɐhad
lahat	lɐhat
lahi	lahɪʔ
lahid	lahɪd
lahok	lɐhok
lahoy	lahoɪ̯
lain	laɪ̯n
laing	laʔɪŋ
laing	lɐʔiŋ
lait	laʔɪt
laitin	lɐʔitɪn
lakad	laxɐd
lakad	lɐxad
lakambini	lɐxɐmbinɪ
lakan	laxɐn
lakan	lɐxan
lakandiwa	lɐxɐndiwɐʔ
lakansugo	lɐxɐnsuɰoʔ
lakas	lɐxas
lakatan	lɐxɐtan
lakbay	lɐkbaɪ̯
lakdang	lɐkdaŋ
lakdaw	lɐkdaʊ̯
lakdawkaphay	lɐkdaʊ̯xɐphaɪ̯
lakdawyugto	lɐkdaʊ̯jʊɡtoʔ
lakhan	lɐkhan
laki	lɐxi
lakihan	lɐxɪhan
lakip	laxɪp
lakip	lɐxip
lakit	laxɪt
laklak	lɐklak
lako	laxoʔ
lako	lɐxo
laksa	lɐksa
laksa	lɐksaʔ
laksante	lɐksante
laksatiba	lɐksɐtibɐ
laktaw	lɐktaʊ̯
laktosa	lɐktosɐ
lakwatsa	lɐkwat͡ʃɐ
lakwatsera	lɐkwɐt͡ʃeɾɐ
lakwatsero	lɐkwɐt͡ʃeɾo
lala	lalɐ
lala	lalɐʔ
lala	lɐla
lala	lɐlaʔ
lalab	lalɐb
lalaban	lɐlabɐn
lalad	lɐlad
lalagukan	lɐlɐɰuxɐn
lalagukan	lɐlɐɰʊxan
lalagyan	lalɐɡjan
lalagyan	lɐlɐɡjan
lalaki	lɐlaxɪ
lalaki	lɐlɐxi
lalamunan	lɐlɐmunɐn
lalan	lɐlan
lalang	lɐlaŋ
lalanghutan	lɐlɐŋhutɐn
lalanghutan	lɐlɐŋhʊtan
lalawigan	lɐlɐwiɰɐn
lalay	lɐlaɪ̯
lali	lalɪ
lalik	lalɪk
lalim	lalɪm
lalin	lalɪn
lam	lɐm
lamad	lamɐd
laman	lɐman
lamang	lamɐŋ
lamang	lɐmaŋ
lamas	lamɐs
lamas	lɐmas
lamasin	lɐmasɪn
lamat	lamɐt
lamay	lamaɪ̯
lamba	lɐmba
lamba	lɐmbaʔ
lambak	lɐmbak
lambal	lɐmbal
lambang	lɐmbaŋ
lambanog	lɐmbanoɡ
lambanog	lɐmbɐnoɡ
lambat	lɐmbat
lambayog	lɐmbajoɡ
lambi	lɐmbiʔ
lambing	lɐmbiŋ
lambitin	lɐmbitɪn
lambo	lɐmbo
lambo	lɐmboʔ
lambot	lɐmbot
lamesa	lɐmesɐ
lamesita	lɐmesitɐ
lamig	lɐmiɡ
lamira	lɐmiɾɐʔ
lamira	lɐmɪɾaʔ
lamog	lɐmoɡ
lamok	lɐmok
lampa	lɐmpa
lampara	lampɐɾa
lampas	lɐmpas
lampaso	lɐmpaso
lampik	lɐmpik
lampin	lɐmpin
lamuga	lɐmuɰɐʔ
lamukos	lɐmuxos
lamukos	lɐmʊxos
lamuymoy	lɐmʊɪmoɪ̯
lamyerda	lɐmjeɾdɐ
lana	lanɐ
lanab	lanɐb
lanao	lanaʊ̯
lanap	lanɐp
lanap	lɐnap
lanaw	lanaʊ̯
lanaw	lɐnaʊ̯
lanay	lanaɪ̯
lanay	lɐnaɪ̯
landa	lɐnda
landas	landɐs
landas	lɐndas
landi	lɐndiʔ
landit	lɐndit
landrito	lɐndɾito
lang	lɐŋ
langal	lɐŋal
langaray	lɐŋaɾaɪ̯
langasngas	lɐŋɐsŋas
langaw	laŋaʊ̯
langayak	lɐŋɐjak
langgam	lɐŋɡam
langgas	lɐŋɡas
langgotse	lɐŋɡot͡ʃe
langhap	lɐŋhap
langhapan	lɐŋhapɐn
langib	lɐŋib
langil	laŋɪl
langis	lɐŋis
langit	laŋɪt
langitngit	lɐŋɪtŋit
langka	lɐŋkaʔ
langkaan	lɐŋkaʔɐn
langkal	lɐŋkal
langkap	lɐŋkap
langkas	lɐŋkas
langkaw	lɐŋkaʊ̯
langkay	lɐŋkaɪ̯
langkayan	lɐŋkajɐn
langlang	lɐŋlaŋ
lango	lɐŋo
langoy	lɐŋoɪ̯
langyot	lɐŋjot
lanip	lanɪp
lanlan	lɐnlan
lansa	lansɐ
lansa	lɐnsa
lansang	lɐnsaŋ
lansangan	lɐnsaŋɐn
lansina	lɐnsinɐʔ
lansones	lɐnsones
lanta	lɐnta
lantad	lɐntad
lantak	lɐntak
lantaka	lɐntaxɐʔ
lantana	lɐntanɐʔ
lantay	lɐntaɪ̯
lanting	lantɪŋ
lanting	lɐntiŋ
lantod	lɐntod
lantong	lɐntoŋ
lantot	lɐmbiŋ
lantsa	lant͡ʃɐ
lantutay	lɐntutaɪ̯
lanubo	lɐnuboʔ
lanunab	lɐnunɐb
lanuza	lɐnusɐ
lao	laʊ̯
laoag	lɐwaɡ
laog	lɐʔoɡ
laon	lɐʔon
laos	lɐʔos
lapad	lapɐd
lapad	lɐpad
lapag	lɐpaɡ
lapas	lɐpas
lapastangan	lɐpɐstaŋɐn
lapat	lapɐt
lapat	lɐpat
lapay	lapaɪ̯
lapay	lɐpaɪ̯
lapi	lapɪʔ
lapida	lapɪda
lapig	lapɪɡ
laping	lɐpiŋ
lapirot	lɐpiɾot
lapirot	lɐpɪɾot
lapis	lapɪs
lapisa	lɐpɪsaʔ
lapit	lapɪt
lapit	lɐpit
laplap	lɐplap
lapnis	lɐpnis
lapnit	lɐpnit
lapnos	lɐpnos
lapok	lɐpok
lapulapu	lapʊlapʊ
lapurit	lɐpuɾɪt
lapurit	lɐpʊɾit
lapuz	lapʊs
lapya	lɐpjaʔ
lapyad	lɐpjad
laquindanum	lɐxɪndanʊm
larang	laɾɐŋ
larangan	lɐɾaŋɐn
larawan	lɐɾawɐn
laray	laɾaɪ̯
larga	laɾɡɐ
larga	lɐɾɡa
laris	lɐɾis
laro	lɐɾo
laro	lɐɾoʔ
larot	lɐɾot
laroy	laɾoɪ̯
laroy	lɐɾoɪ̯
laruan	laɾʊʔan
laruan	lɐɾʊʔan
laryo	lɐɾjo
lasa	lasɐ
lasa	lasɐʔ
lasa	lɐsaʔ
lasak	lasɐk
lasak	lɐsak
lasap	lɐsap
lasaw	lasaʊ̯
lasaw	lɐsaʊ̯
lascano	lɐskano
lasenggera	lɐseŋɡeɾɐ
lasenggero	lɐseŋɡeɾo
lasenggo	lɐseŋɡo
lasgas	lɐsɡas
lasing	lɐsiŋ
lasinggera	lɐsɪŋɡeɾɐ
lasinggero	lɐsɪŋɡeɾo
laskuta	lɐskutɐʔ
laslas	lɐslas
laso	lɐsoʔ
lasog	lɐsoɡ
laspag	lɐspaɡ
lastag	lɐstaɡ
lastay	lɐstaɪ̯
lastiko	lastɪxo
lasuna	lɐsʊnaʔ
lasunin	lɐsunɪn
laswa	lɐswaʔ
lata	latɐ
lata	lɐtaʔ
latag	latɐɡ
latag	lɐtaɡ
latak	latɐk
latak	lɐtak
latay	lataɪ̯
latayan	lɐtajɐn
lathala	lɐthalɐʔ
lathala	lɐthɐlaʔ
lati	latɪʔ
latigo	latɪɰo
latik	lɐtik
latin	lɐtin
latitud	lɐtɪtud
latok	lɐtok
latundan	lɐtʊndan
lauriat	loɾjɐt
lawa	lawɐʔ
lawaan	lɐwaʔɐn
lawaan	lɐwɐʔan
lawak	lawɐk
laway	lawaɪ̯
laway	lɐwaɪ̯
lawi	lɐwi
lawig	lawɪɡ
lawig	lɐwiɡ
lawin	lawɪn
lawing	lɐwiŋ
lawit	lawɪt
lawit	lɐwit
lawlaw	laʊ̯laʊ̯
laxamana	lɐksɐmanɐ
laya	lajɐ
laya	lajɐʔ
laya	lɐjaʔ
layag	lajɐɡ
layag	lɐjaɡ
layak	lɐjak
layas	lajɐs
layas	lɐjas
layaw	lajaʊ̯
layaw	lɐjaʊ̯
laygo	laɪ̯ɰo
laylay	laɪ̯laɪ̯
laylayan	laɪ̯lajɐn
laylo	laɪ̯lo
layno	laɪ̯no
layo	lɐjoʔ
layon	lɐjon
layter	laɪ̯teɾ
lazarte	lɐsaɾte
lazatin	lɐsatɪn
lebadura	lebɐduɾɐ
lechias	let͡ʃiɐs
lee	lɪ
legal	leɰal
legalidad	leɰɐlɪdad
legazpi	leɰaspɪ
legwas	leɡwɐs
lehislasyon	lehɪslɐʃon
lehislatura	lehɪslɐtuɾɐ
lehitimo	lehitɪmo
lehiya	lehiɐ
lehiya	lehɪa
leksikograpiko	leksɪxoɡɾapɪxo
leksikograpiya	leksɪxoɡɾɐpiɐ
leksikograpo	leksɪxoɡɾɐpo
leksiyon	lekʃon
leksiyon	lɪkʃon
lelang	lelɐŋ
lemur	lemʊɾ
lengguwahe	leŋɡwɐhe
lentehas	lentehɐs
lesbiyana	lesbjɐnɐ
lesbyana	lesbjɐnɐ
lespu	lespʊ
letmaku	letmɐxu
letra	letɾɐ
letsugas	let͡ʃuɰɐs
leung	ljʊŋ
leynes	leɪ̯nes
leyte	leɪ̯te
li	lɪ
libag	lɪbaɡ
libak	lɪbak
liban	libɐn
liban	lɪban
libang	lɪbaŋ
libano	libɐno
libay	lɪbaɪ̯
liberal	lɪbeɾal
liberalisasyon	lɪbeɾɐlɪsɐʃon
liberasyon	lɪbeɾɐʃon
libid	libɪd
libid	lɪbid
libing	lɪbiŋ
libingan	libiŋɐn
libingan	lɪbɪŋan
libis	lɪbis
liblib	lɪblib
libot	lɪbot
libra	libɾɐ
libradilla	lɪbɾɐdillɐ
libre	lɪbɾe
libro	lɪbɾo
libtos	lɪbtos
libumbon	lɪbumbon
libuntaon	libʊntɐʔon
libya	libjɐ
lichauco	lɪt͡ʃaʊ̯xo
licup	lixʊp
liderato	lɪdeɾato
liga	liɰɐ
ligalig	lɪɰalɪɡ
ligalig	lɪɰɐliɡ
ligamento	lɪɰɐmento
ligamgam	lɪɰɐmɡam
ligao	lɪɰaʊ̯
ligat	liɰɐt
ligata	lɪɰatɐʔ
ligaw	liɰaʊ̯
ligaw	lɪɰaʊ̯
ligawgaw	lɪɰaʊ̯ɰaʊ̯
ligaya	lɪɰajɐ
ligid	liɰɪd
ligid	lɪɰid
ligis	lɪɰis
ligo	liɰoʔ
ligo	lɪɰo
ligo	lɪɰoʔ
ligoy	liɰoɪ̯
ligpit	lɪɡpit
ligpitin	lɪɡpɪtin
ligta	lɪɡtaʔ
ligtas	lɪɡtas
ligwak	lɪɡwak
ligwan	lɪɡwan
liha	lihɐ
liha	lihɐʔ
liha	lɪha
liham	lihɐm
lihi	lɪhi
lihi	lɪhiʔ
lihim	lihɪm
lihim	lɪhim
lihis	lɪhis
lihiya	lɪhiɐ
lihiya	lɪhɪa
lihukan	lihuxɐn
liig	lɪʔiɡ
liing	lɪʔiŋ
liit	lɪʔit
likas	lixɐs
likas	lɪxas
likat	lɪxat
likaw	lixaʊ̯
likaw	lɪxaʊ̯
likha	lɪkha
likha	lɪkhaʔ
likido	lixɪdo
liknayan	lɪknajɐn
liko	lɪxoʔ
likod	lɪxod
likom	lixom
likom	lɪxom
likop	lixop
likop	lɪxop
likot	lɪxot
liksi	lɪksiʔ
likuran	lɪxʊɾan
lila	lilɐ
lila	lilɐʔ
lilik	lilɪk
lilim	lilɪm
liling	lilɪŋ
lilip	lilɪp
lilip	lɪlip
lilok	lɪlok
lima	lɪma
limahi	lɪmahɪʔ
limahi	lɪmɐhiʔ
limahid	lɪmahɪd
limahid	lɪmɐhid
limampu	lɪmɐmpuʔ
limandaan	lɪmɐndɐʔan
limanlaksa	lɪmɐnlɐksaʔ
limas	lɪmas
limatik	lɪmatɪk
limatik	lɪmɐtik
limay	limaɪ̯
limay	lɪmaɪ̯
limbag	lɪmbaɡ
limbaga	lɪmbaɰɐ
limbay	lɪmbaɪ̯
limi	limɪ
limi	limɪʔ
limi	lɪmiʔ
limit	limɪt
limita	lɪmɪta
limitado	lɪmɪtado
limitasyon	lɪmɪtɐʃon
limjoco	lɪmd͡ʒoxo
limlim	lɪmlim
limon	lɪmon
limonada	lɪmonadɐ
limonsito	lɪmonsito
limos	lɪmos
limot	lɪmot
limpa	lɪmpaʔ
limpak	lɪmpak
limpal	lɪmpal
limpik	lɪmpik
limsiha	lɪmsihɐʔ
limusina	lɪmʊsinɐ
linab	lɪnab
linang	lɪnaŋ
linatoc	lɪnatok
linatsay	lɪnɐt͡ʃaɪ̯
linaw	linaʊ̯
linay	linaɪ̯
linay	lɪnaɪ̯
lindayag	lɪndajɐɡ
lindol	lɪndol
lindulin	lɪndʊlin
linga	liŋɐʔ
linga	lɪŋa
linga	lɪŋaʔ
lingad	liŋɐd
lingaw	liŋaʊ̯
lingaw	lɪŋaʊ̯
lingawngaw	lɪŋaʊ̯ŋaʊ̯
linggal	lɪŋɡal
linggatong	lɪŋɡatoŋ
linggaw	lɪŋɡaʊ̯
linggi	lɪŋɡiʔ
linggit	lɪŋɡit
linggo	lɪŋɡo
lingguwista	lɪŋɡwɪstɐ
lingguwistika	lɪŋɡwistɪxa
lingid	lɪŋid
lingil	liŋɪl
lingil	lɪŋil
lingindayat	lɪŋindɐjat
lingindayat	lɪŋɪndajɐt
lingkaw	lɪŋkaʊ̯
lingkod	lɪŋkod
lingming	lɪŋmiŋ
lingo	lɪŋo
lingon	lɪŋon
linib	lɪnib
linis	linɪs
linis	lɪnis
linisan	lɪnisɐn
linisan	lɪnɪsan
linisin	lɪnisɪn
linisin	lɪnɪsin
linlang	lɪnlaŋ
linsil	lɪnsil
linta	lɪntaʔ
lintik	lɪntik
lintos	lɪntos
linuknok	lɪnʊknok
linya	liɲɐ
lipa	lipɐʔ
lipa	lɪpa
lipad	lɪpad
lipak	lɪpak
lipana	lɪpanɐʔ
lipas	lipɐs
lipas	lɪpas
lipat	lipɐt
lipi	lipɪʔ
lipit	lipɪt
lipol	lɪpol
lipot	lɪpot
lipstik	lipstɪk
lipumpon	lɪpumpon
lipunan	lipunɐn
lipunan	lɪpʊnan
lipya	lɪpjaʔ
liquigan	lɪxiɰɐn
lira	liɾɐ
lira	liɾɐʔ
lirot	lɪɾot
lisa	lɪsaʔ
lisan	lisɐn
lisensiya	lɪsenʃa
lisensiyado	lɪsenʃɐdo
lising	lisɪŋ
lislis	lɪslis
liso	lɪso
liso	lɪsoʔ
lisok	lɪsok
lista	listɐ
lista	lɪsta
listahan	lɪstahɐn
listahan	lɪstɐhan
listo	lɪsto
litak	lɪtak
litang	lɪtaŋ
litas	litɐs
litaw	lɪtaʊ̯
literal	lɪteɾal
literasiya	lɪteɾɐsiɐ
literasya	lɪteɾaʃɐ
literatura	lɪteɾɐtuɾɐ
litid	litɪd
litigante	lɪtɪɰante
litigasyon	lɪtɪɰɐʃon
litik	litɪk
litis	litɪs
litograpiya	lɪtoɡɾɐpiɐ
litratista	lɪtɾɐtistɐ
litrato	lɪtɾato
litsiyas	lɪt͡ʃiɐs
litson	lɪt͡ʃon
liturhiya	lɪtuɾhɪa
litwanya	lɪtwaɲɐ
lityo	lit͡ʃo
liwag	liwɐɡ
liwaliw	lɪwɐliʊ̯
liwanag	lɪwanɐɡ
liwas	liwɐs
liwas	lɪwas
liwat	liwɐt
liway	lɪwaɪ̯
liwayway	lɪwaɪ̯waɪ̯
liya	liɐʔ
liya	ljaʔ
liyab	ljab
liyama	ljɐmɐ
liyamado	lɪɐmado
liyempo	ljempo
lizada	lɪsadɐ
llanera	llɐneɾɐ
loa	loʔɐ
lodi	lodɪ
logarta	loɰaɾtɐ
logo	loɰo
lohika	lohɪxa
lohikal	lohɪxal
lohiko	lohɪxo
lohuwa	lohʊa
loka	loxɐ
lokal	loxal
lokalidad	loxɐlɪdad
loko	loxo
lola	lolɐ
lolipap	lolɪpap
lomi	lomɪ
lomibao	lomibaʊ̯
lona	lonɐ
longganisa	loŋɡɐnisɐ
longhitud	loŋhɪtud
lonta	lontɐ
loo	lʊ
loobkaphay	loʔobkɐphaɪ̯
lorenzana	loɾensanɐ
loryat	loɾjɐt
losyon	loʃon
loteriya	loteɾiɐ
loterya	loteɾjɐ
lowat	lowɐt
lozada	losadɐ
lu	lʊ
luad	lʊʔad
lubak	lubɐk
lubak	lʊbak
lubang	lubɐŋ
lubay	lʊbaɪ̯
lubha	lʊbhaʔ
lubiano	lʊbjano
lubid	lubɪd
lubid	lʊbid
lubig	lʊbiɡ
lubigan	lʊbiɰɐn
lubigan	lʊbɪɰan
lublob	lʊblob
lubo	lʊbo
lubo	lʊboʔ
lubog	lʊboɡ
lubos	lʊbos
lubot	lʊbot
lubyak	lʊbjak
lucena	lʊsenɐ
lucy	lʊsɪ
luga	luɰɐʔ
lugami	lʊɰamɪʔ
lugami	lʊɰɐmiʔ
luganggang	lʊŋɡɐɰaŋ
lugar	lʊɰaɾ
lugas	lʊɰas
lugaw	luɰaʊ̯
lugaw	lʊɰaʊ̯
lugay	luɰaɪ̯
lugay	lʊɰaɪ̯
lugi	luɰɪ
lugi	luɰɪʔ
lugit	luɰɪt
luglog	lʊɡloɡ
lugmok	lʊɡmok
lugnas	lʊɡnas
lugo	lʊɰo
lugod	lʊɰod
lugot	luɰot
lugot	lʊɰot
lugpo	lʊɡpoʔ
lugso	lʊɡsoʔ
luha	luhɐʔ
luhod	lʊhod
luhuran	luhuɾɐn
luhuran	lʊhʊɾan
lukba	lʊkbaʔ
lukban	lukbɐn
lukban	lʊkban
lukbot	lʊkbot
lukemya	lʊxemjɐ
luklok	lʊklok
luklukan	lʊkluxɐn
luklukan	lʊklʊxan
luko	luxo
luko	lʊxoʔ
lukob	luxob
lukob	lʊxob
lukong	lʊxoŋ
lukot	luxot
lukot	lʊxot
luksa	lʊksaʔ
luksemburgo	lʊksembuɾɡo
lukso	lʊkso
lukto	lʊktoʔ
lukton	lʊkton
lukulok	lʊxʊlok
lukutan	lʊxutɐn
lula	lulɐʔ
lula	lʊlaʔ
lulan	lulɐn
lulay	lulaɪ̯
lulod	lʊlod
lulon	lʊlon
lulong	lʊloŋ
lulot	lʊlot
luma	lumɐʔ
luma	lʊma
lumabag	lʊmɐbaɡ
lumaban	lʊmabɐn
lumabas	lʊmɐbas
lumabo	lʊmaboʔ
lumabo	lʊmɐbo
lumad	lumɐd
lumagui	lʊmaɰɪ
lumakad	lʊmaxɐd
lumakas	lʊmɐxas
lumakdang	lʊmɐkdaŋ
lumaki	lʊmɐxi
lumalaban	lʊmɐlabɐn
lumambitin	lʊmɐmbitɪn
lumamig	lʊmɐmiɡ
lumanay	lʊmanaɪ̯
lumanglas	lʊmaŋlɐs
lumangoy	lʊmɐŋoɪ̯
lumapastangan	lʊmɐpɐstaŋɐn
lumapirot	lʊmɐpɪɾot
lumapit	lʊmapɪt
lumay	lumaɪ̯
lumay	lʊmaɪ̯
lumaya	lʊmajɐʔ
lumayas	lʊmajɐs
lumayo	lʊmajoʔ
lumayo	lʊmɐjoʔ
lumbang	lumbɐŋ
lumbao	lumbaʊ̯
lumbay	lumbaɪ̯
lumboy	lumboɪ̯
lumi	lumɪʔ
lumi	lʊmiʔ
lumibao	lʊmibaʊ̯
lumigwak	lʊmɪɡwak
lumihis	lʊmɪhis
lumiit	lʊmɪʔit
lumikha	lʊmɪkhaʔ
luminaw	lʊminaʊ̯
lumindol	lʊmɪndol
luminis	lʊminɪs
lumipad	lʊmɪpad
lumipol	lʊmipol
lumiwanag	lʊmɪwanɐɡ
lumo	lʊmo
lumon	lʊmon
lumpia	lumpjaʔ
lumpiya	lumpjaʔ
lumuklok	lʊmʊklok
lumundag	lʊmʊndaɡ
lumutang	lʊmutɐŋ
lumuwag	lʊmwaɡ
lunak	lʊnak
lunas	lunɐs
lunas	lʊnas
lunaw	lunaʊ̯
lunaw	lʊnaʊ̯
lundag	lʊndaɡ
lunday	lʊndaɪ̯
lundo	lʊndoʔ
lungad	luŋɐd
lungad	lʊŋad
lungas	lʊŋas
lungaw	lʊŋaʊ̯
lungga	lʊŋɡaʔ
lunggati	lʊŋɡɐtiʔ
lungib	lʊŋib
lungkag	lʊŋkaɡ
lungkot	lʊŋkot
lungsod	lʊŋsod
luningning	lʊnɪŋniŋ
lunod	lʊnod
lunok	lʊnok
lunot	lʊnot
lunsad	lʊnsad
lunsod	lʊnsod
lunti	lʊntiʔ
luntian	lʊntiʔɐn
luntian	lʊntɪʔan
luntidinsol	lʊntɪdɪnsol
lunukin	lʊnʊxin
luoy	lʊʔoɪ̯
lupa	lupɐʔ
lupagi	lʊpaɰɪʔ
lupagi	lʊpɐɰiʔ
lupain	lʊpɐʔin
lupalop	lʊpalop
lupasay	lʊpasaɪ̯
lupasay	lʊpɐsaɪ̯
lupi	lʊpiʔ
lupig	lupɪɡ
lupig	lʊpiɡ
luping	lupɪŋ
luping	lʊpiŋ
lupit	lʊpit
lupog	lʊpoɡ
lura	lʊɾaʔ
lusaw	lusaʊ̯
lusaw	lʊsaʊ̯
lusay	lusaɪ̯
lusay	lʊsaɪ̯
luslos	lʊslos
lusok	lʊsok
lusong	lʊsoŋ
lusot	lʊsot
lutad	lʊtad
lutang	lutɐŋ
lutang	lʊtaŋ
lutas	lutɐs
lutas	lʊtas
lutay	lutaɪ̯
lutay	lʊtaɪ̯
luto	lʊto
luto	lʊtoʔ
lutong	lʊtoŋ
luwa	luɐ
luwa	lwaʔ
luwad	lwad
luwag	lwaɡ
luwal	lwal
luwalhati	lʊɐlhatɪʔ
luwan	lwan
luwang	lwaŋ
luwas	lwas
luwat	lwat
luway	lwaɪ̯
luy	lʊɪ
luya	lujɐ
luyok	lʊjok
luzano	lʊsano
luzon	lʊson
luzuriaga	lʊsʊɾjaɰɐ
maabilidad	mɐʔɐbɪlɪdad
maabo	mɐʔɐbo
maagap	mɐʔaɰɐp
maagrabyado	mɐʔɐʔɡɾɐbjado
maako	mɐʔɐxo
maalamat	mɐɐlɐmat
maalat	mɐʔalɐt
maalintana	mɐʔɐlɪntanɐ
maalon	maɐlon
maamag	mɐʔamɐɡ
maangas	mɐʔaŋɐs
maangas	mɐʔɐŋas
maanghang	mɐɐŋhaŋ
maapoy	mɐɐpoɪ̯
maarte	mɐʔaɾte
maasim	mɐʔasɪm
maasin	mɐʔɐsin
maatik	mɐʔɐtik
mababa	mɐbabɐʔ
mababaw	mɐbabaʊ̯
mabagal	mɐbaɰɐl
mabagsik	mɐbɐɡsik
mabagyo	mɐbɐɡjo
mabait	mɐbɐʔit
mabalacat	mɐbɐlaxɐt
mabalahibo	mɐbɐlɐhibo
mabali	mɐbalɪʔ
mabalot	mɐbalot
mabanas	mɐbɐnas
mabangis	mɐbɐŋis
mabasa	mabasɐ
mabasa	mabɐsaʔ
mabasa	mɐbasɐ
mabasa	mɐbɐsa
mabasa	mɐbɐsaʔ
mabasag	mɐbasɐɡ
mabato	mabɐto
mabato	mɐbɐto
mabayaran	mɐbɐjaɾɐn
mabigat	mɐbɪɰat
mabilis	mɐbɪlis
mabini	mɐbinɪ
mabini	mɐbinɪʔ
mabitamina	mɐbɪtɐminɐ
mabolo	mɐbolo
mabuhok	mɐbʊhok
mabuhol	mɐbʊhol
mabula	mɐbʊlaʔ
mabulaklak	mɐbʊlɐklak
mabulo	mɐbulo
maburyong	mɐbʊɾjoŋ
mabuti	mɐbutɪ
mabutig	mɐbʊtiɡ
mabuwisit	mɐbwisɪt
macababbad	mɐxɐbabbɐd
macadangdang	mɐxɐdaŋdɐŋ
macalalad	mɐxɐlalɐd
macalindong	mɐxɐlindoŋ
macapagal	mɐxɐpɐɰal
macapinlac	mɐxɐpinlɐk
macapugay	mɐxɐpuɰaɪ̯
macaranas	mɐxɐɾanɐs
macasaet	mɐxasɐet
macasieb	mɐxasɪeb
macaspac	mɐxaspɐk
macatulad	mɐxɐtulɐd
maceda	mɐsedɐ
macuha	mɐxuhɐ
madaga	mɐdɐɰaʔ
madalas	mɐdɐlas
madaldal	mɐdɐldal
madamay	mɐdamaɪ̯
madamot	mɐdamot
madlangbayan	mɐdlɐŋbajɐn
madriaga	mɐdɾiɐɰɐ
madulas	madʊlas
madulas	mɐdʊlas
madyong	mɐd͡ʒoŋ
magabok	mɐɰɐbok
magaling	mɐɰalɪŋ
magallanes	mɐɰɐljanes
magalona	mɐɰɐlonɐ
maganap	mɐɰɐnap
magandahan	mɐɰɐndɐhan
magarbo	mɐɰaɾbo
magaso	mɐɰɐso
magatas	mɐɰatɐs
magbababoy	mɐɡbɐbɐboɪ̯
magbabakal	mɐɡbɐbaxɐl
magbabakal	mɐɡbɐbɐxal
magbabalot	mɐɡbɐbɐlot
magbabaon	nɐɡbaʔon
magbabaon	nɐɡbɐʔon
magbabasa	mɐɡbɐbɐsa
magbabasa	mɐɡbɐbɐsaʔ
magbakal	mɐɡbaxɐl
magbakal	mɐɡbɐxal
magbakasakali	mɐɡbɐxɐsɐxalɪʔ
magbalatkayo	mɐɡbɐlɐtkɐjoʔ
magbanda	mɐɡbandɐ
magbanua	mɐɡbanʊɐ
magbaon	mɐɡbaʔon
magbaon	mɐɡbɐʔon
magbarena	mɐɡbɐɾenɐ
magbasa	mɐɡbɐsa
magbasa	mɐɡbɐsaʔ
magbati	mɐɡbɐti
magbati	mɐɡbɐtiʔ
magbayad	mɐɡbajɐd
magbenta	mɐɡbentɐ
magbentilador	mɐɡbentɪlɐdoɾ
magbibigas	mɐɡbɪbiɰɐs
magbibigas	mɐɡbɪbɪɰas
magbigay	mɐɡbɪɰaɪ̯
magbihis	mɐɡbihɪs
magbilad	mɐɡbɪlad
magbinata	mɐɡbɪnɐtaʔ
magbiro	mɐɡbɪɾoʔ
magbisikleta	mɐɡbɪsɪkletɐ
magbobote	mɐɡbobote
magboo	mɐɡboo
magbrotsa	mɐɡbɾot͡ʃɐ
magbubukid	mɐɡbʊbuxɪd
magbubukid	mɐɡbʊbʊxid
magbuhat	mɐɡbuhɐt
magbukid	mɐɡbuxɪd
magbulakbol	mɐɡbʊlɐkbol
magdalaga	mɐɡdɐlɐɰa
magdamag	mɐɡdɐmaɡ
magdaspan	mɐɡdaspɐn
magdayao	mɐɡdajaʊ̯
magdede	mɐɡdede
magdede	mɐɡdedeʔ
magdeliryo	mɐɡdeliɾjo
magdemanda	mɐɡdemandɐ
maggatong	mɐɡɡatoŋ
maghabilin	mɐɡhɐbilɪn
maghabla	mɐɡhɐbla
maghalili	mɐɡhɐlilɪ
maghalili	mɐɡhɐlɪli
maghanapbuhay	mɐɡhɐnɐpbuhaɪ̯
maghanda	mɐɡhɐndaʔ
maghangad	mɐɡhɐŋad
maghapon	mɐɡhapon
maghari	mɐɡhaɾɪʔ
maghasik	mɐɡhɐsik
maghati	mɐɡhatɪʔ
maghawak	mɐɡhawɐk
maghiganti	mɐɡhɪɰɐnti
maghikab	mɐɡhɪxab
maghikaw	mɐɡhixaʊ̯
maghilik	mɐɡhɪlik
maghimagsik	mɐɡhɪmɐɡsik
maghimutok	mɐɡhɪmʊtok
maghinala	mɐɡhɪnalɐʔ
maghingalo	mɐɡhɪŋɐlo
maghinto	mɐɡhɪntoʔ
maghinuha	mɐɡhɪnuhɐʔ
maghirang	mɐɡhiɾɐŋ
maghirap	mɐɡhiɾɐp
maghitso	mɐɡhɪt͡ʃo
maghiyas	mɐɡhɪas
maghugas	mɐɡhuɰɐs
maghumpay	mɐɡhumpaɪ̯
magkaaway	mɐɡkɐʔawaɪ̯
magkakarne	mɐɡkɐxɐɾne
magkanlong	mɐɡkɐnloŋ
magkataon	mɐɡkɐtɐʔon
magkeyk	mɐɡkeɪ̯k
maglabas	mɐɡlɐbas
maglalako	mɐɡlɐlaxoʔ
maglalako	mɐɡlɐlɐxoʔ
maglalang	mɐɡlalɐŋ
maglandi	mɐɡlɐndiʔ
maglanggas	mɐɡlɐŋɡas
maglangib	mɐɡlɐŋib
maglango	mɐɡlɐŋo
maglantod	mɐɡlɐntod
maglapa	mɐɡlapɐʔ
maglapastangan	mɐɡlɐpɐstaŋɐn
maglarawan	mɐɡlɐɾawɐn
maglaro	mɐɡlɐɾoʔ
maglaso	mɐɡlaso
maglaway	mɐɡlɐwaɪ̯
maglingid	mɐɡlɪŋid
maglingkod	mɐɡlɪŋkod
maglola	mɐɡlolɐ
maglolo	mɐɡlolo
magluwat	mɐɡlwat
magma	maɡmɐ
magmaliw	mɐɡmalɪʊ̯
magmaneho	mɐɡmɐneho
magmaniobra	mɐɡmɐniobɾɐ
magmartsa	mɐɡmaɾt͡ʃɐ
magnakaw	mɐɡnaxaʊ̯
magnanakaw	mɐɡnɐnɐxaʊ̯
magnanay	mɐɡnanaɪ̯
magnesyo	mɐɡneʃo
magnetiko	mɐɡnetɪxo
magnipayer	mɐɡnɪpajeɾ
magnipikador	mɐɡnɪpɪxɐdoɾ
magpalaganap	mɐɡpɐlɐɰanɐp
magpanatili	mɐɡpɐnɐtilɪ
magparaya	mɐɡpɐɾajɐʔ
magpasubasta	mɐɡpɐsʊbastɐ
magpaubaya	mɐɡpaʊ̯bajɐʔ
magpaubaya	mɐɡpɐʔʊbajɐʔ
magpawis	mɐɡpɐwis
magpraktis	mɐɡpɾaktɪs
magrasa	mɐɡɾasɐ
magrenta	mɐɡɾentɐ
magsalang	mɐɡsalɐŋ
magsaliksik	mɐɡsɐlɪksik
magsapatos	mɐɡsɐpatos
magsimba	mɐɡsɪmba
magsiwalat	mɐɡsɪwalɐt
magsugal	mɐɡsʊɰal
magsuntukan	mɐɡsʊntuxɐn
magtalas	mɐɡtalɐs
magtalo	mɐɡtalo
magtimpla	mɐɡtɪmpla
magtinda	mɐɡtɪnda
magustuhan	mɐɰʊstʊhan
magwala	mɐɡwɐlaʔ
mahalaga	mɐhɐlɐɰa
mahalay	mɐhalaɪ̯
mahamog	mɐhɐmoɡ
mahangin	mɐhaŋɪn
mahikaw	mɐhixaʊ̯
mahilig	mɐhilɪɡ
mahinay	mɐhinaɪ̯
mahirap	mɐhiɾɐp
mahistrado	mɐhɪstɾado
mahiwaga	mɐhɪwaɰɐʔ
mahiyain	mɐhɪaʔɪn
mahulog	mɐhuloɡ
mahumaling	mɐhʊmɐliŋ
maingay	mɐʔiŋaɪ̯
mainit	mɐʔinɪt
mainsekto	mɐʔɪnsekto
mais	mɐʔis
makaako	mɐxɐʔɐxo
makabuluhan	mɐxɐbʊlʊhan
makahiya	mɐxɐhɪaʔ
makakaliwa	mɐxakɐlɪwaʔ
makalat	mɐxalɐt
makaluma	mɐxɐlumɐʔ
makapuno	mɐxɐpʊnoʔ
makati	mɐxatɪ
makatotohanan	mɐxɐtotohanɐn
makatulog	mɐxɐtuloɡ
makatulog	mɐxɐtʊloɡ
makiapid	mɐxiʔɐpid
makibahagi	mɐxɪbɐhaɰɪʔ
makiko	mɐxiko
makina	maxɪnɐ
makinis	mɐxinɪs
makipagbati	mɐxɪpɐɡbɐtiʔ
makipagsuntukan	mɐxɪpɐɡsʊntuxɐn
makontento	mɐxontento
makulimlim	mɐxʊlɪmlim
makulit	mɐxʊlit
makulog	mɐxʊloɡ
makunan	mɐxunɐn
makunat	mɐxunɐt
malabuntala	mɐlɐbʊntalɐʔ
malabuyoc	mɐlɐbujok
malakanyang	mɐlɐxaɲɐŋ
malaluan	mɐlalʊɐn
malamang	mɐlɐmaŋ
malambot	mɐlambot
malanta	mɐlɐnta
malas	malɐs
malaswa	mɐlɐswaʔ
malatala	mɐlɐtalɐʔ
malay	malaɪ̯
malaya	mɐlajɐʔ
malbarosa	mɐlbɐɾosɐ
maliban	mɐlibɐn
malibiran	mɐlɪbiɾɐn
malicsi	mɐliksɪ
maligaw	malɪɰaʊ̯
maligaw	mɐlɪɰaʊ̯
malihan	mɐlihɐn
malikdim	mɐlikdɪm
malikhain	mɐlɪkhaʔɪn
maliksi	mɐliksɪ
malindol	mɐlɪndol
malinis	mɐlinɪs
malisyoso	mɐlɪʃoso
maliwanag	mɐlɪwanɐɡ
mallare	mɐllaɾe
mallari	mɐljaɾɪ
mallorca	mɐlloɾkɐ
malta	maltɐ
malubak	mɐlʊbak
malukong	mɐlʊxoŋ
malutong	mɐlʊtoŋ
mamad	mɐmad
mamagitan	mɐmɐɰitɐn
mamahagi	mɐmɐhaɰɪʔ
mamakyaw	mɐmakjaʊ̯
mamamahayag	mɐmɐmɐhɐjaɡ
mamamakyaw	mɐmamɐkjaʊ̯
mamamakyaw	mɐmɐmɐkjaʊ̯
mamamana	mɐmɐmanɐʔ
mamamangka	mɐmɐmɐŋkaʔ
mamamayan	mɐmɐmɐjan
mamanhikan	mɐmɐŋhixɐn
mamaril	mɐmaɾɪl
mamaril	mɐmɐɾil
mamasa	mɐmɐsaʔ
mamasada	mɐmɐsadɐ
mamasura	mɐmɐsuɾɐ
mambabae	mɐmbɐbaʔe
mambabarang	mɐmbɐbaɾɐŋ
mambabatas	mɐmbɐbatɐs
mambiktima	mɐmbɪktimɐ
mambobola	mɐmbobolɐ
mambola	mɐmbolɐ
mamboso	mɐmboso
mambugaw	mɐmbuɰaʊ̯
mambuwisit	mɐmbwisɪt
mamigay	mɐmiɰaɪ̯
mamihasa	mɐmɪhasɐ
mamihasa	mɐmɪhasɐʔ
mamimili	mɐmɪmilɪ
mamimili	mɐmɪmɪli
mamintog	mɐmɪntoɡ
mamuhunan	mɐmʊhunɐn
mamulaklak	mɐmʊlɐklak
mamumundok	mamʊmʊndok
mamuti	mɐmʊtiʔ
mamuyac	mɐmujɐk
man	mɐn
manabat	mɐnabɐt
manabunot	mɐnɐbunot
managinip	mɐnɐɰinɪp
manakit	mɐnɐxit
manalad	mɐnalɐd
manalikod	mɐnɐlixod
manalo	mɐnalo
manaloto	mɐnɐloto
manamantala	mɐnɐmɐntɐla
manamit	mɐnɐmit
mananahi	mɐnɐnahɪʔ
mananahi	mɐnɐnɐhiʔ
mananakop	mɐnɐnaxop
manananggal	mɐnɐnɐŋɡal
manang	manɐŋ
manangan	mɐnaŋɐn
mananghalian	mɐnɐŋhɐliʔɐn
mananquil	mɐnaŋkɪl
manantan	mɐnantɐn
manaog	manɐoɡ
manaois	manɐoɪ̯s
manarang	mɐnaɾɐŋ
manatad	mɐnatɐd
mancao	maŋkaʊ̯
mandadangkal	mɐndɐdɐŋkal
mandaragat	mɐndɐɾɐɰat
mandarambong	mɐndɐɾɐmboŋ
mandirigma	mɐndɪɾɪɡmaʔ
mandocdoc	mɐndokdok
mandukot	mɐnduxot
mandurukot	mɐndʊɾuxot
maneho	mɐneho
mang	mɐŋ
mangagat	mɐŋɐɰat
mangailangan	mɐŋɐʔɪlaŋɐn
mangalandakan	mɐŋɐlɐndaxɐn
mangalay	mɐŋalaɪ̯
mangalunya	mɐŋɐlʊɲaʔ
mangamba	mɐŋɐmba
mangamote	mɐŋɐmote
manganak	mɐŋɐnak
mangaoang	mɐŋawɐŋ
mangaway	mɐŋawaɪ̯
manggagantso	mɐŋɡɐɰant͡ʃo
manggantso	mɐŋɡant͡ʃo
manggas	mɐŋɡas
manggulo	mɐŋɡʊlo
manghalik	mɐŋhɐlik
manghawa	mɐŋhawɐ
manghimasok	mɐŋhɪmasok
manghuhula	mɐŋhʊhulɐʔ
manghula	mɐŋhulɐʔ
manghusga	mɐŋhʊsɡa
manghuthot	mɐŋhʊthot
mangikil	mɐŋixɪl
mangilit	mɐŋilɪt
manginginom	mɐŋɪŋinom
mangingisda	mɐŋɪŋɪsdaʔ
mangisay	mɐŋisaɪ̯
mangisda	mɐŋɪsdaʔ
mangitlog	mɐŋɪtloɡ
mangkukulam	mɐŋkʊxulɐm
manglicmot	mɐŋlikmot
mangmang	mɐŋmaŋ
mangoba	mɐŋobɐ
mangobra	mɐŋobɾɐ
mangopya	mɐŋopjɐ
mangubra	mɐŋʊbɾa
manguiat	maŋɪɐt
mangulabnan	mɐŋʊlabnɐn
mangulangot	mɐŋʊlaŋot
mangupit	mɐŋupɪt
mangutang	mɐŋutɐŋ
manhid	mɐŋhid
maniago	mɐniɐɰo
maniego	mɐɲeɰo
manigarilyo	mɐnɪɰɐɾiljo
manikin	mɐnɪxin
manilaw	mɐnilaʊ̯
manilip	mɐnilɪp
manindigan	mɐnɪndiɰɐn
maniobra	mɐniobɾɐ
maniquiz	mɐnixɪs
manlaban	mɐnlɐban
manlait	mɐnlaʔɪt
manlalakbay	mɐnlɐlɐkbaɪ̯
manlalaro	mɐnlɐlaɾoʔ
manlangit	mɐnlaŋɪt
manlapaz	mɐnlapɐs
manlapig	mɐnlapɪɡ
manligaw	mɐnliɰaʊ̯
manliligaw	mɐnlɪliɰaʊ̯
manlililok	mɐnlɪlilok
manloko	mɐnloxo
manloloko	mɐnloloxo
manlutac	mɐnlutɐk
manok	mɐnok
manrique	mɐnɾixe
mansanas	mɐnsanɐs
mansanitas	mɐnsɐnitɐs
mansiyon	mɐnʃon
mantika	mɐntixɐʔ
manuhol	mɐnuhol
manuntok	mɐnʊntok
manunugal	mɐnʊnuɰɐl
manyak	maɲɐk
mapagmatyag	mɐpɐɡmɐt͡ʃaɡ
mapagsamantala	mɐpɐɡsɐmɐntɐla
mapahiya	mɐpɐhɪaʔ
mapalad	mɐpalɐd
mapanghusga	mɐpaŋhʊsɡa
mapangutya	mɐpaŋʊt͡ʃaʔ
mapaniil	mɐpɐnɪil
mapera	mɐpeɾɐ
mapusyaw	mɐpʊʃɐu
maralit	mɐɾalɪt
maramot	mɐɾamot
marani	mɐɾɐniʔ
marapao	mɐɾapɐo
maravilla	mɐɾɐbiljɐ
marbella	mɐɾbellɐ
marcial	maɾʃɐl
mariko	mɐɾixo
marinduque	mɐɾɪnduxe
mariseko	mɐɾɪsexo
maristela	mɐɾɪstelɐ
marites	maɾɪtes
mariñas	mɐɾiɲɐs
marquinez	mɐɾkines
martilyo	mɐɾtiljo
martinez	mɐɾtines
marungis	mɐɾuŋɪs
marupok	mɐɾʊpok
masabon	masɐbon
masabon	mɐsɐbon
masahiro	mɐsɐhiɾo
masaker	mɐsaxeɾ
masamid	masɐmid
masangcay	mɐsaŋkaɪ̯
masangkay	mɐsaŋkaɪ̯
maselan	mɐselɐn
maski	mɐski
masukal	mɐsuxɐl
masurot	mɐsuɾot
masyado	mɐʃɐdo
mata	mɐta
mataasnakahoy	mɐtɐʔasnɐxɐhoɪ̯
matae	mɐtɐʔe
matalo	mɐtalo
matatakutin	mɐtɐtɐxʊtin
matauhan	mɐtɐʔuhɐn
matematika	mɐtematɪxa
materyalismo	mɐteɾjɐlismo
matibag	mɐtibɐɡ
matigas	mɐtɪɰas
matisod	mɐtisod
matrapik	mɐtɾapɪk
matunog	mɐtʊnoɡ
maulan	mɐʔʊlan
mauleon	maʊ̯leon
maunahan	maʊ̯nahɐn
maya	majɐ
maybahay	maɪ̯bahaɪ̯
mayuga	mɐjuɰɐ
mayumi	mɐjumɪ
mañago	mɐɲɐɰo
mañalac	mɐɲɐlɐk
medalya	medaljɐ
medina	medinɐ
megan	meɰɐn
megumi	meɰumɪ
mejia	mehiɐ
mekanismo	mexɐnismo
mendoza	mendosɐ
menorca	menoɾkɐ
mental	mentɐl
meryenda	meɾjendɐ
mesa	mesɐ
mga	mɐŋa
michelena	mɪt͡ʃelenɐ
michiko	mɪt͡ʃixo
midori	mɪdoɾɪ
mijares	mɪd͡ʒaɾes
mikiko	mɪxiko
miklawas	mɪklawɐs
miksipat	mɪksɪpat
milagro	mɪlaɡɾo
militante	mɪlɪtante
militar	mɪlɪtaɾ
milya	miljɐ
minako	mɪnaxo
minami	mɪnamɪ
mindanao	mɪndanaʊ̯
mindanaw	mɪndanaʊ̯
mingming	mɪŋmiŋ
minviluz	mɪnbilʊs
miranda	mɪɾandɐ
misako	mɪsaxo
misteryo	mɪsteɾjo
misteryoso	mɪsteɾjoso
misyon	mɪʃon
mitsa	mɪt͡ʃa
miyembro	mjembɾo
miyuki	mjʊxɪ
modernisasyon	modeɾnɪsɐʃon
moises	moɪ̯ses
monako	monɐxo
mondragon	mondɾaɰon
monica	monɪxɐ
monopolisasyon	monopolɪsɐʃon
montealegre	monteɐleɡɾe
montecalvo	montexalbo
montejo	ʔɐlkaɪ̯de
montillano	montɪllano
montinola	montɪnolɐ
montoya	montojɐ
motoko	motoxo
mukha	mʊkhaʔ
mukha	mʊxaʔ
mulapik	mʊlapɪk
mulkaphay	mʊlkɐphaɪ̯
munggo	mʊŋɡo
mura	muɾɐ
mursiko	mʊɾsixo
musika	musɪxɐ
musoleyo	mʊsolejo
mustasa	mʊstasɐ
mutuc	mutʊk
muñoz	mʊɲos
nabasa	nabasɐ
nabasa	nabɐsaʔ
nabasa	nɐbasɐ
nabasa	nɐbɐsaʔ
nacpil	nakpɪl
nagbabaon	nɐɡbɐbaʔon
nagbabaon	nɐɡbɐbɐʔon
nagbaon	nɐɡbaʔon
nagbaon	nɐɡbɐʔon
nakakaalarma	nɐxɐkɐɐlaɾmɐ
nakakabingi	nɐxɐkɐbɪŋi
nakakabobo	nɐxɐkɐbobo
nakakabuwisit	nɐxɐkɐbwisɪt
nakakabwisit	nɐxɐkɐbwisɪt
nakakahawa	nɐxɐkɐhawɐ
nakakaintriga	nɐxɐkɐʔɪntɾiɰɐ
nakakaloko	nɐxɐkɐloxo
nakakatakot	nɐxɐkɐtaxot
nakamulaga	nɐxɐmʊlɐɰaʔ
nakawin	nɐxawɪn
nakibahagi	mɐxɪbɐhaɰɪʔ
nako	nɐxo
nakpil	nakpɪl
naku	nɐxu
naman	nɐman
nancy	nansɪ
nangka	nɐŋkaʔ
nanlilimahid	nɐnlɪlɪmahɪd
naoko	naoxo
naomi	naomɪ
naptalina	nɐptɐlinɐ
narvaez	nɐɾbaes
nasaan	nasɐn
nasaan	nasɐʔan
natae	natɐʔe
natae	nɐtɐʔe
natsuko	nɐt͡ʃuxo
natural	nɐtʊɾal
navoa	naboɐ
negosasyon	neɰosɐʃon
negosyador	neɰoʃɐdoɾ
negosyante	neɰoʃɐnte
negra	neɡɾɐ
ngalan	ŋalɐn
nganga	ŋaŋɐʔ
nganga	ŋɐŋa
ngayon	ŋɐjon
ngimay	ŋimaɪ̯
nguya	ŋujɐʔ
nibel	nɪbel
nicdao	nikdɐo
nietes	ɲetes
niknik	nɪknik
nikotina	nɪxotinɐ
nilabasan	nɪlɐbɐsan
nilabhan	nɪlɐbhan
ninang	ninɐŋ
ninyo	nɪɲɔ
niyo	ɲo
niyog	ɲoɡ
nobela	nobelɐ
nobleza	noblesɐ
nobuhisa	nobʊhisɐ
noriega	noɾjeɰɐ
noriko	noɾixo
norwega	noɾweɰɐ
noypi	noɪ̯pɪ
obligacion	ʔoblɪɰaʃon
ocampo	ʔoxampo
olaguer	ʔolaɰeɾ
olaivar	ʔolaɪ̯bɐɾ
olalia	ʔolalɪɐ
olanda	ʔolandɐ
olats	ʔolat͡s
olayvar	ʔolaɪ̯bɐɾ
oliba	ʔolibɐ
oligarka	ʔolɪɰaɾkɐ
oligarkiya	ʔolɪɰɐɾkiɐ
oligopolyo	ʔolɪɰopoljo
oliva	ʔolibɐ
olivares	ʔolɪbaɾes
olivera	ʔolɪbeɾɐ
oliveros	ʔolɪbeɾos
olongapo	ʔoloŋɐpo
ongkiko	ʔoŋkixo
onomastika	ʔonomastɪxa
opasidad	ʔopɐsɪdad
opeña	ʔopeɲɐ
opisyales	ʔopɪʃɐles
oportunista	ʔopoɾtʊnistɐ
opyum	ʔopjʊm
oracion	ʔoɾaʃon
orasyon	ʔoɾɐʃon
ordenansa	ʔoɾdenansɐ
orendain	ʔoɾendaɪ̯n
oribello	ʔoɾɪbello
orkid	ʔoɾkɪd
ortega	ʔoɾteɰɐ
osamu	ʔosamʊ
paa	pɐʔa
paasa	pɐʔasɐ
pabor	pɐboɾ
paborito	pɐboɾable
pacana	pɐxanɐ
pacaña	pɐxaɲɐ
pader	pɐdeɾ
padilla	pɐdiljɐ
padrino	pɐdɾino
pag	pɐɡ
pagala	pɐɰalɐʔ
pagbabasa	pɐɡbɐbɐsa
pagbabasa	pɐɡbɐbɐsaʔ
pagbasehan	pɐɡbɐsehɐn
pagbati	pɐɡbatɪʔ
pagbati	pɐɡbɐti
pagbubukid	pɐɡbʊbuxɪd
pagbubuntis	pɐɡbʊbʊntis
pagcaliwagan	pɐɡkɐlɪwaɰɐn
pagdilao	pɐɡdilaʊ̯
pagdinig	pɐɡdɪniɡ
pagdudahan	pɐɡdʊdahɐn
paggatas	pɐɡɡatɐs
paggiba	pɐɡɡɪbaʔ
paghahabol	pɐɡhɐhabol
paghuhukom	pɐɡhʊhʊxom
pagi	paɰɪ
pagitan	pɐɰitɐn
pagka	pɐɡka
pagkabilanggo	pɐɡkɐbɪlɐŋɡoʔ
pagkabuhay	pɐɡkabuhaɪ̯
pagkabuhay	pɐɡkɐbuhaɪ̯
pagkabuhay	pɐɡkɐbʊhaɪ̯
pagkaigkasin	pɐɡkɐʔɪɡkasɪn
pagkakataon	pɐɡkɐxɐtɐʔon
pagkapangulo	pɐɡkapɐŋulo
pagmamadali	pɐɡmɐmɐdɐliʔ
pagnanakaw	pɐɡnɐnaxaʊ̯
pagpag	pɐɡpaɡ
pagsamantalahan	pɐɡsɐmɐntɐlɐhan
pagsanjan	pɐɡsɐŋhan
pagsasabansa	pɐɡsɐsɐbɐnsaʔ
pagsasaka	pɐɡsɐsaxɐ
pagsuway	pɐɡswaɪ̯
pagtae	pɐɡtaʔe
pagtakhan	pɐɡtakhɐn
pagtakpan	pɐɡtɐkpan
pagtalikod	pɐɡtɐlixod
pagtaluhan	pɐɡtɐluhɐn
pagtalunan	pɐɡtɐlunɐn
pagtalunan	pɐɡtɐlʊnan
pagtawanan	paɡtɐwanɐn
pagtripan	pɐɡtɾɪpan
pagtutulungan	pɐɡtʊtʊlʊŋan
paguia	paɡjɐ
pahamak	pɐhamɐk
pahina	pahɪnɐ
pahinga	pɐhɪŋa
pahintulot	pɐhɪntulot
pahiyain	pɐhɪɐʔin
pain	paʔɪn
pajares	pɐd͡ʒaɾes
pakla	pɐkla
pako	paxoʔ
pako	pɐxoʔ
pakulo	pɐxʊloʔ
pakupya	pɐxʊpjaʔ
pala	palɐ
pala	palɐʔ
pala	pɐla
pala	pɐlaʔ
palaaway	pɐlɐʔɐwaɪ̯
palabas	pɐlɐbas
palabasa	pɐlɐbɐsa
palabasan	palɐbasɐn
palaboy	pɐlaboɪ̯
palacol	pɐlaxol
palafox	pɐlafoks
palahaw	pɐlahaʊ̯
palaisipan	pɐlaɪ̯sɪpan
palaka	pɐlɐxaʔ
palakol	pɐlɐxol
palaman	pɐlɐman
palamuti	pɐlɐmʊtiʔ
palansak	pɐlɐnsak
palasihayan	pɐlɐsɪhajɐn
palasihayanan	pɐlasihɐjɐnan
palaspas	pɐlɐspas
palayan	pɐlɐjan
palayasin	pɐlɐjasɪn
palda	paldɐ
palikuran	palɪxuɾɐn
palima	pɐlimɐ
palisoc	pɐlisok
palit	pɐlit
palitada	pɐlɪtadɐ
palitadahan	pɐlɪtɐdahɐn
palitan	pɐlitɐn
palitan	pɐlɪtan
paliwanag	pɐlɪwanɐɡ
palomares	pɐlomaɾes
pamahalaan	pɐmɐhɐlaan
pamahiin	pamɐhiʔɪn
pamahiin	pamɐhɪʔin
pamahiin	pɐmɐhɪʔin
pamalo	pɐmaloʔ
pamamahagi	pɐmɐmɐhaɰɪʔ
pamamanhikan	pɐmɐmɐŋhixɐn
pamamaril	pɐmɐmɐɾil
pamaypay	pɐmaɪ̯paɪ̯
pambansa	pɐmbɐnsaʔ
pambati	pɐmbɐti
pambilo	pɐmbɪlo
pamilyar	pɐmɪljaɾ
pamilyaridad	pɐmɪljɐɾɪdad
pamimilosopo	pɐmɪmɪlosopo
paminta	pɐmɪnta
pamintuan	pɐmintʊɐn
panalangin	pɐnɐlaŋɪn
panalo	pɐnalo
pananabotahe	pɐnɐnɐbotahe
pananagutan	pɐnɐnɐɰutɐn
pananawagan	pɐnɐnɐwaɰɐn
pananim	pɐnɐnim
pandaigdig	pɐndaɪ̯ɡdiɡ
pandemya	pɐndemjɐ
pandikit	pɐndɪxit
pandiwa	pɐndiwɐʔ
panelo	pɐnelo
pangako	pɐŋaxoʔ
pangalan	pɐŋalɐn
pangangasiwa	pɐŋɐŋɐsiwɐʔ
pangatnig	pɐŋɐtniɡ
panggupit	pɐŋɡʊpit
panghalip	pɐŋhɐlip
panghimasukan	pɐŋhɪmɐsuxɐn
panghimpapawid	pɐŋhɪmpɐpɐwid
pangkaraniwan	pɐŋkɐɾɐniwɐn
pangngalan	pɐŋŋalɐn
pangulo	pɐŋulo
panguman	pɐŋʊman
panhik	pɐŋhik
panibughuin	pɐnɪbʊɡhuʔɪn
paninigarilyo	pɐnɪnɪɰɐɾiljo
panirahan	panɪɾahɐn
panirahanan	pɐnɪɾɐhanɐn
panitikan	panɪtɪxan
panlaqui	pɐnlaxɪ
panlikod	pɐnlɪxod
panlikuran	panlɪxʊɾan
panlinis	pɐnlinɪs
panlipunan	pɐnlipunɐn
pansamantala	pɐnsɐmɐntɐla
pansin	pɐnsin
pantablay	pɐntɐblaɪ̯
pantig	pantɪɡ
pantoja	pɐntohɐ
panukala	pɐnʊxalɐʔ
papagayo	pɐpɐɰajo
papagtaluhan	papɐɡtɐluhɐn
papagtalunan	papɐɡtɐlunɐn
papagtalunan	papɐɡtɐlʊnan
papagtawanan	papɐɡtɐwanɐn
papansin	pɐpansɪn
papasyalan	papɐʃɐlan
papaya	pɐpajɐ
paraan	pɐɾɐʔan
parada	pɐɾadɐ
paragas	pɐɾaɰɐs
paraikit	pɐɾɐʔɪxit
parayno	pɐɾaɪ̯no
pareño	pɐɾeɲo
pari	paɾɪʔ
parilla	pɐɾillɐ
parinig	pɐɾɪniɡ
parke	pɐɾke
parreño	pɐɾeɲo
parusa	pɐɾusɐ
pasakalye	pɐsɐxalje
pasaway	pɐsawaɪ̯
pasay	pasaɪ̯
pasig	pasɪɡ
pasista	pɐsistɐ
pasiya	pɐʃa
pasko	pɐsko
paskuwa	pɐskuɐ
pasonanca	pɐsonaŋkɐ
pastol	pɐstol
pastor	pɐstoɾ
pastora	pɐstoɾɐ
pastulan	pɐstulɐn
pasugalan	pasʊɰalɐn
pasuguan	pɐsʊɰuʔɐn
pasukan	pɐsuxɐn
pasukan	pɐsʊxan
pasulo	pɐsulo
pasyal	pɐʃal
pasyalan	pɐʃɐlɐn
pasyente	pɐʃente
patahian	pɐtɐhiʔɐn
patatas	pɐtatɐs
patayin	pɐtɐjin
patiag	pat͡ʃɐɡ
patibong	pɐtɪboŋ
pating	pɐtiŋ
patintero	pɐtɪnteɾo
patiño	pɐtiɲo
patnubay	pɐtnubaɪ̯
patutsada	pɐtʊt͡ʃadɐ
paupahan	paʊ̯pahɐn
paupahan	paʊ̯pɐhan
pawatas	pɐwɐtas
pawikan	pɐwixɐn
pawis	pawɪs
pawis	pɐwis
pawisan	pɐwisɐn
pawisan	pɐwɪsan
payapa	pɐjapɐʔ
payatot	pɐjatot
paypay	paɪ̯paɪ̯
payumo	pɐjumo
paz	pɐs
pekas	pexɐs
peke	pexeʔ
peking	pexɪŋ
peklat	peklɐt
pekulyar	pexʊljaɾ
pekulyaridad	pexʊljɐɾɪdad
pelikula	pelixʊla
peluka	peɾuxɐ
penikula	penixʊla
peninsula	peninsʊla
peninsulares	peninsʊlaɾes
penitensiya	penɪtenʃa
pensiyon	penʃon
pensiyonado	penʃonado
peras	peɾɐs
perera	peɾeɾɐ
perlas	peɾlɐs
perya	peɾjɐ
pestisidyo	pestɪsid͡ʒo
peñaflor	peɲɐfloɾ
peñaflorida	peɲɐfloɾidɐ
peñaranda	peɲɐɾandɐ
pg	pid͡ʒɪ
piga	pɪɰaʔ
pigain	pɪɰɐʔin
pigsa	pɪɡsa
pigsa	pɪɡsaʔ
pihikan	pɪhixɐn
pilantik	pɪlɐntik
pilantropo	pɪlantɾopo
pilapil	pɪlapɪl
pilat	pilɐt
pilipinas	pɪlɪpinɐs
pilosopiya	pɪlosopiɐ
pilosopo	pɪlosopo
piloto	pɪloto
pinaghihinalaan	pɪnɐɡhɪhɪnɐlaɐn
pinagsamantalahan	pɪnɐɡsɐmɐntɐlɐhan
pinagtaluhan	pɪnaɡtɐluhɐn
pinagtalunan	pɪnaɡtɐlunɐn
pinagtalunan	pɪnaɡtɐlʊnan
pinagtawanan	pɪnaɡtɐwanɐn
pinapagtaluhan	pɪnapɐɡtɐluhɐn
pinapagtalunan	pɪnapɐɡtɐlunɐn
pinapagtalunan	pɪnapɐɡtɐlʊnan
pinapagtawanan	pɪnapɐɡtɐwanɐn
pinapasyalan	pɪnapɐʃɐlan
pinas	pɪnas
pinasyalan	pɪnɐʃɐlan
pindot	pɪndot
pinggan	pɪŋɡan
pinlac	pinlɐk
pinlandiya	pɪnland͡ʒa
pinlandya	pɪnland͡ʒɐ
pinsan	pinsɐn
pintakasi	pɪntɐxasɪ
pintuan	pɪntuʔɐn
pinya	pɪɲa
pipi	pipɪ
pipi	pipɪʔ
pipi	pɪpi
pipi	pɪpiʔ
piraso	pɪɾaso
pirmahan	pɪɾmɐhan
pirurutong	pɪɾʊɾutoŋ
pisan	pisɐn
pisan	pɪsan
piskal	pɪskal
piskalya	pɪskaljɐ
piskalya	pɪskɐlja
pisngi	pɪsŋi
pista	pɪsta
pistola	pɪstolɐ
pitumbuko	pɪtumbʊxo
pitumpu	pɪtumpuʔ
piyano	pjɐno
piyo	pjoʔ
pizarro	pɪsaɾɾo
plais	plaɪ̯s
plakard	plaxɐɾd
planas	planɐs
planeta	plɐnetɐ
planetaryum	plɐnetaɾjʊm
plapla	plaplɐ
plaslayt	plaslaɪ̯t
plastik	plastɪk
platito	plɐtito
plawta	plaʊ̯tɐ
policarpio	polɪxaɾpjo
polintan	polintɐn
politika	politɪxa
politikal	politɪxal
politikal	polɪtɪxal
politiko	politɪxo
polonya	poloɲɐ
ponema	ponemɐ
poon	pʊn
portugal	poɾtʊɰal
portuges	poɾtʊɰes
posas	posɐs
post	poʊst
potensiyal	potenʃal
prangka	pɾaŋkɐ
praning	pɾanɪŋ
prayoridad	pɾɐjoɾidɐd
presensiya	pɾesenʃa
pribilehiyo	pɾɪbɪlehio
probinsiyano	pɾobɪnʃano
proklamasyon	pɾoklɐmɐʃon
propagandista	pɾopɐɰɐndistɐ
propesyon	pɾopeʃon
propesyonal	pɾopeʃonal
propesyonalismo	pɾopeʃonɐlismo
protekta	pɾotektɐ
prudente	pɾʊdente
pua	pʊɐ
puday	pʊdaɪ̯
pudpod	pʊdpod
pugad	puɰɐd
pugo	puɰoʔ
pugok	pʊɰok
pugon	pʊɰon
pugot	pʊɰot
pugutan	pʊɰutɐn
puhunan	pʊhunɐn
puke	puxe
puke	puxeʔ
puki	puxɪ
puki	puxɪʔ
pukyutan	pʊkjutɐn
pulahan	pʊlɐhan
pulbura	pʊlbʊɾa
pulgada	pʊlɡadɐ
pulgas	pʊlɡas
pulikat	pʊlixɐt
pulis	pʊlis
pulmonya	pʊlmoɲa
pulo	pʊloʔ
pulot	pʊlot
pulubi	pʊlubɪ
pulutan	pʊlutɐn
pumarada	pʊmɐɾadɐ
pumatay	pʊmɐtaɪ̯
pumula	pʊmʊla
pumutok	pʊmʊtok
pundasyon	pʊndaʃon
pundido	pʊndido
punerarya	pʊneɾaɾjɐ
punongbayan	pʊnoŋbajɐn
punongkahoy	pʊnoŋkahoɪ̯
punsalang	pʊnsalɐŋ
punso	pʊnso
punso	pʊnsoʔ
puntahan	pʊntɐhan
puntirya	pʊntɪɾja
punzalan	pʊnsalɐn
pusa	pusɐʔ
pusod	pʊsod
puson	pʊson
pusta	pʊsta
pustahan	pʊstahɐn
pustiso	pʊstiso
pusyaw	pʊʃau
putakti	pʊtɐkti
puwas	pwas
puwes	pwes
puyat	pujɐt
puyat	pʊjat
puyod	pʊjod
quezon	kxeson
quiambao	kjɐmbaʊ̯
quiapo	kjɐpoʔ
quimpo	kximpo
quintos	kxintos
quirante	kxɪɾante
quisumbing	kxɪsumbɪŋ
quitain	kxitaɪ̯n
quiñones	kxɪɲones
racelis	ɾɐselɪs
ragas	ɾaɰɐs
ragasa	ɾɐɰasɐ
ragsak	ɾɐɡsak
ragudo	ɾɐɰudo
raha	ɾahɐ
rajah	ɾahɐ
raket	ɾaxet
rali	ɾalɪ
raliyista	ɾɐlɪjistɐ
rambulan	ɾɐmbulɐn
rason	ɾɐson
raw	ɾaʊ̯
reaño	ɾeɐɲo
rebentador	ɾebentɐdoɾ
rebisa	ɾebɪsa
regala	ɾeɰalɐ
rehas	ɾehɐs
rehimen	ɾehɪmen
rekisito	ɾexɪsito
rekisitos	ɾexɪsitos
relihiyon	ɾelɪhɪon
remolatsa	ɾemolat͡ʃɐ
remulla	ɾemullɐ
reodica	ɾeodixɐ
replyan	ɾeplɐjan
resistensya	ɾesɪstenʃɐ
resurreccion	ɾesʊɾekʃon
retratista	ɾetɾɐtistɐ
reyna	ɾeɪ̯nɐ
ricafort	ɾɪxafoɾt
ricarte	ɾɪxaɾte
rimarim	ɾɪmaɾɪm
rimas	ɾimɐs
rin	ɾɪn
rivero	ɾɪbeɾo
riyan	ɾjan
rizal	ɾɪsal
rocafort	ɾoxafoɾt
rodrigo	ɾodɾiɰo
rodriguez	ɾodɾiɰes
rombaoa	ɾumbawɐ
roxas	ɾohɐs
rulloda	ɾʊllodɐ
rumupok	ɾʊmʊpok
rusoblanka	ɾʊsoblaŋkɐ
rusya	ɾuʃɐ
ruta	ɾutɐ
saan	sɐʔan
saba	sɐba
sabana	sɐbanɐ
sabangan	sɐbaŋɐn
sabater	sɐbateɾ
sabihin	sɐbihɪn
sabila	sabɪla
sabog	sɐboɡ
sabon	sɐbon
saboy	saboɪ̯
sabsab	sabsɐb
sabunan	sɐbunɐn
sabunan	sɐbʊnan
sabunin	sɐbʊnin
sabunot	sɐbunot
sabunutan	sɐbʊnutɐn
saburo	sɐbuɾo
sacdalan	sɐkdalɐn
sadie	seɪ̯dɪ
sadya	sɐd͡ʒaʔ
saga	saɰɐʔ
sagana	sɐɰanɐ
sagimuymoy	saɰimujmoj
saging	saɰɪŋ
saguinsin	sɐɰinsɪn
sagun	saɰʊn
saha	sahɐʔ
sahagun	sɐhaɰʊn
sahog	sɐhoɡ
saing	saʔɪŋ
sais	sɐʔis
sakal	sɐxal
sakali	sɐxalɪʔ
sakdal	sɐkdal
sakit	sɐxit
sakitin	sɐxitɪn
saksak	sɐksak
saksi	sɐksi
saksihan	sɐksɪhan
sakuna	sɐxʊna
sala	salɐ
salagubang	sɐlɐɰubɐŋ
salamat	sɐlamɐt
salap	salɐp
salap	sɐlap
salapi	sɐlɐpiʔ
salarin	sɐlɐɾin
salaula	sɐlɐʔulɐʔ
salawal	sɐlɐwal
salazar	sɐlɐsaɾ
salba	sɐlba
saldaña	sɐldaɲɐ
salinlahi	sɐlɪnlahɪʔ
salitre	sɐlitɾe
salonga	sɐloŋɡɐ
salud	salʊd
salumbides	sɐlumbides
salvacion	sɐlbasɪon
salvador	sɐlbɐdoɾ
salvatierra	salbɐt͡ʃeɾɐ
samahan	sɐmahɐn
samahan	sɐmɐhan
samaniego	sɐmɐɲeɰo
samantala	sɐmɐntalɐʔ
samid	sɐmid
samonte	sɐmonte
sampaloc	sɐmpalok
sampalok	sɐmpalok
sampan	sɐmpan
sampay	sɐmpaɪ̯
sampayan	sɐmpajɐn
sana	sɐna
sangalang	sɐŋɡalɐŋ
sanggol	sɐŋɡol
sanggumay	sɐŋɡumaɪ̯
sangkot	sɐŋkot
sangla	sɐŋlaʔ
sanidad	sɐnɪdad
sanitaryo	sɐnɪtaɾjo
sanke	sɐŋke
sanki	sɐŋki
santiago	sɐnt͡ʃaɰo
sapa	sapɐʔ
sapak	sapɐk
sapak	sɐpak
sapatos	sɐpatos
sapodilya	sɐpodiljɐ
sapok	sɐpok
saquing	saxɪŋ
saranggola	sɐɾɐŋɡolɐ
sarimanok	sɐɾɪmɐnok
sasakyan	sasɐkjan
sasakyan	sɐsɐkjan
satomi	sɐtomɪ
saturno	sɐtuɾno
sawa	sawɐʔ
sawa	sɐwa
sawa	sɐwaʔ
saway	sawaɪ̯
sawayin	sɐwɐjin
sawi	sɐwiʔ
sayson	saɪ̯son
segismundo	seɰɪsmundo
segui	seɰɪ
segunda	seɰundɐ
selan	selɐn
selang	selɐŋ
selda	seldɐ
selular	selulɐɾ
semantika	semantɪxɐ
semaña	semaɲɐ
seminar	seminɐɾ
seminaryo	semɪnaɾjo
sentensiya	sentenʃɐ
sentensiyahan	sentenʃɐhan
sentigrado	sentɪɡɾado
sentimo	sentɪmo
sepulturero	sepʊltʊɾeɾo
seremonya	seɾemoɲɐ
serna	seɾnɐ
setsuko	set͡ʃuxo
setyembre	set͡ʃembɾe
shabu	ʃɐbu
shizuko	shɪsuxo
shohei	shoheɪ̯
siason	ʃɐson
sibayan	sɪbajɐn
sibug	sibʊɡ
sibuyas	sɪbujɐs
sidras	sidɾɐs
siga	siɰɐʔ
siga	sɪɰaʔ
sigarilyas	sɪɰɐɾiljɐs
sige	sɪɰe
siguraduhin	sɪɰʊɾɐduhɪn
siguro	sɪɰuɾo
sigwasan	sɪɡwasɐn
sihay	sihaɪ̯
sihayan	sɪhajɐn
siko	sixo
sikreto	sɪkɾeto
siksin	sɪksin
silayan	sɪlajɐn
silid	sɪlid̪
silidkaphay	sɪlɪdkɐphaɪ̯
silidlawas	sɪlɪdlawɐs
silindro	sɪlindɾo
simbahan	sɪmbahɐn
simbulan	sɪmbulɐn
simenteryo	sɪmenteɾjo
simento	sɪmento
simpatiko	sɪmpatɪxo
sinag	sinɐɡ
sinamomo	sɪnɐmomo
sinapupunan	sɪnɐpʊpunɐn
sinat	sinɐt
sinauna	sɪnaʊ̯nɐ
sinco	siŋko
sinelas	sɪnelɐs
singgapur	sɪŋɡɐpuɾ
singil	sɪŋil
singkit	sɪŋkit
sinigwelas	sɪnɪɡwelɐs
sinturon	sɪntʊɾon
sinukmani	sɪnʊkmanɪ
sioson	ʃoson
siping	sipɪŋ
sipnayan	sɪpnajɐn
sipon	sɪpon
sipon	sɪpʔon
sipsip	sipsɪp
sira	siɾɐʔ
sira	sɪɾaʔ
sirain	sɪɾaʔɪn
sirena	sɪɾenɐ
sirwelas	sɪɾwelɐs
sisi	sisɪ
sisid	sisɪd
sisihan	sɪsɪhan
sitse	sɪt͡ʃe
sitwasyon	sɪtwɐʃon
siya	ʃa
siyampu	ʃɐmpʊ
siyempre	ʃempɾe
siyesta	ʃestɐ
siyete	ʃete
siyokoy	ʃoxoɪ̯
sobrepeña	sobɾepeɲɐ
solidum	solidʊm
solis	solɪs
sosa	sosɐ
sosyal	soʃal
spg	ʔespid͡ʒɪ
strikto	stɾɪkto
suan	swɐn
suazo	swɐso
subsidiya	sʊbsɪdiɐ
sucgang	sukɡɐŋ
sugal	sʊɰal
sugarol	sʊɰɐɾol
sugok	sʊɰok
suha	suhɐʔ
suico	suɪxo
suka	suxɐ
suka	suxɐʔ
sukal	suxɐl
sukgisan	sʊkɡisɐn
sulsol	sʊlsol
sultan	sultɐn
sultana	sʊltanɐ
sulyasid	sʊljasɪd
sumadsad	sʊmadsɐd
sumagot	sʊmɐɰot
sumemplang	sʊmemplɐŋ
sumiko	sʊmixo
sundang	sʊndaŋ
suntok	sʊntok
suntukan	sʊntuxɐn
suntukin	sʊntʊxin
suot	sʊot
supil	supɪl
supil	sʊpil
supling	sʊpliŋ
surimbangkay	suɾɪmbɐŋkaɪ̯
susmaryosep	sʊsmɐɾjosep
sustento	sʊstento
suwelas	swelɐs
suwesya	sweʃɐ
sya	ʃa
syota	ʃotɐʔ
tabas	tabɐs
tabas	tɐbas
tabla	tablɐ
tabla	tɐbla
taboy	tɐboɪ̯
taduran	tɐduɾɐn
tagabukid	tɐɰɐbuxɪd
tagal	tɐɰal
tagalinis	tɐɰɐlinɪs
tagapagmana	tɐɰɐpɐɡmanɐ
tagapangasiwa	tɐɰɐpɐŋɐsiwɐʔ
tagas	taɰɐs
tagasaw	tɐɰɐsaʊ̯
tagiktik	tɐɰɪktik
tagiliran	tɐɰɪliɾɐn
tago	taɰoʔ
tagos	tɐɰos
tagtuyot	tɐɡtʊjot
taguba	tɐɰubɐ
tagubilin	tɐɰʊbilɪn
taguinod	tɐɰinod
tagunya	tɐɰʊɲaʔ
tagupa	tɐɰupɐ
takahashi	tɐxɐhaʃɪ
takako	tɐxako
takal	taxɐl
takal	tɐxal
takbo	tɐkbo
takeko	tɐxeko
tala	talɐʔ
tala	tɐlaʔ
talabong	tɐlaboŋ
talag	talɐɡ
talampas	tɐlampɐs
talang	talɐŋ
talavera	tɐlɐbeɾɐ
talento	tɐlento
talong	tɐloŋ
taludtod	tɐlʊdtod
talukbong	tɐlʊkboŋ
talunan	talʊnan
talunan	tɐlʊnan
tambakol	tɐmbaxol
tambalan	tɐmbalɐn
tamban	tɐmban
tamiko	tɐmixo
tamis	tɐmis
tamod	tɐmod
tampal	tɐmpal
tampisaw	tɐmpɪsaʊ̯
tanauan	tɐnawɐn
tanauan	tɐnʔawɐn
tancinco	tɐnsiŋko
tang	tɐŋ
tanga	tɐŋa
tanghali	tɐŋhalɪʔ
tanghalian	tɐŋhɐliʔɐn
tangka	tɐŋkaʔ
tangkal	tɐŋkal
tanikala	tɐnɪxɐlaʔ
taning	tanɪŋ
tanlap	tɐnlap
tansan	tansɐn
tansan	tɐnsan
tansiya	tɐnʃa
tanso	tɐnsoʔ
tantiya	tɐnt͡ʃa
taon	tɐʔon
tapales	tɐpales
tapay	tapaɪ̯
tapilok	tɐpɪlok
tapos	tɐpos
tapos	tɐs
tapsilog	tɐpsɪloɡ
tapulaw	tɐpulaʊ̯
tapunan	tɐpʊnan
tarik	tɐɾik
taruc	taɾʊk
tas	tɐs
tasa	tɐsa
tatlonghari	tɐtloŋhaɾɪ
tatlumpu	tɐtlumpuʔ
tato	tɐtoʔ
tatsuko	tɐt͡ʃuxo
tatsulok	tɐt͡ʃʊlok
tauhan	tɐʔuhɐn
tawanan	tawanɐn
tawanan	tɐwanɐn
tawanan	tɐwɐnan
tayabas	tɐjabɐs
tayo	tɐjoʔ
tañada	tɐɲɐdɐ
teknolohiya	teknolohiɐ
telebisyon	telebɪʃon
tenga	teŋɐ
tenyente	teɲente
teoriya	teoɾiɐ
teritoryo	teɾɪtoɾjo
teruko	teɾuxo
tetano	tetɐno
tiamson	t͡ʃamson
tiangco	t͡ʃaŋko
tibay	tibaɪ̯
tibig	tɪbiɡ
tiburcio	tɪbuɾʃo
tigang	tiɰɐŋ
tigang	tɪɰaŋ
tigas	tɪɰas
tignan	tɪɡnan
tigyawat	tɪɡjawɐt
tiis	tɪʔis
tikbalang	tɪkbalɐŋ
tiklop	tɪklop
tiktik	tɪktik
timbang	tɪmbaŋ
tina	tinɐʔ
tinapa	tɪnɐpa
tinapay	tɪnapaɪ̯
tinda	tindɐ
tindera	tɪndeɾɐ
tindero	tɪndeɾo
tindig	tɪndiɡ
tinga	tɪŋa
tingala	tɪŋɐlaʔ
tingalaan	tɪŋɐlaan
tingga	tɪŋɡaʔ
tingin	tɪŋin
tingnan	tɪŋnan
tinidor	tɪnɪdoɾ
tinik	tɪnik
tino	tɪnoʔ
tinta	tintɐ
tio	t͡ʃo
tiozon	t͡ʃoson
tipak	tɪpak
tipaklong	tipɐkloŋ
tira	tiɾɐ
tira	tiɾɐʔ
tira	tɪɾa
tirada	tɪɾadɐ
tirahan	tɪɾahɐn
tirahan	tɪɾɐhan
tiraniya	tɪɾɐniɐ
tirik	tiɾɪk
tirik	tɪɾik
tiris	tɪɾis
tirona	tɪɾonɐ
titik	titɪk
tiwali	tɪwɐliʔ
tiya	tiɐ
tiyaga	tɪɐɰaʔ
tiyahin	t͡ʃahɪn
tiyan	t͡ʃan
tiyanak	t͡ʃanɐk
tiyangge	t͡ʃaŋɡeʔ
tiyesa	t͡ʃesɐ
tiyuhin	t͡ʃuhɪn
tokayo	toxajo
tomiko	tomixo
tomoko	tomoxo
tonelada	toneladɐ
topacio	topaʃo
topak	topɐk
torralba	toɾɾalbɐ
torrecampo	toɾɾexampo
trahedya	tɾɐhed͡ʒɐ
trangkaso	tɾɐŋkaso
trapik	tɾapɪk
traqueña	tɾɐxeɲɐ
tratado	tɾɐtado
traydor	tɾaɪ̯doɾ
tren	trɛn
tren	tɾɛn
tria	tɾɪɐ
trillanes	tɾɪllanes
trip	tɾɪp
tsaa	t͡ʃɐʔa
tsampoy	t͡ʃɐmpoɪ̯
tseke	t͡ʃexe
tseko	t͡ʃexo
tsekya	t͡ʃekjɐ
tsempedak	t͡ʃempedɐk
tsikinini	t͡ʃɪxɪninɪʔ
tsiko	t͡ʃixo
tsikot	t͡ʃɪxot
tsinelas	t͡ʃɪnelɐs
tsismis	t͡ʃismɪs
tsismosa	t͡ʃɪsmosɐ
tsokolate	t͡ʃoxolate
tsunami	t͡ʃʊnamɪ
tuason	twɐson
tuba	tʊba
tuba	tʊbaʔ
tubero	tʊbeɾo
tubo	tʊbo
tubuhan	tʊbʊhan
tugade	tʊɰade
tugtugin	tʊɡtuɰɪn
tugtugin	tʊɡtʊɰin
tukod	tuxod
tukso	tʊkso
tulad	tulɐd
tulak	tulɐk
tulay	tulaɪ̯
tulingan	tʊliŋɐn
tullao	tuljaʊ̯
tuloy	tuloɪ̯
tumacder	tʊmakdeɾ
tumae	tʊmaʔe
tumanggap	tʊmɐŋɡap
tumbaga	tumbaɰɐ
tumbalik	tumbalɪk
tumingala	tʊmɪŋɐlaʔ
tumingin	tʊmɪŋin
tumira	tʊmiɾɐ
tumira	tʊmɪɾa
tumukso	tʊmʊkso
tunay	tunaɪ̯
tung	tʊŋ
tungaw	tʊŋaʊ̯
tungkab	tʊŋkab
tungkod	tʊŋkod
tungkol	tʊŋkol
tungkos	tʊŋkos
tunog	tʊnoɡ
tunton	tʊnton
tupa	tupɐ
tupad	tʊpad
tupada	tʊpadɐ
tupi	tʊpiʔ
turnilyo	tʊɾniljo
turok	tʊɾok
tutuli	tʊtʊli
tuwa	twaʔ
tuwad	tuɐd
tuwad	twad
tuwalya	twɐljɐ
tuwang	twaŋ
uban	ʔubɐn
ubas	ʔubɐs
ubasan	ʔʊbɐsan
udyukan	ʔʊd͡ʒʊxan
ugat	ʔʊɰat
uhaw	ʔuhaʊ̯
uhaw	ʔʊhaʊ̯
ulam	ʔulɐm
ulianin	ʔʊlianɪn
ulila	ʔʊlilɐ
uling	ʔulɪŋ
ulnungkuro	ʔʊlnʊŋkuɾoʔ
umaa	ʔʊmaʔɐʔ
umaa	ʔʊmɐʔaʔ
umaaa	ʔʊmɐʔɐʔaʔ
umaakyat	ʔʊmɐʔɐkjat
umabyad	ʔʊmɐbjad
umagahas	ʔʊmɐɰahɐs
umagahas	ʔʊmɐɰɐhas
umagnas	ʔʊmɐɡnas
umakyat	ʔʊmɐkjat
umalingawngaw	ʔʊmɐlɪŋaʊ̯ŋaʊ̯
umalog	ʔʊmɐloɡ
umapaw	ʔʊmapaʊ̯
umasim	ʔʊmasɪm
umasinta	ʔʊmɐsɪnta
umawat	ʔʊmawɐt
umawit	ʔʊmawɪt
umayos	ʔʊmajos
umebak	ʔʊmebɐk
umepal	ʔʊmepɐl
umiskor	ʔʊmɪskoɾ
umisod	ʔʊmisod
umpisa	ʔumpɪsa
umurong	ʔʊmuɾoŋ
umutot	ʔʊmʊtot
unan	ʔunɐn
unano	ʔʊnanoʔ
untalan	ʔʊntalɐn
upa	ʔupɐ
urano	ʔʊɾano
uriarte	ʔʊɾjaɾte
urong	ʔʊɾoŋ
ursua	ʔuɾsʊɐ
ursula	ʔuɾsʊlɐ
usap	ʔusɐp
usisera	ʔʊsɪseɾɐ
usisero	ʔʊsɪseɾo
usman	ʔusmɐn
utang	ʔutɐŋ
utot	ʔʊtot
uwak	ʔʊak
uwas	ʔʊas
uwi	ʔʊiʔ
valera	bɐleɾɐ
valmores	bɐlmoɾes
van	bɐn
varias	baɾɪɐs
varona	bɐɾonɐ
veloria	beloɾjɐ
veneracion	beneɾaʃon
venturina	bentʊɾinɐ
venus	benʊs
vergara	beɾɡaɾɐ
veronica	beɾonɪxɐ
versoza	beɾsosɐ
vigilante	bɪd͡ʒɪlante
villablanca	bɪllɐblaŋkɐ
villacarlos	bɪllɐxaɾlos
villafranca	bɪllɐfɾaŋkɐ
villafuerte	bɪljɐfweɾte
villagracia	bɪllɐɡɾaʃɐ
villamater	bɪllɐmateɾ
villamin	bɪllamɪn
villamor	bɪllamoɾ
villapando	bɪllɐpando
villareal	bɪllaɾeɐl
villarino	bɪllɐɾino
villaruz	bɪllaɾʊs
villaseñor	bɪllɐseɲoɾ
villasis	bɪllasɪs
villaverde	bɪllɐbeɾde
villavicencio	bɪllɐbɪsenʃo
villegas	bɪljeɰɐs
villena	bɪljenɐ
vinoya	bɪnojɐ
virata	bɪɾatɐ
virrey	biɾɾeɪ̯
virus	baɪ̯ɾʊs
virus	biɾʊs
visaya	bɪsajɐʔ
vitales	bɪtales
vizcarra	bɪskaɾɐ
wag	wɐɡ
wahoy	wahoɪ̯
wala	walɐʔ
wala	wɐlaʔ
wang	wɐŋ
wangis	waŋɪs
wari	waɾɪ
wari	waɾɪʔ
wawa	wawɐʔ
welga	welɡɐ
wika	wixɐʔ
wiski	wiskɪ
wu	wʊ
yaeko	jaexo
yakap	jaxɐp
yalung	jalʊŋ
yan	jɐn
yang	jɐŋ
yarda	jaɾdɐ
yari	jaɾɪ
yari	jaɾɪʔ
yari	jɐɾɪ
yasay	jasaɪ̯
ybañez	ʔɪbaɲes
yena	jenɐ
yolanda	jolandɐ
yoshiko	joshixo
yosi	josɪ
yuichiro	jʊɪt͡ʃiɾo
yumabang	jʊmabɐŋ
yumi	jumɪʔ
yuvienco	jʊbieŋko
yñiguez	jɲɪɰes
zafra	safɾɐ
zaide	saɪ̯de
zamboanga	sɐmbwɐŋɡɐ
zamora	sɐmoɾɐ
zapanta	sɐpantɐ
zavalla	sɐballɐ
zoleta	soletɐ
zoraida	soɾaɪ̯dɐ
zuñiga	sʊɲɪɰɐ
