de	de
a	ˈa
en	en
y	jˈe
que	kɛ
o	ˈo
ye	jɛ
se	se
os	os
con	kon
un	ˈun
una	ˈuna
la	la
por	poɾ
A	ˈa
as	ˈas
lo	lo
como	kˌomo
suya	sˈuja
u	ˈu
En	en
O	ˈo
no	nˈo
son	sˈon
ta	ta
ha	ˈa
suyo	sˈujɔ
d	dˈe
mas	mˈas
tamién	tamjˈen
Os	os
población	pˌoβlaθjˈon
l	ˈɛle
los	los
habitants	ˌaβitˈantʰs
las	las
dos	dˈos
Ye	jɛ
entre	ˈentɾe
pa	pa
fa	fˈa
La	la
As	ˈas
bi	bi
más	mˈas
pero	pˈeɾo
Se	se
yera	jˈɛɾa
estió	estjˈo
nombre	nˈombɾe
dende	dˈende
estar	estˈaɾ
gran	ɣɾˈan
forma	fˈoɾma
encara	enkˈaɾa
i	ˈi
dica	dˈika
parte	pˈaɾte
suyos	sˈujɔs
Tamién	tamjˈen
puet	pwˈɛtʰ
sobre	sˈoβɾe
per	peɾ
suyas	sˈujas
dimpués	dimpwˈes
ciudat	θjuðˈatʰ
fan	fˈan
quan	kwan
pueden	pwˈɛðen
on	on
ya	jˈa
tien	tjˈɛn
troba	tɾˈoβa
diferents	dˌifeɾˈentʰs
termin	tˈeɾmin
atros	ˈatɾos
mesmo	mˈesmo
més	mˈes
parti	pˈaɾti
tot	tˈotʰ
luenga	lwˈɛnɡa
servir	seɾβˈiɾ
han	ˈan
fer	fˈeɾ
atras	ˈatɾas
fue	fwˈɛ
tienen	tjˈɛnen
aragonés	ˌaɾaɣonˈes
ista	ˈista
anyos	ˈaɲɔs
Bi	bi
mientres	mjˈɛntɾes
e	ˈe
lugar	luɣˈaɾ
Manimenos	mˌanimˈenos
baixo	bˈaʃo
bells	bels
luengas	lwˈɛnɡas
tres	tɾˈes
latín	latˈin
Por	poɾ
del	dˈel
puesto	pwˈɛsto
si	sˈi
mes	mes
totz	tˈoθ
Lo	lo
iste	ˈiste
enta	ˈenta
muitos	muˈitos
primera	pɾimˈeɾa
municipal	mˌuniθipˈal
primer	pɾimˈeɾ
muit	muˈitʰ
sieglo	sjˈɛɣlo
yeran	jˈɛɾan
nomás	nomˈas
sin	sin
río	rˈio
feito	fˈe͡ɪto
lugars	luɣˈas
mayor	majˈɔɾ
Sant	sˈantʰ
país	paˈis
Un	ˈun
Una	ˈuna
francés	fɾanθˈes
Dimpués	dimpwˈes
diz	dˈiθ
heba	ˈeβa
muito	muˈito
Zaragoza	θˌaɾaɣˈoθa
numero	numˈeɾo
mundo	mˈundo
asinas	asˈinas
Los	los
puede	pwˈɛðe
grans	ɣɾˈans
metros	mˈetɾos
norte	nˈoɾte
cada	kˈaða
grupo	ɣɾˈupo
estato	estˈato
Aragón	ˌaɾaɣˈon
formas	fˈoɾmas
estau	estˈa͡ʊ
sobén	soβˈen
caso	kˈaso
el	el
eixemplo	eʃˈemplo
traza	tɾˈaθa
zona	θˈona
cheneral	t͡ʃˌeneɾˈal
tiempo	tjˈɛmpo
qui	ki
capital	kˌapitˈal
traviés	tɾaβjˈes
vida	bˈiða
bien	bjˈɛn
important	ˌimpoɾtˈantʰ
sud	sˈu
muitas	muˈitas
part	pˈaɾtʰ
estando	estˈando
regular	rˌeɣulˈaɾ
contra	kˈontɾa
sistema	sistˈema
Dende	dˈende
ixo	ˈiʃo
Ista	ˈista
menos	mˈenos
Con	kon
bellas	bˌeʎas
seguntes	seɣˈuntes
le	le
verbos	bˈeɾβos
parola	paɾˈola
El	el
I	ˈi
superficie	sˌupeɾfˈiθjɛ
m	ˈɛme
rechión	ret͡ʃjˈon
mayoría	mˌajɔɾˈia
tanto	tˈanto
No	nˈo
ilesia	ilˈesja
alto	ˈalto
prou	pɾˈow
Iste	ˈiste
fació	faθjˈo
territorio	tˌeritˈoɾjɔ
millons	miʎˈons
tener	tenˈeɾ
casa	kˈasa
historia	istˈoɾja
teneba	tenˈeβa
periodo	peɾjˈɔðo
casos	kˈasos
castellán	kˌasteʎˈan
mesma	mˈesma
poder	poðˈeɾ
dito	dˈito
Como	kˌomo
centro	θˈentɾo
Encara	enkˈaɾa
meyo	mˈejɔ
países	paˈises
gosa	ɣˈosa
guerra	ɡˈɛra
quantos	kwˈantos
veiga	bˈe͡ɪɣa
segunda	seɣˈunda
tiene	tjˈɛne
verbo	bˈeɾβo
chunto	t͡ʃˈunto
obra	ˈoβɾa
troban	tɾˈoβan
tipo	tˈipo
Ta	ta
bell	bel
Actualment	ˌaktwalmˈentʰ
rei	rˈe͡ɪ
quasi	kwˈasi
zonas	θˈonas
Entre	ˈentɾe
cinta	θˈinta
parolas	paɾˈolas
arredol	ˌareðˈol
conchunto	kont͡ʃˈunto
personas	peɾsˈonas
punto	pˈunto
color	kolˈoɾ
especies	espˈeθjɛs
este	ˈeste
ixe	ˈiʃe
puestos	pwˈɛstos
dita	dˈita
día	dˈia
estioron	estjˈɔɾon
vegadas	beɣˈaðas
común	komˈun
partir	paɾtˈiɾ
Estió	estjˈo
Quan	kwan
toponimo	tˌoponˈimo
Las	las
Santa	sˈanta
primers	pɾimˈes
val	bˈal
conoixito	kˌonoʃˈito
grupos	ɣɾˈupos
man	mˈan
uns	ˈuns
carrera	karˈeɾa
tiempos	tjˈɛmpos
municipio	mˌuniθˈipjɔ
Son	sˈon
Tien	tjˈɛn
ni	ni
textos	tˈekstos
Asinas	asˈinas
proceso	pɾoθˈeso
quantas	kwˈantas
esta	ˈesta
garra	ɣˈara
palabras	palˈaβɾas
prencipal	pɾˌenθipˈal
familia	famˈilja
gosan	ɣˈosan
segundo	seɣˈundo
significa	sˌiɡnifˈika
ciudatz	θjuðˈaθ
principal	pɾˌinθipˈal
unas	ˈunas
vegada	beɣˈaða
considera	kˌonsiðˈeɾa
hue	ɡwˈɛ
pp	pˌepˈe
De	de
debant	deβˈantʰ
importants	ˌimpoɾtˈantʰs
anyadas	aɲˈaðas
isla	ˈisla
siempre	sjˈɛmpɾe
fuoron	fwˈɔɾon
popular	pˌopulˈaɾ
vegatas	beɣˈatas
qualsiquier	kwˌalsikjˈɛɾ
bella	bˌeʎa
li	li
presenta	pɾesˈenta
trobar	tɾoβˈaɾ
porque	pˌoɾkɛ
presencia	pɾesˈenθja
The	tˈe
actual	aktwˈal
función	funθjˈon
habió	aβjˈo
prencipals	pɾˌenθipˈals
posición	pˌosiθjˈon
muerte	mwˈɛɾte
nuevo	nwˈɛβo
unidatz	ˌuniðˈaθ
catalán	kˌatalˈan
causa	kˈa͡ʊsa
cuerpo	kwˈɛɾpo
denominación	dˌenomˌinaθjˈon
especie	espˈeθjɛ
fendo	fˈendo
miembros	mjˈɛmbɾos
primeras	pɾimˈeɾas
total	totˈal
María	maɾˈia
chenero	t͡ʃenˈeɾo
localidat	lˌokaliðˈatʰ
tierra	tjˈɛra
muller	muʎˈeɾ
diferent	dˌifeɾˈentʰ
obras	ˈoβɾas
serie	sˈeɾjɛ
altaria	altˈaɾja
amás	amˈas
anyo	ˈaɲɔ
cal	kˈal
gubierno	ɣuβjˈɛɾno
p	pˈe
propia	pɾˈopja
va	bˈa
cintas	θˈintas
orichen	oɾˈit͡ʃen
poco	pˈoko
quatre	kwˈatɾe
central	θentɾˈal
millor	miʎˈoɾ
movimiento	mˌoβimjˈɛnto
qual	kwˈal
alemán	ˌalemˈan
istos	ˈistos
materials	mˌateɾjˈals
natural	nˌatuɾˈal
qualques	kwˈalkɛs
treballo	tɾeβˈaʎo
antigo	antˈiɣo
chent	t͡ʃˈentʰ
cultura	kultˈuɾa
pueblos	pwˈɛβlos
Republica	rˌepuβlˈika
todas	tˈoðas
zaguers	θaɣˈɛs
Francia	fɾˈanθja
conoixita	kˌonoʃˈita
cuenta	kwˈɛnta
epoca	epˈoka
sufixo	sufˈiʃo
tradicional	tɾˌaðiθjɔnˈal
aragonesa	ˌaɾaɣonˈesa
campo	kˈampo
medieval	mˌeðjɛβˈal
nuclio	nˈukljɔ
seu	sˈe͡ʊ
km	kˌaˈɛme
Amás	amˈas
atra	ˈatɾa
occidental	ˌokθiðentˈal
provincia	pɾoβˈinθja
actualment	ˌaktwalmˈentʰ
animals	ˌanimˈals
relación	rˌelaθjˈon
II	seɣˈundo
destacar	dˌestakˈaɾ
fillo	fˈiʎo
final	finˈal
manimenos	mˌanimˈenos
mar	mˈaɾ
construcción	kˌonstɾukθjˈon
linia	lˈinja
presonas	pɾesˈonas
anque	ˈankɛ
casas	kˈasas
politica	pˌolitˈika
Mientres	mjˈɛntɾes
an	ˈan
anglés	anɡlˈes
fin	fˈin
oficial	ˌofiθjˈal
elementos	ˌelemˈentos
hai	ˈa͡ɪ
material	mˌateɾjˈal
palabra	palˈaβɾa
teneban	tenˈeβan
atro	ˈatɾo
naixito	naʃˈito
reino	rˈe͡ɪno
Teruel	tˌeɾuˈɛl
referencia	rˌefeɾˈenθja
veyer	bejˈɛɾ
cantidat	kˌantiðˈatʰ
da	dˈa
luz	lˈuθ
colla	kˈoʎa
les	les
oriental	ˌoɾjɛntˈal
Tierra	tjˈɛra
cosa	kˈosa
ixas	ˈiʃas
libro	lˈiβɾo
local	lokˈal
posible	posˈiβle
present	pɾesˈentʰ
uno	ˈuno
Seguntes	seɣˈuntes
alavez	ˌalaβˈeθ
of	ˈof
orichinal	ˌoɾit͡ʃinˈal
sierra	sjˈɛra
tenió	tenjˈo
resta	rˈesta
zaguer	θaɣˈɛɾ
Casa	kˈasa
castiello	kastjˈɛʎo
dialecto	djalˈekto
es	es
guaire	ɡwˈa͡ɪɾe
nombres	nˈombɾes
territorios	tˌeritˈoɾjɔs
Unius	unˈius
Yera	jˈɛɾa
feba	fˈeβa
ixa	ˈiʃa
sola	sˈola
Pero	pˈeɾo
Universidat	ˌuniβˌeɾsiðˈatʰ
decir	deθˈiɾ
tierras	tjˈɛras
Si	sˈi
días	dˈias
evolución	ˌeβoluθjˈon
interior	ˌinteɾjˈɔɾ
medievals	mˌeðjɛβˈals
muga	mˈuɣa
plantas	plˈantas
president	pɾˌesiðˈentʰ
antigos	antˈiɣos
cinco	θˈinko
estructura	ˌestɾuktˈuɾa
redolada	rˌeðolˈaða
situación	sˌitwaθjˈon
solo	sˈolo
Estaus	estˈa͡ʊs
capacidat	kˌapaθiðˈatʰ
istas	ˈistas
sieglos	sjˈɛɣlos
dialectos	djalˈektos
importancia	ˌimpoɾtˈanθja
lexico	leksˈiko
propio	pɾˈopjɔ
Editorial	ˌeðitoɾjˈal
Mapa	mˈapa
San	sˈan
base	bˈase
pueblo	pwˈɛβlo
nacional	nˌaθjɔnˈal
producción	pɾˌoðukθjˈon
rechions	ret͡ʃjˈɔns
siga	sˈiɣa
significau	sˌiɡnifikˈa͡ʊ
situato	sitwˈato
superior	sˌupeɾjˈɔɾ
planta	plˈanta
ser	sˈeɾ
costa	kˈosta
dicen	dˈiθen
miembro	mjˈɛmbɾo
sino	sˈino
Europa	e͡ʊɾˈopa
camín	kamˈin
chicota	t͡ʃikˈota
clima	klˈima
existe	eksˈiste
griego	ɣɾjˈɛɣo
menor	menˈoɾ
nueva	nwˈɛβa
pasau	pasˈa͡ʊ
dreito	ðɾˈe͡ɪto
edición	ˌeðiθjˈon
pocos	pˈokos
charra	t͡ʃˈara
km²	kˌaˈɛmeðˈos
Nacional	nˌaθjɔnˈal
baixa	bˈaʃa
caracteristicas	kˌaɾaktˌeɾistˈikas
dezaga	deθˈaɣa
municipios	mˌuniθˈipjɔs
nunca	nˈunka
toponimos	tˌoponˈimos
usos	ˈusos
variedat	bˌaɾjɛðˈatʰ
antiga	antˈiɣa
desembolique	dˌesembolˈikɛ
social	soθjˈal
zaguera	θaɣˈɛɾa
Este	ˈeste
Sindembargo	sˌindembˈaɾɣo
Titán	titˈan
actuals	aktwˈals
adintro	aðˈintɾo
conoixiu	kˌonoʃˈiu
islas	ˈislas
musica	musˈika
tipos	tˈipos
totas	tˈotas
variant	baɾjˈantʰ
forman	fˈoɾman
meya	mˈeja
podría	poðɾˈia
villa	bˈiʎa
Consello	konsˈeʎo
amán	amˈan
antis	ˈantis
construyíu	kˌonstɾujˈiu
dicir	diθˈiɾ
ell	ˈel
equipe	ekˈipe
latina	latˈina
meses	mˈeses
variants	baɾjˈantʰs
versión	beɾsjˈon
Antiparte	ˌantipˈaɾte
José	xosˈe
chicotz	t͡ʃikˈoθ
feban	fˈeβan
formación	fˌoɾmaθjˈon
igual	iɣwˈal
premios	pɾˈemjɔs
presentan	pɾesˈentan
recibe	reθˈiβe
romances	romˈanθes
alta	ˈalta
canta	kˈanta
comarca	komˈaɾka
ells	ˈels
parla	pˈaɾla
termins	teɾmˈins
tota	tˈota
tracta	tɾˈakta
trobamos	tɾoβˈamos
cabo	kˈaβo
deriva	deɾˈiβa
dreita	ðɾˈe͡ɪta
espacio	espˈaθjɔ
influencia	imflwˈɛnθja
mayo	mˈajɔ
paso	pˈaso
prencipió	pɾˌenθipjˈo
realidat	rˌealiðˈatʰ
Ha	ˈa
Imperio	impˈeɾjɔ
Nueva	nwˈɛβa
creyar	kɾejˈaɾ
mullers	muʎˈes
Isto	ˈisto
autor	a͡ʊtˈoɾ
buena	bwˈɛna
condato	kondˈato
formato	foɾmˈato
idioma	iðjˈɔma
televisión	tˌeleβisjˈon
van	bˈan
Barcelona	bˌaɾθelˈona
Fue	fwˈɛ
Reino	rˈe͡ɪno
autors	a͡ʊtˈos
batalla	batˈaʎa
conoixida	kˌonoʃˈiða
francesa	fɾanθˈesa
internacional	ˌinteɾnˌaθjɔnˈal
libel	liβˈel
nº	ˌɛneˌoɾðinˌalmaskulˈin
pas	pas
recibió	rˌeθiβjˈo
representa	rˌepɾesˈenta
temperatura	tˌempeɾatˈuɾa
tornó	toɾnˈo
Bells	bels
conoix	konˈoʃ
desambigación	dˌesambˌiɣaθjˈon
ella	ˈeʎa
temporada	tˌempoɾˈaða
facioron	faθjˈɔɾon
fuent	fwˈɛntʰ
italián	ˌitaljˈan
piedra	pjˈɛðɾa
prencipalment	pɾˌenθipalmˈentʰ
quatro	kwˈatɾo
cultural	kˌultuɾˈal
heban	ˈeβan
planeta	planˈeta
plegar	pleɣˈaɾ
Gubierno	ɣuβjˈɛɾno
Historia	istˈoɾja
auguas	ˈa͡ʊɣwas
chicot	t͡ʃikˈotʰ
condicions	kˌondiθjˈɔns
fillos	fˈiʎos
haber	aβˈeɾ
laco	lˈako
persona	peɾsˈona
poblacions	pˌoβlaθjˈɔns
practica	pɾaktˈika
relativament	rˌelatˌiβamˈentʰ
siguient	siɣjˈɛntʰ
tropas	tɾˈopas
Gran	ɣɾˈan
Val	bˈal
chicotas	t͡ʃikˈotas
clase	klˈase
consideran	kˌonsiðˈeɾan
disco	dˈisko
escrito	eskɾˈito
sociedat	sˌoθjɛðˈatʰ
sía	sˈia
vegata	beɣˈata
Ilesia	ilˈesja
Per	peɾ
aC	aθˈe
diferencia	dˌifeɾˈenθja
dirección	dˌiɾekθjˈon
escuela	eskwˈɛla
especial	ˌespeθjˈal
estilo	estˈilo
lista	lˈista
locals	lokˈals
naturals	nˌatuɾˈals
plural	pluɾˈal
sería	seɾˈia
tercera	teɾθˈeɾa
tradición	tɾˌaðiθjˈon
Guerra	ɡˈɛra
arias	ˈaɾjas
colors	kolˈos
comunidat	kˌomuniðˈatʰ
envueltas	embwˈɛltas
fueras	fwˈɛɾas
letra	lˈetɾa
millors	miʎˈos
nau	nˈa͡ʊ
ríos	rˈios
teoría	tˌeoɾˈia
toda	tˈoða
vico	bˈiko
Alto	ˈalto
Fa	fˈa
beluns	belˈuns
cantas	kˈantas
caracter	kˌaɾaktˈeɾ
districto	distɾˈikto
formar	foɾmˈaɾ
publico	puβlˈiko
quals	kwˈals
sistemas	sistˈemas
Chuan	t͡ʃwˈan
Espanya	espˈaɲa
Navarra	naβˈara
especialment	ˌespeθjalmˈentʰ
hombres	ˈombɾes
mida	mˈiða
pasa	pˈasa
relacions	rˌelaθjˈɔns
sentiu	sentˈiu
solament	sˌolamˈentʰ
the	tˈe
Aragonesa	ˌaɾaɣonˈesa
Chuegos	t͡ʃwˈɛɣos
Istos	ˈistos
alemans	ˌalemˈans
anterior	ˌanteɾjˈɔɾ
antes	ˈantes
campos	kˈampos
canto	kˈanto
chulio	t͡ʃˈuljɔ
creyó	kɾejˈo
datos	dˈatos
dreitos	ðɾˈe͡ɪtos
fuents	fwˈɛntʰs
fácil	fˈaθil
permite	peɾmˈite
plaza	plˈaθa
presona	pɾesˈona
servicios	seɾβˈiθjɔs
Fernando	feɾnˈando
Juan	xwˈan
Muitos	muˈitos
Pa	pa
Sobrarbe	soβɾˈaɾβe
caracteristica	kˌaɾaktˌeɾistˈika
conoixe	konˈoʃe
división	dˌiβisjˈon
existencia	ˌeksistˈenθja
fútbol	fˈutβol
lur	lˈuɾ
muita	muˈita
musulmans	mˌusulmˈans
tan	tˈan
Istas	ˈistas
aragoneses	ˌaɾaɣonˈeses
aria	ˈaɾja
chinero	t͡ʃinˈeɾo
disenyo	disˈeɲɔ
feitos	fˈe͡ɪtos
mans	mˈans
nuevas	nwˈɛβas
puntos	pˈuntos
royo	rˈojɔ
seis	sˈe͡ɪs
Esta	ˈesta
Instituto	ˌinstitˈuto
Roma	rˈoma
augua	ˈa͡ʊɣwa
control	kontɾˈol
cristians	kɾistjˈans
departamento	dˌepaɾtamˈento
enerchía	ˌeneɾt͡ʃˈia
literatura	lˌiteɾatˈuɾa
luengache	lwɛnɡˈat͡ʃe
mai	mˈa͡ɪ
montanya	montˈaɲa
ninos	nˈinos
organización	ˌoɾɣanˌiθaθjˈon
papel	papˈel
politico	pˌolitˈiko
representación	rˌepɾesˌentaθjˈon
torre	tˈore
XIX	dˌeθinʊˈeno
chuga	t͡ʃˈuɣa
club	klˈub
comuns	komˈuns
edificio	ˌeðifˈiθjɔ
existen	eksˈisten
largo	lˈaɾɣo
leis	lˈe͡ɪs
quala	kwˈala
romana	romˈana
tién	tjˈen
tornar	toɾnˈaɾ
trazas	tɾˈaθas
uso	ˈuso
XX	bintˈeno
apareixe	ˌapaɾˈeʃe
dencima	denθˈima
diversas	diβˈeɾsas
elemento	ˌelemˈento
huei	ɡwˈe͡ɪ
melitar	mˌelitˈaɾ
razón	raθˈon
romans	romˈans
situau	sitwˈa͡ʊ
traducción	tɾˌaðukθjˈon
Hue	ɡwˈɛ
III	tɛɾθˈɛɾo
blanca	blˈanka
comercial	kˌomeɾθjˈal
cuenca	kwˈɛnka
decada	dekˈaða
estatos	estˈatos
estudio	estˈuðjɔ
fuerza	fwˈɛɾθa
humans	umˈans
maxima	maksˈima
medio	mˈeðjɔ
modelo	moðˈelo
orden	ˈoɾðen
prene	pɾˈene
propiedat	pɾˌopjɛðˈatʰ
siet	sjˈɛtʰ
simbolo	simbˈolo
Cal	kˈal
Estudios	estˈuðjɔs
Norte	nˈoɾte
anteriors	ˌanteɾjˈɔs
antigas	antˈiɣas
categoría	kˌateɣoɾˈia
clasificación	klˌasifˌikaθjˈon
dentro	dˈentɾo
ermita	eɾmˈita
espanyola	ˌespaɲˈɔla
idiomas	iðjˈɔmas
indica	indˈika
isto	ˈisto
numeros	numˈeɾos
parque	pˈaɾkɛ
provién	pɾoβjˈen
radiz	raðˈiθ
sector	sektˈoɾ
setiembre	setjˈɛmbɾe
siguients	siɣjˈɛntʰs
simple	sˈimple
situata	sitwˈata
su	su
unidat	ˌuniðˈatʰ
vista	bˈista
zagueras	θaɣˈɛɾas
Carlos	kˈaɾlos
Rusia	rˈusja
conchugación	kˌont͡ʃuɣaθjˈon
convirtió	kˌombiɾtjˈo
crovates	kɾoβˈates
dreitament	ðɾˌe͡ɪtamˈentʰ
economía	ˌekonomˈia
espanyol	ˌespaɲˈɔl
etc	ˈetk
gracias	ɣɾˈaθjas
humana	umˈana
ideya	iðˈeja
lis	lis
mugas	mˈuɣas
partiu	paɾtˈiu
produce	pɾoðˈuθe
provincias	pɾoβˈinθjas
queda	kˈɛða
tradicionals	tɾˌaðiθjɔnˈals
títol	tˈitol
Libro	lˈiβɾo
Unión	unjˈon
actividat	ˌaktiβiðˈatʰ
agora	aɣˈoɾa
equipes	ekˈipes
estudios	estˈuðjɔs
exito	eksˈito
grau	ɣɾˈa͡ʊ
imachen	imˈat͡ʃen
inte	ˈinte
libros	lˈiβɾos
metat	metˈatʰ
musical	mˌusikˈal
naturaleza	nˌatuɾalˈeθa
obchecto	obt͡ʃˈekto
ormino	oɾmˈino
pasó	pasˈo
prochecto	pɾot͡ʃˈekto
programa	pɾoɣɾˈama
publica	puβlˈika
simplament	sˌimplamˈentʰ
tercer	teɾθˈeɾ
toponimia	tˌoponˈimja
vía	bˈia
actividatz	ˌaktiβiðˈaθ
contina	kontˈina
ditos	dˈitos
dominio	domˈinjɔ
fase	fˈase
filla	fˈiʎa
fonetica	fˌonetˈika
occidentals	ˌokθiðentˈals
populars	pˌopulˈas
puerta	pwˈɛɾta
puerto	pwˈɛɾto
velocidat	bˌeloθiðˈatʰ
viven	bˈiβen
Alemanya	ˌalemˈaɲa
Cruz	kɾˈuθ
Internacional	ˌinteɾnˌaθjɔnˈal
Y	jˈe
arabe	aɾˈaβe
barranco	barˈanko
carreras	karˈeɾas
conserva	konsˈeɾβa
corrient	korjˈɛntʰ
creiximiento	kɾˌeʃimjˈɛnto
edificios	ˌeðifˈiθjɔs
emperador	ˌempeɾaðˈoɾ
fuerte	fwˈɛɾte
largaria	laɾɣˈaɾja
lei	lˈe͡ɪ
partito	paɾtˈito
pasar	pasˈaɾ
posteriors	pˌosteɾjˈɔs
rechimen	ret͡ʃˈimen
remató	rˌematˈo
tenemos	tenˈemos
terreno	terˈeno
torna	tˈoɾna
transporte	tɾanspˈoɾte
China	t͡ʃˈina
Institución	ˌinstituθjˈon
Polonia	polˈonja
Totz	tˈoθ
adverbios	adβˈeɾβjɔs
codigo	koðˈiɣo
contacto	kontˈakto
emplego	emplˈeɣo
formau	foɾmˈa͡ʊ
kilometros	kˌilomˈetɾos
leva	lˈeβa
marzo	mˈaɾθo
mesmos	mˈesmos
obchectos	obt͡ʃˈektos
partis	pˈaɾtis
piet	pjˈɛtʰ
problemas	pɾoβlˈemas
propios	pɾˈopjɔs
suelo	swˈɛlo
Cada	kˈaða
Mundial	mundjˈal
Uesca	ɡwˈɛska
altros	ˈaltɾos
carretera	kˌaretˈeɾa
considerato	kˌonsiðeɾˈato
creyación	kɾˌejaθjˈon
cucha	kˈut͡ʃa
ecetra	eθˈetɾa
estos	ˈestos
febrero	feβɾˈeɾo
fins	fˈins
fuellas	fwˈɛʎas
neerlandés	nˌeeɾlandˈes
prebas	pɾˈeβas
prener	pɾenˈeɾ
principals	pɾˌinθipˈals
situada	sitwˈaða
socials	soθjˈals
tema	tˈema
Catalunya	kˌatalˈuɲa
concepto	konθˈepto
diversos	diβˈeɾsos
estas	ˈestas
feita	fˈe͡ɪta
griegos	ɣɾjˈɛɣos
independencia	ˌindependˈenθja
localidatz	lˌokaliðˈaθ
mantener	mˌantenˈeɾ
monesterio	mˌonestˈeɾjɔ
prencipio	pɾenθˈipjɔ
presión	pɾesjˈon
producto	pɾoðˈukto
s	ˈɛse
Miguel	miɣˈɛl
Muitas	muˈitas
Premio	pɾˈemjɔ
al	ˈal
cheneralment	t͡ʃˌeneɾalmˈentʰ
creye	kɾˈejɛ
et	ˈetʰ
haiga	ˈa͡ɪɣa
inferior	ˌimfeɾjˈɔɾ
información	ˌimfoɾmaθjˈon
manera	manˈeɾa
ocupa	okˈupa
peninsula	pˌeninsˈula
podeban	poðˈeβan
presents	pɾesˈentʰs
probablement	pɾˌoβaβlemˈentʰ
productos	pɾoðˈuktos
propiedatz	pɾˌopjɛðˈaθ
ruso	rˈuso
texto	tˈeksto
Atros	ˈatɾos
Dica	dˈika
IV	kwatɾˈeno
composición	kˌomposiθjˈon
districtos	distɾˈiktos
exterior	ˌeksteɾjˈɔɾ
ganó	ɣanˈo
griega	ɣɾjˈɛɣa
incluye	inklˈujɛ
mont	mˈontʰ
parabra	paɾˈaβɾa
plega	plˈeɣa
plegó	pleɣˈo
relichión	rˌelit͡ʃjˈon
servicio	seɾβˈiθjɔ
sí	sˈi
talment	talmˈentʰ
temas	tˈemas
Ana	ˈana
amplo	ˈamplo
culturals	kˌultuɾˈals
debaixo	deβˈaʃo
deciba	deθˈiβa
ditas	dˈitas
independient	ˌindependjˈɛntʰ
marguin	mˈaɾɣin
masa	mˈasa
metal	metˈal
movimientos	mˌoβimjˈɛntos
parlants	paɾlˈantʰs
plana	plˈana
poquet	pokˈɛtʰ
reis	rˈe͡ɪs
variedatz	bˌaɾjɛðˈaθ
vecins	beθˈins
Antonio	antˈonjɔ
Bosnia	bˈosnja
Católico	katˈoliko
Olimpicos	ˌolimpˈikos
Sierra	sjˈɛra
cine	θˈine
competición	kˌompetiθjˈon
comunidatz	kˌomuniðˈaθ
cosas	kˈosas
emplegar	ˌempleɣˈaɾ
equivalent	ˌekiβalˈentʰ
estándar	estˈandaɾ
fuerzas	fwˈɛɾθas
futuro	futˈuɾo
infinitivo	ˌimfinitˈiβo
inicial	ˌiniθjˈal
interpresa	ˌinteɾpɾˈesa
libre	lˈiβɾe
nivel	niβˈel
occitán	ˌokθitˈan
oficialment	ˌofiθjalmˈentʰ
pareix	paɾˈeʃ
participio	pˌaɾtiθˈipjɔ
preba	pɾˈeβa
protección	pɾˌotekθjˈon
pueda	pwˈɛða
resultau	rˌesultˈa͡ʊ
rete	rˈete
sigue	sˈiɣɛ
subchecto	subt͡ʃˈekto
treballos	tɾeβˈaʎos
unica	unˈika
verano	beɾˈano
Atras	ˈatɾas
Madrit	maðɾˈitʰ
altas	ˈaltas
ampla	ˈampla
articlos	aɾtˈiklos
banda	bˈanda
carga	kˈaɾɣa
chunio	t͡ʃˈunjɔ
claro	klˈaɾo
cm	θˌeˈɛme
cocina	koθˈina
contino	kontˈino
continó	kˌontinˈo
distancia	distˈanθja
estación	ˌestaθjˈon
freqüent	fɾekwˈentʰ
historica	ˌistoɾˈika
honor	onˈoɾ
mena	mˈena
montanyas	montˈaɲas
mundial	mundjˈal
par	pˈaɾ
partes	pˈaɾtes
podemos	poðˈemos
representan	rˌepɾesˈentan
reyal	rejˈal
scientificos	esθjˌɛntifˈikos
selección	sˌelekθjˈon
sentito	sentˈito
serbos	sˈeɾβos
vechetación	bˌet͡ʃetaθjˈon
Castiella	kastjˈɛʎa
Parque	pˈaɾkɛ
Virchen	bˈiɾt͡ʃen
accions	akθjˈɔns
batería	bˌateɾˈia
cambra	kˈambɾa
capa	kˈapa
categorías	kˌateɣoɾˈias
charran	t͡ʃˈaran
chelo	t͡ʃˈelo
corresponde	kˌorespˈonde
dan	dˈan
dar	dˈaɾ
diez	djˈɛθ
dinastía	dˌinastˈia
divide	diβˈiðe
ellas	ˈeʎas
grandaria	ɣɾandˈaɾja
indican	indˈikan
mos	mos
politicas	pˌolitˈikas
prenió	pɾenjˈo
rematar	rˌematˈaɾ
resistencia	rˌesistˈenθja
sonito	sonˈito
tal	tˈal
temperaturas	tˌempeɾatˈuɾas
unatra	unˈatɾa
unión	unjˈon
veye	bˈejɛ
vicos	bˈikos
álbum	ˈalβum
Baixo	bˈaʃo
Edat	eðˈatʰ
Martín	maɾtˈin
Revista	reβˈista
blanco	blˈanko
calendata	kˌalendˈata
cambeo	kambˈeo
clases	klˈases
comunicación	kˌomunˌikaθjˈon
consiguió	kˌonsiɣjˈo
costau	kostˈa͡ʊ
distribución	dˌistɾiβuθjˈon
industrial	ˌindustɾjˈal
ixos	ˈiʃos
liga	lˈiɣa
marca	mˈaɾka
mica	mˈika
noviembre	noβjˈɛmbɾe
oficials	ˌofiθjˈals
pietz	pjˈɛθ
ran	rˈan
respecto	respˈekto
rusos	rˈusos
sobretot	sˌoβɾetˈotʰ
terminación	tˌeɾminaθjˈon
trobaba	tɾoβˈaβa
valle	bˈaʎe
versions	beɾsjˈɔns
vocal	bokˈal
vocals	bokˈals
Ciudat	θjuðˈatʰ
París	paɾˈis
Santo	sˈanto
Sud	sˈu
XV	kinθˈeno
anyatas	aɲˈatas
cambio	kˈambjɔ
chodigos	t͡ʃoðˈiɣos
chuego	t͡ʃwˈɛɣo
corona	koɾˈona
difuera	difwˈɛɾa
fuera	fwˈɛɾa
funcions	funθjˈɔns
fusta	fˈusta
interpresas	ˌinteɾpɾˈesas
linias	lˈinjas
només	nomˈes
parlas	pˈaɾlas
parroquia	parˈokja
pico	pˈiko
pocas	pˈokas
podeba	poðˈeβa
preposición	pɾˌeposiθjˈon
proviene	pɾoβjˈɛne
remata	remˈata
salut	salˈutʰ
voz	bˈoθ
Francisco	fɾanθˈisko
Real	reˈal
adchectivos	ˌadt͡ʃektˈiβos
and	ˈan
baverán	bˌaβeɾˈan
cabeza	kaβˈeθa
cargo	kˈaɾɣo
consiste	konsˈiste
debito	deβˈito
densidat	dˌensiðˈatʰ
dificil	dˌifiθˈil
edat	eðˈatʰ
estructuras	ˌestɾuktˈuɾas
formata	foɾmˈata
habitual	ˌaβitwˈal
horas	ˈoɾas
interna	intˈeɾna
levar	leβˈaɾ
nuclios	nˈukljɔs
personaches	pˌeɾsonˈat͡ʃes
prencipia	pɾenθˈipja
primero	pɾimˈeɾo
problema	pɾoβlˈema
restas	rˈestas
roca	rˈoka
rocas	rˈokas
rural	ruɾˈal
sección	sekθjˈon
será	seɾˈa
ueito	ɡwˈe͡ɪto
von	bˈon
Reyal	rejˈal
University	ˌuniβeɾsˈiti
Valencia	balˈenθja
acción	akθjˈon
aintro	ˈa͡ɪntɾo
amuestra	amwˈɛstɾa
aspecto	aspˈekto
aus	ˈa͡ʊs
ciudadans	θjˌuðaðˈans
clamau	klamˈa͡ʊ
comercials	kˌomeɾθjˈals
conseqüencia	kˌonsekwˈenθja
considerau	kˌonsiðeɾˈa͡ʊ
cursa	kˈuɾsa
derivau	dˌeɾiβˈa͡ʊ
destaca	destˈaka
enantes	enˈantes
escuelas	eskwˈɛlas
femenín	fˌemenˈin
franceses	fɾanθˈeses
numerosos	nˌumeɾˈosos
otomans	ˌotomˈans
particular	pˌaɾtikulˈaɾ
procesos	pɾoθˈesos
produció	pɾˌoðuθjˈo
refiere	refjˈɛɾe
reina	rˈe͡ɪna
sciencia	esθjˈɛnθja
series	sˈeɾjɛs
singular	sˌinɡulˈaɾ
sol	sˈol
tecnica	teknˈika
unatro	unˈatɾo
vasco	bˈasko
victoria	biktˈoɾja
Cortz	kˈoɾθ
Existen	eksˈisten
John	xˈon
New	nˈeβ
Partito	paɾtˈito
bandera	bandˈeɾa
canal	kanˈal
car	kˈaɾ
clamata	klamˈata
comarcas	komˈaɾkas
compuestos	kompwˈɛstos
construccions	kˌonstɾukθjˈɔns
diametro	djamˈetɾo
director	dˌiɾektˈoɾ
economica	ˌekonomˈika
europeu	ˌe͡ʊɾopˈe͡ʊ
fiestas	fjˈɛstas
flors	flˈos
frent	fɾˈentʰ
lingüistica	lˌinɡwistˈika
modelos	moðˈelos
monedas	monˈeðas
nueu	nwˈe͡ʊ
orichinalment	ˌoɾit͡ʃˌinalmˈentʰ
orientals	ˌoɾjɛntˈals
pais	pˈa͡ɪs
palacio	palˈaθjɔ
posterior	pˌosteɾjˈɔɾ
premio	pɾˈemjɔ
presa	pɾˈesa
pronombre	pɾonˈombɾe
román	romˈan
roya	rˈoja
to	tˈo
treballadors	tɾˌeβaʎaðˈos
vals	bˈals
Campo	kˈampo
Central	θentɾˈal
Cheneral	t͡ʃˌeneɾˈal
Diccionario	dˌikθjɔnˈaɾjɔ
Qualques	kwˈalkɛs
XVIII	dˌeθiɣwitˈeno
activo	aktˈiβo
aragonesas	ˌaɾaɣonˈesas
cambios	kˈambjɔs
cara	kˈaɾa
celulas	θelˈulas
conoixitos	kˌonoʃˈitos
denguna	denɡˈuna
dios	djˈɔs
efecto	efˈekto
escape	eskˈape
estaus	estˈa͡ʊs
estausunidense	ˌesta͡ʊsˌuniðˈense
estrela	estɾˈela
exercito	ˌekseɾθˈito
extensión	ˌekstensjˈon
filmografía	fˌilmoɣɾafˈia
gobierno	ɣoβjˈɛɾno
instalacions	ˌinstalaθjˈɔns
libres	lˈiβɾes
mal	mˈal
meridional	mˌeɾiðjɔnˈal
modo	mˈoðo
puent	pwˈɛntʰ
treballar	tɾˌeβaʎˈaɾ
volumen	bolˈumen
Deriva	deɾˈiβa
Les	les
Manuel	manwˈɛl
Press	pɾˈess
XVI	sɛθˈeno
alemana	ˌalemˈana
anyada	aɲˈaða
arabes	aɾˈaβes
branca	βɾˈanka
chefe	t͡ʃˈefe
civil	θiβˈil
clara	klˈaɾa
colonias	kolˈonjas
denominacions	dˌenomˌinaθjˈɔns
documentos	dˌokumˈentos
eslavos	eslˈaβos
familias	famˈiljas
fundamental	fˌundamentˈal
melitars	mˌelitˈas
memoria	memˈoɾja
mm	ˌɛmeˈɛme
negra	nˈeɣɾa
nuevos	nwˈɛβos
pai	pˈa͡ɪ
paz	pˈaθ
pende	pˈende
posibilidat	pˌosiβˌiliðˈatʰ
principio	pɾinθˈipjɔ
puyar	pujˈaɾ
qualas	kwˈalas
quedó	kɛðˈo
real	reˈal
recursos	rekˈuɾsos
sale	sˈale
seguindo	seɣˈindo
selvas	sˈelβas
sudeste	suðˈeste
territorial	tˌeritoɾjˈal
tienga	tjˈɛnɡa
tradicionalment	tɾˌaðiθjˌɔnalmˈentʰ
unos	ˈunos
Antimás	ˌantimˈas
Congreso	konɡɾˈeso
Corona	koɾˈona
Frusciante	fɾusθjˈante
García	ɣaɾθˈia
Italia	itˈalja
Mas	mˈas
Nomás	nomˈas
Oriental	ˌoɾjɛntˈal
Zelanda	θelˈanda
belunas	belˈunas
calor	kalˈoɾ
choven	t͡ʃˈoβen
chugadors	t͡ʃˌuɣaðˈos
clasico	klasˈiko
components	kˌomponˈentʰs
comportamiento	kˌompoɾtamjˈɛnto
conservación	kˌonseɾβaθjˈon
corresponden	kˌorespˈonden
cuentas	kwˈɛntas
dengún	denɡˈun
escudo	eskˈuðo
fenomeno	fˌenomˈeno
imperio	impˈeɾjɔ
mención	menθjˈon
menors	menˈos
moderna	moðˈeɾna
moderno	moðˈeɾno
momento	momˈento
peso	pˈeso
politicos	pˌolitˈikos
poseye	posˈejɛ
principalment	pɾˌinθipalmˈentʰ
pronunciación	pɾˌonunθjaθjˈon
propias	pɾˈopjas
remonta	remˈonta
resultato	rˌesultˈato
tardi	tˈaɾði
templo	tˈemplo
valor	balˈoɾ
Anque	ˈankɛ
Centro	θˈentɾo
Dos	dˈos
Federación	fˌeðeɾaθjˈon
ISBN	ˈisbn
Mundo	mˈundo
Museu	musˈe͡ʊ
X	ʃˈe
aconsiguió	ˌakonsiɣjˈo
avions	aβjˈɔns
buen	bwˈɛn
calidat	kˌaliðˈatʰ
concentración	kˌonθentɾaθjˈon
conoixitas	kˌonoʃˈitas
considerata	kˌonsiðeɾˈata
conta	kˈonta
culto	kˈulto
decenio	deθˈenjɔ
dimensions	dˌimensjˈɔns
economico	ˌekonomˈiko
emplegato	ˌempleɣˈato
escribir	ˌeskɾiβˈiɾ
escrita	eskɾˈita
frase	fɾˈase
historico	ˌistoɾˈiko
ilesias	ilˈesjas
incluyen	inklˈujɛn
institución	ˌinstituθjˈon
ir	ˈiɾ
luent	lwˈɛntʰ
mesura	mesˈuɾa
negro	nˈeɣɾo
nobles	nˈoβles
nucleyar	nˌuklejˈaɾ
periglo	peɾˈiɣlo
personache	pˌeɾsonˈat͡ʃe
pieza	pjˈɛθa
poca	pˈoka
producen	pɾoðˈuθen
quiere	kjˈɛɾe
sers	sˈes
subchuntivo	sˌubt͡ʃuntˈiβo
transmisión	tɾˌansmisjˈon
troles	tɾˈoles
valura	balˈuɾa
vin	bˈin
visto	bˈisto
vivir	biβˈiɾ
Copa	kˈopa
España	espˈaɲa
Le	le
Palacio	palˈaθjɔ
Portugal	pˌoɾtuɣˈal
administrativa	ˌadminˌistɾatˈiβa
anyal	aɲˈal
aviento	aβjˈɛnto
britanico	βɾˌitanˈiko
campión	kampjˈon
cautivo	ka͡ʊtˈiβo
chirmán	t͡ʃiɾmˈan
cofadría	kˌofaðɾˈia
conoixer	kˌonoʃˈeɾ
conquiesta	konkjˈɛsta
dició	diθjˈo
diferencias	dˌifeɾˈenθjas
esdevinió	ˌesðeβinjˈo
fabrica	faβɾˈika
famosa	famˈosa
fuella	fwˈɛʎa
internacionals	ˌinteɾnˌaθjɔnˈals
investigación	ˌimbestˌiɣaθjˈon
lacos	lˈakos
levan	lˈeβan
lingüistico	lˌinɡwistˈiko
lurs	lˈus
menistro	menˈistɾo
metodos	metˈoðos
muralla	muɾˈaʎa
nueit	nwˈe͡ɪtʰ
para	pˈaɾa
permiten	peɾmˈiten
perén	peɾˈen
plegoron	pleɣˈoɾon
polacos	polˈakos
profesionals	pɾˌofesjɔnˈals
quedan	kˈɛðan
quedoron	kɛðˈoɾon
razons	raθˈons
scientifica	esθjˌɛntifˈika
semana	semˈana
sexual	sekswˈal
sirven	sˈiɾβen
solar	solˈaɾ
tant	tˈantʰ
terrestre	terˈestɾe
vocabulario	bˌokaβulˈaɾjɔ
Academia	ˌakaðˈemja
Bellas	bˌeʎas
Club	klˈub
Constitución	kˌonstituθjˈon
Lituania	litwˈanja
Meya	mˈeja
Pireneus	pˌiɾenˈe͡ʊs
Tot	tˈotʰ
Tres	tɾˈes
Viena	bjˈɛna
XVII	dˌeθisɛtˈeno
allora	aʎˈoɾa
caracters	kˌaɾaktˈes
castellana	kˌasteʎˈana
centros	θˈentɾos
clamada	klamˈaða
colección	kˌolekθjˈon
comercio	komˈeɾθjɔ
conoixen	konˈoʃen
conservan	konsˈeɾβan
cubierta	kuβjˈɛɾta
culturas	kultˈuɾas
derivaus	dˌeɾiβˈa͡ʊs
dioses	djˈɔses
dotze	dˈoθe
escribió	ˌeskɾiβjˈo
escritos	eskɾˈitos
etimolochía	ˌetimˌolot͡ʃˈia
evitar	ˌeβitˈaɾ
fiesta	fjˈɛsta
individuos	ˌindiβˈiðwɔs
industria	indˈustɾja
leyenda	lejˈɛnda
literalment	lˌiteɾalmˈentʰ
longaria	lonɡˈaɾja
manca	mˈanka
maximo	maksˈimo
mezcla	mˈeθkla
minchar	mint͡ʃˈaɾ
musulmana	mˌusulmˈana
nacionals	nˌaθjɔnˈals
ocasions	ˌokasjˈɔns
orichens	ˌoɾit͡ʃˈens
parabras	paɾˈaβɾas
periodos	peɾjˈɔðos
planas	plˈanas
plegau	pleɣˈa͡ʊ
poemas	poˈemas
rasgos	rˈasɣos
revista	reβˈista
sexo	sˈekso
usuarios	uswˈaɾjɔs
versant	beɾsˈantʰ
Bell	bel
Cambridge	kambɾˈidxe
Chesús	t͡ʃesˈus
David	daβˈi
Isabel	ˌisaβˈel
Suecia	swˈɛθja
Torre	tˈore
V	bˌeβˈaʃa
VI	sˌe͡ɪsˈeno
Ya	jˈa
aduya	aðˈuja
alas	ˈalas
altras	ˈaltɾas
artistica	ˌaɾtistˈika
campanya	kampˈaɲa
chusto	t͡ʃˈusto
conflictos	komflˈiktos
creya	kɾˈeja
curto	kˈuɾto
descendients	dˌesθendjˈɛntʰs
diners	dinˈes
do	dˈo
documenta	dˌokumˈenta
educación	ˌeðukaθjˈon
eixemplos	eʃˈemplos
especials	ˌespeθjˈals
etapa	etˈapa
feitas	fˈe͡ɪtas
formando	foɾmˈando
fuertes	fwˈɛɾtes
identidat	ˌiðentiðˈatʰ
ideyas	iðˈejas
liquido	likˈiðo
naixió	naʃjˈo
necesidat	nˌeθesiðˈatʰ
oracions	ˌoɾaθjˈɔns
partitos	paɾtˈitos
producir	pɾˌoðuθˈiɾ
programas	pɾoɣɾˈamas
publicó	pˌuβlikˈo
quimica	kimˈika
qué	kˈe
qüestión	kwestjˈon
radices	raðˈiθes
rechistro	ret͡ʃˈistɾo
rusa	rˈusa
sabe	sˈaβe
significato	sˌiɡnifikˈato
sinyal	siɲˈal
sufixos	sufˈiʃos
tabla	tˈaβla
tecnolochía	tˌeknolot͡ʃˈia
tendencia	tendˈenθja
tornan	tˈoɾnan
tuca	tˈuka
verbal	beɾβˈal
árbols	ˈaɾβols
Alifonso	ˌalifˈonso
Consellero	kˌonseʎˈeɾo
Esto	ˈesto
Huesca	ɡwˈɛska
Mequinenza	mˌekinˈenθa
Mont	mˈontʰ
Natural	nˌatuɾˈal
Occidental	ˌokθiðentˈal
Saturno	satˈuɾno
Toponimia	tˌoponˈimja
agosto	aɣˈosto
armenios	aɾmˈenjɔs
brancas	βɾˈankas
cadaguna	kˌaðaɣˈuna
cheneración	t͡ʃˌeneɾaθjˈon
chira	t͡ʃˈiɾa
conchunta	kont͡ʃˈunta
contexto	kontˈeksto
els	els
emplegan	emplˈeɣan
entidat	ˌentiðˈatʰ
expansión	ˌekspansjˈon
favor	faβˈoɾ
fisica	fisˈika
fonema	fonˈema
fusión	fusjˈon
gas	ɣˈas
humán	umˈan
influencias	imflwˈɛnθjas
institucions	ˌinstituθjˈɔns
interpretación	ˌinteɾpɾˌetaθjˈon
latins	latˈins
luita	luˈita
moneda	monˈeða
numerosas	nˌumeɾˈosas
octubre	oktˈuβɾe
paper	papˈeɾ
parar	paɾˈaɾ
perque	pˈeɾkɛ
piel	pjˈɛl
posibles	posˈiβles
prencipios	pɾenθˈipjɔs
reciben	reθˈiβen
revolución	rˌeβoluθjˈon
ribera	riβˈeɾa
sala	sˈala
substantivo	sˌuβstantˈiβo
superiors	sˌupeɾjˈɔs
tamas	tˈamas
tarde	tˈaɾðe
temporal	tˌempoɾˈal
teorías	tˌeoɾˈias
tipico	tipˈiko
urbán	uɾβˈan
veyen	bˈejɛn
á	ˈaakθɛntwˈaða
Atlas	ˈatlas
Beluns	belˈuns
Biblioteca	bˌiβljɔtˈeka
Cassini	kassˈini
Colección	kˌolekθjˈon
Luna	lˈuna
Mayor	majˈɔɾ
Pirineo	pˌiɾinˈeo
Segunda	seɣˈunda
amuestran	amwˈɛstɾan
artistas	aɾtˈistas
artistico	ˌaɾtistˈiko
azul	aθˈul
carne	kˈaɾne
cerca	θˈeɾka
chenerals	t͡ʃˌeneɾˈals
chovens	t͡ʃoβˈens
clasica	klasˈika
complexo	komplˈekso
considerar	kˌonsiðeɾˈaɾ
consonant	kˌonsonˈantʰ
contrario	kontɾˈaɾjɔ
cursas	kˈuɾsas
definición	dˌefiniθjˈon
deixó	deʃˈo
electrica	ˌelektɾˈika
escala	eskˈala
esdevenió	ˌesðeβenjˈo
espacial	ˌespaθjˈal
espanyols	ˌespaɲˈɔls
fegura	feɣˈuɾa
figura	fiɣˈuɾa
finalidat	fˌinaliðˈatʰ
freqüencia	fɾekwˈenθja
fundo	fˈundo
hombre	ˈombɾe
imachens	ˌimat͡ʃˈens
independients	ˌindependjˈɛntʰs
interpretacions	ˌinteɾpɾˌetaθjˈɔns
matrimonio	mˌatɾimˈonjɔ
mesmas	mˈesmas
mil	mˈil
morió	moɾjˈo
motivos	motˈiβos
municipals	mˌuniθipˈals
organos	oɾɣˈanos
parlan	pˈaɾlan
partius	paɾtˈius
piedras	pjˈɛðɾas
plan	plˈan
podrían	poðɾˈian
portugués	pˌoɾtuɣˈes
prenioron	pɾenjˈɔɾon
qualo	kwˈalo
refirme	refˈiɾme
relativa	rˌelatˈiβa
representar	rˌepɾesentˈaɾ
respuesta	respwˈɛsta
sinyals	siɲˈals
tipica	tipˈika
ubierto	uβjˈɛɾto
verda	bˈeɾða
viello	bjˈɛʎo
viene	bjˈɛne
viento	bjˈɛnto
web	βˈeb
zaguerías	θˌaɣɛɾˈias
Comité	kˌomitˈe
División	dˌiβisjˈon
Esquema	eskˈɛma
Estas	ˈestas
Existe	eksˈiste
Fabla	fˈaβla
Frank	fɾˈank
General	xˌeneɾˈal
Luenga	lwˈɛnɡa
Madrid	maðɾˈi
Países	paˈises
Presenta	pɾesˈenta
Salvador	sˌalβaðˈoɾ
XII	doθˈeno
amaneixió	ˌamaneʃjˈo
animal	ˌanimˈal
baixas	bˈaʃas
buenas	bwˈɛnas
cadagún	kˌaðaɣˈun
cantón	kantˈon
clubs	klˈubs
collas	kˈoʎas
comparanza	kˌompaɾˈanθa
competicions	kˌompetiθjˈɔns
comuna	komˈuna
conoixius	kˌonoʃˈius
continental	kˌontinentˈal
corazón	kˌoɾaθˈon
cristiana	kɾistjˈana
cruz	kɾˈuθ
debe	dˈeβe
deixa	dˈeʃa
derivan	deɾˈiβan
desapareixer	dˌesapˌaɾeʃˈeɾ
emplegau	ˌempleɣˈa͡ʊ
emplegos	emplˈeɣos
encomenzó	ˌenkomenθˈo
esportes	espˈoɾtes
estudeos	ˌestuðˈeos
expresión	ˌekspɾesjˈon
fablants	faβlˈantʰs
femenina	fˌemenˈina
formó	foɾmˈo
grafía	ɣɾafˈia
guerras	ɡˈɛras
igualment	ˌiɣwalmˈentʰ
metano	metˈano
minerals	mˌineɾˈals
mitat	mitˈatʰ
modernos	moðˈeɾnos
motivo	motˈiβo
nativos	natˈiβos
necesidatz	nˌeθesiðˈaθ
normal	noɾmˈal
obtener	ˌobtenˈeɾ
organismos	ˌoɾɣanˈismos
pachina	pat͡ʃˈina
paisache	pa͡ɪsˈat͡ʃe
partidos	paɾtˈiðos
pelo	pˈelo
pobreza	poβɾˈeθa
podió	poðjˈo
posteriorment	pˌosteɾjɔɾmˈentʰ
profesional	pɾˌofesjɔnˈal
proposición	pɾˌoposiθjˈon
ra	ra
reinos	rˈe͡ɪnos
sierras	sjˈɛras
suposa	supˈosa
tecnicas	teknˈikas
verbals	beɾβˈals
verde	bˈeɾðe
Antis	ˈantis
Anvista	ambˈista
Fútbol	fˈutβol
Mar	mˈaɾ
Seu	sˈe͡ʊ
Socialista	sˌoθjalˈista
William	βiʎjˈam
amplaria	amplˈaɾja
articlo	aɾtˈiklo
astí	astˈi
baloncesto	bˌalonθˈesto
barrio	bˈarjɔ
basa	bˈasa
belún	belˈun
benasqués	bˌenaskˈes
caballo	kaβˈaʎo
cambeos	kambˈeos
caza	kˈaθa
chacimientos	t͡ʃˌaθimjˈɛntos
charrar	t͡ʃarˈaɾ
chents	t͡ʃˈentʰs
cheografica	t͡ʃˌeoɣɾafˈika
cognato	koɡnˈato
component	kˌomponˈentʰ
conchunción	kˌont͡ʃunθjˈon
conciertos	konθjˈɛɾtos
conoixencia	kˌonoʃˈenθja
conte	kˈonte
cuerpos	kwˈɛɾpos
curva	kˈuɾβa
decidió	dˌeθiðjˈo
deixar	deʃˈaɾ
describe	deskɾˈiβe
discografica	dˌiskoɣɾafˈika
discos	dˈiskos
distinción	dˌistinθjˈon
doncas	dˈonkas
du	dˈu
espectadors	ˌespektaðˈos
europeus	ˌe͡ʊɾopˈe͡ʊs
familiar	fˌamiljˈaɾ
fauna	fˈa͡ʊna
foneticas	fˌonetˈikas
guitarra	ɡitˈara
hipotesi	ˌipotˈesi
instrumento	ˌinstɾumˈento
licencia	liθˈenθja
lisos	lˈisos
literaria	lˌiteɾˈaɾja
mamiferos	mˌamifˈeɾos
masculín	mˌaskulˈin
medios	mˈeðjɔs
n	ˈɛne
necesariament	nˌeθesˌaɾjamˈentʰ
obchectivo	ˌobt͡ʃektˈiβo
oral	oɾˈal
pensar	pensˈaɾ
penya	pˈeɲa
perder	peɾðˈeɾ
piezas	pjˈɛθas
pista	pˈista
pistas	pˈistas
potencia	potˈenθja
presentar	pɾˌesentˈaɾ
pronombres	pɾonˈombɾes
radio	rˈaðjɔ
rechional	rˌet͡ʃjɔnˈal
recibir	rˌeθiβˈiɾ
relichiosas	rˌelit͡ʃjˈɔsas
repuis	repˈuis
restos	rˈestos
rota	rˈota
tenendo	tenˈendo
terrestres	terˈestɾes
uellos	ɡwˈɛʎos
unico	unˈiko
urbana	uɾβˈana
Alavez	ˌalaβˈeθ
Aragonés	ˌaɾaɣonˈes
Can	kˈan
Castellón	kˌasteʎˈon
Diario	djˈaɾjɔ
Espanyola	ˌespaɲˈɔla
Europea	ˌe͡ʊɾopˈea
Gara	ɣˈaɾa
Huei	ɡwˈe͡ɪ
Liga	lˈiɣa
Puet	pwˈɛtʰ
XIV	kˌatoɾθˈeno
York	jˈɔɾk
amaneixen	ˌamanˈeʃen
artificial	ˌaɾtifiθjˈal
autoridatz	ˌa͡ʊtoɾiðˈaθ
auxiliar	ˌa͡ʊksiljˈaɾ
camins	kamˈins
cantaire	kantˈa͡ɪɾe
centrals	θentɾˈals
cercuito	θˌeɾkuˈito
chineses	t͡ʃinˈeses
clama	klˈama
concello	konθˈeʎo
continar	kˌontinˈaɾ
correspondient	kˌorespondjˈɛntʰ
curso	kˈuɾso
definir	dˌefinˈiɾ
deixando	deʃˈando
destacan	destˈakan
diminutivo	dˌiminutˈiβo
documentación	dˌokumˌentaθjˈon
duque	dˈukɛ
ellos	ˈeʎos
esporte	espˈoɾte
estrelas	estɾˈelas
europeas	ˌe͡ʊɾopˈeas
facilment	fˌaθilmˈentʰ
fembras	fˈembɾas
fisico	fisˈiko
fizo	fˈiθo
frontera	fɾontˈeɾa
helenismos	ˌelenˈismos
historicos	ˌistoɾˈikos
leyer	lejˈɛɾ
macizo	maθˈiθo
maratón	mˌaɾatˈon
marcas	mˈaɾkas
marcha	mˈaɾt͡ʃa
mecanica	mˌekanˈika
mensaches	mensˈat͡ʃes
metodo	metˈoðo
midas	mˈiðas
mira	mˈiɾa
mui	mˈui
norueste	nˌoɾuˈɛste
orichinals	ˌoɾit͡ʃinˈals
paretz	paɾˈeθ
participoron	pˌaɾtiθipˈoɾon
particlas	paɾtˈiklas
patrimonio	pˌatɾimˈonjɔ
personal	pˌeɾsonˈal
pintura	pintˈuɾa
plans	plˈans
potencial	pˌotenθjˈal
publicación	pˌuβlikaθjˈon
puertas	pwˈɛɾtas
punta	pˈunta
reacción	rˌeakθjˈon
relacionau	rˌelaθjɔnˈa͡ʊ
relichioso	rˌelit͡ʃjˈɔso
respectivament	rˌespektˌiβamˈentʰ
retz	rˈeθ
sectors	sektˈos
software	sˈoftweɾ
standard	estandˈaɾ
tenioron	tenjˈɔɾon
tractato	tɾaktˈato
trescruzato	tɾˌeskɾuθˈato
ueste	ɡwˈɛste
variable	baɾjˈaβle
vei	bˈe͡ɪ
verdat	beɾðˈatʰ
veyió	bejjˈo
visible	bisˈiβle
vive	bˈiβe
Alpes	ˈalpes
Bavera	baβˈeɾa
Estato	estˈato
Finlandia	finlˈandja
Gramática	ɣɾamˈatika
Grecia	ɣɾˈeθja
Gredos	ɣɾˈeðos
Khan	kˈan
Londres	lˈondɾes
Nuestra	nwˈɛstɾa
Pedro	pˈeðɾo
Ramón	ramˈon
Roya	rˈoja
Sol	sˈol
Sovietica	sˌoβjɛtˈika
Suiza	suˈiθa
Tradicionalment	tɾˌaðiθjˌɔnalmˈentʰ
abril	aβɾˈil
aconseguir	ˌakonseɣˈiɾ
actos	ˈaktos
agricola	ˌaɣɾikˈola
antimás	ˌantimˈas
autoridat	ˌa͡ʊtoɾiðˈatʰ
bizantins	bˌiθantˈins
canals	kanˈals
castellano	kˌasteʎˈano
celebra	θelˈeβɾa
censo	θˈenso
chacimiento	t͡ʃˌaθimjˈɛnto
cierto	θjˈɛɾto
clamato	klamˈato
conflicto	komflˈikto
consumo	konsˈumo
continent	kˌontinˈentʰ
describir	dˌeskɾiβˈiɾ
distinguir	dˌistinɡˈiɾ
doble	dˈoβle
documentau	dˌokumentˈa͡ʊ
efectos	efˈektos
embotada	ˌembotˈaða
escritura	ˌeskɾitˈuɾa
eslavo	eslˈaβo
esleito	eslˈe͡ɪto
esto	ˈesto
etnografico	ˌetnoɣɾafˈiko
fierro	fjˈɛro
frisón	fɾisˈon
fuego	fwˈɛɣo
fuese	fwˈɛse
funcionamiento	fˌunθjɔnamjˈɛnto
ganar	ɣanˈaɾ
habría	aβɾˈia
hemisferio	ˌemisfˈeɾjɔ
hese	ˈese
instrumentos	ˌinstɾumˈentos
larga	lˈaɾɣa
lengua	lˈenɡwa
masclos	mˈasklos
mayors	majˈɔs
meter	metˈeɾ
musicals	mˌusikˈals
nomadas	nomˈaðas
normas	nˈoɾmas
paret	paɾˈetʰ
parlar	paɾlˈaɾ
patrón	patɾˈon
pinturas	pintˈuɾas
platos	plˈatos
plazas	plˈaθas
podioron	poðjˈɔɾon
prenen	pɾˈenen
primerías	pɾˌimeɾˈias
pus	pus
quatreno	kwatɾˈeno
radiación	rˌaðjaθjˈon
realizar	rˌealiθˈaɾ
relacionaus	rˌelaθjɔnˈa͡ʊs
remontan	remˈontan
replega	replˈeɣa
reptils	reptˈils
rumán	rumˈan
salir	salˈiɾ
scientifico	esθjˌɛntifˈiko
seguir	seɣˈiɾ
sirve	sˈiɾβe
tozal	toθˈal
trol	tɾˈol
variacions	bˌaɾjaθjˈɔns
viviban	biβˈiβan
vías	bˈias
Autonoma	ˌa͡ʊtonˈoma
Categoría	kˌateɣoɾˈia
Chapón	t͡ʃapˈon
Chunto	t͡ʃˈunto
Chusé	t͡ʃusˈe
Estos	ˈestos
Felipe	felˈipe
Ixa	ˈiʃa
Ixo	ˈiʃo
Luis	lˈuis
Rumanía	rˌumanˈia
VII	sɛtˈeno
Valle	bˈaʎe
Villa	bˈiʎa
World	βˈoɾl
XI	onθˈeno
abaixo	aβˈaʃo
altos	ˈaltos
amigos	amˈiɣos
arco	ˈaɾko
biens	bjˈɛns
bulgaros	bulɣˈaɾos
caracteriza	kˌaɾakteɾˈiθa
casco	kˈasko
celtas	θˈeltas
chermanismos	t͡ʃˌeɾmanˈismos
complemento	kˌomplemˈento
completa	komplˈeta
constitución	kˌonstituθjˈon
corrients	korjˈɛntʰs
costato	kostˈato
curtos	kˈuɾtos
cómo	kˈomo
dau	dˈa͡ʊ
diario	djˈaɾjɔ
diccionario	dˌikθjɔnˈaɾjɔ
diftongo	diftˈonɡo
dura	dˈuɾa
equipos	ekˈipos
escritas	eskɾˈitas
esportiva	ˌespoɾtˈiβa
estase	estˈase
exposición	ˌeksposiθjˈon
fabricación	fˌaβɾikaθjˈon
famoso	famˈoso
finals	finˈals
fruito	fɾuˈito
historiadors	ˌistoɾjaðˈos
hora	ˈoɾa
imperial	ˌimpeɾjˈal
indicar	ˌindikˈaɾ
intrés	intɾˈes
locucions	lˌokuθjˈɔns
maquinas	makˈinas
materia	matˈeɾja
mete	mˈete
mirar	miɾˈaɾ
misión	misjˈon
monts	mˈontʰs
muertos	mwˈɛɾtos
nieu	njˈe͡ʊ
peixes	pˈeʃes
pendendo	pendˈendo
pintor	pintˈoɾ
popularidat	pˌopulˌaɾiðˈatʰ
preso	pɾˈeso
procesión	pɾˌoθesjˈon
prochectos	pɾot͡ʃˈektos
profesor	pɾˌofesˈoɾ
protagonista	pɾˌotaɣonˈista
ret	rˈetʰ
rock	rˈok
romanico	rˌomanˈiko
ropa	rˈopa
salita	salˈita
sangre	sˈanɡɾe
scenario	esθenˈaɾjɔ
seguiu	seɣˈiu
sigan	sˈiɣan
siguen	sˈiɣɛn
sinyor	siɲˈɔɾ
sovietico	sˌoβjɛtˈiko
termino	teɾmˈino
termín	teɾmˈin
terrenos	terˈenos
transición	tɾˌansiθjˈon
tribus	tɾˈiβus
universal	ˌuniβeɾsˈal
universidat	ˌuniβˌeɾsiðˈatʰ
vez	bˈeθ
viella	bjˈɛʎa
visigodos	bˌisiɣˈoðos
Adintro	aðˈintɾo
Baixos	bˈaʃos
Campionato	kˌampjɔnˈato
Chusticia	t͡ʃustˈiθja
Concello	konθˈeʎo
Consultato	kˌonsultˈato
Diputación	dˌiputaθjˈon
Don	dˈon
Fuent	fwˈɛntʰ
Gobierno	ɣoβjˈɛɾno
Grupo	ɣɾˈupo
Hongría	onɡɾˈia
Kirk	kˈiɾk
Maria	mˈaɾja
Mexico	meksˈiko
Oxford	oksfˈoɾ
Parlamento	pˌaɾlamˈento
Peninsula	pˌeninsˈula
Primera	pɾimˈeɾa
Pueden	pwˈɛðen
Ribagorza	rˌiβaɣˈoɾθa
Street	estɾeˈetʰ
actriz	aktɾˈiθ
anyals	aɲˈals
aplicacions	ˌaplikaθjˈɔns
baixar	baʃˈaɾ
be	bˈe
belatros	belˈatɾos
bispe	bˈispe
blancas	blˈankas
bomba	bˈomba
caballos	kaβˈaʎos
cabalto	kaβˈalto
cadena	kaðˈena
capaz	kapˈaθ
catolicos	kˌatolˈikos
chermanico	t͡ʃˌeɾmanˈiko
chirmans	t͡ʃiɾmˈans
ciclo	θˈiklo
coda	kˈoða
companyers	kˌompaɲˈɛs
composicions	kˌomposiθjˈɔns
concreto	konkɾˈeto
controlar	kˌontɾolˈaɾ
costera	kostˈeɾa
creixer	kɾeʃˈeɾ
cubilar	kˌuβilˈaɾ
decisión	dˌeθisjˈon
dentrada	dentɾˈaða
depresión	dˌepɾesjˈon
derivato	dˌeɾiβˈato
dió	djˈo
dolars	dolˈas
emplega	emplˈeɣa
esdevenindo	ˌesðeβenˈindo
establió	ˌestaβljˈo
estadio	estˈaðjɔ
estudeo	ˌestuðˈeo
exclusivament	ˌeksklusˌiβamˈentʰ
existiba	ˌeksistˈiβa
facilidat	fˌaθiliðˈatʰ
factors	faktˈos
feble	fˈeβle
federal	fˌeðeɾˈal
fenomenos	fˌenomˈenos
fundador	fˌundaðˈoɾ
habitadors	ˌaβitaðˈos
habito	aβˈito
hectarias	ektˈaɾjas
historicas	ˌistoɾˈikas
humanas	umˈanas
iba	ˈiβa
indicativo	ˌindikatˈiβo
indichenas	ˌindit͡ʃˈenas
interpretar	ˌinteɾpɾetˈaɾ
letras	lˈetɾas
lexicos	leksˈikos
masiau	masjˈa͡ʊ
menester	mˌenestˈeɾ
menutos	menˈutos
militar	mˌilitˈaɾ
mosica	mosˈika
motor	motˈoɾ
muro	mˈuɾo
musclos	mˈusklos
noble	nˈoβle
ocupación	ˌokupaθjˈon
pareixito	pˌaɾeʃˈito
participios	pˌaɾtiθˈipjɔs
partz	pˈaɾθ
permitió	pˌeɾmitjˈo
perteneixe	pˌeɾtenˈeʃe
perteneixen	pˌeɾtenˈeʃen
plato	plˈato
popularment	pˌopulaɾmˈentʰ
pos	pos
prenendo	pɾenˈendo
privar	pɾiβˈaɾ
pronuncia	pɾonˈunθja
publicacions	pˌuβlikaθjˈɔns
publicato	pˌuβlikˈato
publicau	pˌuβlikˈa͡ʊ
pues	pwɛs
raso	rˈaso
recient	reθjˈɛntʰ
recients	reθjˈɛntʰs
reconoiximiento	rˌekonˌoʃimjˈɛnto
recuperar	rˌekupeɾˈaɾ
referencias	rˌefeɾˈenθjas
reinato	re͡ɪnˈato
relichions	rˌelit͡ʃjˈɔns
relichiosos	rˌelit͡ʃjˈɔsos
representant	rˌepɾesentˈantʰ
representants	rˌepɾesentˈantʰs
respective	rˌespektˈiβe
riqueza	rikˈɛθa
rurals	ruɾˈals
seguida	seɣˈiða
sudueste	suðwˈɛste
tanyer	taɲˈɛɾ
teniu	tenˈiu
tensión	tensjˈon
tornada	toɾnˈaða
torres	tˈores
totalment	tˌotalmˈentʰ
tractau	tɾaktˈa͡ʊ
ubierta	uβjˈɛɾta
variar	baɾjˈaɾ
vien	bjˈɛn
vita	bˈita
zifra	θˈifɾa
Agustín	ˌaɣustˈin
Armenia	aɾmˈenja
Bretanya	βɾetˈaɲa
Cinca	θˈinka
Española	ˌespaɲˈola
George	xeˈoɾxe
India	ˈindja
Louis	lˈowis
Media	mˈeðja
Pueyo	pwˈɛjɔ
Red	rˈe
Serbia	sˈeɾβja
Sistema	sistˈema
Todas	tˈoðas
Turolenses	tˌuɾolˈenses
VIII	ɡwitˈeno
abundants	ˌaβundˈantʰs
acabaus	ˌakaβˈa͡ʊs
actuacions	ˌaktwaθjˈɔns
anglesa	anɡlˈesa
armas	ˈaɾmas
arredols	ˌareðˈols
aspectos	aspˈektos
autonoma	ˌa͡ʊtonˈoma
b	bˈe
caixa	kˈaʃa
carta	kˈaɾta
casó	kasˈo
chelera	t͡ʃelˈeɾa
chinés	t͡ʃinˈes
colonia	kolˈonja
considerada	kˌonsiðeɾˈaða
diferiencia	dˌifeɾjˈɛnθja
dividita	dˌiβiðˈita
divisions	dˌiβisjˈɔns
ducato	dukˈato
durando	duɾˈando
economicos	ˌekonomˈikos
encomienza	ˌenkomjˈɛnθa
entibo	entˈiβo
esfensa	esfˈensa
establita	ˌestaβlˈita
formada	foɾmˈaða
g	ɡˈe
global	ɡloβˈal
gols	ɣˈols
guión	ɡjˈon
historicament	ˌistoɾˌikamˈentʰ
individual	ˌindiβiðwˈal
inferiors	ˌimfeɾjˈɔs
latinas	latˈinas
libertat	lˌiβeɾtˈatʰ
luego	lwˈɛɣo
malautía	mˌala͡ʊtˈia
masas	mˈasas
mediterrania	mˌeðiterˈanja
mercato	meɾkˈato
mercau	meɾkˈa͡ʊ
molimento	mˌolimˈento
nacions	naθjˈɔns
nombrato	nombɾˈato
normalment	nˌoɾmalmˈentʰ
ocupaba	ˌokupˈaβa
orientación	ˌoɾjɛntaθjˈon
paisaches	pa͡ɪsˈat͡ʃes
particularment	pˌaɾtikˌulaɾmˈentʰ
pasando	pasˈando
pasoron	pasˈoɾon
plegan	plˈeɣan
portalada	pˌoɾtalˈaða
posicions	pˌosiθjˈɔns
precipitación	pɾˌeθipˌitaθjˈon
prefixo	pɾefˈiʃo
presonal	pɾˌesonˈal
pro	pɾˈo
rechistros	ret͡ʃˈistɾos
relaciona	rˌelaθjˈɔna
reproducción	rˌepɾoðukθjˈon
republica	rˌepuβlˈika
reserva	resˈeɾβa
revuelta	reβwˈɛlta
récord	rˈekˌoɾ
serán	seɾˈan
significaus	sˌiɡnifikˈa͡ʊs
sinonimo	sˌinonˈimo
situacions	sˌitwaθjˈɔns
subespecie	sˌuβespˈeθjɛ
substantivos	sˌuβstantˈiβos
sustantivos	sˌustantˈiβos
t	tˈe
tampoco	tampˈoko
tradicions	tɾˌaðiθjˈɔns
trafico	tɾafˈiko
uello	ɡwˈɛʎo
urbans	uɾβˈans
valors	balˈos
victimas	biktˈimas
vivió	biβjˈo
Atra	ˈatɾa
B	bˈe
Barranco	barˈanko
C	θˈe
Chaime	t͡ʃˈa͡ɪme
Chapeto	t͡ʃapˈeto
Chunta	t͡ʃˈunta
Fernández	feɾnˈandeθ
Ferrando	ferˈando
GPL	ɡˌepˌeˈɛle
Imachen	imˈat͡ʃen
Ixe	ˈiʃe
Jean	xˈean
Literatura	lˌiteɾatˈuɾa
Loís	loˈis
Mesmo	mˈesmo
Más	mˈas
Orden	ˈoɾðen
Pablo	pˈaβlo
Penya	pˈeɲa
Rei	rˈe͡ɪ
Representa	rˌepɾesˈenta
Robert	roβˈeɾtʰ
Sinyora	siɲˈɔɾa
Tanto	tˈanto
Tomo	tˈomo
agricolas	ˌaɣɾikˈolas
amplament	ˌamplamˈentʰ
apareixen	ˌapaɾˈeʃen
aquell	akˈɛl
britanicos	βɾˌitanˈikos
cadiera	kaðjˈɛɾa
calcula	kalkˈula
cambras	kˈambɾas
campionato	kˌampjɔnˈato
cans	kˈans
cantos	kˈantos
capiella	kapjˈɛʎa
caracteristico	kˌaɾaktˌeɾistˈiko
cargos	kˈaɾɣos
catalana	kˌatalˈana
cayer	kajˈɛɾ
chugador	t͡ʃˌuɣaðˈoɾ
cielo	θjˈɛlo
civilización	θˌiβilˌiθaθjˈon
cobalto	koβˈalto
coincide	ko͡ɪnθˈiðe
coincidindo	kˌo͡ɪnθiðˈindo
combate	kombˈate
combinación	kˌombinaθjˈon
completo	komplˈeto
conchuncions	kˌont͡ʃunθjˈɔns
condatos	kondˈatos
condición	kˌondiθjˈon
constant	konstˈantʰ
constituye	kˌonstitˈujɛ
construyó	kˌonstɾujˈo
contar	kontˈaɾ
contiene	kontjˈɛne
costas	kˈostas
creyan	kɾˈejan
cristianismo	kɾˌistjanˈismo
crosta	kɾˈosta
crovate	kɾoβˈate
cubierto	kuβjˈɛɾto
curtas	kˈuɾtas
cutio	kˈutjɔ
decadas	dekˈaðas
der	dˈeɾ
despoblato	dˌespoβlˈato
destín	destˈin
dividen	diβˈiðen
dividito	dˌiβiðˈito
documento	dˌokumˈento
emplegando	ˌempleɣˈando
erosión	ˌeɾosjˈon
escriben	eskɾˈiβen
escritor	ˌeskɾitˈoɾ
esdevenir	ˌesðeβenˈiɾ
esportistas	ˌespoɾtˈistas
estreita	estɾˈe͡ɪta
expresar	ˌekspɾesˈaɾ
fases	fˈases
formacions	fˌoɾmaθjˈɔns
formal	foɾmˈal
fundó	fundˈo
fuyir	fujˈiɾ
ganato	ɣanˈato
gara	ɣˈaɾa
hierba	jˈɛɾβa
individuals	ˌindiβiðwˈals
irregulars	ˌireɣulˈas
italiana	ˌitaljˈana
literario	lˌiteɾˈaɾjɔ
malautías	mˌala͡ʊtˈias
marins	maɾˈins
menas	mˈenas
mesa	mˈesa
meyos	mˈejɔs
microtoponimos	mˌikɾotˌoponˈimos
morir	moɾˈiɾ
muros	mˈuɾos
museu	musˈe͡ʊ
naixen	nˈaʃen
naus	nˈa͡ʊs
nobleza	noβlˈeθa
nombrau	nombɾˈa͡ʊ
pagar	paɣˈaɾ
patas	pˈatas
perfecto	peɾfˈekto
polaco	polˈako
practicament	pɾˌaktikamˈentʰ
prencipiar	pɾˌenθipjˈaɾ
prencipioron	pɾˌenθipjˈɔɾon
principios	pɾinθˈipjɔs
probable	pɾoβˈaβle
productor	pɾˌoðuktˈoɾ
publicas	puβlˈikas
puedan	pwˈɛðan
pueyo	pwˈɛjɔ
puya	pˈuja
qualos	kwˈalos
quedando	kɛðˈando
quiesto	kjˈɛsto
raza	rˈaθa
reforma	refˈoɾma
representacions	rˌepɾesˌentaθjˈɔns
residencia	rˌesiðˈenθja
responsable	rˌesponsˈaβle
restaurants	rˌesta͡ʊɾˈantʰs
risgo	rˈisɣo
romanas	romˈanas
romanica	rˌomanˈika
single	sˈinɡle
suma	sˈuma
superficies	sˌupeɾfˈiθjɛs
tals	tˈals
también	tambjˈen
tiengan	tjˈɛnɡan
titol	titˈol
toneladas	tˌonelˈaðas
tribu	tɾˈiβu
trobada	tɾoβˈaða
títols	tˈitols
venda	bˈenda
viva	bˈiβa
vivos	bˈiβos
x	ʃˈe
Al	ˈal
Astí	astˈi
Baixa	bˈaʃa
Bielsa	bjˈɛlsa
Castiello	kastjˈɛʎo
Cort	kˈoɾtʰ
Cristo	kɾˈisto
Cuenca	kwˈɛnka
Cultura	kultˈuɾa
Cultural	kˌultuɾˈal
Dios	djˈɔs
Federal	fˌeðeɾˈal
Festival	fˌestiβˈal
Fierro	fjˈɛro
Filología	fˌiloloxˈia
Fuellas	fwˈɛʎas
Henrique	enrˈikɛ
Historicament	ˌistoɾˌikamˈentʰ
Hitler	itlˈeɾ
Joan	xˈoan
Macedonia	mˌaθeðˈonja
Manstein	manstˈe͡ɪn
Monte	mˈonte
Pierre	pjˈɛre
Plan	plˈan
Plana	plˈana
Records	rekˈoɾs
Star	estˈaɾ
Sydney	sˈidne͡ɪ
Tienen	tjˈɛnen
Uniu	unˈiu
XIII	treθˈeno
acceso	akθˈeso
administrativas	ˌadminˌistɾatˈiβas
alcuerdo	alkwˈɛɾðo
alemanas	ˌalemˈanas
alfabeto	ˌalfaβˈeto
amigo	amˈiɣo
aproximadament	ˌapɾoksˌimaðamˈentʰ
arabismos	ˌaɾaβˈismos
barrancos	barˈankos
budismo	buðˈismo
chuegos	t͡ʃwˈɛɣos
clau	klˈa͡ʊ
competencia	kˌompetˈenθja
conceptos	konθˈeptos
conoiximiento	kˌonoʃimjˈɛnto
consello	konsˈeʎo
consideratos	kˌonsiðeɾˈatos
constituyen	kˌonstitˈujɛn
contienen	kontjˈɛnen
contraste	kontɾˈaste
correspondients	kˌorespondjˈɛntʰs
creyoron	kɾejˈɔɾon
criterios	kɾitˈeɾjɔs
criticas	kɾitˈikas
cuello	kwˈɛʎo
cultos	kˈultos
cursos	kˈuɾsos
definiu	dˌefinˈiu
dentrata	dentɾˈata
desapareixió	dˌesapˌaɾeʃjˈo
desembolicó	dˌesembˌolikˈo
desepara	dˌesepˈaɾa
destacando	dˌestakˈando
difusión	dˌifusjˈon
disenyos	disˈeɲɔs
diversidat	dˌiβeɾsiðˈatʰ
edicions	ˌeðiθjˈɔns
eleccions	ˌelekθjˈɔns
electrons	ˌelektɾˈons
espectro	espˈektɾo
estacions	ˌestaθjˈɔns
excepción	ˌeksθepθjˈon
ezquierda	eθkjˈɛɾða
faixas	fˈaʃas
fama	fˈama
familiars	fˌamiljˈas
ficción	fikθjˈon
figurar	fˌiɣuɾˈaɾ
fixa	fˈiʃa
formula	foɾmˈula
francico	fɾanθˈiko
freqüents	fɾekwˈentʰs
fruitos	fɾuˈitos
funda	fˈunda
goyo	ɣˈojɔ
gramatical	ɣɾˌamatikˈal
gusto	ɣˈusto
habitan	aβˈitan
homosexuals	ˌomosekswˈals
in	ˈin
industrias	indˈustɾjas
intención	ˌintenθjˈon
intresant	ˌintɾesˈantʰ
introducción	ˌintɾoðukθjˈon
invasión	ˌimbasjˈon
irregular	ˌireɣulˈaɾ
italians	ˌitaljˈans
laterals	lˌateɾˈals
leit	lˈe͡ɪtʰ
lingüisticos	lˌinɡwistˈikos
magnitut	mˌaɡnitˈutʰ
mapa	mˈapa
metals	metˈals
metropolitana	mˌetɾopˌolitˈana
meyana	mejˈana
millón	miʎˈon
mirando	miɾˈando
moleculas	mˌolekˈulas
moros	mˈoɾos
nación	naθjˈon
noreste	noɾˈeste
novela	noβˈela
obchectivos	ˌobt͡ʃektˈiβos
operación	ˌopeɾaθjˈon
opinión	ˌopinjˈon
oración	ˌoɾaθjˈon
ordens	oɾðˈens
organo	oɾɣˈano
ortografía	ˌoɾtoɣɾafˈia
pareixe	paɾˈeʃe
parroquial	pˌarokjˈal
participación	pˌaɾtiθˌipaθjˈon
pasato	pasˈato
pastors	pastˈos
patrimonials	pˌatɾimonjˈals
permanent	pˌeɾmanˈentʰ
pesca	pˈeska
pilota	pilˈota
plastico	plastˈiko
plena	plˈena
posesión	pˌosesjˈon
practicas	pɾaktˈikas
radar	raðˈaɾ
rango	rˈanɡo
recibito	rˌeθiβˈito
relacionatos	rˌelaθjɔnˈatos
residents	rˌesiðˈentʰs
seguridat	sˌeɣuɾiðˈatʰ
septentrional	sˌeptentɾjɔnˈal
signos	sˈiɡnos
simbolos	simbˈolos
suposó	sˌuposˈo
te	te
terminacions	tˌeɾminaθjˈɔns
tornoron	toɾnˈoɾon
treballa	tɾeβˈaʎa
treballan	tɾeβˈaʎan
treballó	tɾˌeβaʎˈo
turco	tˈuɾko
túnel	tˈunel
uga	ˈuɣa
variables	baɾjˈaβles
viache	bjˈat͡ʃe
vivo	bˈiβo
vueito	bwˈe͡ɪto
zaguero	θaɣˈɛɾo
é	ˈeakθɛntwˈaða
Aquí	akˈi
Archivo	aɾt͡ʃˈiβo
Benedet	bˌeneðˈetʰ
Bohemia	boˈemja
Bulgaria	bulɣˈaɾja
Crimea	kɾimˈea
Debito	deβˈito
E	ˈe
Is	ˈis
Javier	xaβjˈɛɾ
Moldavia	molðˈaβja
Noruega	nˌoɾuˈɛɣa
Patrimonio	pˌatɾimˈonjɔ
Paul	pˈa͡ʊl
País	paˈis
Plaza	plˈaθa
President	pɾˌesiðˈentʰ
Revolución	rˌeβoluθjˈon
Román	romˈan
Sancho	sˈant͡ʃo
Tenió	tenjˈo
Tién	tjˈen
Turquía	tuɾkˈia
Vicente	biθˈente
Vlaquia	blˈakja
Zen	θˈen
adchectivo	ˌadt͡ʃektˈiβo
afers	afˈes
alternativa	ˌalteɾnatˈiβa
arquitectura	ˌaɾkitektˈuɾa
bronze	βɾˈonθe
calient	kaljˈɛntʰ
cargas	kˈaɾɣas
celebracions	θˌeleβɾaθjˈɔns
cheneracions	t͡ʃˌeneɾaθjˈɔns
chermanicas	t͡ʃˌeɾmanˈikas
chuntos	t͡ʃˈuntos
cierta	θjˈɛɾta
clamaus	klamˈa͡ʊs
clasifican	klˌasifˈikan
colonización	kˌolonˌiθaθjˈon
columnas	kolˈumnas
conchuntos	kont͡ʃˈuntos
conseguir	kˌonseɣˈiɾ
consonants	kˌonsonˈantʰs
construir	kˌonstɾuˈiɾ
contes	kˈontes
cort	kˈoɾtʰ
costatos	kostˈatos
costaus	kostˈa͡ʊs
coste	kˈoste
crei	kɾˈe͡ɪ
creixe	kɾˈeʃe
cristals	kɾistˈals
cubre	kˈuβɾe
cucho	kˈut͡ʃo
curta	kˈuɾta
decenas	deθˈenas
dentrar	dentɾˈaɾ
dentró	dentɾˈo
dependendo	dˌependˈendo
descrito	deskɾˈito
devez	deβˈeθ
dients	djˈɛntʰs
dificultatz	dˌifikultˈaθ
difícil	difˈiθil
diosa	djˈɔsa
directo	diɾˈekto
dispositivos	dˌispositˈiβos
duración	dˌuɾaθjˈon
encomienzan	ˌenkomjˈɛnθan
entidatz	ˌentiðˈaθ
equivalents	ˌekiβalˈentʰs
esferencia	ˌesfeɾˈenθja
estandar	ˌestandˈaɾ
etnico	etnˈiko
explica	eksplˈika
fembra	fˈembɾa
ficacio	fikˈaθjɔ
fisicos	fisˈikos
fundación	fˌundaθjˈon
graus	ɣɾˈa͡ʊs
guitarrista	ɡˌitarˈista
habendo	aβˈendo
habioron	aβjˈɔɾon
habiu	aβˈiu
hongaros	onɡˈaɾos
legal	leɣˈal
leito	lˈe͡ɪto
localización	lˌokalˌiθaθjˈon
locución	lˌokuθjˈon
mando	mˈando
mantenimiento	mˌantenimjˈɛnto
masculina	mˌaskulˈina
mayestro	majˈɛstɾo
medallas	meðˈaʎas
millas	mˈiʎas
mils	mˈils
minoritaria	mˌinoɾitˈaɾja
minorías	mˌinoɾˈias
muerto	mwˈɛɾto
muestra	mwˈɛstɾa
nacionalidat	nˌaθjɔnˌaliðˈatʰ
naixe	nˈaʃe
ne	ne
nino	nˈino
operacions	ˌopeɾaθjˈɔns
ordinadors	ˌoɾðinaðˈos
organicos	ˌoɾɣanˈikos
pan	pˈan
paralela	pˌaɾalˈela
pareixita	pˌaɾeʃˈita
participan	pˌaɾtiθˈipan
plataforma	plˌatafˈoɾma
pobres	pˈoβɾes
poeta	poˈeta
precipitacions	pɾˌeθipˌitaθjˈɔns
prencipe	pɾenθˈipe
promoción	pɾˌomoθjˈon
publicos	puβlˈikos
quatrena	kwatɾˈena
quedar	kɛðˈaɾ
quimicas	kimˈikas
reflecta	reflˈekta
reglas	rˈeɣlas
relatos	relˈatos
rematan	remˈatan
reservas	resˈeɾβas
resultaus	rˌesultˈa͡ʊs
ritmo	rˈitmo
salas	sˈalas
salen	sˈalen
scena	esθˈena
seguro	seɣˈuɾo
seqüencia	sekwˈenθja
serbios	sˈeɾβjɔs
sigla	sˈiɣla
simients	simjˈɛntʰs
simpla	sˈimpla
simples	sˈimples
sitúa	sitˈua
soldatos	solðˈatos
sonitos	sonˈitos
sovietica	sˌoβjɛtˈika
sovieticos	sˌoβjɛtˈikos
substancia	suβstˈanθja
tardano	taɾðˈano
teatro	teˈatɾo
tenito	tenˈito
treballando	tɾˌeβaʎˈando
trescruza	tɾeskɾˈuθa
urbano	uɾβˈano
vechetals	bˌet͡ʃetˈals
vecinas	beθˈinas
verticals	bˌeɾtikˈals
vesitants	bˌesitˈantʰs
vientos	bjˈɛntos
viviba	biβˈiβa
Africa	afɾˈika
Alta	ˈalta
Australia	a͡ʊstɾˈalja
CPU	kpˈu
Canal	kanˈal
Catalana	kˌatalˈana
Consultau	kˌonsultˈa͡ʊ
Ebro	ˈeβɾo
Estatos	estˈatos
Estau	estˈa͡ʊ
Fuentes	fwˈɛntes
Galia	ɣˈalja
González	ɣonθˈaleθ
Guadalachara	ɡwˌaðalat͡ʃˈaɾa
Guardia	ɡwˈaɾðja
Guía	ɡˈia
Herzegovina	ˌeɾθeɣoβˈina
Ibn	ˈibn
Jack	xˈak
James	xˈames
Jesús	xesˈus
Leyón	lejˈon
Madeira	maðˈe͡ɪɾa
Mare	mˈaɾe
Martin	mˈaɾtin
Meyo	mˈejɔ
Millor	miʎˈoɾ
Nacions	naθjˈɔns
Naixitos	naʃˈitos
Poco	pˈoko
Prensas	pɾˈensas
Pérez	pˈeɾeθ
Road	roˈa
Sin	sin
Tomás	tomˈas
Va	bˈa
Vietnam	bjɛtnˈam
Yugoslavia	jˌuɣoslˈaβja
actors	aktˈos
alimentos	ˌalimˈentos
altarias	altˈaɾjas
amés	amˈes
apareixió	ˌapaɾeʃjˈo
arte	ˈaɾte
asociación	ˌasoθjaθjˈon
berbers	beɾβˈes
botigas	botˈiɣas
brazos	βɾˈaθos
cantidatz	kˌantiðˈaθ
capas	kˈapas
capeza	kapˈeθa
capitán	kˌapitˈan
celebran	θelˈeβɾan
celula	θelˈula
chaponés	t͡ʃˌaponˈes
chenerico	t͡ʃˌeneɾˈiko
chentilicio	t͡ʃˌentilˈiθjɔ
chermanicos	t͡ʃˌeɾmanˈikos
cheso	t͡ʃˈeso
chica	t͡ʃˈika
chudicial	t͡ʃˌuðiθjˈal
cinematografica	θˌinemˌatoɣɾafˈika
clarament	klˌaɾamˈentʰ
com	kˈom
companyía	kˌompaɲˈia
complexos	komplˈeksos
comunas	komˈunas
conoixidas	kˌonoʃˈiðas
consigue	konsˈiɣɛ
continación	kˌontinaθjˈon
continoron	kˌontinˈoɾon
convierte	kombjˈɛɾte
cosacos	kosˈakos
costumbres	kostˈumbɾes
crisi	kɾˈisi
critica	kɾitˈika
dando	dˈando
declaró	dˌeklaɾˈo
descubierto	dˌeskuβjˈɛɾto
determinar	dˌeteɾminˈaɾ
determinato	dˌeteɾminˈato
dichital	dˌit͡ʃitˈal
dificils	dˌifiθˈils
dimana	dimˈana
dispositivo	dˌispositˈiβo
doctrina	doktɾˈina
durada	duɾˈaða
economicas	ˌekonomˈikas
electronica	ˌelektɾonˈika
emplegada	ˌempleɣˈaða
escritors	ˌeskɾitˈos
esdevenito	ˌesðeβenˈito
esleitos	eslˈe͡ɪtos
especifica	ˌespeθifˈika
espelunga	ˌespelˈunɡa
esportivas	ˌespoɾtˈiβas
estable	estˈaβle
estatus	estˈatus
estrato	estɾˈato
etnonimo	ˌetnonˈimo
europea	ˌe͡ʊɾopˈea
eventos	eβˈentos
explicación	ˌeksplikaθjˈon
expresa	ekspɾˈesa
falla	fˈaʎa
falta	fˈalta
federación	fˌeðeɾaθjˈon
fibra	fˈiβɾa
flor	flˈoɾ
foro	fˈoɾo
francesas	fɾanθˈesas
fósils	fˈosils
ganador	ɣˌanaðˈoɾ
gosaba	ɣosˈaβa
gubernador	ɣˌuβeɾnaðˈoɾ
habrá	aβɾˈa
homosexualidat	ˌomosˌekswaliðˈatʰ
humanidat	ˌumaniðˈatʰ
imperativo	ˌimpeɾatˈiβo
infantil	ˌimfantˈil
intensa	intˈensa
intervención	ˌinteɾβenθjˈon
latitutz	lˌatitˈuθ
libels	liβˈels
lingüistas	linɡwˈistas
líder	lˈiðeɾ
mantiene	mantjˈɛne
melitant	mˌelitˈantʰ
membrana	membɾˈana
mesuras	mesˈuɾas
modernas	moðˈeɾnas
mugants	muɣˈantʰs
neolatinas	nˌeolatˈinas
nos	nos
occitanismos	ˌokθitanˈismos
oposición	ˌoposiθjˈon
orbita	oɾβˈita
orichinau	ˌoɾit͡ʃinˈa͡ʊ
parcialment	pˌaɾθjalmˈentʰ
pareixidas	pˌaɾeʃˈiðas
particla	paɾtˈikla
partida	paɾtˈiða
pasachers	pˌasat͡ʃˈes
pasan	pˈasan
pasos	pˈasos
pendient	pendjˈɛntʰ
penyas	pˈeɲas
percepción	pˌeɾθepθjˈon
perdió	peɾðjˈo
personals	pˌeɾsonˈals
piensa	pjˈɛnsa
placas	plˈakas
plevia	plˈeβja
polo	pˈolo
positiva	pˌositˈiβa
presonals	pɾˌesonˈals
principe	pɾinθˈipe
propuesta	pɾopwˈɛsta
quitó	kitˈo
recinto	reθˈinto
recuperación	rˌekupˌeɾaθjˈon
relativos	rˌelatˈiβos
representato	rˌepɾesentˈato
romanización	rˌomanˌiθaθjˈon
saber	saβˈeɾ
satelite	sˌatelˈite
scenas	esθˈenas
seguidors	sˌeɣiðˈos
segundos	seɣˈundos
sentir	sentˈiɾ
significativa	sˌiɡnifˌikatˈiβa
solitario	sˌolitˈaɾjɔ
solos	sˈolos
solución	sˌoluθjˈon
sovieticas	sˌoβjɛtˈikas
subordinada	sˌuβoɾðinˈaða
suficient	sˌufiθjˈɛntʰ
tercio	tˈeɾθjɔ
transformación	tɾˌansfoɾmaθjˈon
trobó	tɾoβˈo
tunica	tunˈika
une	ˈune
utilizau	ˌutiliθˈa͡ʊ
variación	bˌaɾjaθjˈon
violencia	bjɔlˈenθja
visión	bisjˈon
vivindo	biβˈindo
vuelo	bwˈɛlo
vuelta	bwˈɛlta
árbol	ˈaɾβol
Antón	antˈon
Austria	ˈa͡ʊstɾja
Belunas	belˈunas
Brasil	βɾasˈil
Broto	βɾˈoto
Casas	kˈasas
Cinco	θˈinko
Comarca	komˈaɾka
Conejero	kˌonexˈeɾo
Destaca	destˈaka
Edad	eðˈa
Einstein	e͡ɪnstˈe͡ɪn
Escudo	eskˈuðo
Escuela	eskwˈɛla
Evolución	ˌeβoluθjˈon
Gosa	ɣˈosa
Hispania	ispˈanja
Ligallo	liɣˈaʎo
Meseta	mesˈeta
Monesterio	mˌonestˈeɾjɔ
Murcia	mˈuɾθja
Nuevo	nwˈɛβo
Odiseu	ˌoðisˈe͡ʊ
Orichinalment	ˌoɾit͡ʃˌinalmˈentʰ
Paleolitico	pˌaleˌolitˈiko
Peter	petˈeɾ
Podemos	poðˈemos
Posteriorment	pˌosteɾjɔɾmˈentʰ
Prene	pɾˈene
Quasi	kwˈasi
Radio	rˈaðjɔ
Recibió	rˌeθiβjˈo
Secilia	seθˈilja
St	ˌɛsetˈe
Su	su
Superior	sˌupeɾjˈɔɾ
Tiene	tjˈɛne
Universitarias	ˌuniβˌeɾsitˈaɾjas
Vaticano	bˌatikˈano
Ventura	bentˈuɾa
Venus	bˈenus
absoluta	ˌaβsolˈuta
achent	at͡ʃˈentʰ
acido	aθˈiðo
actuación	ˌaktwaθjˈon
actuar	aktwˈaɾ
adaptación	ˌaðaptaθjˈon
administrativament	ˌadminˌistɾatˌiβamˈentʰ
adultos	aðˈultos
aerio	aˈeɾjɔ
alazetz	ˌalaθˈeθ
aldeyas	alðˈejas
amaneix	ˌamanˈeʃ
amariello	ˌamaɾjˈɛʎo
ambient	ambjˈɛntʰ
apareixioron	ˌapaɾeʃjˈɔɾon
armenia	aɾmˈenja
arribar	ˌariβˈaɾ
artes	ˈaɾtes
ataque	atˈakɛ
atletas	atlˈetas
autoctona	ˌa͡ʊtoktˈona
bellos	bˌeʎos
bizantín	bˌiθantˈin
boca	bˈoka
brazo	βɾˈaθo
caballers	kˌaβaʎˈes
cabecera	kˌaβeθˈeɾa
cadenas	kaðˈenas
cambiar	kambjˈaɾ
capable	kapˈaβle
centimetros	θˌentimˈetɾos
chenetica	t͡ʃˌenetˈika
cheografía	t͡ʃˌeoɣɾafˈia
cheolochico	t͡ʃˌeolot͡ʃˈiko
chusticia	t͡ʃustˈiθja
clasificar	klˌasifikˈaɾ
comité	kˌomitˈe
composau	kˌomposˈa͡ʊ
condicional	kˌondiθjɔnˈal
conoixió	kˌonoʃjˈo
considerablement	kˌonsiðˌeɾaβlemˈentʰ
construito	kˌonstɾuˈito
continan	kontˈinan
costumbre	kostˈumbɾe
dato	dˈato
delta	dˈelta
des	des
determinadas	dˌeteɾminˈaðas
di	dˈi
distintas	distˈintas
distintos	distˈintos
distribuye	dˌistɾiβˈujɛ
dominios	domˈinjɔs
duró	duɾˈo
emblema	emblˈema
emplegata	ˌempleɣˈata
encluye	enklˈujɛ
equipo	ekˈipo
era	ˈeɾa
esfuerzo	esfwˈɛɾθo
espacios	espˈaθjɔs
esperanto	ˌespeɾˈanto
estreito	estɾˈe͡ɪto
etnica	etnˈika
exclusiva	ˌeksklusˈiβa
exemplars	ˌeksemplˈas
exitos	eksˈitos
expedición	ˌekspeðiθjˈon
externa	ekstˈeɾna
ferrocarril	fˌerokarˈil
filosofía	fˌilosofˈia
firme	fˈiɾme
flora	flˈoɾa
fluvial	fluβjˈal
foranos	foɾˈanos
formaban	foɾmˈaβan
fuesen	fwˈɛsen
haigan	ˈa͡ɪɣan
hipotesis	ˌipotˈesis
humano	umˈano
impacto	impˈakto
individuo	ˌindiβˈiðwɔ
insectos	insˈektos
internos	intˈeɾnos
kg	kˌaɣˈe
lingüisticas	lˌinɡwistˈikas
luitar	lˌuitˈaɾ
luna	lˈuna
mandato	mandˈato
mapas	mˈapas
medico	meðˈiko
mensache	mensˈat͡ʃe
minoría	mˌinoɾˈia
miran	mˈiɾan
misions	misjˈɔns
mitolochía	mˌitolot͡ʃˈia
monarquía	mˌonaɾkˈia
montanyosas	mˌontaɲˈɔsas
mozarabe	mˌoθaɾˈaβe
musclo	mˈusklo
musicos	musˈikos
musulmán	mˌusulmˈan
nomenclatura	nˌomenklatˈuɾa
norma	nˈoɾma
nuestro	nwˈɛstɾo
ocupan	okˈupan
organismo	ˌoɾɣanˈismo
pareixiu	pˌaɾeʃˈiu
parella	paɾˈeʎa
pars	pˈas
partidarios	pˌaɾtiðˈaɾjɔs
partido	paɾtˈiðo
perfectament	pˌeɾfektamˈentʰ
piloto	pilˈoto
piso	pˈiso
placa	plˈaka
planetas	planˈetas
plano	plˈano
plegada	pleɣˈaða
plegando	pleɣˈando
pleno	plˈeno
potencias	potˈenθjas
presupuesto	pɾˌesupwˈɛsto
produz	pɾoðˈuθ
promeyo	pɾomˈejɔ
propietario	pɾˌopjɛtˈaɾjɔ
proposicions	pɾˌoposiθjˈɔns
proposito	pɾˌoposˈito
provenients	pɾˌoβenjˈɛntʰs
provienen	pɾoβjˈɛnen
quadro	kwˈaðɾo
razas	rˈaθas
realiza	rˌealˈiθa
realment	rˌealmˈentʰ
reals	reˈals
recipient	rˌeθipjˈɛntʰ
rector	rektˈoɾ
reformas	refˈoɾmas
relacionato	rˌelaθjɔnˈato
relativo	rˌelatˈiβo
representaba	rˌepɾesentˈaβa
restauración	rˌesta͡ʊɾaθjˈon
ronda	rˈonda
rotación	rˌotaθjˈon
rotas	rˈotas
selva	sˈelβa
semellants	sˌemeʎˈantʰs
siglo	sˈiɣlo
significar	sˌiɡnifikˈaɾ
sindembargo	sˌindembˈaɾɣo
sinyors	siɲˈɔs
sobirán	sˌoβiɾˈan
sociedatz	sˌoθjɛðˈaθ
sonda	sˈonda
soniu	sonˈiu
suelos	swˈɛlos
testimonio	tˌestimˈonjɔ
tipicas	tipˈikas
torismo	toɾˈismo
totalidat	tˌotaliðˈatʰ
tozuelo	toθwˈɛlo
traduccions	tɾˌaðukθjˈɔns
transportar	tɾˌanspoɾtˈaɾ
tren	tɾˈen
trens	tɾˈens
trobaban	tɾoβˈaβan
turcos	tˈuɾkos
vapor	bapˈoɾ
varía	baɾˈia
vertical	bˌeɾtikˈal
veyemos	bejˈɛmos
viellos	bjˈɛʎos
vinient	binjˈɛntʰ
vivienda	biβjˈɛnda
vuelos	bwˈɛlos
Altoaragoneses	ˌaltoˌaɾaɣonˈeses
Balbastro	balβˈastɾo
Belarrusia	bˌelarˈusja
Buena	bwˈɛna
Chris	t͡ʃɾˈis
City	θˈiti
Comisión	kˌomisjˈon
Conseller	kˌonseʎˈeɾ
Dreito	ðɾˈe͡ɪto
Fuerza	fwˈɛɾθa
Galitzia	ɣalˈiθja
Gaulle	ɣˈa͡ʊʎe
IX	nʊˈeno
Jones	xˈones
Lei	lˈe͡ɪ
Negra	nˈeɣɾa
North	nˈoɾt
Pacifico	pˌaθifˈiko
Peña	pˈeɲa
Pilar	pilˈaɾ
Popular	pˌopulˈaɾ
Praga	pɾˈaɣa
Prencipió	pɾˌenθipjˈo
Reparo	repˈaɾo
Río	rˈio
Totas	tˈotas
Ucraína	ˌukɾaˈina
Varsovia	baɾsˈoβja
abraca	aβɾˈaka
abundant	ˌaβundˈantʰ
acceder	ˌakθeðˈeɾ
achents	at͡ʃˈentʰs
actor	aktˈoɾ
administrativo	ˌadminˌistɾatˈiβo
aire	ˈa͡ɪɾe
aon	ˌaon
apareixer	ˌapaɾeʃˈeɾ
aquells	akˈɛls
aquí	akˈi
atmosfera	ˌatmosfˈeɾa
basica	basˈika
bispes	bˈispes
cabos	kˈaβos
caita	kˈa͡ɪta
cambeó	kˌambeˈo
campanyas	kampˈaɲas
campionatos	kˌampjɔnˈatos
cantar	kantˈaɾ
cartas	kˈaɾtas
catolica	kˌatolˈika
celta	θˈelta
ch	t͡ʃˈe
chaponesa	t͡ʃˌaponˈesa
cheografico	t͡ʃˌeoɣɾafˈiko
chodiga	t͡ʃoðˈiɣa
chodigo	t͡ʃoðˈiɣo
cima	θˈima
coinciden	ko͡ɪnθˈiðen
colaboración	kˌolaβˌoɾaθjˈon
columna	kolˈumna
composa	kompˈosa
composadas	kˌomposˈaðas
concreta	konkɾˈeta
conseqüencias	kˌonsekwˈenθjas
considerable	kˌonsiðeɾˈaβle
consideraus	kˌonsiðeɾˈa͡ʊs
contextos	kontˈekstos
continents	kˌontinˈentʰs
contién	kontjˈen
copias	kˈopjas
correcta	korˈekta
correu	korˈe͡ʊ
cortz	kˈoɾθ
costeras	kostˈeɾas
creyada	kɾejˈaða
creyen	kɾˈejɛn
debiu	deβˈiu
decisions	dˌeθisjˈɔns
definito	dˌefinˈito
deixan	dˈeʃan
denomina	dˌenomˈina
derivación	dˌeɾiβaθjˈon
desapareixe	dˌesapaɾˈeʃe
descripción	dˌeskɾipθjˈon
deseparación	dˌesepˌaɾaθjˈon
designa	desˈiɡna
designar	dˌesiɡnˈaɾ
dialectal	djˌalektˈal
dialectals	djˌalektˈals
dificultat	dˌifikultˈatʰ
dio	djˈɔ
dirichita	dˌiɾit͡ʃˈita
disenyau	dˌiseɲˈa͡ʊ
disponible	dˌisponˈiβle
distancias	distˈanθjas
distingue	distˈinɡɛ
dividiu	dˌiβiðˈiu
duques	dˈukɛs
eixe	ˈeʃe
electrico	ˌelektɾˈiko
entorno	entˈoɾno
entrada	entɾˈaða
esdevinioron	ˌesðeβinjˈɔɾon
eslavas	eslˈaβas
español	ˌespaɲˈol
especificament	ˌespeθˌifikamˈentʰ
esportivos	ˌespoɾtˈiβos
estratos	estɾˈatos
estudiants	ˌestuðjˈantʰs
etimolochica	ˌetimˌolot͡ʃˈika
etnicos	etnˈikos
exposicions	ˌeksposiθjˈɔns
facto	fˈakto
faina	fˈa͡ɪna
fese	fˈese
feto	fˈeto
figuras	fiɣˈuɾas
fluvials	fluβjˈals
fondo	fˈondo
foranas	foɾˈanas
glandulas	ɡlandˈulas
gol	ɣˈol
golfo	ɣˈolfo
gosaban	ɣosˈaβan
gramatica	ɣɾˌamatˈika
guaires	ɡwˈa͡ɪɾes
habla	ˈaβla
hibiernos	iβjˈɛɾnos
hierarquía	jˌɛɾaɾkˈia
historias	istˈoɾjas
iban	ˈiβan
industrials	ˌindustɾjˈals
iu	ˌiˈu
largos	lˈaɾɣos
lechislativo	lˌet͡ʃislatˈiβo
levó	leβˈo
literarios	lˌiteɾˈaɾjɔs
mala	mˈala
maorís	mˌaoɾˈis
maquina	makˈina
marinas	maɾˈinas
marrón	marˈon
masclo	mˈasklo
mayoritariament	mˌajɔɾˌitaɾjamˈentʰ
me	me
mencionan	menθjˈɔnan
mencionato	mˌenθjɔnˈato
metro	mˈetɾo
meyaus	mejˈa͡ʊs
militars	mˌilitˈas
ministro	minˈistɾo
molimentos	mˌolimˈentos
muere	mwˈɛɾe
narancha	naɾˈant͡ʃa
natal	natˈal
ninvió	nimbjˈo
nombran	nˈombɾan
novelas	noβˈelas
obtenió	ˌobtenjˈo
organizacions	ˌoɾɣanˌiθaθjˈɔns
ortodoxa	ˌoɾtoðˈoksa
ortodoxos	ˌoɾtoðˈoksos
otomán	ˌotomˈan
parellanas	pˌaɾeʎˈanas
participó	pˌaɾtiθipˈo
pasiva	pasˈiβa
patrimonial	pˌatɾimonjˈal
peix	pˈeʃ
pensamiento	pˌensamjˈɛnto
periodico	pˌeɾjɔðˈiko
permitir	pˌeɾmitˈiɾ
petrolio	petɾˈoljɔ
picos	pˈikos
poders	poðˈes
predominan	pɾˌeðomˈinan
presienta	pɾesjˈɛnta
primaria	pɾimˈaɾja
primavera	pɾˌimaβˈeɾa
procesions	pɾˌoθesjˈɔns
proteínas	pɾˌoteˈinas
psicolochía	sˌikolot͡ʃˈia
qualque	kwˈalkɛ
quarta	kwˈaɾta
quimico	kimˈiko
relacionadas	rˌelaθjɔnˈaðas
representau	rˌepɾesentˈa͡ʊ
resulta	resˈulta
revistas	reβˈistas
romance	romˈanθe
romano	romˈano
romanz	romˈanθ
sabor	saβˈoɾ
sape	sˈape
seccions	sekθjˈɔns
secreto	sekɾˈeto
semellant	sˌemeʎˈantʰ
sendicatos	sˌendikˈatos
serían	seɾˈian
simient	simjˈɛntʰ
sobiranía	sˌoβiɾanˈia
solido	solˈiðo
sonora	sonˈoɾa
sus	sus
tecnolochías	tˌeknolot͡ʃˈias
tematica	tˌematˈika
tendría	tendɾˈia
terminolochía	tˌeɾminˌolot͡ʃˈia
trachectoria	tɾˌat͡ʃektˈoɾja
transmeso	tɾansmˈeso
trenta	tɾˈenta
trobato	tɾoβˈato
troboron	tɾoβˈoɾon
turquica	tuɾkˈika
videos	biðˈeos
vins	bˈins
votos	bˈotos
yo	jˈɔ
être	ˈetɾe
America	ˌameɾˈika
Biescas	bjˈɛskas
Cerro	θˈero
Chaca	t͡ʃˈaka
Charles	t͡ʃˈaɾles
Comunidat	kˌomuniðˈatʰ
Costa	kˈosta
Croacia	kɾoˈaθja
Cup	kˈup
Democratica	dˌemokɾatˈika
Dinamarca	dˌinamˈaɾka
Domingo	domˈinɡo
Ella	ˈeʎa
Els	els
English	ˈenɡlis
Enta	ˈenta
Fueva	fwˈɛβa
Fundación	fˌundaθjˈon
Galicia	ɣalˈiθja
Galligo	ɣaʎˈiɣo
Han	ˈan
Jaime	xˈa͡ɪme
Karabakh	kˌaɾaβˈak
Libre	lˈiβɾe
Marilyn	maɾˈilin
Martínez	maɾtˈineθ
Molimento	mˌolimˈento
Montenegro	mˌontenˈeɣɾo
Monts	mˈontʰs
Municipal	mˌuniθipˈal
N	ˈɛne
Nápols	nˈapols
Organización	ˌoɾɣanˌiθaθjˈon
Otomán	ˌotomˈan
Pamplona	pamplˈona
Quercus	kˈɛɾkus
Respective	rˌespektˈiβe
Sciencias	esθjˈɛnθjas
Semana	semˈana
Sinyor	siɲˈɔɾ
Sobre	sˈoβɾe
Talment	talmˈentʰ
Teneba	tenˈeβa
Tercera	teɾθˈeɾa
Territorio	tˌeritˈoɾjɔ
UEFA	ɡwˈɛfa
Veïnat	be͡ɪnˈatʰ
accento	akθˈento
acidos	aθˈiðos
activos	aktˈiβos
administrativos	ˌadminˌistɾatˈiβos
afirma	afˈiɾma
altament	ˌaltamˈentʰ
altra	ˈaltɾa
amostranza	ˌamostɾˈanθa
amplas	ˈamplas
analochía	ˌanalot͡ʃˈia
aniellos	anjˈɛʎos
arriba	arˈiβa
atomos	atˈomos
baile	bˈa͡ɪle
basata	basˈata
bases	bˈases
blancos	blˈankos
boiras	bˈo͡ɪɾas
bosniacos	bosnjˈakos
cabal	kaβˈal
calandario	kˌalandˈaɾjɔ
calendatas	kˌalendˈatas
calients	kaljˈɛntʰs
campiona	kampjˈɔna
capiellas	kapjˈɛʎas
capítol	kapˈitol
causas	kˈa͡ʊsas
cayen	kˈajɛn
celebrar	θˌeleβɾˈaɾ
cercuitos	θˌeɾkuˈitos
chardín	t͡ʃaɾðˈin
charrau	t͡ʃarˈa͡ʊ
cheneros	t͡ʃenˈeɾos
cheograficos	t͡ʃˌeoɣɾafˈikos
chugaban	t͡ʃuɣˈaβan
cientos	θjˈɛntos
cinqueno	θinkˈɛno
circulación	θˌiɾkulaθjˈon
civils	θiβˈils
claras	klˈaɾas
colechio	kolˈet͡ʃjɔ
comportamientos	kˌompoɾtamjˈɛntos
composada	kˌomposˈaða
conoixeba	kˌonoʃˈeβa
construita	kˌonstɾuˈita
contaminación	kˌontamˌinaθjˈon
conteniu	kˌontenˈiu
contrimuestra	kˌontɾimwˈɛstɾa
convertiu	kˌombeɾtˈiu
copa	kˈopa
creixen	kɾˈeʃen
cultismos	kultˈismos
decreto	dekɾˈeto
define	defˈine
definida	dˌefinˈiða
demografica	dˌemoɣɾafˈika
dependencia	dˌependˈenθja
derivar	dˌeɾiβˈaɾ
desaparición	dˌesapˌaɾiθjˈon
describen	deskɾˈiβen
desemboca	dˌesembˈoka
despoblau	dˌespoβlˈa͡ʊ
destacatos	dˌestakˈatos
determinau	dˌeteɾminˈa͡ʊ
dice	dˈiθe
dichitals	dˌit͡ʃitˈals
dieta	djˈɛta
diya	dˈija
dominación	dˌominaθjˈon
dorsal	doɾsˈal
eficient	ˌefiθjˈɛntʰ
eixemplars	ˌeʃemplˈas
electronicos	ˌelektɾonˈikos
empecipió	ˌempeθipjˈo
entrenador	ˌentɾenaðˈoɾ
eslecions	ˌesleθjˈɔns
espacials	ˌespaθjˈals
especifico	ˌespeθifˈiko
especificos	ˌespeθifˈikos
esportivo	ˌespoɾtˈiβo
esquena	eskˈɛna
establimiento	ˌestaβlimjˈɛnto
estatal	ˌestatˈal
evident	ˌeβiðˈentʰ
exacta	eksˈakta
exercitos	ˌekseɾθˈitos
factor	faktˈoɾ
faiga	fˈa͡ɪɣa
fambre	fˈambɾe
fesen	fˈesen
fisicas	fisˈikas
fotografía	fˌotoɣɾafˈia
franca	fɾˈanka
frases	fɾˈases
fruita	fɾuˈita
funcional	fˌunθjɔnˈal
gana	ɣˈana
garras	ɣˈaras
golpe	ɣˈolpe
gotico	ɣotˈiko
grant	ɣɾˈantʰ
gubiernos	ɣuβjˈɛɾnos
h	ˈat͡ʃe
habita	aβˈita
horizontal	ˌoɾiθontˈal
ibons	iβˈons
incluyindo	ˌinklujˈindo
indoeuropea	ˌindoˌe͡ʊɾopˈea
intelectual	ˌintelektwˈal
labor	laβˈoɾ
laboratorio	lˌaβoɾatˈoɾjɔ
largas	lˈaɾɣas
liberar	lˌiβeɾˈaɾ
linache	linˈat͡ʃe
mamifers	mˌamifˈes
manifestacions	mˌanifˌestaθjˈɔns
manifiesta	mˌanifjˈɛsta
mantenió	mˌantenjˈo
mantienen	mantjˈɛnen
marina	maɾˈina
masiva	masˈiβa
materna	matˈeɾna
mayestros	majˈɛstɾos
medida	meðˈiða
mental	mentˈal
meridionals	mˌeɾiðjɔnˈals
mesurar	mˌesuɾˈaɾ
minchan	mˈint͡ʃan
monesterios	mˌonestˈeɾjɔs
montanyosa	mˌontaɲˈɔsa
mover	moβˈeɾ
mundials	mundjˈals
murallas	muɾˈaʎas
muscular	mˌuskulˈaɾ
nacionalismo	nˌaθjɔnalˈismo
navegación	nˌaβeɣaθjˈon
negativa	nˌeɣatˈiβa
nombrar	nombɾˈaɾ
nota	nˈota
notables	notˈaβles
noticias	notˈiθjas
nuestra	nwˈɛstɾa
ocupando	ˌokupˈando
ocurre	okˈure
ofreixe	ofɾˈeʃe
ondas	ˈondas
opera	opˈeɾa
ordinador	ˌoɾðinaðˈoɾ
papels	papˈels
parellas	paɾˈeʎas
peninsular	pˌeninsulˈaɾ
perdiu	peɾðˈiu
perduga	peɾðˈuɣa
plantilla	plantˈiʎa
pobladors	pˌoβlaðˈos
pobre	pˈoβɾe
podendo	poðˈendo
poesía	pˌoesˈia
poquetz	pokˈɛθ
poseyen	posˈejɛn
posiblement	pˌosiβlemˈentʰ
pozos	pˈoθos
pre	pɾˈe
prebatinas	pɾˌeβatˈinas
prefixos	pɾefˈiʃos
prencipiando	pɾˌenθipjˈando
presas	pɾˈesas
presentó	pɾˌesentˈo
presonache	pɾˌesonˈat͡ʃe
previament	pɾˌeβjamˈentʰ
procede	pɾoθˈeðe
procedents	pɾˌoθeðˈentʰs
producito	pɾˌoðuθˈito
protecher	pɾˌotet͡ʃˈeɾ
qualidat	kwˌaliðˈatʰ
quarto	kwˈaɾto
quedau	kɛðˈa͡ʊ
quereba	kɛɾˈeβa
rechira	ret͡ʃˈiɾa
recientment	rˌeθjɛnmˈentʰ
reconoixita	rˌekonoʃˈita
reconquiesta	rˌekonkjˈɛsta
recorriu	rˌekorˈiu
recurso	rekˈuɾso
refirmar	rˌefiɾmˈaɾ
reflexión	rˌefleksjˈon
regularment	rˌeɣulaɾmˈentʰ
relacionar	rˌelaθjɔnˈaɾ
requiere	rekjˈɛɾe
rica	rˈika
salida	salˈiða
santo	sˈanto
sciencias	esθjˈɛnθjas
sendero	sendˈeɾo
sepoltura	sˌepoltˈuɾa
setio	sˈetjɔ
substancias	suβstˈanθjas
sufrachio	sufɾˈat͡ʃjɔ
sur	sˈuɾ
sustancias	sustˈanθjas
sían	sˈian
tartres	tˈaɾtɾes
tendrá	tendɾˈa
tetulo	tetˈulo
tienden	tjˈɛnden
tocar	tokˈaɾ
toristico	tˌoɾistˈiko
tramo	tɾˈamo
trampo	tɾˈampo
transchenero	tɾˌanst͡ʃenˈeɾo
trobau	tɾoβˈa͡ʊ
turismo	tuɾˈismo
uellas	ɡwˈɛʎas
urbanas	uɾβˈanas
usau	usˈa͡ʊ
valencia	balˈenθja
vasca	bˈaska
vasos	bˈasos
vechetal	bˌet͡ʃetˈal
viviendas	biβjˈɛndas
volar	bolˈaɾ
voluntarios	bˌoluntˈaɾjɔs
zarrar	θarˈaɾ
án	ˈan
Adams	aðˈams
Aeria	aˈeɾja
Albarracín	ˌalβaraθˈin
Alionor	ˌaljɔnˈoɾ
Apareixe	ˌapaɾˈeʃe
Arredol	ˌareðˈol
Asimov	ˌasimˈob
Asinasmesmo	ˌasinasmˈesmo
Balcans	balkˈans
Banco	bˈanko
Banks	bˈanks
Beach	beˈat͡ʃ
Belchica	belt͡ʃˈika
Carmen	kˈaɾmen
Chorche	t͡ʃˈoɾt͡ʃe
Civil	θiβˈil
Confederación	kˌomfeðˌeɾaθjˈon
César	θˈesaɾ
Daroca	daɾˈoka
Departamento	dˌepaɾtamˈento
Die	djˈɛ
Es	es
Finalment	fˌinalmˈentʰ
Fuente	fwˈɛnte
Gupta	ɣˈupta
Hu	u
Island	islˈan
López	lˈopeθ
M	ˈɛme
Mallorca	maʎˈoɾka
Mediterrania	mˌeðiterˈanja
Moncayo	monkˈajɔ
Patrick	patɾˈik
Primer	pɾimˈeɾ
Puede	pwˈɛðe
Puent	pwˈɛntʰ
Puerta	pwˈɛɾta
Puerto	pwˈɛɾto
Quatre	kwˈatɾe
Rafael	rˌafaˈel
Ran	rˈan
Rechión	ret͡ʃjˈon
Recibe	reθˈiβe
Royal	rojˈal
Saint	sˈa͡ɪntʰ
Sellier	seʎjˈɛɾ
Teatro	teˈatɾo
Teherán	tˌeeɾˈan
Tena	tˈena
Universal	ˌuniβeɾsˈal
Viello	bjˈɛʎo
Villas	bˈiʎas
acaban	akˈaβan
academicos	ˌakaðemˈikos
accidents	ˌakθiðˈentʰs
adverbial	ˌadβeɾβjˈal
afecta	afˈekta
africana	ˌafɾikˈana
altro	ˈaltɾo
amanata	ˌamanˈata
amaneixe	ˌamanˈeʃe
ambients	ambjˈɛntʰs
americana	ˌameɾikˈana
aquella	akˈɛʎa
asociacions	ˌasoθjaθjˈɔns
atorga	atˈoɾɣa
auxiliars	ˌa͡ʊksiljˈas
avión	aβjˈon
basada	basˈaða
basicament	bˌasikamˈentʰ
bebidas	beβˈiðas
biera	bjˈɛɾa
buenos	bwˈɛnos
busca	bˈuska
cadieras	kaðjˈɛɾas
campesins	kˌampesˈins
capitals	kˌapitˈals
catalans	kˌatalˈans
caye	kˈajɛ
chenerar	t͡ʃˌeneɾˈaɾ
chens	t͡ʃˈens
chovenil	t͡ʃˌoβenˈil
chudicio	t͡ʃuðˈiθjɔ
chugando	t͡ʃuɣˈando
chunta	t͡ʃˈunta
chóven	t͡ʃˈoβen
ciertas	θjˈɛɾtas
ciudadanía	θjˌuðaðanˈia
clamatos	klamˈatos
clasicos	klasˈikos
clero	klˈeɾo
comarcal	kˌomaɾkˈal
combina	kombˈina
combustible	kˌombustˈiβle
comercios	komˈeɾθjɔs
completivas	kˌompletˈiβas
complexa	komplˈeksa
compromís	kˌompɾomˈis
comunista	kˌomunˈista
conducta	kondˈukta
confluyencia	kˌomflujˈɛnθja
confusión	kˌomfusjˈon
consiguioron	kˌonsiɣjˈɔɾon
continentals	kˌontinentˈals
coordinador	kˌooɾðˌinaðˈoɾ
correr	korˈeɾ
creticas	kɾetˈikas
cruzada	kɾuθˈaða
cráter	kɾˈateɾ
cría	kɾˈia
cubren	kˈuβɾen
cuento	kwˈɛnto
data	dˈata
deben	dˈeβen
decadencia	dˌekaðˈenθja
defensa	defˈensa
definita	dˌefinˈita
demanda	demˈanda
demás	demˈas
dentra	dˈentɾa
depende	depˈende
derivatos	dˌeɾiβˈatos
descubrió	dˌeskuβɾjˈo
deseyo	desˈejɔ
desintegración	dˌesintˌeɣɾaθjˈon
diaspora	djaspˈoɾa
directa	diɾˈekta
disponibles	dˌisponˈiβles
dople	dˈople
dormir	doɾmˈiɾ
duro	dˈuɾo
elaboración	ˌelaβˌoɾaθjˈon
electricos	ˌelektɾˈikos
emigración	ˌemiɣɾaθjˈon
emigroron	ˌemiɣɾˈoɾon
emplegatos	ˌempleɣˈatos
empresa	empɾˈesa
encargau	ˌenkaɾɣˈa͡ʊ
encomenzoron	ˌenkomenθˈoɾon
eno	ˈeno
entalto	entˈalto
entero	entˈeɾo
escandinavo	ˌeskandinˈaβo
esfera	esfˈeɾa
especialidat	ˌespeθjˌaliðˈatʰ
establir	ˌestaβlˈiɾ
etz	ˈeθ
evidencia	ˌeβiðˈenθja
exactament	ˌeksaktamˈentʰ
existents	ˌeksistˈentʰs
extensions	ˌekstensjˈɔns
externos	ekstˈeɾnos
fayena	fajˈɛna
feguras	feɣˈuɾas
ferramientas	fˌeramjˈɛntas
finalment	fˌinalmˈentʰ
formatos	foɾmˈatos
fortaleza	fˌoɾtalˈeθa
fueros	fwˈɛɾos
fundata	fundˈata
godos	ɣˈoðos
gramaticals	ɣɾˌamatikˈals
grano	ɣɾˈano
gravación	ɣɾˌaβaθjˈon
gravedat	ɣɾˌaβeðˈatʰ
griegas	ɣɾjˈɛɣas
habituals	ˌaβitwˈals
hereu	eɾˈe͡ʊ
hibierno	iβjˈɛɾno
ibn	ˈibn
implica	implˈika
imposible	ˌimposˈiβle
incluius	ˌinkluˈius
incoativos	ˌinkoatˈiβos
indicador	ˌindikaðˈoɾ
ingredients	ˌinɡɾeðjˈɛntʰs
ingresos	inɡɾˈesos
inscripcions	ˌinskɾipθjˈɔns
internacionalment	ˌinteɾnˌaθjɔnalmˈentʰ
invariable	ˌimbaɾjˈaβle
invasions	ˌimbasjˈɔns
investigacions	ˌimbestˌiɣaθjˈɔns
lanzamiento	lˌanθamjˈɛnto
lateral	lˌateɾˈal
lechislación	lˌet͡ʃislaθjˈon
limfaticos	lˌimfatˈikos
liquida	likˈiða
luengo	lwˈɛnɡo
lunas	lˈunas
magnetico	mˌaɡnetˈiko
manifestación	mˌanifˌestaθjˈon
mantién	mantjˈen
maritimo	mˌaɾitˈimo
masculins	mˌaskulˈins
medalla	meðˈaʎa
mediterranio	mˌeðiterˈanjɔ
microorganismos	mˌikɾoˌoɾɣanˈismos
microtoponimo	mˌikɾotˌoponˈimo
mineral	mˌineɾˈal
minima	minˈima
molins	molˈins
muebles	mwˈɛβles
murió	muɾjˈo
m²	ˈɛmeðˈos
napas	nˈapas
narracions	nˌaraθjˈɔns
negativas	nˌeɣatˈiβas
nivels	niβˈels
nominal	nˌominˈal
nusaltros	nusˈaltɾos
observar	ˌoβseɾβˈaɾ
oficio	ofˈiθjɔ
operativo	ˌopeɾatˈiβo
ortograficas	ˌoɾtoɣɾafˈikas
pachinas	pat͡ʃˈinas
paralelas	pˌaɾalˈelas
parroquias	parˈokjas
particulars	pˌaɾtikulˈas
pavo	pˈaβo
permitiba	pˌeɾmitˈiβa
permitindo	pˌeɾmitˈindo
pisos	pˈisos
plachas	plˈat͡ʃas
platiellos	platjˈɛʎos
plegata	pleɣˈata
plegato	pleɣˈato
plumas	plˈumas
poderba	poðˈeɾβa
policía	pˌoliθˈia
posan	pˈosan
posesions	pˌosesjˈɔns
posibilidatz	pˌosiβˌiliðˈaθ
precisión	pɾˌeθisjˈon
predomina	pɾˌeðomˈina
predominant	pɾˌeðominˈantʰ
preparación	pɾˌepaɾaθjˈon
preposicions	pɾˌeposiθjˈɔns
propagación	pɾˌopaɣaθjˈon
proporción	pɾˌopoɾθjˈon
proposau	pɾˌoposˈa͡ʊ
proposó	pɾˌoposˈo
punk	pˈunk
quartel	kwaɾtˈel
r	ˈɛre
racial	raθjˈal
radical	rˌaðikˈal
reaccions	rˌeakθjˈɔns
reconoixencia	rˌekonoʃˈenθja
reconoixer	rˌekonoʃˈeɾ
rectangular	rˌektanɡulˈaɾ
regla	rˈeɣla
relato	relˈato
rematanza	rˌematˈanθa
republicas	rˌepuβlˈikas
responsabilidat	rˌesponsˌaβiliðˈatʰ
resultatos	rˌesultˈatos
revueltas	reβwˈɛltas
robots	roβˈotʰs
royos	rˈojɔs
ruinas	ruˈinas
santuario	santwˈaɾjɔ
satelites	sˌatelˈites
secundario	sˌekundˈaɾjɔ
sedimentos	sˌeðimˈentos
semanas	semˈanas
septentrionals	sˌeptentɾjɔnˈals
siente	sjˈɛnte
siglos	sˈiɣlos
significaba	sˌiɡnifikˈaβa
silaba	silˈaβa
sinonimos	sˌinonˈimos
substrato	suβstɾˈato
succesión	sˌukθesjˈon
suizo	suˈiθo
superficial	sˌupeɾfiθjˈal
tallo	tˈaʎo
tasa	tˈasa
tecnico	teknˈiko
teito	tˈe͡ɪto
territorials	tˌeritoɾjˈals
titular	tˌitulˈaɾ
tractamiento	tɾˌaktamjˈɛnto
trastes	tɾˈastes
trescruzar	tɾˌeskɾuθˈaɾ
tripulación	tɾˌipulaθjˈon
tu	tu
turquicos	tuɾkˈikos
ubrió	uβɾjˈo
universidatz	ˌuniβˌeɾsiðˈaθ
usato	usˈato
venir	benˈiɾ
viaches	bjˈat͡ʃes
viellas	bjˈɛʎas
visibles	bisˈiβles
vlacos	blˈakos
Ángel	ˈanxel
Aires	ˈa͡ɪɾes
Alfonso	alfˈonso
Anatolia	ˌanatˈolja
Andreu	andɾˈe͡ʊ
Antes	ˈantes
Atro	ˈatɾo
Berenguer	bˌeɾenɡˈɛɾ
Blanca	blˈanka
Blas	blˈas
Borgonya	boɾɣˈoɲa
Buenos	bwˈɛnos
CD	θˌeðˈe
Calatayú	kˌalatajˈu
Cambra	kˈambɾa
Canadá	kˌanaðˈa
Catolica	kˌatolˈika
Chardín	t͡ʃaɾðˈin
Cheorchia	t͡ʃeˈoɾt͡ʃja
Cine	θˈine
Colechio	kolˈet͡ʃjɔ
Comunista	kˌomunˈista
Congo	kˈonɡo
Coreya	koɾˈeja
Cortes	kˈoɾtes
Costantinoble	kˌostantinˈoβle
Danubio	danˈuβjɔ
Dentre	dˈentɾe
Dentro	dˈentɾo
Diz	dˈiθ
Eduardo	eðwˈaɾðo
Eixemplos	eʃˈemplos
Estadio	estˈaðjɔ
Fat	fˈatʰ
Ferrández	ferˈandeθ
Golfo	ɣˈolfo
Guadalajara	ɡwˌaðalaxˈaɾa
Head	eˈa
Heinrich	e͡ɪnrˈit͡ʃ
IP	ˌipˈe
ISO	ˈiso
ISSN	ˈissn
Iberica	ˌiβeɾˈika
Islas	ˈislas
Joseph	xosˈep
Krajina	kɾaxˈina
League	leˈaɣɛ
Lengua	lˈenɡwa
Letras	lˈetɾas
León	leˈon
Logo	lˈoɣo
Léxico	lˈeksiko
Matarranya	mˌatarˈaɲa
Michael	mˌit͡ʃaˈel
Moscú	moskˈu
Muit	muˈitʰ
Mónegue	mˈoneɣɛ
Navarro	naβˈaro
Nº	ˌɛneˌoɾðinˌalmaskulˈin
Occident	ˌokθiðˈentʰ
P	pˈe
Partiu	paɾtˈiu
Pireneu	pˌiɾenˈe͡ʊ
Platón	platˈon
Porto	pˈoɾto
Poseye	posˈejɛ
Pueblos	pwˈɛβlos
Quaid	kwˈa͡ɪ
Rechional	rˌet͡ʃjɔnˈal
Reina	rˈe͡ɪna
Ribas	rˈiβas
Royo	rˈojɔ
Santiago	santjˈaɣo
Semontano	sˌemontˈano
Sociedad	sˌoθjɛðˈa
Solament	sˌolamˈentʰ
Steven	estˈeβen
Sánchez	sˈant͡ʃeθ
Thomas	tˈomas
Toledo	tolˈeðo
URSS	ˌuˌɛreˌɛseˈɛse
Victoria	biktˈoɾja
Zona	θˈona
abellas	aβˈeʎas
aconsigue	ˌakonsˈiɣɛ
actas	ˈaktas
activa	aktˈiβa
adreza	aðɾˈeθa
aduyó	ˌaðujˈo
adverbials	ˌadβeɾβjˈals
adverbio	adβˈeɾβjɔ
alans	alˈans
aletas	alˈetas
alumnos	alˈumnos
amanatas	ˌamanˈatas
amariella	ˌamaɾjˈɛʎa
ambitos	ambˈitos
americán	ˌameɾikˈan
aniello	anjˈɛʎo
anunció	ˌanunθjˈo
aparent	ˌapaɾˈentʰ
aplicación	ˌaplikaθjˈon
artificials	ˌaɾtifiθjˈals
asambleya	ˌasamblˈeja
asambleyas	ˌasamblˈejas
asegurar	ˌaseɣuɾˈaɾ
ataques	atˈakɛs
au	ˈa͡ʊ
autonomas	ˌa͡ʊtonˈomas
azuls	aθˈuls
baixan	bˈaʃan
baixos	bˈaʃos
banco	bˈanko
bandas	bˈandas
barcos	bˈaɾkos
basicos	basˈikos
beluna	belˈuna
breu	βɾˈe͡ʊ
café	kafˈe
caleba	kalˈeβa
cantons	kantˈons
caras	kˈaɾas
carbonio	kaɾβˈonjɔ
carreteras	kˌaretˈeɾas
castellanas	kˌasteʎˈanas
castellanismo	kˌasteʎanˈismo
castiellos	kastjˈɛʎos
cauz	kˈa͡ʊθ
celebración	θˌeleβɾaθjˈon
celebre	θelˈeβɾe
centra	θˈentɾa
ceramica	θˌeɾamˈika
chenitivo	t͡ʃˌenitˈiβo
cheolochía	t͡ʃˌeolot͡ʃˈia
chinesa	t͡ʃinˈesa
choventut	t͡ʃˌoβentˈutʰ
chuez	t͡ʃwˈɛθ
chugar	t͡ʃuɣˈaɾ
chunyo	t͡ʃˈuɲɔ
chóvens	t͡ʃˈoβens
cinquena	θinkˈɛna
citar	θitˈaɾ
clasificacions	klˌasifˌikaθjˈɔns
climatico	klˌimatˈiko
coalición	kˌoaliθjˈon
codete	koðˈete
colaboró	kˌolaβoɾˈo
coloca	kolˈoka
colonial	kˌolonjˈal
coloquial	kˌolokjˈal
coma	kˈoma
comentarios	kˌomentˈaɾjɔs
comparten	kompˈaɾten
composata	kˌomposˈata
comunistas	kˌomunˈistas
concentra	konθˈentɾa
confundir	kˌomfundˈiɾ
conservar	kˌonseɾβˈaɾ
conservau	kˌonseɾβˈa͡ʊ
construyida	kˌonstɾujˈiða
construyir	kˌonstɾujˈiɾ
convento	kombˈento
cooperación	kˌoopˌeɾaθjˈon
coordinación	kˌooɾðˌinaθjˈon
cordelera	kˌoɾðelˈeɾa
coro	kˈoɾo
corredor	kˌoreðˈoɾ
creyador	kɾˌejaðˈoɾ
creyato	kɾejˈato
creyau	kɾejˈa͡ʊ
cristianas	kɾistjˈanas
criterio	kɾitˈeɾjɔ
criticos	kɾitˈikos
cubrir	kuβɾˈiɾ
cuencas	kwˈɛnkas
cul	kˈul
decide	deθˈiðe
declinación	dˌeklinaθjˈon
definicions	dˌefiniθjˈɔns
dels	dˈels
dentradas	dentɾˈaðas
derivadas	dˌeɾiβˈaðas
desapareixioron	dˌesapˌaɾeʃjˈɔɾon
desapareixiu	dˌesapˌaɾeʃˈiu
desaugua	desˈa͡ʊɣwa
descubrimiento	dˌeskuβɾimjˈɛnto
descubrimientos	dˌeskuβɾimjˈɛntos
desembocadura	dˌesembˌokaðˈuɾa
deseparato	dˌesepaɾˈato
deseparau	dˌesepaɾˈa͡ʊ
desinencia	dˌesinˈenθja
despoblados	dˌespoβlˈaðos
destacable	dˌestakˈaβle
destacato	dˌestakˈato
detectar	dˌetektˈaɾ
determina	dˌeteɾmˈina
determinan	dˌeteɾmˈinan
diferenciar	dˌifeɾenθjˈaɾ
diftongación	dˌiftonɡaθjˈon
dimensión	dˌimensjˈon
dirichent	dˌiɾit͡ʃˈentʰ
dirichito	dˌiɾit͡ʃˈito
disenyato	dˌiseɲˈato
disolución	dˌisoluθjˈon
disposición	dˌisposiθjˈon
dividió	dˌiβiðjˈo
dunas	dˈunas
emitir	ˌemitˈiɾ
enchaquia	ent͡ʃˈakja
encluyen	enklˈujɛn
enemigo	ˌenemˈiɣo
entender	ˌentendˈeɾ
entroron	entɾˈoɾon
equilibrio	ˌekilˈiβɾjɔ
escatas	eskˈatas
esferencias	ˌesfeɾˈenθjas
esfuerzos	esfwˈɛɾθos
española	ˌespaɲˈola
especificas	ˌespeθifˈikas
espelungas	ˌespelˈunɡas
estatals	ˌestatˈals
estatua	estˈatwa
estausunidenses	ˌesta͡ʊsˌuniðˈenses
estilos	estˈilos
estructural	ˌestɾuktuɾˈal
estudiar	ˌestuðjˈaɾ
etapas	etˈapas
etnicas	etnˈikas
evolucions	ˌeβoluθjˈɔns
ex	ˈeks
excepcions	ˌeksθepθjˈɔns
existir	ˌeksistˈiɾ
exteriors	ˌeksteɾjˈɔs
fabricas	faβɾˈikas
faigan	fˈa͡ɪɣan
famosos	famˈosos
feminín	fˌeminˈin
ferramienta	fˌeramjˈɛnta
fina	fˈina
financiero	fˌinanθjˈɛɾo
fluido	fluˈiðo
foco	fˈoko
fondón	fondˈon
fonetico	fˌonetˈiko
formalment	fˌoɾmalmˈentʰ
formoron	foɾmˈoɾon
francos	fɾˈankos
français	fɾanθˈa͡ɪs
fuesa	fwˈɛsa
ganando	ɣanˈando
garchola	ɣaɾt͡ʃˈola
grafico	ɣɾafˈiko
herencio	eɾˈenθjɔ
hesen	ˈesen
hi	ˈi
homonima	ˌomonˈima
identificar	ˌiðentˌifikˈaɾ
ideyal	ˌiðejˈal
incendio	inθˈendjɔ
influyó	ˌimflujˈo
inicialment	ˌiniθjalmˈentʰ
intentos	intˈentos
irregularidatz	ˌireɣˌulaɾiðˈaθ
islam	islˈam
ixes	ˈiʃes
laboral	lˌaβoɾˈal
lexica	leksˈika
librement	lˌiβɾemˈentʰ
licherament	lˌit͡ʃeɾamˈentʰ
liders	liðˈes
lingüista	linɡwˈista
lituans	litwˈans
lochica	lot͡ʃˈika
luengaches	lwɛnɡˈat͡ʃes
malas	mˈalas
malotías	mˌalotˈias
mampostería	mˌamposteɾˈia
maniera	manjˈɛɾa
manto	mˈanto
marchar	maɾt͡ʃˈaɾ
marguins	maɾɣˈins
masculinas	mˌaskulˈinas
mencions	menθjˈɔns
meten	mˈeten
meyatos	mejˈatos
minutos	minˈutos
mirandés	mˌiɾandˈes
mixtas	mˈiʃtas
molín	molˈin
monarca	monˈaɾka
monches	mˈont͡ʃes
mongols	monɡˈols
motors	motˈos
multiples	multˈiples
nacionalista	nˌaθjɔnalˈista
nacionalistas	nˌaθjɔnalˈistas
naixencia	naʃˈenθja
naiximiento	nˌaʃimjˈɛnto
naixita	naʃˈita
nasal	nasˈal
necesario	nˌeθesˈaɾjɔ
negros	nˈeɣɾos
noción	noθjˈon
nombra	nˈombɾa
normals	noɾmˈals
numeración	nˌumeɾaθjˈon
occitans	ˌokθitˈans
ocuporon	ˌokupˈoɾon
ofensiva	ˌofensˈiβa
ofreix	ofɾˈeʃ
olimpico	ˌolimpˈiko
onda	ˈonda
onsos	ˈonsos
opción	opθjˈon
ordenó	ˌoɾðenˈo
padre	pˈaðɾe
papa	pˈapa
pareixen	paɾˈeʃen
parellana	pˌaɾeʎˈana
parlamento	pˌaɾlamˈento
parques	pˈaɾkɛs
pelache	pelˈat͡ʃe
pelos	pˈelos
pena	pˈena
percusión	pˌeɾkusjˈon
persa	pˈeɾsa
perspectiva	pˌeɾspektˈiβa
pierde	pjˈɛɾðe
platero	platˈeɾo
plurals	pluɾˈals
poblata	poβlˈata
polaca	polˈaka
portugueses	pˌoɾtuɣˈɛses
posa	pˈosa
posar	posˈaɾ
prebar	pɾeβˈaɾ
premite	pɾemˈite
presentación	pɾˌesentaθjˈon
prestichio	pɾestˈit͡ʃjɔ
profundidat	pɾˌofundiðˈatʰ
propietarios	pɾˌopjɛtˈaɾjɔs
proporciona	pɾˌopoɾθjˈɔna
proposa	pɾopˈosa
provenzal	pɾˌoβenθˈal
provincial	pɾˌoβinθjˈal
puertos	pwˈɛɾtos
qualidatz	kwˌaliðˈaθ
quitar	kitˈaɾ
qüestions	kwestjˈɔns
rapedo	rapˈeðo
raro	rˈaɾo
rayo	rˈajɔ
rechionals	rˌet͡ʃjɔnˈals
reconoixiu	rˌekonoʃˈiu
recupera	rˌekupˈeɾa
redota	reðˈota
regano	reɣˈano
relacionada	rˌelaθjɔnˈaða
releu	relˈe͡ʊ
relichiosa	rˌelit͡ʃjˈɔsa
rematando	rˌematˈando
reparto	repˈaɾto
representando	rˌepɾesentˈando
resolución	rˌesoluθjˈon
responsables	rˌesponsˈaβles
reyals	rejˈals
ribagorzano	rˌiβaɣoɾθˈano
riego	rjˈɛɣo
rocoso	rokˈoso
rodiato	roðjˈato
romanicas	rˌomanˈikas
ruedas	ruˈɛðas
rusio	rˈusjɔ
saxón	saksˈon
sentimiento	sˌentimjˈɛnto
signo	sˈiɡno
simbolica	sˌimbolˈika
sistematica	sˌistematˈika
soldaus	solðˈa͡ʊs
sozmesos	soθmˈesos
subespecies	sˌuβespˈeθjɛs
subordinadas	sˌuβoɾðinˈaðas
superar	sˌupeɾˈaɾ
tallar	taʎˈaɾ
tamien	tˈamjɛn
tardana	taɾðˈana
tasament	tˌasamˈentʰ
teatral	tˌeatɾˈal
tendencias	tendˈenθjas
tipicament	tˌipikamˈentʰ
tractar	tɾaktˈaɾ
transistors	tɾˌansistˈos
tribals	tɾiβˈals
trozos	tɾˈoθos
ubicación	ˌuβikaθjˈon
ubiertos	uβjˈɛɾtos
usando	usˈando
veranos	beɾˈanos
via	bjˈa
vienen	bjˈɛnen
villas	bˈiʎas
vital	bitˈal
yoga	jˈɔɣa
zucre	θˈukɾe
Ánchel	ˈant͡ʃel
álbums	ˈalβums
