က	ka̰
ကကုသန်	ka̰kṵθàɴ
ကကုသန်ဘုရား	ka̰kṵθàɴpʰəjá
ကက်စီနို	kɛʔsìnò
ကက်ပတိန်	kɛʔpətèɪɴ
ကက်သလစ်	kɛʔθəlɪʔ
ကကြီး	ka̰d͡ʑí
ကချင်	kət͡ɕʰɪ̀ɴ
ကချေသည်	ka̰d͡ʑèðè
ကင်ဆာရောဂါ	kɪ̀ɴsʰàjɔ́ɡà
ကင်ညာ	kɪ̀ɴɲà
ကင်ပွန်း	kɪ̀ɴbʊ́ɴ
ကင်မရာ	kɪ̀ɴməɹà
ကင်မရွန်း	kɪ̀ɴma̰ɹʊ́ɴ
ကင်း	kɪ́ɴ
ကင်းခြေများ	kɪ́ɴt͡ɕìmjá
ကင်းပုံ	kɪ́ɴbòʊɴ
ကင်းမြီးကောက်	kɪ́ɴmjíɡaʊʔ
ကင်းမွန်	kɪ́ɴmʊ̀ɴ
ကစား	ɡəzá
ကစားကွင်း	ɡəzáɡwɪ́ɴ
ကစားစရာ	ɡəzázəjà
ကစားသမား	ɡəsáðəmá
ကဆုန်	kəsʰòʊɴ
ကဆုန်လပြည့်နေ့	kəsʰòʊɴla̰pjḭnḛ
ကညာ	kəɲà
ကညွတ်ရိုး	kəɲʊʔjó
ကဏန်း	ɡənáɴ
ကဏ္ဍ	kànda̰
ကတည်းက	ɡədɛ́ɡa̰
ကတိ	ɡədḭ
ကတော့	ɡədɔ̰
ကတော်	ɡədɔ̀
ကတ္တား	kaʔtá
ကတ္တီပါ	ɡədìbà
ကတ်	kaʔ
ကတ်ကြေး	kaʔt͡ɕí
ကတ်ကြေးကိုက်	kaʔt͡ɕíkaɪʔ
ကတ်ပြား	kaʔpjá
ကတ်သလိတ်	kaʔθəleɪʔ
ကတွတ်ယို	kədʊʔjò
ကထိန်	kətʰèɪɴ
ကဒ်	kàd
ကနခို	kənəkʰò
ကနစိုး	kənəzó
ကနား	kəná
ကနုကမာ	kənṵkəmà
ကနုတ်	kənoʊʔ
ကနေဒါ	ka̰nèdà
ကန့်	ka̰ɴ
ကန့်လန့်ကာ	kələɡà
ကန္တာရ	kàɴtàja̰
ကန်	kàɴ
ကန်စွန်း	ɡəzʊ́ɴ
ကန်စွန်းဥ	ɡəzʊ́ɴʔṵ
ကန်တော့	ɡədɔ̰
ကန်ထရိုက်	kàɴtʰəɹaɪʔ
ကပ္ပလီ	kaʔpəlì
ကပ္ပလီပင်လယ်	kaʔpəlìpɪ̀ɴlɛ̀
ကပ်	kaʔ
ကပ်ကြီးသုံးပါး	kaʔd͡ʑíθóʊɴbá
ကပ်နာ	kaʔnà
ကပ်ပယ်	kaʔpɛ̀
ကပ်ပါး	kaʔpá
ကပ်ရောဂါ	kaʔjɔ́ɡà
ကပွဲရုံ	ka̰bwɛ́jòʊɴ
ကဖီး	kəpʰí
ကဗျာ	ɡəbjà
ကဘီလူး	ka̰bəlú
ကမန်	ka̰màɴ
ကမာ	kəmà
ကမာရွတ်	kəmàjʊʔ
ကမ္ဗလာ	ɡəbəlà
ကမ္ဗောဇ	kàɴbɔ́za̰
ကမ္ဘာ	ɡəbà
ကမ္ဘာဂြိုဟ်	ɡəbàd͡ʑò
ကမ္ဘာလုံးခြမ်း	ɡəbàlóʊɴd͡ʑàɴ
ကမ္ဘောဒီးယား	kàɴbɔ́díjá
ကမ်စော်	kàɴzɔ̀
ကမ်း	káɴ
ကမ်းခြေ	káɴd͡ʑè
ကယား	kəjá
ကယ်တင်ရှင်	kɛ̀tɪ̀ɴʃɪ̀ɴ
ကယ်လဆီယမ်	kɛ̀ləsʰìjàɴ
ကရင်	kəjɪ̀ɴ
ကရစ်ကက်	kəɹɪʔkɛʔ
ကရဝိက်	kəɹa̰weɪʔ
ကရိန်း	kəɹéɪɴ
ကလပ်	kəlaʔ
ကလမောင်း	kələmáʊɴ
ကလာပ်စည်း	kəlaʔsí
ကလိုရင်း	kəlòɹɪ́ɴ
ကလီစာ	kəlìzà
ကလောင်	kəlàʊɴ
ကလေး	kʰəlé
ကလျာ	kələjà
ကလျာဏမိတ္တ	kələjàna̰meɪʔta̰
ကလျာဏီ	kələjànì
ကဝိ	kəwḭ
ကဝေ	kəwè
ကသည်း	kəθí
ကာ	kà
ကာကွယ်	kàɡwɛ̀
ကာကွယ်ဆေး	kàɡwɛ̀zé
ကာကွယ်ရေး	kàɡwɛ̀jé
ကာဂစ်စတန်	kəɡɪʔsətàɴ
ကာဂျစ္စတန်	kəd͡ʑɪʔsətàɴ
ကာဇက်စတန်	kàzɛʔsətàɴ
ကာတာ	kàtà
ကာတွန်း	kàtʊ́ɴ
ကာဗွန်	kàbʊ̀ɴ
ကာမ	kàma̰
ကာယ	kəja̰
ကာယကံ	kàjəɡàɴ
ကာယပညာ	kàja̰pa̰ɲà
ကာရန်	kəjàɴ
ကာလ	kàla̰
ကာလဝမ်း	kàləwʊ́ɴ
ကာလသား	kàləðá
ကာလသားရောဂါ	kàla̰θájɔ́ɡà
ကာလာမသုတ်	kàlàma̰θoʊʔ
ကာလီဖိုးနီးယား	kàlìpʰóníjá
ကား	ká
ကားဂိတ်	káɡeɪʔ
ကားမှတ်တိုင်	kám̥aʔtàɪɴ
ကားရုံ	kájòʊɴ
ကိစ္စ	keɪʔsa̰
ကိတ်	keɪʔ
ကိတ်ဗာဒီ	keɪʔbədì
ကိတ်မုန့်	keɪʔmo̰ʊɴ
ကိန္နရာ	kèɪɴnəjà
ကိန္နရီ	kèɪɴnəjì
ကိန်း	kéɪɴ
ကိမိလဗေဒ	kḭmḭla̰bèda̰
ကိရိယာ	kəɹḭjà
ကိလေသာ	kḭlèθà
ကို	kò
ကို	ɡò
ကို	ɴ
ကို	ʔ
ကိုကာကိုလာ	kòkàkòlà
ကိုက်	kaɪʔ
ကိုက်လန်	kaɪʔlàɴ
ကိုင်	kàɪɴ
ကိုဆိုဗို	kòsʰòbò
ကိုဘော့	kòbɔ̰
ကိုမိုရို	kòmòɹò
ကိုယ့်ဥမှဥထင်	ko̰jʔṵm̥a̰ʔṵtʰɪ̀ɴ
ကိုယ်	kò
ကိုယ်စားလှယ်	kòjzəl̥ɛ̀
ကိုယ်လုပ်တော်	kòloʊʔtɔ̀
ကိုယ်ဝန်	kòjwʊ̀ɴ
ကိုယ်ဝန်ဆောင်	kòjwʊ̀ɴsʰàʊɴ
ကိုယ်ဝန်ရှိ	kòjwʊ̀ɴʃḭ
ကိုရမ်ကျမ်း	kòɹàɴt͡ɕáɴ
ကိုရီးယား	kòɹíjá
ကိုလိုနီ	kòlònì
ကိုလံဘီယာ	kòlàɴbìjà
ကိုး	kó
ကိုးကန့်	kóɡa̰ɴ
ကိုးလ	kóla̰
ကီလိုဂရမ်	kìlòɡəɹàɴ
ကီးမား	kímá
ကီးယက်	kíjɛʔ
ကုဋေ	ɡədè
ကုတ်	koʊʔ
ကုတ်ဟီးနာ	koʊʔhínà
ကုန်	kòʊɴ
ကုန်ကား	kòʊɴɡá
ကုန်ကုန်	kòʊɴɡòʊɴ
ကုန်စည်	kòʊɴzì
ကုန်တင်ကား	kòʊɴdɪ̀ɴɡá
ကုန်သည်	kòʊɴðè
ကုန်း	kóʊɴ
ကုန်းနှီး	kóʊɴn̥í
ကုဗ	kṵba̰
ကုမ္ပဏီ	kòʊɴpənì
ကုလသမဂ္ဂ	kṵla̰θa̰mɛʔɡa̰
ကုလား	kəlá
ကုလားထိုင်	kələtʰàɪɴ
ကုလားနို့	kələno̰
ကုလားပဲ	kələpɛ́
ကုလားဖြူ	kələpʰjù
ကုလားအုတ်	kələʔoʊʔ
ကုသိုလ်	kṵθò
ကုသိုလ်ကံ	kṵðòɡàɴ
ကုသိုလ်ရှင်	kṵθòʃɪ̀ɴ
ကုံကုမံ	ɡòʊɴɡəmàɴ
ကူ	kù
ကူညီ	kùɲì
ကူဖီ	kùpʰì
ကူလီ	kùlì
ကူဝိတ်	kùweɪʔ
ကူး	kú
ကူးစက်ရောဂါ	kúzɛʔjɔ́ɡà
ကူးတို့	ɡədo̰
ကူးတို့ဆိပ်	ɡədo̰zeɪʔ
ကူးပြောင်း	kúpjáʊɴ
ကေ	kè
ကေတုမဒီ	kètṵmədì
ကေသ	kèθa̰
ကေသာ	kèθà
ကော	kɔ́
ကော	ɡɔ́
ကောက်	kaʊʔ
ကောက်ညှင်း	kaʊʔɲ̊ɪ́ɴ
ကောက်ညှင်းပေါင်း	kaʊʔɲ̊ɪ́ɴbáʊɴ
ကောက်ရိုး	kaʊʔjó
ကောင်	kàʊɴ
ကောင်ငယ်	kàʊɴŋɛ̀
ကောင်စစ်ဝန်	kàʊɴsɪʔwʊ̀ɴ
ကောင်စစ်ဝန်ရုံး	kàʊɴsɪʔwʊ̀ɴjóʊɴ
ကောင်စီ	kàʊɴsì
ကောင်တာ	kàʊɴtà
ကောင်မငယ်	kàʊɴma̰ŋɛ̀
ကောင်မလေး	kàʊɴma̰lé
ကောင်း	káʊɴ
ကောင်းကင်	káʊɴɡɪ̀ɴ
ကောင်းကင်ကြိုး	káʊɴɡɪ̀ɴd͡ʑó
ကောင်းကင်တမန်	káʊɴɡɪ̀ɴtəmàɴ
ကောင်းကင်ဘုံ	káʊɴɡɪ̀ɴbòʊɴ
ကောင်းကောင်း	káʊɴɡáʊɴ
ကောဏဂုံ	kɔ́nəɡòʊɴ
ကောဏဂုံဘုရား	kɔ́nəɡòʊɴpʰəjá
ကောဏ္ဍည	kɔ̀ndəɲa̰
ကောဏ္ဍညဘုရား	kɔ̀ndəɲa̰pʰəjá
ကောလာဟလ	kɔ́làha̰la̰
ကောလိပ်	kɔ́leɪʔ
ကောလိသိန်	kɔ́lḭθèɪɴ
ကော့စတာရီကာ	kɔ̰sətàɹìkà
ကော်	kɔ̀
ကော်ဇော	kɔ̀zɔ́
ကော်တွန်	kɔ̀tʊ̀ɴ
ကော်ပီ	kɔ̀pì
ကော်ပီစာအုပ်	kɔ̀pìsàʔoʊʔ
ကော်ပြန့်	kɔ̀pja̰ɴ
ကော်ပြန့်ကြော်	kɔ̀pja̰ɴd͡ʑɔ̀
ကော်ပြန့်စိမ်း	kɔ̀pja̰ɴzéɪɴ
ကော်ဖီ	kɔ̀pʰì
ကော်မတီ	kɔ̀mətì
ကော်ရည်ခေါက်ဆွဲ	kɔ̀jìkʰaʊʔsʰwɛ́
ကော်လာ	kɔ̀là
ကဲ့	kɛ̰
ကံ	kàɴ
ကံကြမ္မာ	kàɴt͡ɕəmà
ကံသုံးပါး	kàɴθóʊɴbá
ကံ့ကူတံ	ka̰ɴɡùdàɴ
ကံ့ကော်	ɡa̰ɴɡɔ̀
ကျ	t͡ɕa̰
ကျက်သရေ	t͡ɕɛʔθəjè
ကျင်ကြီး	t͡ɕɪ̀ɴd͡ʑí
ကျင်ချောင်း	t͡ɕɪ̀ɴt͡ɕʰáʊɴ
ကျင်စွယ်	t͡ɕɪ̀ɴzwɛ̀
ကျဉ်း	t͡ɕɪ́ɴ
ကျဉ်းကျပ်	t͡ɕɪ́ɴt͡ɕaʔ
ကျည်	t͡ɕì
ကျည်ကပ်	t͡ɕìɡaʔ
ကျည်ဖူး	t͡ɕìbú
ကျနော်	t͡ɕənɔ̀
ကျန်	t͡ɕàɴ
ကျန်း	t͡ɕáɴ
ကျန်းမာရေး	t͡ɕáɴmàjé
ကျပ်	t͡ɕaʔ
ကျပ်သား	t͡ɕaʔθá
ကျမ	t͡ɕəma̰
ကျယ်	t͡ɕɛ̀
ကျယ်ဝန်း	t͡ɕɛ̀wʊ́ɴ
ကျား	t͡ɕá
ကျားကျားလျားလျား	t͡ɕád͡ʑájájá
ကျားမ	t͡ɕáma̰
ကျားမျက်လုံး	t͡ɕámjɛʔlóʊɴ
ကျားလက်သည်း	t͡ɕálɛʔθɛ́
ကျားလျှာ	t͡ɕáʃà
ကျားသစ်	t͡ɕəθɪʔ
ကျိန္တလီ	t͡ɕèɪɴta̰lì
ကျိန်း	t͡ɕéɪɴ
ကျို	t͡ɕò
ကျိုက္ခမီ	t͡ɕaɪʔkʰəmì
ကျိုက်ထို	t͡ɕaɪʔtʰò
ကျိုက်ထီးရိုး	t͡ɕaɪʔtʰíjó
ကျိုက်မရော	t͡ɕaɪʔməɹɔ́
ကျိုင်းတုံ	t͡ɕáɪɴtòʊɴ
ကျီး	t͡ɕí
ကျီးအ	t͡ɕíʔa̰
ကျုပ်	t͡ɕoʊʔ
ကျုပ်တို့	t͡ɕoʊʔto̰
ကျူးဘား	t͡ɕúbá
ကျော	t͡ɕɔ́
ကျောက်	t͡ɕaʊʔ
ကျောက်ကပ်	t͡ɕaʊʔkaʔ
ကျောက်ကြီး	t͡ɕaʊʔt͡ɕí
ကျောက်ဂွမ်း	t͡ɕaʊʔɡʊ́ɴ
ကျောက်စိမ်း	t͡ɕaʊʔséɪɴ
ကျောက်နီ	t͡ɕaʊʔnì
ကျောက်ပွင့်သုပ်	t͡ɕaʊʔpwɪ̰ɴθoʊʔ
ကျောက်ဖရုံ	t͡ɕaʊʔpʰəjòʊɴ
ကျောက်ဖြူ	t͡ɕaʊʔpʰjù
ကျောက်မီး	t͡ɕaʊʔmí
ကျောက်မီးသွေး	t͡ɕaʊʔmíðwé
ကျောက်သင်ပုန်း	t͡ɕaʊʔθɪ̀ɴbóʊɴ
ကျောင်း	t͡ɕáʊɴ
ကျောင်းနေဖက်	t͡ɕáʊɴnèbɛʔ
ကျောင်းသား	t͡ɕáʊɴðá
ကျောင်းသုံးစာအုပ်	t͡ɕáʊɴðóʊɴsàʔoʊʔ
ကျောင်းသူ	t͡ɕáʊɴðù
ကျောပိုးအိတ်	t͡ɕɔ́bóʔeɪʔ
ကျောရိုး	t͡ɕɔ́jó
ကျေးဇူး	t͡ɕézú
ကျေးဇူးတင်	t͡ɕézútɪ̀ɴ
ကျေးဇူးတင်ပါတယ်	t͡ɕézútɪ̀ɴbàdɛ̀
ကျေးဇူးပြု၍	t͡ɕézúpjṵjwḛ
ကျေးဇူးရှင်	t͡ɕézúʃɪ̀ɴ
ကျဲ	t͡ɕɛ́
ကျွန်	t͡ɕʊ̀ɴ
ကျွန်တော့်	t͡ɕʊ̀ɴdɔ̰
ကျွန်တော်	t͡ɕʊ̀ɴdɔ̀
ကျွန်တော်တို့	t͡ɕʊ̀ɴdɔ̀do̰
ကျွန်မ	t͡ɕʊ̀ɴma̰
ကျွန်မတို့	t͡ɕʊ̀ɴma̰do̰
ကျွန်း	t͡ɕʊ́ɴ
ကျွန်းကလေး	t͡ɕʊ́ɴɡəlé
ကျွန်းကိုင်းမှီကိုင်းကျွန်းမှီ	t͡ɕʊ́ɴkáɪɴm̥ìkáɪɴt͡ɕʊ́ɴm̥ì
ကျွန်းဆွယ်	t͡ɕʊ́ɴzwɛ̀
ကျွဲ	t͡ɕwɛ́
ကျွဲကော	t͡ɕwɛ́ɡɔ́
ကျွဲပြည့်စင်	t͡ɕwɛ́pjḭzɪ̀ɴ
ကြက်	t͡ɕɛʔ
ကြက်ခြေ	t͡ɕɛʔt͡ɕʰè
ကြက်ခြေနီ	t͡ɕɛʔt͡ɕʰènì
ကြက်ခြေနီအသင်း	t͡ɕɛʔt͡ɕʰènìʔəθɪ́ɴ
ကြက်ဆင်	t͡ɕɛʔsʰɪ̀ɴ
ကြက်ဆီထမင်း	t͡ɕɛʔsʰìtʰəmɪ́ɴ
ကြက်ဆူ	t͡ɕɛʔsʰù
ကြက်တူရွေး	t͡ɕɛʔtùjwé
ကြက်ဖ	t͡ɕɛʔpʰa̰
ကြက်မ	t͡ɕɛʔma̰
ကြက်မောက်	t͡ɕɛʔmaʊʔ
ကြက်မောက်သီး	t͡ɕɛʔmaʊʔθí
ကြက်သား	t͡ɕɛʔθá
ကြက်သီးထ	t͡ɕɛʔθéɪɴtʰa̰
ကြက်သီးမွေးညင်းထ	t͡ɕɛʔθéɪɴmwéɲɪ́ɴtʰa̰
ကြက်သွန်	t͡ɕɛʔθʊ̀ɴ
ကြက်သွန်နီ	t͡ɕɛʔθʊ̀ɴnì
ကြက်သွန်ဖြူ	t͡ɕɛʔθʊ̀ɴbjù
ကြက်သွန်မြိတ်	t͡ɕɛʔθʊ̀ɴmjeɪʔ
ကြက်ဟင်းခါးသီး	t͡ɕɛʔhɪ́ɴɡáðí
ကြက်အူချောင်း	t͡ɕɛʔʔùd͡ʑáʊɴ
ကြခတ်ဝါး	t͡ɕəkʰaʔwá
ကြငှန်း	t͡ɕəŋ̊áɴ
ကြဉ်	t͡ɕɪ̀ɴ
ကြည့်	t͡ɕḭ
ကြည့်မြင်တိုင်	t͡ɕḭmjɪ̀ɴdàɪɴ
ကြည်	t͡ɕì
ကြည်	t͡ɕɪ̀ɴ
ကြည်းတပ်	t͡ɕídaʔ
ကြမ္မာ	t͡ɕəmà
ကြမ်း	t͡ɕáɴ
ကြယ်	t͡ɕɛ̀
ကြယ်စု	t͡ɕɛ̀zṵ
ကြယ်တံခွန်	t͡ɕɛ̀dəɡʊ̀ɴ
ကြယ်သီး	t͡ɕɛ̀θí
ကြာ	t͡ɕà
ကြာကြာ	t͡ɕàd͡ʑà
ကြာချည်	t͡ɕàt͡ɕʰì
ကြာဆံ	t͡ɕàzàɴ
ကြာဆံသုပ်	t͡ɕàzàɴθoʊʔ
ကြာညို့	t͡ɕàɲo̰
ကြာသပတေး	t͡ɕàθa̰pa̰dé
ကြား	t͡ɕá
ကြိမ်	t͡ɕèɪɴ
ကြိယာ	kəɹḭjà
ကြိယာဝိသေသန	kəɹḭjàwḭθèθəna̰
ကြိုက်	t͡ɕaɪʔ
ကြိုဆိုပါ၏	t͡ɕòzòbàʔɛ̰
ကြို့	t͡ɕo̰
ကြိုး	t͡ɕó
ကြိုးကြာ	d͡ʑód͡ʑà
ကြိုးစင်	t͡ɕózɪ̀ɴ
ကြိုးစား	t͡ɕózá
ကြီး	t͡ɕí
ကြီးကြီး	t͡ɕíd͡ʑí
ကြီးမား	t͡ɕímá
ကြောက်	t͡ɕaʊʔ
ကြောင့်	d͡ʑa̰ʊɴ
ကြောင်	t͡ɕàʊɴ
ကြောင်ကလေး	t͡ɕàʊɴɡəlé
ကြောင်ထီး	t͡ɕàʊɴdí
ကြောင်မ	t͡ɕàʊɴma̰
ကြောင်လိမ်လှေကား	t͡ɕàʊɴlèɪɴl̥èɡá
ကြောင်အိမ်	t͡ɕàʊɴʔèɪɴ
ကြော်	t͡ɕɔ̀
ကြော်ငြာ	t͡ɕɔ̀ɲà
ကြော်ငြာစာ	t͡ɕɔ̀ɲàzà
ကြေး	t͡ɕé
ကြေးကြီး	t͡ɕét͡ɕí
ကြေးငွေ	t͡ɕéŋwè
ကြေးစည်	t͡ɕézì
ကြေးနန်း	t͡ɕénáɴ
ကြေးနီ	t͡ɕénì
ကြေးမုံ	t͡ɕémòʊɴ
ကြေးဝါ	t͡ɕéwà
ကြေးအိုး	t͡ɕéʔó
ကြံ	t͡ɕàɴ
ကြံ့	t͡ɕa̰ɴ
ကြံ့လျော်	t͡ɕa̰ɴʃɔ̀
ကြွ	t͡ɕwa̰
ကြွက်	t͡ɕwɛʔ
ကြွက်နို့	t͡ɕwɛʔno̰
ကြွက်သား	t͡ɕwɛʔθá
ကြွင်း	t͡ɕwɪ́ɴ
ကြွပ်	t͡ɕʊʔ
ကြွယ်	t͡ɕwɛ̀
ကြွေ	t͡ɕwè
ကြွေး	t͡ɕwé
ကွင်း	kwɪ́ɴ
ကွင်းထိုးဖိနပ်	ɡwɪ́ɴdópʰənaʔ
ကွတ်	kʊʔ
ကွန်	kʊ̀ɴ
ကွန်ကရစ်	kʊ̀ɴɡəɹɪʔ
ကွန်ဂို	kʊ̀ɴɡò
ကွန်ဒုံး	kʊ̀ɴdóʊɴ
ကွန်ပါ	kʊ̀ɴpà
ကွန်ပျူတာ	kʊ̀ɴpjùtà
ကွန်ဖရင့်	kʊ̀ɴpʰəɹɪ̰ɴ
ကွန်ဖြူးရှပ်	kʊ̀ɴpʰjúʃaʔ
ကွန်ရက်	kʊ̀ɴjɛʔ
ကွမ်ရင်	kwàɴjɪ̀ɴ
ကွမ်ရင်မယ်တော်	kwàɴjɪ̀ɴmɛ̀dɔ̀
ကွမ်းတောင်	kʊ́ɴdàʊɴ
ကွမ်းမွှေး	kʊ́ɴm̥wé
ကွမ်းယာ	kʊ́ɴjà
ကွမ်းရွက်ပင်	kʊ́ɴjwɛʔpɪ̀ɴ
ကွယ်လွန်	kwɛ̀lʊ̀ɴ
ကွာစေ့	kwàsḭ
ကွာလာလမ်ပူ	kwàlàlàɴpù
ကွီး	kwí
ကွဲ	kwɛ́
ကဿပ	kaʔθəpa̰
ကဿပဘုရား	kaʔθəpa̰pʰəjá
ခ	kʰa̰
ခက်	kʰɛʔ
ခက်ရင်း	kʰəjɪ́ɴ
ခကွေး	kʰa̰ɡwé
ခင်	kʰɪ̀ɴ
ခင်ပွန်း	kʰɪ̀ɴbʊ́ɴ
ခင်ဗျာ	kʰəmjà
ခင်ဗျာ့	kʰɪ̀ɴbja̰
ခင်ဗျား	kʰɪ̀ɴbjá
ခင်ဗျားတို့	kʰɪ̀ɴbjádo̰
ခင်မင်မှု	kʰɪ̀ɴmɪ̀ɴm̥ṵ
ခဏ	kʰəna̰
ခဏခဏ	kʰəna̰ɡəna̰
ခတ္တိယ	kʰaʔtḭja̰
ခနုံထုပ်	kʰənòʊɴdoʊʔ
ခနုံအီ	kʰənòʊɴʔì
ခန္တီ	kʰàɴtì
ခန္ဓာ	kʰàɴdà
ခန္ဓာငါးပါး	kʰàɴdàŋábá
ခန္ဓာဗေဒ	kʰàɴdàbèda̰
ခန်တမာ	kʰàɴtəmà
ခန်း	kʰáɴ
ခပ်သိမ်း	kʰaʔθéɪɴ
ခမည်းတော်	kʰəmídɔ̀
ခမာ	kʰəmà
ခမောက်	kʰəmaʊʔ
ခယ်မ	kʰɛ̀ma̰
ခရင်း	kʰəjɪ́ɴ
ခရစ္စမတ်	kʰəɹɪʔsəmaʔ
ခရစ်	kʰəɹɪʔ
ခရစ်တော်	kʰəɹɪʔtɔ̀
ခရစ်ယာန်	kʰəɹɪʔjàn
ခရမ်း	kʰəjáɴ
ခရမ်းချဉ်	kʰəjáɴd͡ʑɪ̀ɴ
ခရမ်းသီး	kʰəjáɴθí
ခရာမွှေး	kʰəjàm̥wé
ခရိုင်	kʰəjàɪɴ
ခရိုမီယမ်	kʰəɹòmìjàɴ
ခရိုအေးရှား	kʰəɹòʔéʃá
ခရီး	kʰəjí
ခရီးသည်	kʰəjíðè
ခရု	kʰəjṵ
ခရုပက်ကျိ	kʰəjṵpɛʔt͡ɕḭ
ခရေ	kʰəjè
ခလာသီ	kʰəlàθì
ခလုတ်	kʰəloʊʔ
ခလုတ်ခုံ	kʰəloʊʔkʰòʊɴ
ခဝဲ	kʰəwɛ́
ခါ	kʰà
ခါး	kʰá
ခါးပတ်	ɡəbaʔ
ခို	kʰò
ခိုး	kʰó
ခိုးစား	kʰósá
ခု	kʰṵ
ခုခံအားကျရောဂါ	kʰṵɡàɴʔát͡ɕa̰jɔ́ɡà
ခုနစ်	kʰʊ̀ɴn̥ɪʔ
ခုနစ်လ	kʰʊ̀ɴn̥əla̰
ခုန်	kʰòʊɴ
ခုံတန်းလျား	kʰòʊɴtáɴjá
ခုံရှည်	kʰòʊɴʃè
ခေတ္တ	kʰɪʔta̰
ခေတ်	kʰɪʔ
ခေမာရဋ္ဌ	kʰèmàjətʰa̰
ခေါက်	kʰaʊʔ
ခေါက်ဆွဲ	kʰaʊʔsʰwɛ́
ခေါက်ဆွဲဆိုင်	kʰaʊʔsʰwɛ́zàɪɴ
ခေါက်ဆွဲသုပ်	kʰaʊʔsʰwɛ́θoʊʔ
ခေါက်မုန့်	kʰaʊʔmo̰ʊɴ
ခေါင်း	kʰáʊɴ
ခေါင်း	ɡáʊɴ
ခေါင်းဆောင်	ɡáʊɴsʰàʊɴ
ခေါင်းဆောင်	ɡáʊɴzàʊɴ
ခေါင်းပေါင်း	ɡáʊɴbáʊɴ
ခေါင်းလောင်း	kʰáʊɴláʊɴ
ခေါင်းလျှော်ရည်	ɡáʊɴʃɔ̀jè
ခေါင်းအုံး	ɡáʊɴʔóʊɴ
ခေါပုတ်	kʰɔ́boʊʔ
ခေါပျဉ်	kʰɔ́bjɪ̀ɴ
ခေါ်	kʰɔ̀
ခေး	kʰé
ခဲ	kʰɛ́
ခဲတံ	kʰɛ́dàɴ
ခဲဖျက်	kʰɛ́bjɛʔ
ခဲယဉ်း	kʰɛ́jɪ́ɴ
ခဲအို	kʰɛ́ʔò
ခဲ့	kʰɛ̰
ခဲ့	ɡɛ̰
ခံ	kʰàɴ
ခံစား	kʰàɴzá
ခံတပ်	kʰàɴdaʔ
ခံမြို့	kʰàɴmjo̰
ခံယူချက်	kʰàɴjùd͡ʑɛʔ
ချက်	t͡ɕʰɛʔ
ချက်ကြိုး	t͡ɕʰɛʔt͡ɕó
ချက်သမ္မတ	t͡ɕʰɛʔθəməda̰
ချင်	t͡ɕʰɪ̀ɴ
ချင်း	d͡ʑɪ́ɴ
ချင်း	t͡ɕʰɪ́ɴ
ချင်းမိုင်	t͡ɕʰɪ́ɴmàɪɴ
ချင်းသုပ်	d͡ʑɪ́ɴðoʊʔ
ချစ်	t͡ɕʰɪʔ
ချစ်ခင်	t͡ɕʰɪʔkʰɪ̀ɴ
ချစ်တီး	t͡ɕʰɪʔtí
ချစ်သူ	t͡ɕʰɪʔθù
ချဉ်	t͡ɕʰɪ̀ɴ
ချဉ်ပေါင်	t͡ɕʰɪ̀ɴbàʊɴ
ချည်	t͡ɕʰì
ချည်လုံး	t͡ɕʰìlóʊɴ
ချဒ်	t͡ɕʰàd
ချပါတီ	t͡ɕʰəpàtì
ချပ်	d͡ʑaʔ
ချမ်း	t͡ɕʰáɴ
ချယ်ရီ	t͡ɕʰɛ̀ɹì
ချာတိတ်	t͡ɕʰàteɪʔ
ချားလ်	t͡ɕʰál
ချိတ်	d͡ʑeɪʔ
ချို	d͡ʑò
ချို	t͡ɕʰò
ချိုချဉ်	t͡ɕʰòt͡ɕʰɪ̀ɴ
ချိုး	t͡ɕʰó
ချီလီ	t͡ɕʰìlì
ချုပ်	t͡ɕʰoʊʔ
ချူးအင်းဂမ်း	t͡ɕʰúʔɪ́ɴɡáɴ
ချေ	d͡ʑè
ချေ	d͡ʑì
ချေ	t͡ɕʰè
ချေ	t͡ɕʰì
ချော	t͡ɕʰɔ́
ချောကလက်	t͡ɕʰɔ́kəlɛʔ
ချောက်	t͡ɕʰaʊʔ
ချောင်	t͡ɕʰàʊɴ
ချောင်း	t͡ɕʰáʊɴ
ချော်	t͡ɕʰɔ̀
ချေး	t͡ɕʰí
ချေးထုပ်	t͡ɕʰétʰoʊʔ
ချဲ့ချဲ့	t͡ɕʰɛ̰d͡ʑɛ̰
ချွန်	t͡ɕʰʊ̀ɴ
ချွန်ထက်	t͡ɕʰʊ̀ɴtʰɛʔ
ချွေး	t͡ɕʰwé
ချွေးမ	t͡ɕʰwéma̰
ချွံချွံ	t͡ɕʰʊ̀ɴd͡ʑʊ̀ɴ
ခြ	t͡ɕʰa̰
ခြင်	t͡ɕʰɪ̀ɴ
ခြင်း	t͡ɕʰɪ́ɴ
ခြင်းလုံး	t͡ɕʰɪ́ɴlóʊɴ
ခြင်္သေ့	t͡ɕʰɪ̀ɴðḛ
ခြင်္သေ့ကလေး	t͡ɕʰɪ̀ɴðḛɡəlé
ခြင်္သေ့မ	t͡ɕʰɪ̀ɴðḛma̰
ခြည်	t͡ɕʰì
ခြတောင်ပို့	t͡ɕʰa̰tàʊɴbo̰
ခြမ်း	t͡ɕʰáɴ
ခြား	t͡ɕʰá
ခြားနား	t͡ɕʰáná
ခြားနားချက်	t͡ɕʰánád͡ʑɛʔ
ခြေ	t͡ɕʰè
ခြေစွပ်	t͡ɕʰèzʊʔ
ခြေထောက်	t͡ɕʰèdaʊʔ
ခြေနင်း	t͡ɕʰènɪ́ɴ
ခြေဖနောင့်	t͡ɕʰèbəna̰ʊɴ
ခြေဖဝါး	t͡ɕʰèbəwá
ခြေသည်း	t͡ɕʰèðé
ခြေအိတ်	t͡ɕʰèʔeɪʔ
ခြောက်	t͡ɕʰaʊʔ
ခြောက်လ	t͡ɕʰaʊʔla̰
ခြံ	t͡ɕʰàɴ
ခွက်	kʰwɛʔ
ခွင့်လွှတ်	kʰwɪ̰ɴl̥ʊʔ
ခွဆုံ	ɡwa̰zòʊɴ
ခွန်	kʰʊ̀ɴ
ခွန်း	kʰʊ́ɴ
ခွာ	kʰwà
ခွာနာလျှာနာ	kʰwànàʃànà
ခွေး	kʰwé
ခွေးမ	kʰwéma̰
ခွေးမသား	kʰwéma̰ðá
ခွေးရူးပြန်ရောဂါ	kʰwéjúbjàɴjɔ́ɡà
ခွေးသူတောင်းစား	kʰwéðədáʊɴzá
ခွေးအိမ်	kʰwéʔèɪɴ
ခွဲ	kʰwɛ́
ခွံ	kʰʊ̀ɴ
ဂငယ်	ɡa̰ŋɛ̀
ဂငယ်ကွေ့	ɡa̰ŋɛ̀ɡwḛ
ဂင်းနီဗစ်ဆော	ɡɪ́ɴnìbɪʔsʰɔ́
ဂင်္ဂါ	ɡɪ̀ɴɡà
ဂဏန်း	ɡənáɴ
ဂဏန်းတွက်စက်	ɡənáɴtwɛʔsɛʔ
ဂန္ထဗေဒ	ɡàɴtʰa̰bèda̰
ဂန္ထဝင်	ɡàɴdəwɪ̀ɴ
ဂန္ဒမာ	ɡàɴdəmà
ဂန်ဂျာ	ɡàɴd͡ʑà
ဂန်ဒူး	ɡàɴdú
ဂမ်ဘီယာ	ɡàɴbìjà
ဂယ်လက်ဆီ	ɡɛ̀lɛʔsʰì
ဂရပ်	ɡəɹaʔ
ဂရမ်	ɡəɹàɴ
ဂရိ	ɡəɹḭ
ဂရိတ်ဗြိတိန်	ɡəɹeɪʔbjḭtèɪɴ
ဂရု	ɡəjṵ
ဂလင်း	ɡəlɪ́ɴ
ဂဠုန်	ɡəlòʊɴ
ဂါထာ	ɡàtʰà
ဂါနာ	ɡànà
ဂါဘွန်	ɡàbʊ̀ɴ
ဂိတ်	ɡeɪʔ
ဂိတ်ဆုံး	ɡeɪʔsʰóʊɴ
ဂိမှာန်	ɡèɪɴm̥àɴ
ဂိရိမေခလာ	ɡḭɹḭmèkʰəlà
ဂိုင်ယာနာ	ɡàɪɴjànà
ဂိုဏ်း	ɡón
ဂိုဏ်းချုပ်	ɡáɪɴd͡ʑoʊʔ
ဂိုဏ်းထောက်	ɡóndaʊʔ
ဂိုဏ်းအုပ်	ɡónʔoʊʔ
ဂိုဒေါင်	ɡòdàʊɴ
ဂီတ	ɡìta̰
ဂီတပညာ	ɡìta̰pa̰ɲà
ဂီတသမား	ɡìta̰ðəmá
ဂီတာ	ɡìtà
ဂီနီ	ɡìnì
ဂုဏ်	ɡòʊɴ
ဂုန္တန်	ɡòʊɴdàɴ
ဂုရု	ɡṵɹṵ
ဂူ	ɡù
ဂေဟဗေဒ	ɡèha̰ta̰bèda̰
ဂေါက်	ɡaʊʔ
ဂေါတမ	ɡɔ́təma̰
ဂေါတမဘုရား	ɡɔ́təma̰pʰəjá
ဂေါ်	ɡɔ̀
ဂေါ်ဖီထုပ်	ɡɔ̀bìdoʊʔ
ဂေါ်ဖီပန်း	ɡɔ̀bìpáɴ
ဂေါ်မိတ်	ɡɔ̀meɪʔ
ဂေါ်ရခါး	ɡɔ̀jəkʰá
ဂေါ်ရခါးသီး	ɡɔ̀jəkʰáθí
ဂျက်	d͡ʑɛʔ
ဂျင်	d͡ʑɪ̀ɴ
ဂျင်းဘောင်းဘီ	d͡ʑɪ́ɴbáʊɴbì
ဂျပန်	d͡ʑəpàɴ
ဂျမေကာ	d͡ʑəmèkà
ဂျလေဘီ	d͡ʑəlèbì
ဂျာမနီ	d͡ʑàmənì
ဂျာမန်	d͡ʑàmàɴ
ဂျီဘူတီ	d͡ʑìbùtì
ဂျုံ	d͡ʑòʊɴ
ဂျုံမှုန့်	d͡ʑòʊɴm̥o̰ʊɴ
ဂျူး	d͡ʑú
ဂျေရုဆလင်	d͡ʑèɹṵsʰa̰lɪ̀ɴ
ဂျော့ခ်ျ	d͡ʑɔ̰t͡ɕʰə
ဂျော်ဂျီယာ	d͡ʑɔ̀d͡ʑìjà
ဂျော်ဒန်	d͡ʑɔ̀dàɴ
ဂျော်နီ	d͡ʑɔ̀nì
ဂြိုဟ်	d͡ʑò
ဂြိုဟ်တု	d͡ʑòhdṵ
ဂွမ်း	ɡʊ́ɴ
ဂွါတီမာလာ	ɡwàtìmàlà
ဂွေး	ɡwé
ဃကြီး	ɡa̰d͡ʑí
င	ŋa̰
ငချိတ်	ŋət͡ɕʰeɪʔ
ငတ်	ŋaʔ
ငန်	ŋàɴ
ငန်း	ŋáɴ
ငယ်	ŋɛ̀
ငရုတ်	ŋəjoʊʔ
ငရုတ်ကောင်း	ŋəjoʊʔɡáʊɴ
ငရဲ	ŋəjɛ́
ငရဲကြီးရှစ်ထပ်	ŋəjɛ́d͡ʑíʃɪʔtʰaʔ
ငရဲမင်း	ŋəjɛ́mɪ́ɴ
ငရဲသား	ŋəjɛ́ðá
ငလျင်	ŋəljɪ̀ɴ
ငါ	ŋà
ငါတို့	ŋàto̰
ငါ့	ŋa̰
ငါး	ŋá
ငါးကျပ်တင်	ŋát͡ɕaʔtɪ̀ɴ
ငါးကြင်း	ŋád͡ʑɪ́ɴ
ငါးခူ	ŋəkʰù
ငါးပိ	ŋəpḭ
ငါးပိထောင်း	ŋápḭtʰáʊɴ
ငါးပိရည်	ŋəpḭjè
ငါးပုဏ္ဏား	ŋəpòʊɴná
ငါးပေါင်းထုပ်	ŋəbáʊɴdoʊʔ
ငါးဖန်ခွက်	ŋəpʰàɴɡwɛʔ
ငါးဖယ်	ŋəpʰɛ̀
ငါးဖျင်းသလက်	ŋəpʰjɪ́ɴθəlɛʔ
ငါးမန်း	ŋəmáɴ
ငါးမုန့်	ŋámo̰ʊɴ
ငါးမူး	ŋámú
ငါးမျှားတံ	ŋəm̥jádàɴ
ငါးမြစ်ချင်း	ŋəmjɪʔt͡ɕʰɪ́ɴ
ငါးရံ့	ŋəja̰ɴ
ငါးလ	ŋála̰
ငါးသလောက်	ŋəθəlaʊʔ
ငါးသလောက်ပေါင်း	ŋəθəlaʊʔbáʊɴ
ငါးဥ	ŋáʔṵ
ငို	ŋò
ငု	ŋṵ
ငုစပ်	ŋṵzaʔ
ငုသိမ်	ŋṵðèɪɴ
ငူတူတူ	ŋùtùdù
ငံ	ŋàɴ
ငံပြာရည်	ŋàɴbjàjè
ငြာ	ɲà
ငြိမ်းချမ်းရေး	ɲéɪɴd͡ʑáɴjé
ငွေ	ŋwè
ငွေကြေး	ŋwèt͡ɕé
ငွေသား	ŋwèðá
ငွေ့ငွေ့	ŋwḛŋwḛ
ငှက်	ŋ̊ɛʔ
ငှက်ဆိုး	ŋ̊ɛʔsʰó
ငှက်ပျော	ŋəpjɔ́
ငှက်ပျောပေါင်း	ŋ̊əbjɔ́báʊɴ
ငှက်ဖျား	ŋ̊ɛʔpʰjá
ငှါး	ŋ̊á
ငှား	ŋ̊á
စ	sa̰
စကတ်	səkaʔ
စကား	zəɡá
စကားထာ	zəɡətʰà
စကားနည်းရန်စဲ	zəɡánɛ́jàɴzɛ́
စကားပုံ	zəɡəbòʊɴ
စကားပြန်	zəɡəbjàɴ
စကားပြောကြေးနန်း	zəɡábjɔ́t͡ɕénáɴ
စကားလုံး	zəɡəlóʊɴ
စကားဝှက်	zəɡəʍɛʔ
စက္ကန့်	sɛʔka̰ɴ
စက္ကရီတေရီ	sɛʔkəɹìtèjì
စက္ကူ	sɛʔkù
စက်	sɛʔ
စက်ခေါင်း	sɛʔɡáʊɴ
စက်ဆရာ	sɛʔsʰəjà
စက်ဆုပ်	sɛʔsʰoʊʔ
စက်တင်ဘာ	sɛʔtɪ̀ɴbà
စက်ဘီး	sɛʔbéɪɴ
စက်ရုပ်	sɛʔjoʊʔ
စက်ရုံ	sɛʔjòʊɴ
စက်လှေကား	sɛʔl̥èɡá
စက်သုံးဆီဆိုင်	sɛʔθóʊɴsʰìsʰàɪɴ
စက်သေနတ်	sɛʔθənaʔ
စကြဝဠာ	sɛʔt͡ɕàwəlà
စကြာ	sɛʔt͡ɕà
စကြာဝဠာဗေဒ	sɛʔt͡ɕàwəlàbèda̰
စခန်း	səkʰáɴ
စင်	sɪ̀ɴ
စင်ကာပူ	sɪ̀ɴɡəpù
စင်စင်	sɪ̀ɴzɪ̀ɴ
စင်း	sɪ́ɴ
စင်္ကာပူ	sɪ̀ɴɡəpù
စင်္ကြံ	zɪ́ɴd͡ʑàɴ
စစ်	sɪʔ
စစ်ကိုင်း	zəɡáɪɴ
စစ်ကဲ	sɪʔkɛ́
စစ်တပ်	sɪʔtaʔ
စစ်တုရင်	sɪʔbəjɪ̀ɴ
စစ်တွေ	sɪʔtwè
စစ်ဗိုလ်	sɪʔbò
စစ်သား	sɪʔθá
စဉ်းစား	sɪ́ɴzá
စည်	sì
စည်ပိုင်း	sìbáɪɴ
စည်း	sí
စည်းပုံ	síbòʊɴ
စတိုး	sətó
စတု	zətṵ
စတုဂံ	sətṵɡàɴ
စတုတ္ထ	zədoʊʔtʰa̰
စတုဒိသာ	sətṵdḭθà
စတုရန်း	sətṵjáɴ
စတေဒီယံ	sətèdìjàɴ
စနစ်	sənɪʔ
စနေ	sənè
စန္ဒရား	sàɴdəjá
စန္ဒာ	sàɴdà
စန္ဒီ	sàɴdì
စန္ဒြမာသ	sàɴdɹa̰màθa̰
စန္ဒြာ	sàɴdɹà
စန်း	sáɴ
စပါး	zəbá
စပါးလင်	zəbəlɪ̀ɴ
စပိန်	səpèɪɴ
စပ်	saʔ
စပျစ်	zəbjɪʔ
စပျစ်သီး	zəbjɪʔθí
စပွတ်နစ်	səpʊʔnɪʔ
စမတ်	səmaʔ
စမူဆာ	səmùzà
စမူဆာသုပ်	səmùzàθoʊʔ
စမ်း	sáɴ
စရိတ်	zəjeɪʔ
စရိုက်	zəjaɪʔ
စလုံး	sa̰lóʊɴ
စလွယ်	səlwè
စအို	səʔò
စာ	sà
စာကိုယ်	sàɡò
စာကြည့်တိုက်	sàt͡ɕḭdaɪʔ
စာချုပ်	sət͡ɕʰoʊʔ
စာစောင်	sàzàʊɴ
စာဆို	sàzò
စာတိုက်	sàdaɪʔ
စာပို့	sàbo̰
စာပို့	sàpo̰
စာပုံး	sàbóʊɴ
စာပေ	sàpè
စာဖတ်	sàpʰaʔ
စာမရီ	sàməjì
စာမေးပွဲ	sàmébwɛ́
စာမျက်နှာ	sàmjɛʔn̥à
စာမွဲ	səmwɛ́
စာရင်း	səjɪ́ɴ
စာရင်းကိုင်	səjɪ́ɴɡàɪɴ
စာရင်းကိုင်ပညာ	səjɪ́ɴɡàɪɴpjɪ̀ɴɲà
စာရင်းအင်း	sàjɪ́ɴʔɪ́ɴ
စာရေး	səjé
စာရေးဆရာ	sàjésʰəjà
စာရွက်စာတမ်း	sàjwɛʔsàdáɴ
စာလုံးပေါင်းသတ်ပုံ	səlóʊɴbáʊɴθaʔpòʊɴ
စာသင်ခန်း	sàθɪ̀ɴɡáɴ
စာသား	sàðá
စာအိတ်	sàʔeɪʔ
စာအုပ်	sàʔoʊʔ
စာအုပ်ဆိုင်	sàʔoʊʔsʰàɪɴ
စား	sá
စားချဉ့်ပြန်	sət͡ɕʰɪ̰ɴpjàɴ
စားစရာ	sázəjà
စားတော်ဆက်	sádɔ̀sʰɛʔ
စားတော်ဆက်	sádɔ̀zɛʔ
စားပြီးပြီလား	sápíbìlá
စားပွဲ	sábwɛ́
စားပွဲ	zəbwɛ́
စားပွဲထိုး	zábwɛ́dó
စားဖို	səpʰò
စားဖိုဆောင်	səpʰòzàʊɴ
စားမြုံ့ပြန်	səmjo̰ʊɴpjàɴ
စားသောက်ဆိုင်	sáθaʊʔsʰàɪɴ
စိတ္တဇ	seɪʔdəza̰
စိတ္တဇပန်းချီ	seɪʔdəza̰bəd͡ʑì
စိတ္တဇရောဂါ	seɪʔdəza̰jɔ́ɡà
စိတ္တဗေဒ	seɪʔta̰bèda̰
စိတ်	seɪʔ
စိတ်ဆိုး	seɪʔsʰó
စိတ်ဓာတ်	seɪʔdàt
စိတ်ပညာ	seɪʔpjɪ̀ɴɲà
စိတ်မှတ်	seɪʔm̥aʔ
စိတ်ရောဂါ	seɪʔjɔ́ɡà
စိန်	sèɪɴ
စိန်ဖြူ	sèɪɴpʰjù
စိမ့်	sḛɪɴ
စိမ်း	séɪɴ
စိမ်းစားဥ	séɪɴzáʔṵ
စို	sò
စိုက်	saɪʔ
စိုက်ပျိုးရေး	saɪʔpjójé
စိုင်း	sáɪɴ
စိုထိုင်း	sòtʰáɪɴ
စို့	so̰
စီဒီ	sìdì
စီလုံ	sìlòʊɴ
စီလုံတီး	sìlòʊɴtí
စီး	sí
စီးကရက်	síkəɹɛʔ
စီးကလိပ်	síkəleɪʔ
စီးနင်း	sínɪ́ɴ
စီးပွား	síbwá
စီးပွားရေး	síbwájé
စီးပွားရေးသမား	síbwájéðəmá
စုတ်	soʊʔ
စုန်း	sóʊɴ
စုပ်	soʊʔ
စုပ်စုပ်	soʊʔsoʊʔ
စုလျား	sṵjá
စုံစမ်း	sòʊɴzáɴ
စုံထောက်	sòʊɴdaʊʔ
စုံဖက်	sòʊɴpʰɛʔ
စူပါမားကတ်	sùpəmákaʔ
စူးစူး	súzú
စေတနာ	sèdənà
စေတနာရှင်	sèdənàʃɪ̀ɴ
စေတီ	zèdì
စော	sɔ́
စောက်	saʊʔ
စောင့်	sa̰ʊɴ
စောင်	sàʊɴ
စောင်း	sáʊɴ
စောင်းလျား	záʊɴjá
စောစော	sɔ́zɔ́
စောပြာ	sɔ́bjà
စော်ဘွား	sɔ̀bwá
စေ့စပ်	sḛzaʔ
စဲ	sɛ́
စံပယ်	zəbɛ̀
စွင့်	swɪ̰ɴ
စွတ်စွတ်နာ	sʊʔsʊʔnà
စွတ်ဖါး	sʊʔpʰá
စွန်	sʊ̀ɴ
စွန်ကုပ်	sʊ̀ɴɡoʊʔ
စွပ်	sʊʔ
စွပ်ပြုတ်	sʊʔpjoʊʔ
စွမ်း	swáɴ
စွမ်းအင်	swáɴʔɪ̀ɴ
စွယ်	swɛ̀
စွေ့စွေ့	swḛzwḛ
ဆက္ကဂံ	sʰɛʔkəɡàɴ
ဆက်	sʰɛʔ
ဆက်ဆံ	sʰɛʔsʰàɴ
ဆက်သွယ်ရေး	sʰɛʔθwɛ̀jé
ဆင့်	sʰɪ̰ɴ
ဆင်	sʰɪ̀ɴ
ဆင်ခြေထောက်ရောဂါ	sʰɪ̀ɴt͡ɕʰèdaʊʔjɔ́ɡà
ဆင်စွယ်	sʰɪ̀ɴzwɛ̀
ဆင်ဝင်	sʰɪ̀ɴwɪ̀ɴ
ဆင်း	sʰɪ́ɴ
ဆင်းရဲ	sʰɪ́ɴjɛ́
ဆစ်ဒနီ	sʰɪʔdənì
ဆဋ္ဌမ	sʰaʔtʰəma̰
ဆန့်ကျင်	sʰa̰ɴd͡ʑɪ̀ɴ
ဆန့်ကျင်ဘက်	sʰa̰ɴd͡ʑɪ̀ɴbɛʔ
ဆန္ဒ	sʰàɴda̰
ဆန္ဒပြပွဲ	sʰàɴda̰pja̰bwɛ́
ဆန်	sʰàɴ
ဆန်ခါ	zəɡà
ဆန်ပြုတ်	sʰàɴbjoʊʔ
ဆန်မာရီနို	sʰàɴmàɹìnò
ဆန်း	sʰáɴ
ဆန်းဒဝစ်	sʰáɴdəwɪʔ
ဆနွင်းမကင်း	sʰənwɪ́ɴməkɪ́ɴ
ဆပ္ပတ်	sʰaʔpaʔ
ဆပ်	sʰaʔ
ဆပ်ကပ်	sʰaʔkaʔ
ဆပ်ပြာ	sʰaʔpjà
ဆပ်သွားဖူး	sʰaʔθwápʰú
ဆယ့်တစ်	sʰɛ̰tɪʔ
ဆယ့်တစ်လ	sʰɛ̰tɪʔla̰
ဆယ့်နှစ်	sʰɛ̰n̥ɪʔ
ဆယ့်နှစ်ရာသီ	sʰɛ̰n̥əjàθì
ဆယ့်နှစ်လ	sʰɛ̰n̥əla̰
ဆယ်	sʰɛ̀
ဆယ်လ	sʰɛ̀la̰
ဆရာ	sʰəjà
ဆရာတော်	sʰəjàdɔ̀
ဆရာမ	sʰəjàma̰
ဆရာလေး	sʰəjàlé
ဆရာဝန်	sʰa̰jàwʊ̀ɴ
ဆရာသမား	sʰa̰jàθəmá
ဆလတ်	sʰəlaʔ
ဆလဗ	sʰəla̰ba̰
ဆလိမ်	sʰa̰lèɪɴ
ဆလိုင်း	sʰəláɪɴ
ဆလိုဗားကီးယား	sʰəlòbákíjá
ဆလိုဗေးနီးယား	sʰəlòbéníjá
ဆာ	sʰà
ဆာဂျင်	sʰàd͡ʑɪ̀ɴ
ဆာမူရိုင်း	sʰàmùɹáɪɴ
ဆာယာ	sʰàjà
ဆာရီ	sʰàɹì
ဆာလဖာ	sʰàləpʰà
ဆား	sʰá
ဆားကြက်ဥ	sʰát͡ɕɛʔʔṵ
ဆားဘီးယား	sʰábíjá
ဆားဘဲဥ	sʰábɛ́ʔṵ
ဆားရည်	sʰájè
ဆိတ်	sʰeɪʔ
ဆိတ်ကုလား	sʰeɪʔkəlá
ဆိတ်ချေး	sʰeɪʔt͡ɕʰí
ဆိတ်ထီး	sʰeɪʔtʰí
ဆိတ်မ	sʰeɪʔma̰
ဆိပ်	sʰeɪʔ
ဆိပ်ကမ်း	sʰeɪʔkáɴ
ဆိမ့်	sʰḛɪɴ
ဆို	sʰò
ဆိုကရေးတီး	sʰòka̰jétí
ဆိုကရေးတီး	sʰòkəɹétí
ဆိုက်	sʰaɪʔ
ဆိုက်ကား	sʰaɪʔká
ဆိုက်ပရပ်စ်	sʰaɪʔpəɹaʔs
ဆိုက်ဘေးရီးယား	sʰaɪʔbéɹíjá
ဆိုင်	sʰàɪɴ
ဆိုင်း	sʰáɪɴ
ဆိုင်းထိုး	sʰáɪɴtʰó
ဆိုင်းဘုတ်	sʰáɪɴboʊʔ
ဆိုင်းဝိုင်း	sʰáɪɴwáɪɴ
ဆိုဆုံးမ	sʰòsʰóʊɴma̰
ဆိုထုံး	sʰòdóʊɴ
ဆိုဒီယမ်	sʰòdìjàɴ
ဆိုဖာ	sʰòpʰà
ဆိုဗီယက်	sʰòbìjɛʔ
ဆိုမာလီယာ	sʰòmàlìjà
ဆိုမြည်	sʰòmjì
ဆိုရိုးစကား	sʰòjózəɡá
ဆိုး	sʰó
ဆိုးဆေး	sʰózé
ဆီ	sʰì
ဆီချက်	sʰìd͡ʑɛʔ
ဆီချက်ခေါက်ဆွဲ	sʰìd͡ʑɛʔkʰaʊʔsʰwɛ́
ဆီထမင်း	sʰìtʰəmɪ́ɴ
ဆီနီဂေါ	sʰìnìɡɔ́
ဆီပြန်	sʰìbjàɴ
ဆီမီးတောက်	sʰìmídaʊʔ
ဆီယူ	sʰìjù
ဆီရာလီယွန်	sʰìɹàlìjʊ̀ɴ
ဆီး	sʰí
ဆီးချို	sʰíd͡ʑò
ဆီးချုပ်ရောဂါ	sʰíd͡ʑoʊʔjɔ́ɡà
ဆီးပူညောင်းကျ	sʰípùɲáʊɴt͡ɕa̰
ဆီးဖြူ	zíbjù
ဆီးရီးယား	sʰíɹíjá
ဆီးအောင့်ရောဂါ	sʰíʔa̰ʊɴjɔ́ɡà
ဆု	sʰṵ
ဆုံး	sʰóʊɴ
ဆုံးဖြတ်	sʰóʊɴpʰjaʔ
ဆူ	sʰù
ဆူဒန်	sʰùdàɴ
ဆူရာနမ်	sʰùɹànàɴ
ဆူရှီ	sʰùʃì
ဆူး	sʰú
ဆူးပုပ်	sʰúboʊʔ
ဆောက်	sʰaʊʔ
ဆောင်	sʰàʊɴ
ဆောင်ပုဒ်	sʰàʊɴboʊʔ
ဆောင်း	sʰáʊɴ
ဆောင်းပါး	sʰáʊɴbá
ဆောင်းရာသီ	sʰáʊɴjàðì
ဆောင်းဦး	sʰáʊɴʔú
ဆောင်းဦးရာသီ	sʰáʊɴʔújàðì
ဆောရီး	sʰɔ́ɹí
ဆော့	sʰɔ̰
ဆော့ဖ်ဝဲလ်	sʰaʊʔwɛ́
ဆော်ဒီအာရေဗျ	sʰɔ̀dìʔàɹèbja̰
ဆေး	sʰé
ဆေးခန်း	sʰékʰáɴ
ဆေးခြောက်	sʰéd͡ʑaʊʔ
ဆေးဆိုင်	sʰézàɪɴ
ဆေးတံ	sʰédàɴ
ဆေးပေါ့လိပ်	sʰébɔ̰leɪʔ
ဆေးပြင်းလိပ်	sʰébjɪ́ɴleɪʔ
ဆေးဘဲဥ	sʰébɛ́ʔṵ
ဆေးရုံ	sʰéjòʊɴ
ဆေးရှဲ	sʰéʃɛ́
ဆေးလိပ်	sʰéleɪʔ
ဆေးလိပ်မသောက်ရ	sʰéleɪʔməθaʊʔja̰
ဆေးလုံး	sʰélóʊɴ
ဆံ	sʰàɴ
ဆံတော်ချ	sʰàɴtɔ̀t͡ɕʰa̰
ဆံပင်	zəbɪ̀ɴ
ဆံပင်ညှပ်	zəbɪ̀ɴɲ̊aʔ
ဆံပင်တု	zəbɪ̀ɴdṵ
ဆွစ်ဇာလန်	sʰwɪʔzəlàɴ
ဆွဆွ	sʰwa̰zwa̰
ဆွပ်	sʰʊʔ
ဆွမ်း	sʰʊ́ɴ
ဆွမ်းမွှေး	sʰʊ́ɴm̥wé
ဆွမ်းအုပ်	sʰʊ́ɴʔoʊʔ
ဆွယ်တာ	sʰwɛ̀tà
ဆွာဇီလန်	sʰwàzìlàɴ
ဆွီဒင်	sʰwìdɪ̀ɴ
ဆွေခုနစ်ဆက်မျိုးခုနစ်ဆက်	sʰwèkʰənəzɛʔmjókʰənəzɛʔ
ဆွဲ	sʰwɛ́
ဇကွဲ	za̰ɡwɛ́
ဇင့်ခ်	zɪ̰ɴ
ဇင်ဘာဘွေ	zɪ̀ɴbàbwè
ဇင်းမယ်	zɪ́ɴmɛ̀
ဇင်္ဂမဥစ္စာ	zɪ̀ɴɡəma̰ʔoʊʔsà
ဇစ်	zɪʔ
ဇနပုဒ်	zənəpoʊʔ
ဇနီး	zəní
ဇန်နဝါရီ	zàɴnəwàɹì
ဇမ်ဘီယာ	zàɴbìjà
ဇယ	zəja̰
ဇယား	zəjá
ဇရပ်	zəjaʔ
ဇရာ	zəjà
ဇလဗေဒ	zəla̰bèda̰
ဇလုံ	zəlòʊɴ
ဇာ	zà
ဇာဂနာ	zàɡənà
ဇာတိ	zàtḭ
ဇာတိပ္ဖိုလ်	zàdeɪʔpʰò
ဇာတိပ္ဖိုလ်စေ့	zàdeɪʔpʰòzḛ
ဇာတ်	zaʔ
ဇာတ်ကား	zaʔká
ဇာတ်ကြီးဆယ်ဘွဲ့	zàtd͡ʑísʰɛ̀bwɛ̰
ဇာတ်ခုံ	zaʔkʰòʊɴ
ဇာတ်ဆောင်	zaʔsʰàʊɴ
ဇာတ်ညွှန်း	zàtɲ̊ʊ́ɴ
ဇာတ်တော်	zàt
ဇာတ်ရုံ	zaʔjòʊɴ
ဇာနည်	zànì
ဇိန	zḭna̰
ဇိမ်မယ်	zèɪɴmɛ̀
ဇီဇဝါ	zìzəwà
ဇီရာ	zìjà
ဇီရာစေ့	zìjàsḛ
ဇီဝ	zìwa̰
ဇီဝကမ္မဗေဒ	zìwa̰kàɴma̰bèda̰
ဇီဝစက်	zìwa̰sɛʔ
ဇီဝဓာတုဗေဒ	zìwa̰dàtṵbèda̰
ဇီဝဗေဒ	zìwa̰bèda̰
ဇူလိုင်	zùlàɪɴ
ဇေ	zè
ဇေယျ	zèja̰
ဇေယျာပူရ	zèjàpùɹa̰
ဇော်ဂျီ	zɔ̀d͡ʑì
ဇွန်	zʊ̀ɴ
ဇွန်း	zʊ́ɴ
ဈမျဉ်းဆွဲ	za̰mjɪ́ɴzwɛ́
ဈာန်	zàn
ဈာပန	zàpəna̰
ဈေး	zé
ဈေးကြီး	zét͡ɕí
ဈေးချို	zét͡ɕʰò
ဈေးနှုန်း	zén̥óʊɴ
ဉာဏ်	ɲàn
ဉာဏ်စမ်း	ɲànsáɴ
ဉာဏ်တော်	ɲàɴdɔ̀
ဉာဏ်ပူဇော်ခ	ɲànpùzɔ̀kʰa̰
ည	ɲa̰
ညကလေး	ɲa̰kəlé
ညကြီး	ɲa̰t͡ɕí
ညစာ	ɲa̰zà
ညစ်	ɲɪʔ
ညစ်ထည်း	ɲɪʔtʰé
ညည်း	ɲí
ညနေ	ɲa̰nè
ညနေခင်း	ɲa̰nèɡɪ́ɴ
ညလေး	ɲa̰lé
ညာ	ɲà
ညို	ɲò
ညီ	ɲì
ညီနောင်	ɲìnàʊɴ
ညီမ	ɲìma̰
ညီမျှခြင်း	ɲìm̥ja̰d͡ʑɪ́ɴ
ညီလာခံ	ɲìlàɡàɴ
ညီအစ်ကို	ɲìʔəkò
ညီအစ်မ	ɲìʔəma̰
ညောင်	ɲàʊɴ
ညောင်ဖြူ	ɲàʊɴbjù
ညောင်ဗောဓိ	ɲàʊɴbɔ́dḭ
ညောင်လေးပင်	ɲàʊɴlépɪ̀ɴ
ညောင်းကျရောဂါ	ɲáʊɴt͡ɕa̰jɔ́ɡà
ညေး	ɲé
ညံစာစာ	ɲàɴsàzà
ညွန့်	ɲʊ̰ɴ
ညှင်း	ɲ̊ɪ́ɴ
ညှစ်	ɲ̊ɪʔ
ညှပ်	ɲ̊aʔ
ညှာ	ɲ̊à
ဋသန်လျင်းချိတ်	ta̰θəjɪ́ɴd͡ʑeɪʔ
ဌဝမ်းဘဲ	tʰa̰wʊ́ɴbɛ́
ဌာန	tʰàna̰
ဌာပနာ	tʰàpənà
ဌေး	tʰé
ဍရင်ကောက်	da̰jɪ̀ɴɡaʊʔ
ဎရေမှုတ်	da̰jèm̥oʊʔ
ဏကြီး	na̰d͡ʑí
တ	ta̰
တ	tə
တကယ်	dəɡɛ̀
တကာ	dəɡà
တက္ကစီ	tɛʔkəsì
တက္ကဗေဒ	tɛʔka̰bèda̰
တက္ကသိုလ်	tɛʔkəθò
တက်	tɛʔ
တကွ	dəɡwa̰
တချို့	tət͡ɕʰo̰
တခြား	tət͡ɕʰá
တင့်ကား	tɪ̰ɴká
တင်	tɪ̀ɴ
တင်ကူး	tɪ̀ɴɡú
တင်ဒါ	tɪ̀ɴdà
တင်ပါ့ဘုရား	tɪ̀ɴba̰pʰəjá
တင်းတင်း	tɪ́ɴtɪ́ɴ
တင်းထိမ်	tɪ́ɴdèɪɴ
တင်းနစ်	tɪ́ɴnɪʔ
တစပြင်	dəza̰bjɪ̀ɴ
တစောင်း	dəzáʊɴ
တစ္ဆေ	təsʰè
တစ်	tɪʔ
တစ်ခုလပ်	təkʰṵlaʔ
တစ်ချောင်းပုဒ်	tət͡ɕʰáʊɴpoʊʔ
တစ်ဆယ်	təzɛ̀
တစ်ထောင်	tətʰàʊɴ
တစ်ပင်တိုင်မင်းသမီး	dəbɪ̀ɴdàɪɴmɪ́ɴðəmí
တစ်ရာ	təjà
တစ်လ	təla̰
တဆယ်	təzɛ̀
တဆေး	təsʰé
တညင်း	dəɲɪ́ɴ
တညင်းသီး	dəɲɪ́ɴðí
တည်	tì
တည်	tɛ̀
တည်ဆောက်	tìsʰaʊʔ
တည်တံ့	tìda̰ɴ
တည်း	tʰɛ́
တဏှင်္ကရာ	tən̥ɪ̀ɴkəɹà
တဏှင်္ကရာဘုရား	tən̥ɪ̀ɴkəɹàpʰəjá
တဏှာ	tən̥à
တတိယ	ta̰tḭja̰
တတ်	daʔ
တတ်	taʔ
တတ်	ɴ
တတ်	ʔ
တန	ta̰na̰
တနင်္ဂနွေ	tənɪ̀ɴɡənwè
တနင်္လာ	tənɪ́ɴlà
တန်ခိုးရှင်	tàɴkʰóʃɪ̀ɴ
တန်ခူး	dəɡú
တန်ဆောင်မုန်း	dəzàʊɴmóʊɴ
တန်ဇေးနီးယား	tàɴzéníjá
တပည့်တော်	dəbḭdɔ̀
တပည့်တော်မ	dəbḭdɔ̀ma̰
တပို့တွဲ	dəbo̰dwɛ́
တပေါင်း	dəbáʊɴ
တပေါင်းလပြည့်နေ့	dəbáʊɴla̰pjḭnḛ
တပ်	taʔ
တပ်ကြပ်	taʔt͡ɕaʔ
တပ်ကြပ်ကြီး	taʔt͡ɕaʔt͡ɕí
တပ်ခွဲတပ်ကြပ်ကြီး	taʔkʰwɛ́taʔt͡ɕaʔt͡ɕí
တပ်မတော်	taʔmədɔ̀
တပ်မတော်နေ့	taʔmədɔ̀nḛ
တဘက်	dəbɛʔ
တမန်	təmàɴ
တမန်တော်	təmàɴdɔ̀
တမလန်း	təməláɴ
တယော	təjɔ́
တယ်	tɛ̀
တယ်လီဖုန်း	tɛ̀lìpʰóʊɴ
တယ်လီဗီးရှင်း	tɛ̀lìbíʃɪ́ɴ
တရား	təjá
တရားခံ	təjəkʰàɴ
တရားစွဲ	təjáswɛ́
တရားရုံး	təjájóʊɴ
တရားလွှတ်တော်	təjál̥ʊʔtɔ̀
တရားလွှတ်တော်ချုပ်	təjál̥ʊʔtɔ̀d͡ʑoʊʔ
တရားသူကြီး	təjáðùd͡ʑí
တရုတ်	təjoʊʔ
တရုတ်စံကား	ta̰joʊʔsàɴká
တရုတ်ဆီးသီး	təjoʊʔzíθí
တရုတ်နံနံ	ta̰joʊʔnàɴnàɴ
တရုတ်နှင်းသီး	ta̰joʊʔn̥ɪ́ɴθí
တရုတ်မဆလာ	təjoʊʔməsʰəlà
တလည်း	təlé
တလိုင်း	təláɪɴ
တလွဲ	təlwɛ́
တာချီလိတ်	tàt͡ɕʰìleɪʔ
တာဂျစ်ကစ္စတန်	tàd͡ʑɪʔkɪʔsətàɴ
တာတား	tàtá
တာမွေ	tàmwè
တာယာ	tàjà
တာရာ	tàjà
တာလုဇ	tàlṵza̰
တာဝတိံသာ	tàwa̰tèɪɴθà
တာဝန်	tàwʊ̀ɴ
တာ့ခ်မင်နစ္စတန်	ta̰kʰmɪ̀ɴnɪʔsətàɴ
တား	tá
တိ	tḭ
တိတ်	teɪʔ
တိန်းညက်	téɪɴɲɛʔ
တိပိဋက	tḭpḭtəka̰
တိမ်	tèɪɴ
တိရစ္ဆာန်	təɹeɪʔsʰàɴ
တိရစ္ဆာန်ရုံ	təɹeɪʔsʰàɴjòʊɴ
တို	tò
တိုက်	taɪʔ
တိုက်ခန်း	taɪʔkʰáɴ
တိုက်ပုံ	taɪʔpòʊɴ
တိုက်ပွဲ	taɪʔpwɛ́
တိုက်အိမ်	taɪʔʔèɪɴ
တိုကျို	tòt͡ɕò
တိုဂို	tòɡò
တိုင်	tàɪɴ
တိုင်ကီ	tàɪɴkì
တိုင်ပင်	tàɪɴbɪ̀ɴ
တိုင်ဖွန်း	tàɪɴpʰʊ́ɴ
တိုင်းရင်းသား	táɪɴjɪ́ɴðá
တိုဖူး	tòpʰú
တိုရှေ	tòʃè
တိုဟူး	tòhú
တိုဟူးနွေး	tòhúnwé
တိုဟူးသုပ်	tòhúθoʊʔ
တို့	do̰
တိုး	tó
တိုးတက်	tótɛʔ
တိုးတက်ခြင်း	tótɛʔd͡ʑɪ̀ɴ
တိုးတက်ရေး	tótɛʔjé
တိုးတိုး	tódó
တိုးနရား	tónəjá
တိဿ	teɪʔθa̰
တိဿဘုရား	teɪʔθa̰pʰəjá
တီ	tì
တီကောင်	tìɡàʊɴ
တီကေ့	tìkḛ
တီထွင်	tìtʰwɪ̀ɴ
တီထွင်မှု	tìtʰwɪ̀ɴm̥ṵ
တီဗီ	tìbì
တီရှပ်	tìʃaʔ
တီဟီရန်	tìhìɹàɴ
တီး	tí
တီးတိုးပြော	tídópjɔ́
တုတ်	doʊʔ
တုတ်မီး	doʊʔmí
တုံး	tóʊɴ
တူ	tù
တူနီးရှား	tùníʃá
တူမ	tùma̰
တူရကီ	tùɹəkì
တူရိယာ	tùɹḭjà
တူး	tú
တူးမြောင်း	túmjáʊɴ
တူးရစ်	túɹɪʔ
တေဇော	tèzɔ́
တေသံ	tèðàɴ
တော	tɔ́
တောက်တဲ့	taʊʔtɛ̰
တောက်ပ	taʊʔpa̰
တောကြက်မောက်	tɔ́t͡ɕɛʔmaʊʔ
တောခွေး	tɔ́ɡwé
တောင်	tàʊɴ
တောင်ကိုရီးယား	tàʊɴkòɹíjá
တောင်ကြား	tàʊɴd͡ʑá
တောင်ကြီး	tàʊɴd͡ʑí
တောင်ငူ	tàʊɴŋù
တောင်ဆူဒန်	tàʊɴsʰùdàɴ
တောင်ပံ	tàʊɴbàɴ
တောင်ဖက်ဝန်း	tàʊɴpʰɛʔwʊ́ɴ
တောင်သူ	tàʊɴðù
တောင်သူလယ်သမား	tàʊɴðùlɛ̀ðəmá
တောင်သူလယ်သမားနေ့	tàʊɴðùlɛ̀θəmánḛ
တောင်အာဖရိက	tàʊɴʔàpʰəɹḭka̰
တောင်း	táʊɴ
တောင်းပန်	táʊɴbàɴ
တောမန်ကျည်း	tɔ́məd͡ʑí
တောသား	tɔ́ðá
တောသီတင်း	tɔ́θìdɪ́ɴ
တော်	tɔ̀
တော်ပြီ	tɔ̀bì
တော်လေးဝ	tɔ̀léwa̰
တော်လှန်	tɔ̀l̥àɴ
တော်လှန်ရေး	tɔ̀l̥àɴjé
တော်သလင်း	tɔ̀ðəlɪ́ɴ
တေးသံရှင်	téθàɴʃɪ̀ɴ
တေးသွား	téðwá
တဲ	tɛ́
တဲ့	dɛ̰
တံ	tàɴ
တံခါး	dəɡá
တံခါးဗိုလ်	dəɡábò
တံခွန်	dəɡʊ̀ɴ
တံခွန်တိုင်	dəɡʊ̀ɴdàɪɴ
တံငါ	təŋà
တံစဉ်	dəzɪ̀ɴ
တံစဉ်း	dəzɪ́ɴ
တံဆိပ်	dəzeɪʔ
တံဆိပ်ခေါင်း	dəzeɪʔɡáʊɴ
တံတား	dədá
တံတိုင်း	dədáɪɴ
တံတောင်	dədàʊɴ
တံပိုး	dəbó
တံပူ	dəbù
တံမြက်စည်း	dəbjɛʔsí
တံ့တံ့	ta̰ɴda̰ɴ
တြိ	təɹḭ
တြိဂံ	tɹḭɡàɴ
တြိပူရ	təɹḭpùja̰
တွက်	twɛʔ
တွင်	twɪ̀ɴ
တွင်း	twɪ́ɴ
တွန်း	tʊ́ɴ
တွပ်	tʊʔ
တွေ့	twḛ
တွေး	twé
ထ	tʰa̰
ထက်	tʰɛʔ
ထက်ဝယ်ဖွဲ့ခွေ	tʰɛʔwɛ̀pʰwɛ̰kʰwè
ထင်	tʰɪ̀ɴ
ထင်စား	tʰɪ̀ɴzá
ထင်း	tʰɪ́ɴ
ထဆင်ထူး	tʰa̰sʰɪ̀ɴdú
ထည်	tʰɛ̀
ထနောင်း	tʰənáʊɴ
ထန်း	tʰáɴ
ထန်းလျက်	tʰəɲɛʔ
ထပ်	tʰaʔ
ထပ်တစ်ရာ	tʰaʔtəjà
ထဘီ	tʰəmì
ထမင်း	tʰəmɪ́ɴ
ထမင်းကြော်	tʰəmɪ́ɴd͡ʑɔ̀
ထမင်းချဉ်	tʰəmɪ́ɴd͡ʑɪ̀ɴ
ထမင်းဆိုင်	tʰəmɪ́ɴzàɪɴ
ထမင်းသုပ်	tʰa̰mɪ́ɴθoʊʔ
ထမနဲ	tʰa̰ma̰nɛ́
ထယ်	tʰɛ̀
ထာဝရ	tʰàwəja̰
ထာဝရဥစ္စာ	tʰàwəja̰ʔoʊʔsà
ထား	tʰá
ထားဝယ်	dəwɛ̀
ထိ	tʰḭ
ထိကပေါက်	tʰḭɡəbaʊʔ
ထိပ်ခေါင်တင်	tʰeɪʔkʰàʊɴtɪ̀ɴ
ထိပ်စုဖုရား	tʰeɪʔsṵpʰəjá
ထိမ်းမြား	tʰéɪɴmjá
ထို	tʰò
ထိုင်	tʰàɪɴ
ထိုင်ခုံ	tʰàɪɴɡòʊɴ
ထိုင်ပေ	tʰàɪɴpè
ထိုင်မသိမ်း	tʰàɪɴməθéɪɴ
ထိုင်ဝမ်	tʰàɪɴwàɴ
ထိုင်း	tʰáɪɴ
ထိုမှာ	tʰòm̥à
ထိုး	tʰó
ထိုးမုန့်	tʰómo̰ʊɴ
ထီ	tʰì
ထီး	tʰí
ထီးတင်	tʰítɪ̀ɴ
ထီးဖြူ	tʰíbjù
ထုတ်ကုန်	tʰoʊʔkòʊɴ
ထုတ်လုပ်	tʰoʊʔloʊʔ
ထုတ်လုပ်မှု	tʰoʊʔloʊʔm̥ṵ
ထုတ်ဝေသူ	tʰoʊʔwèðù
ထုံးစံ	tʰóʊɴzàɴ
ထူ	tʰù
ထူထဲ	tʰùdɛ́
ထူပါ	tʰùpà
ထူး	tʰú
ထေရဝါဒ	tʰèja̰wàda̰
ထော	tʰɔ́
ထောက်	tʰaʊʔ
ထောက်ကြံ့	tʰaʊʔt͡ɕa̰ɴ
ထောက်ခံ	tʰaʊʔkʰàɴ
ထောက်ပံ့	tʰaʊʔpa̰ɴ
ထောင့်	da̰ʊɴ
ထောင်	tʰàʊɴ
ထောင်ကဲ	tʰàʊɴkɛ́
ထောင်မှူး	tʰàʊɴm̥ú
ထောင်သား	tʰàʊɴðá
ထောပတ်	tʰɔ́baʔ
ထောပတ်ထမင်း	tʰɔ́baʔtʰəmɪ́ɴ
ထောပတ်သီး	tʰɔ́paʔθí
ထော်လာဂျီ	tʰɔ̀làd͡ʑì
ထဲ	tʰɛ́
ထံ	tʰàɴ
ထွက်	tʰwɛʔ
ထွက်ပေါက်	tʰwɛʔpaʊʔ
ထွက်ပြေး	tʰwɛʔpjé
ထွန်	tʰʊ̀ɴ
ထွန်စက်	tʰʊ̀ɴzɛʔ
ထွန်း	tʰʊ́ɴ
ထွေး	tʰwé
ဒကာ	dəɡà
ဒက္ခိဏ	dɛʔkʰḭna̰
ဒဂုံ	dəɡòʊɴ
ဒင်္ဂါး	dɪ̀ɴɡá
ဒင်္ဂါးတိုက်	dɪ̀ɴɡádaɪʔ
ဒစ္စကို	dɪʔsa̰kò
ဒဏ္ဍာရီ	dàndàjì
ဒဏ်	dàn
ဒဏ်ငွေ	dànŋwè
ဒဏ်ရာ	dàɴjà
ဒထွေး	da̰dwé
ဒန့်သလွန်	da̰ɴðəlʊ̀ɴ
ဒန်ပူ	dəbù
ဒန်း	dáɴ
ဒသမ	da̰θəma̰
ဒါ	dà
ဒါန	dàna̰
ဒါပါပဲ	dàbàbɛ́
ဒါပေမဲ့	dàbèmɛ̰
ဒါပော့	dàpɔ̰
ဒိန်ခဲ	dèɪɴɡɛ́
ဒိန်ချဉ်	dèɪɴd͡ʑɪ̀ɴ
ဒိန်းမတ်	déɪɴmaʔ
ဒိုင်ခွက်	dàɪɴɡwɛʔ
ဒိုင်နိုဆော	dàɪɴnòsʰɔ́
ဒိုင်ယာနာ	dàɪɴjànà
ဒိုင်ယာရီ	dàɪɴjəɹì
ဒီ	dì
ဒီဂရီ	dìɡəɹì
ဒီဃ	dìɡa̰
ဒီဇင်ဘာ	dìzɪ̀ɴbà
ဒီဇိုင်နာ	dìzàɪɴnà
ဒီဇိုင်း	dìzáɪɴ
ဒီည	dìɲa̰
ဒီနေ့	dìnḛ
ဒီပင်္ကရာ	dìpɪ̀ɴkəɹà
ဒီပင်္ကရာဘုရား	dìpɪ̀ɴkəɹàpʰəjá
ဒီပါ	dìpà
ဒီပါဝလီ	dìpàwəlì
ဒီဗီဒီ	dìbìdì
ဒီမိုကရေစီ	dìmòkəɹèsì
ဒီမှာ	dìm̥à
ဒီလို	dìlò
ဒီဟာ	dìhà
ဒု	dṵ
ဒုက္ခ	doʊʔkʰa̰
ဒုက္ခသည်	doʊʔkʰa̰ðè
ဒုက္ခိတ	doʊʔkʰḭta̰
ဒုတိယ	dṵtḭja̰
ဒုတိယတပ်ကြပ်	dṵtḭja̰taʔt͡ɕaʔ
ဒုတိယဗိုလ်	dṵtḭja̰bò
ဒုတိယဗိုလ်ချုပ်ကြီး	dṵtḭja̰bòd͡ʑoʊʔd͡ʑí
ဒုတိယဗိုလ်ချုပ်မှူးကြီး	dṵtḭja̰bòd͡ʑoʊʔm̥úd͡ʑí
ဒုတိယဗိုလ်မှူးကြီး	dṵtḭja̰bòm̥úd͡ʑí
ဒုတိယအရာခံဗိုလ်	dṵtḭja̰ʔəjàɡàɴbò
ဒုဗ္ဘိက္ခန္တရကပ်	doʊʔbeɪʔkʰàɴtəɹa̰kaʔ
ဒုယင်တော်	dəjɪ̀ɴdɔ̀
ဒုံမင်း	dòʊɴmɪ́ɴ
ဒုံး	dóʊɴ
ဒုံးပျံ	dóʊɴbjàɴ
ဒူလာ	dùlà
ဒူး	dú
ဒူးခေါင်း	dúɡáʊɴ
ဒူးထောက်	dútʰaʊʔ
ဒူးရင်းယို	dújɪ́ɴjò
ဒူးရင်းသီး	dújɪ́ɴθí
ဒူးလေး	dúlé
ဒူးဝါး	dúwá
ဒေတာဘေ့စ်	dètàbḛs
ဒေဝ	dèwa̰
ဒေဝဒတ်	dèwədaʔ
ဒေဝနာဂရီ	dèwa̰nàɡəɹì
ဒေဝါလီခံ	dèwàlìkʰàɴ
ဒေဝီ	dèwì
ဒေသ	dèθa̰
ဒေသန္တရ	dèθàɴtəja̰
ဒေသန္တရစကား	dèθàɴtəɹa̰zəɡá
ဒေသိယစကား	dèθḭja̰zəɡá
ဒေါက်တာ	daʊʔtà
ဒေါင်း	dáʊɴ
ဒေါင်းလန်း	dáʊɴláɴ
ဒေါ်	dɔ̀
ဒေါ်ကြီး	dɔ̀d͡ʑí
ဒေါ်လာ	dɔ̀là
ဒေါ်လေး	dɔ̀lé
ဒံပေါက်	dàɴpaʊʔ
ဒြပ်	dəɹaʔ
ဒြပ်စင်	dəɹaʔsɪ̀ɴ
ဒြပ်ထု	dəɹaʔtʰù
ဒွယံဒွယံ	dwa̰jàɴdwa̰jàɴ
ဒွာရ	dwàja̰
ဒွိ	dwḭ
ဒွိလိင်	dwḭlèɪɴ
ဒွေးဘော်	dwébɔ̀
ဒဿဂီရိ	dəθa̰ɡìjḭ
ဒဿနဗေဒ	da̰θəna̰bèda̰
ဒဿနိကဗေဒ	da̰θənḭka̰bèda̰
ဓနရှင်	dəna̰ʃɪ̀ɴ
ဓနိတ	dənḭta̰
ဓနု	dənṵ
ဓမ္မ	dəma̰
ဓမ္မတာ	dəmədà
ဓမ္မတာကာလ	dəmədàkàla̰
ဓမ္မတာလာ	dəmədàlà
ဓမ္မတာဝန်	dəmədàwʊ̀ɴ
ဓမ္မဒဿီ	dəma̰ma̰daʔθì
ဓမ္မဒဿီဘုရား	dəma̰dətθìpʰəjá
ဓမ္မပါလ	dàɴma̰pàla̰
ဓမ္မသတ်	dəməθaʔ
ဓလေ့	dəlḛ
ဓအောက်ခြိုက်	da̰ʔaʊʔt͡ɕʰaɪʔ
ဓာတုဗေဒ	dàtṵbèda̰
ဓာတ်	daʔ
ဓာတ်ကြီးလေးပါး	dàtt͡ɕílépá
ဓာတ်ခဲ	daʔkʰé
ဓာတ်ခွက်	dàtkʰwɛʔ
ဓာတ်ငွေ့	daʔŋwḛ
ဓာတ်ဆီ	daʔsʰì
ဓာတ်ဆီဆိုင်	daʔsʰìzàɪɴ
ဓာတ်ပုံ	daʔpòʊɴ
ဓာတ်ပြား	daʔpjà
ဓာတ်မီးခြစ်	daʔmíd͡ʑɪʔ
ဓာတ်မီးပူ	daʔmíbù
ဓာတ်လှေကား	daʔl̥èɡá
ဓာတ်အိုး	daʔʔó
ဓား	dá
ဓားစာခံ	dəzàɡàɴ
ဓားပြ	dəmja̰
ဓားပြား	dəbjá
ဓားအိမ်	dəʔèɪɴ
နက္ခတ္တဗေဒ	nɛʔkʰəta̰bèda̰
နက်	nɛʔ
နက်ဖြန်	nɛʔpʰjàɴ
နကျယ်ကောင်	nəd͡ʑɛ̀ɡàʊɴ
နဂါး	nəɡá
နဂါးမောက်	na̰ɡámaʊʔ
နဂါးမောက်သီး	na̰ɡámaʊʔθí
နငယ်	na̰ŋɛ̀
နင်	nɪ̀ɴ
နင်တို့	nɪ̀ɴdo̰
နည်း	nɛ́
နည်းနည်း	nɛ́nɛ́
နည်းနည်းချင်း	nínít͡ɕʰɪ́ɴ
နည်းပညာ	nípjɪ̀ɴɲà
နတ်	naʔ
နတ်ကွန်း	naʔkʊ́ɴ
နတ်ဆိုး	naʔsʰó
နတ်တော်	nədɔ̀
နတ်နန်း	naʔnáɴ
နတ်ပြည်ခြောက်ထပ်	naʔpjìt͡ɕʰaʊʔtʰaʔ
နတ်ရွာစံ	naʔjwàsàɴ
နတ်သုဓာ	naʔθoʊʔdà
နတ်သုဓာထမင်း	naʔθoʊʔdàtʰəmɪ́ɴ
နဒီ	nədì
နန္ဒာ	nàɴdà
နန်း	náɴ
နန်းကထိ	náɴkətʰḭ
နန်းကြီး	náɴt͡ɕí
နန်းကြီးသုပ်	náɴt͡ɕíθoʊʔ
နန်းတော်	náɴdɔ̀
နန်းပြားသုပ်	náɴbjáθoʊʔ
နန်းမတော်	náɴmədɔ̀
နန်းမြင့်	náɴmjɪ̰ɴ
နနွင်း	sʰənwɪ́ɴ
နပန်း	nəbáɴ
နဖူး	na̰pʰú
နမီးဘီးယား	na̰míbíjá
နမူနာ	nəmùnà
နမ်း	náɴ
နယုန်	nəjòʊɴ
နယူးဇီလန်	nəjúzìlàɴ
နယူးဒေလီ	nəjúdèlì
နယူးယောက်	nəjújaʊʔ
နယ်	nɛ̀
နယ်စပ်	nɛ̀zaʔ
နယ်သာလန်	nɛ̀ðəlàɴ
နရက်	nəɹɛʔ
နရန်း	nəjáɴ
နရား	nəjá
နဝကမ္မ	nəwa̰kàɴma̰
နဝမ	nəwəma̰
နဝရတ်	nəwəɹaʔ
နဝရူပ	na̰wa̰jùpa̰
နာ	nà
နာဂဒေဝ	nàɡa̰dèwa̰
နာဂရီ	nàɡəɹì
နာတာလူးပွဲ	nàtàlúbwɛ́
နာနတ်	nənaʔ
နာနတ်ပွင့်	nənaʔpwɪ̰ɴ
နာနတ်သီး	nànaʔθí
နာနာ	nànà
နာနာဘာဝ	nànàbàwa̰
နာမ	nàma̰
နာမကရဏ	nàma̰kəɹəna̰
နာမကျန်း	nàmət͡ɕáɴ
နာမည်	nàmjì
နာမဝိသေသန	nàma̰wḭθèθəna̰
နာမ်	nàɴ
နာမ်စား	nàmzá
နာရဒ	nàɹəda̰
နာရဒဘုရား	nàɹəda̰pʰəjá
နာရီ	nàjì
နာရီဝက်	nàjìwɛʔ
နား	ná
နားကပ်	náɡaʔ
နားကြပ်	nəd͡ʑaʔ
နားကွင်း	náɡwɪ́ɴ
နားထင်	nətʰɪ̀ɴ
နားထောင်	nátʰàʊɴ
နားရွက်	nəjwɛʔ
နားလည်	nálɛ̀
နိကာယ	nḭkàja̰
နိခါတကဗေဒ	nḭkʰàtəka̰bèda̰
နိဂ္ဂဟိတ	neɪʔɡəhḭta̰
နိစ္စ	nèsa̰
နိဒါန်း	nḭdáɴ
နိဒ္ဒေသ	neɪʔdèθa̰
နိပေါ	nḭpɔ́
နိဗ္ဗာန်	neɪʔbàɴ
နိယာမ	nḭjàma̰
နိုက်ထရိုဂျင်	naɪʔtʰəɹòd͡ʑɪ̀ɴ
နိုင်	nàɪɴ
နိုင်ဂျာ	nàɪɴd͡ʑà
နိုင်ဂျီးရီးယား	nàɪɴd͡ʑíɹíjá
နိုင်ငံ	nàɪɴŋàɴ
နိုင်ငံကူးလက်မှတ်	nàɪɴŋàɴɡúlɛʔm̥aʔ
နိုင်ငံခြား	nàɪɴŋàɴd͡ʑá
နိုင်ငံခြားသား	nàɪɴɡàɴd͡ʑáðà
နိုင်ငံတော်	nàɪɴŋàɴdɔ̀
နိုင်ငံတော်သီချင်း	nàɪɴŋàɴdɔ̀θət͡ɕʰɪ́ɴ
နိုင်ငံရေး	nàɪɴŋàɴjé
နိုင်ငံသား	nàɪɴŋàɴðá
နိုင်ငံသားအဖြစ်	nàɪɴŋàɴðáʔəpʰjɪʔ
နိုင်နိုင်	nàɪɴnàɪɴ
နိုဝင်ဘာ	nòwɪ̀ɴbà
နို့	no̰
နို့ဆီ	no̰zì
နို့လိမ်	no̰lèɪɴ
နို့သီး	no̰ðí
နို့သီးခေါင်း	no̰ðíɡáʊɴ
နိုး	nó
နိဿယ	neɪʔθəja̰
နီ	nì
နီကာရာဂွါ	nìkàɹàɡwà
နီတိ	nìtḭ
နီလာ	nìlà
နီး	ní
နုပ်	noʊʔ
နေ	nè
နေကောင်း	nèkáʊɴ
နေကောင်းရဲ့လား	nèkáʊɴjɛ̰lá
နေစကြဝဠာ	nèsɛʔt͡ɕàwəlà
နေစာ	nèzà
နေထွက်	nètʰwɛʔ
နေပြည်တော်	nèpjìdɔ̀
နေရာ	nèjà
နေရာငါးသွယ်	nèjàŋáθwɛ̀
နေရာထိုင်ခင်း	nèjàtʰàɪɴɡɪ́ɴ
နေဝင်	nèwɪ̀ɴ
နေအိမ်	nèʔèɪɴ
နောက်	naʊʔ
နောက်ကျ	naʊʔt͡ɕa̰
နောက်ဆက်	naʊʔsʰɛʔ
နောက်ပြီး	naʊʔpí
နောက်ရုံး	naʊʔjóʊɴ
နောင်	nàʊɴ
နော်	nɔ̀
နော်ရထာ	nɔ̀jətʰà
နော်ဝေ	nɔ̀wè
နေ့	nḛ
နေ့စဉ်	nḛzɪ̀ɴ
နေ့စွဲ	nḛzwɛ́
နေ့လည်	nḛlɛ̀
နေ့လယ်	nḛlɛ̀
နေ့လယ်စာ	nḛlɛ̀zà
နဲ့	nɛ̰
နံကထိုင်	nàɴkətʰàɪɴ
နံနက်	nàɴnɛʔ
နံနက်စာ	nàɴnɛʔsà
နံနံ	nàɴnàɴ
နံပါတ်	nàɴbaʔ
နံပြား	nàɴbjá
နံရိုး	nàɴjó
နျူကလိယ	njùkəlḭja̰
နွယ်တာ	nwɛ̀tà
နွား	nwá
နွားထီး	nətʰí
နွားနို့	nwáno̰
နွားနို့ခေါက်ဆွဲ	nwáno̰kʰaʊʔsʰwɛ́
နွားမ	nəma̰
နွေ	nwè
နွေရာသီ	nwèjàðì
နွေဦး	nwèʔú
နွေဦးပေါက်	nwèʔúbaʊʔ
နွေဦးရာသီ	nwèʔújàðì
နွေး	nwé
နှင့်	n̥ɪ̰ɴ
နှင့်တကွ	n̥ɪ̰ɴdəɡwa̰
နှင်း	n̥ɪ́ɴ
နှင်းခဲ	n̥ɪ́ɴɡɛ́
နှင်းပွင့်	n̥ɪ́ɴbwɪ̰ɴ
နှင်းသီး	n̥ɪ́ɴðí
နှစ်	n̥ɪʔ
နှစ်ချုပ်	n̥ɪʔd͡ʑoʊʔ
နှစ်ချောင်းပုဒ်	n̥ət͡ɕʰáʊɴpoʊʔ
နှစ်စဉ်	n̥ɪʔzɪ̀ɴ
နှစ်ဆန်းတစ်ရက်	n̥ɪʔsʰáɴtəjɛʔ
နှစ်ဆန်းတစ်ရက်နေ့	n̥ɪʔsʰáɴtəjɛʔnḛ
နှစ်ဆယ့်တစ်	n̥ɪʔsʰɛ̰tɪʔ
နှစ်ဆယ်	n̥ɪʔsʰɛ̀
နှစ်ရာ	n̥əjà
နှစ်လ	n̥əla̰
နှပ်	n̥aʔ
နှမ	n̥əma̰
နှမ်း	n̥áɴ
နှမ်းစေ့	n̥áɴzḛ
နှမ်းဆီ	n̥áɴzì
နှလုံး	n̥əlóʊɴ
နှလုံးရောဂါ	n̥əlóʊɴjɔ́ɡà
နှာ	n̥à
နှာခေါင်း	n̥əkʰáʊɴ
နှာခေါင်းပေါက်	n̥əkʰáʊɴbaʊʔ
နှာဘူး	n̥àbú
နှာမောင်း	n̥əmáʊɴ
နှိပ်ကြယ်သီး	n̥eɪʔt͡ɕɛ̀ðí
နှုတ်	n̥oʊʔ
နှုတ်ခမ်း	n̥oʊʔkʰáɴ
နှုတ်ဆက်	n̥oʊʔsʰɛʔ
နှုတ်သီး	n̥oʊʔθí
နှော	n̥ɔ́
နှောက်	n̥aʊʔ
နှောင်း	n̥áʊɴ
နှေး	n̥é
နှံကောင်	n̥àɴɡàʊɴ
ပကတိ	bəɡədḭ
ပကောဋိ	pəkɔ́dḭ
ပက်ကျိ	pɛʔt͡ɕḭ
ပခုက္ကူ	pəkʰùkkù
ပခုံး	pəkʰóʊɴ
ပင့်	pɪ̰ɴ
ပင့်ကူ	pɪ̰ɴɡù
ပင့်ကူအိမ်	pɪ̰ɴɡùʔèɪɴ
ပင်ဂွင်	pɪ̀ɴɡwɪ̀ɴ
ပင်စင်	pɪ̀ɴsɪ̀ɴ
ပင်စင်စား	pɪ̀ɴsɪ̀ɴsá
ပင်စည်	pɪ̀ɴzì
ပင်စိမ်း	pɪ̀ɴzéɪɴ
ပင်စိမ်းမွှေး	pɪ̀ɴzéɪɴm̥wé
ပင်ပေါင်	pɪ̀ɴpàʊɴ
ပင်မှည့်	pɪ̀ɴm̥ɛ̰
ပင်လယ်	pɪ̀ɴlɛ̀
ပင်လယ်ဆား	pɪ̀ɴlɛ̀zá
ပင်လယ်ဓားပြ	pɪ̀ɴlɛ̀dəmja̰
ပင်လယ်အော်	pɪ̀ɴlɛ̀ʔɔ̀
ပစောက်	pa̰zaʊʔ
ပစ္စက္ခ	pɪʔsɛʔkʰa̰
ပစ္စည်း	pɪʔsí
ပစ္စည်းလေးပါး	pjɪʔsílébá
ပစ္စယာ	pjɪʔsəjà
ပစ္စုပ္ပန်	pjɪʔsoʊʔpàɴ
ပစ္ဆိမ	pjɪʔsʰeɪʔma̰
ပစ်	pjɪʔ
ပဇာ	bəzà
ပဉ္စကလျာဏီ	pjɪ̀ɴsa̰kələjànì
ပဉ္စင်တူရိယာ	pjɪʔsɪ̀ɴtùɹḭjà
ပဉ္စင်း	bəzɪ́ɴ
ပဉ္စမ	pjɪ̀ɴsəma̰
ပဉ္စရူပ	pjɪ̀ɴsa̰ɹùpa̰
ပဉ္စလက်	pɪ̀ɴsəlɛʔ
ပညတ်	pjɪ̰ɴnaʔ
ပညတ်တော်	pjɪ̰ɴnaʔtɔ̀
ပညာ	pjɪ̀ɴɲà
ပညာကျော်	pjɪ̀ɴɲàd͡ʑɔ̀
ပညာပေး	pjɪ̀ɴɲàpé
ပညာဗလ	pjɪ̀ɴɲàbəla̰
ပညာရေး	pjɪ̀ɴɲàjé
ပညာရှင်	pjɪ̀ɴɲàʃɪ̀ɴ
ပဋိဇီဝဆေး	pa̰dḭzìwa̰sʰé
ပဋိပက္ခ	pətḭpɛʔkʰa̰
ပဋိပက္ခဒေသ	pədḭpɛʔkʰa̰dèθa̰
ပဋိသန္ဓေ	pədḭθàɴdè
ပဌမ	pa̰tʰa̰ma̰
ပဏ္ဍိတ	pàndḭta̰
ပဏ္ဏာ	pənà
ပတ္တမြား	bədəmjá
ပတ္တလား	paʔta̰lá
ပတ္ထနာ	pətʰənà
ပတ်	paʔ
ပတ်စပို့	paʔsəpo̰
ပတ်တီး	paʔtí
ပတ်ဝန်းကျင်	paʔwʊ́ɴt͡ɕɪ̀ɴ
ပထမ	pa̰tʰa̰ma̰
ပထမဘွဲ့	pa̰tʰəma̰bwɛ̰
ပထဝီဝင်	pətʰəwìwɪ̀ɴ
ပထွေး	pətʰwé
ပဒုမ	pədṵma̰
ပဒုမဘုရား	pədṵma̰pʰəjá
ပဒုမုတ္တရ	pədṵmoʊʔtəɹa̰
ပဒုမုတ္တရဘုရား	pədṵmoʊʔtəɹa̰pʰəjá
ပဒေသရာဇ်	bədèθəɹɪʔ
ပဒေသာ	bədèðà
ပဒေသာပင်	bədèðàbɪ̀ɴ
ပနားမား	pa̰námá
ပန်	pàɴ
ပန်ကာ	pàɴkà
ပန်တျာ	pàɴtəjà
ပန်း	páɴ
ပန်းကန်	bəɡàɴ
ပန်းခုနစ်မည်	páɴkʰənəmjì
ပန်းချီ	bəd͡ʑì
ပန်းချီဆရာ	bəd͡ʑìsʰəjà
ပန်းခြံ	páɴd͡ʑàɴ
ပန်းဂေါ်ဖီ	páɴɡɔ̀bì
ပန်းစည်း	páɴzí
ပန်းဆယ်မျိုး	páɴsʰɛ̀mjó
ပန်းတဉ်း	bədɪ́ɴ
ပန်းတမော့	páɴdəmɔ̰
ပန်းတော့	páɴdɔ̰
ပန်းထိမ်	bədèɪɴ
ပန်းနာ	páɴnà
ပန်းနာရင်ကျပ်	páɴnàjɪ̀ɴt͡ɕaʔ
ပန်းပု	bəbṵ
ပန်းပဲ	bəbɛ́
ပန်းပွတ်	bəbʊʔ
ပန်းမုန်လာ	páɴmòʊɴlà
ပန်းမုန်လာစိမ်း	páɴmòʊɴlàzéɪɴ
ပန်းမုန်လာဖြူ	páɴmòʊɴlàbjù
ပန်းယွန်း	páɴjʊ́ɴ
ပန်းရန်	bəjàɴ
ပန်းရွဲ	páɴjwɛ́
ပန်းသီး	páɴðí
ပန်းသေရောဂါ	páɴθèjɔ́ɡà
ပန်းသေး	páɴðé
ပန်းသေးခေါက်ဆွဲ	páɴθékʰaʊʔsʰwɛ́
ပန်းအိ	páɴʔḭ
ပန်းအိုး	páɴʔó
ပမာဏ	pəmàna̰
ပယောဂ	pəjɔ́ɡa̰
ပယ်ရှား	pɛ̀ʃá
ပရဟိတ	pəɹa̰hḭta̰
ပရိက္ခရာ	pəɹeɪʔkʰəjà
ပရိဒေဝ	pəɹḭdèwa̰
ပရိဘောဂ	pəɹḭbɔ́ɡa̰
ပရိယာယ်	pəɹḭjè
ပရိသတ်	pəjeɪʔθaʔ
ပရိုဂရမ်	pəɹòɡəɹàɴ
ပရိုဂျက်	pəɹòd͡ʑɛʔ
ပရုတ်	pəjoʊʔ
ပလတ်	pəlaʔ
ပလတ်စတစ်	pəlaʔsətɪʔ
ပလပ်ကြွတ်	pa̰laʔt͡ɕʊʔ
ပလပ်စတစ်	pəlaʔsətɪʔ
ပလာတာ	pəlàtà
ပလိပ်	pəleɪʔ
ပလူတိုနီယမ်	pəlùtònìjàɴ
ပလောင်	pəlàʊɴ
ပလ္လင်	pəlɪ̀ɴ
ပလွေ	pa̰lwè
ပဝရ	pəwəɹa̰
ပဝါ	pa̰wà
ပဝေဏီ	pəwènì
ပသီ	pəθì
ပသျှူး	pəʃú
ပသျှူးရာမ	pəʃújàma̰
ပအို့ဝ်	pəʔo̰
ပါ	pà
ပါကစ္စတန်	pàkɪʔsətàɴ
ပါဆယ်	pàsʰɛ̀
ပါတာနီ	pàtànì
ပါတိတ်	pàteɪʔ
ပါတီ	pàtì
ပါပူအာနယူးဂီနီ	pàpùʔànəjúɡìnì
ပါမောက္ခ	pàmaʊʔkʰa̰
ပါရဂူဘွဲ့	pàjəɡùbwɛ̰
ပါရမီ	pàɹəmì
ပါရရာ	pàɹəjà
ပါရာဂွေး	pàɹàɡwé
ပါရီ	pàɹì
ပါရှား	pàʃá
ပါလက်စတိုင်း	pàlɛʔsətáɪɴ
ပါလီမန်	pàlìmàɴ
ပါဝါ	pàwà
ပါဠိ	pàlḭ
ပါး	pá
ပါးစပ်	pəzaʔ
ပါးဟက်	pəhɛʔ
ပိ	pḭ
ပိဋကတ်	bḭtəɡaʔ
ပိဋကတ်တိုက်	bḭdəɡaʔdaɪʔ
ပိတ်	peɪʔ
ပိန္နဲ	péɪɴnɛ́
ပိန်းဥ	péɪɴʔṵ
ပိရမစ်	pḭɹəmɪʔ
ပို	pò
ပိုက်	paɪʔ
ပိုက်ဆံ	paɪʔsʰàɴ
ပိုက်ဆံအိတ်	paɪʔsʰàɴʔeɪʔ
ပိုက်သမား	paɪʔθəmá
ပိုင်ရှင်	pàɪɴʃɪ̀ɴ
ပိုင်း	páɪɴ
ပိုစတာ	pòsətà
ပိုတက်ဆီယမ်	pòtɛʔsʰìjàɴ
ပိုဒ်	paɪʔ
ပိုလန်	pòlàɴ
ပို့	po̰
ပို့စကတ်	po̰səkaʔ
ပိုး	pó
ပိုးကြာချည်	pót͡ɕàt͡ɕʰì
ပိုးတောင်မာ	pódàʊɴmà
ပိုးလောင်း	póláʊɴ
ပိုးဟပ်	póhaʔ
ပိုးဟပ်ဖြူ	póhaʔpʰjù
ပိဿာ	peɪʔθà
ပီကင်း	pìkɪ́ɴ
ပီကေ	pìkè
ပီစီ	pìsì
ပီဇာ	pìzà
ပီတိ	pìtḭ
ပီပီ	pìbì
ပီယဒဿီ	pìja̰daʔθì
ပီယဒဿီဘုရား	pìja̰daʔθìpʰəjá
ပီရူး	pìɹú
ပီလောပီနံ	pìlɔ́pìnàɴ
ပု	pṵ
ပုခက်	pəkʰɛʔ
ပုဂံ	bəɡàɴ
ပုဂ္ဂလိက	poʊʔɡəlḭɡa̰
ပုဂ္ဂိုလ်	poʊʔɡò
ပုစဉ်း	bəzɪ́ɴ
ပုစ္ဆာ	poʊʔsʰà
ပုစွန်	bəzʊ̀ɴ
ပုဆိန်	pəsʰèɪɴ
ပုဆိုး	pəsʰó
ပုဏ္ဏမာ	pòʊɴnəmà
ပုဏ္ဏား	pòʊɴná
ပုဏ္ဏားကျွန်း	pòʊɴnád͡ʑʊ́ɴ
ပုတ်သင်ညို	poʊʔθɪ̀ɴɲò
ပုထိုး	pətʰó
ပုဒ်	poʊʔ
ပုဒ်ကလေး	poʊʔkəlé
ပုဒ်ကြီး	poʊʔd͡ʑí
ပုဒ်ထီး	poʊʔkəlé
ပုဒ်ဖြတ်	poʊʔpʰjaʔ
ပုဒ်မ	poʊʔma̰
ပုန်ကန်	pòʊɴkàɴ
ပုန်းရည်ကြီး	póʊɴjèd͡ʑí
ပုပ်	poʊʔ
ပုဗ္ဗ	poʊʔba̰
ပုရစ်	pəjɪʔ
ပုရပိုက်	pəɹəbaɪʔ
ပုရွက်	pəjwɛʔ
ပုရွက်ဆိတ်	pəjwɛʔsʰeɪʔ
ပုလင်း	pəlɪ́ɴ
ပုလိပ်	pəleɪʔ
ပုလဲ	pəlɛ́
ပုသိမ်	pəθèɪɴ
ပုံ	pòʊɴ
ပုံဆွဲ	pòʊɴsʰwɛ́
ပုံတူ	pòʊɴdù
ပုံတူကား	pòʊɴdùká
ပုံနှိပ်စက်	pòʊɴn̥eɪʔsɛʔ
ပုံသေနည်း	pòʊɴðèní
ပုံး	póʊɴ
ပူ	pù
ပူဇော်	pùzɔ̀
ပူတင်း	pùtɪ́ɴ
ပူဒီနာ	pùsìnà
ပူရ	pùɹa̰
ပူရီ	pùjì
ပေကျင်း	pèt͡ɕɪ́ɴ
ပေါက်စီ	paʊʔsì
ပေါက်တူး	paʊʔtú
ပေါက်ဖော်	paʊʔpʰɔ̀
ပေါင်	pàʊɴ
ပေါင်မုန့်	pàʊɴmo̰ʊɴ
ပေါင်းတင်း	páʊɴdɪ́ɴ
ပေါင်းဖို	páʊɴbò
ပေါ့	pɔ̰
ပေါ်	bɔ̀
ပေါ်	pɔ̀
ပေါ်ဆန်းမွှေး	pɔ̀sʰáɴm̥wé
ပေါ်တူဂီ	pɔ̀tùɡì
ပေါ်လစီ	pɔ̀ləsì
ပေး	pé
ပဲ	bɛ́
ပဲ	pɛ́
ပဲကြီး	pɛ́d͡ʑí
ပဲခူး	bəɡó
ပဲငံပြာရည်	pɛ́ŋàɴbjàjè
ပဲဆီ	pɛ́zì
ပဲနံ့သာ	pɛ́na̰ɴθà
ပဲပင်ပေါက်	pɛ́bɪ̀ɴbaʊʔ
ပဲပိုးတီ	pɛ́pódì
ပဲမှုန့်	pɛ́m̥o̰ʊɴ
ပဲ့တင်သံ	pɛ̰tɪ̀ɴðàɴ
ပျစ်	pjɪʔ
ပျဉ်	pjɪ̀ɴ
ပျဉ်းကတိုး	pjɪ́ɴɡədó
ပျဉ်းတော်သိမ်	pjɪ́ɴdɔ̀θèɪɴ
ပျဉ်းမ	pjɪ́ɴma̰
ပျပျ	pja̰bja̰
ပျား	pjá
ပျားတူ	ba̰dù
ပျားထီး	pjádí
ပျားရည်	pjájè
ပျိုး	pjó
ပျူ	pjù
ပျော့	pjɔ̰
ပျော်	pjɔ̀
ပျော်ပျော်	pjɔ̀bjɔ̀
ပျံ	pjàɴ
ပျံတော်မူ	pjàɴtɔ̀mù
ပြ	pja̰
ပြက္ခဒိန်	pjɛʔɡədèɪɴ
ပြင်	pjɪ̀ɴ
ပြင်ပြင်	pjɪ̀ɴbjɪ̀ɴ
ပြင်သစ်	pjɪ̀ɴθɪʔ
ပြင်သည်	pjɪ̀ɴθì
ပြင်း	pjɪ́ɴ
ပြင်းဟုပ်	pjɪ́ɴhoʊʔ
ပြစ်မှု	pjɪʔm̥ṵ
ပြည့်	pjḛ
ပြည့်တန်ဆာ	pjḭdəzà
ပြည်	pjì
ပြည်ကြီးငါး	pjìd͡ʑíŋá
ပြည်ကြီးမွန်	pjìd͡ʑímʊ̀ɴ
ပြည်တွင်း	pjìdwɪ́ɴ
ပြည်ထောင်စု	pjìdàʊɴzṵ
ပြည်ထောင်စုတော်လှန်ရေးကောင်စီအဖွဲ့	pjìdàʊɴzṵtɔ̀l̥àɴjékàʊɴsìʔəpʰwɛ̰
ပြည်ထောင်စုနေ့	pjìdàʊɴzṵnḛ
ပြည်ထောင်စုလွှတ်တော်	pjìdàʊɴzṵl̥ʊʔtɔ̀
ပြည်နယ်	pjìnɛ̀
ပြည်သူ	pjìðù
ပြည်သူပိုင်	pjìðùbàɪɴ
ပြည်သူပိုင်သိမ်း	pjìðùbàɪɴðéɪɴ
ပြည်သူပြည်သား	pjìðùpjìðá
ပြည်သူ့ဆိုင်	pjìðṵsʰàɪɴ
ပြည်သူ့လွှတ်တော်	pjìðṵl̥ʊʔtɔ̀
ပြဌာန်း	pja̰tʰáɴ
ပြတင်းပေါက်	bədɪ́ɴbaʊʔ
ပြတိုက်	pja̰daɪʔ
ပြဒါး	bədá
ပြဒါးချိန်	bədád͡ʑèɪɴ
ပြန်	pjàɴ
ပြန်ကြား	pjàɴt͡ɕá
ပြန်ကြားရေး	pjàɴt͡ɕájé
ပြန်လှန်	pjàɴl̥àɴ
ပြပွဲ	pja̰bwɛ́
ပြယုဂ်	pja̰joʊʔ
ပြသ	pja̰θa̰
ပြာ	pjà
ပြာခွက်	pjàɡwɛʔ
ပြာဋိဟာ	pjàdḭhà
ပြာတာ	pjàtà
ပြာသာဒ်	pjaʔθaʔ
ပြာသို	pjàðò
ပြား	pjá
ပြိတ္တာ	pjeɪʔtà
ပြိုင်ပွဲ	pjàɪɴbwé
ပြီ	pjì
ပြီး	pí
ပြီးတော့	pídɔ̰
ပြီးပြီ	píbì
ပြု	pjṵ
ပြုတ်	pjoʊʔ
ပြုပြင်	pjṵbjɪ̀ɴ
ပြုံယမ်း	pjòʊɴjáɴ
ပြုံး	pjóʊɴ
ပြော	pjɔ́
ပြောင်း	pjáʊɴ
ပြောင်းဖူး	pjáʊɴbú
ပြောင်းလဲ	pjáʊɴlɛ́
ပြေး	pjé
ပြွတ်	pjʊʔ
ပြွန်	pjʊ̀ɴ
ပြွမ်း	pjʊ́ɴ
ပြဿဒါး	pjaʔðədá
ပြဿနာ	pjaʔθənà
ပွတ်	pʊʔ
ပွား	pwá
ပွိုင့်	pwa̰ɪɴ
ပွေး	pwé
ပွဲ	pwɛ́
ပွဲတော်	pwɛ́dɔ̀
ဖက်	pʰɛʔ
ဖက်ဆစ်ဝါဒ	pʰɛʔsʰɪʔwàda̰
ဖက်ရှင်	pʰɛʔʃɪ̀ɴ
ဖက်ဝန်း	pʰɛʔwʊ́ɴ
ဖခင်	pʰa̰ɡɪ̀ɴ
ဖငယ်	pʰa̰ŋɛ̀
ဖင်	pʰɪ̀ɴ
ဖင်လန်	pʰɪ̀ɴlàɴ
ဖင်လျက်	pʰɪ̀ɴjɛʔ
ဖတ်	pʰaʔ
ဖတ်တီး	pʰaʔtí
ဖန်ခါး	pʰàɴɡá
ဖန်ခါးသီး	pʰàɴɡáðí
ဖန်တီး	pʰàɴdí
ဖမ်း	pʰáɴ
ဖယောင်း	pʰəjáʊɴ
ဖယောင်းတိုင်	pʰəjáʊɴdàɪɴ
ဖယ်ဒရေးရှင်း	pʰɛ̀dəɹéʃɪ́ɴ
ဖရန့်	pʰəɹa̰ɴ
ဖရုံ	pʰəjòʊɴ
ဖရုံဆွဲ	pʰəjòʊɴzwɛ́
ဖရဲ	pʰəjɛ́
ဖလား	pʰəlá
ဖဝါး	pʰəwá
ဖဦးထုပ်	pʰa̰ʔútʰoʊʔ
ဖာခေါင်း	pʰàɡáʊɴ
ဖာမ	pʰàma̰
ဖာလာ	pʰàlà
ဖာလာစေ့	pʰàlàsḛ
ဖာလူဒါ	pʰàlùdà
ဖာသည်မ	pʰàθɛ̀ma̰
ဖား	pʰá
ဖားပြုပ်	pʰəbjoʊʔ
ဖားလောင်း	pʰəláʊɴ
ဖိတ်	pʰeɪʔ
ဖိနပ်	pʰənaʔ
ဖိလစ်ပိုင်	pʰḭlɪʔpàɪɴ
ဖိအား	pʰḭʔá
ဖိုင်	pʰàɪɴ
ဖို့	pʰo̰
ဖိုးသူတော်	pʰóθùdɔ̀
ဖီဂျီ	pʰìd͡ʑì
ဖုတ်	pʰoʊʔ
ဖုန်	pʰòʊɴ
ဖုန်စုပ်စက်	pʰòʊɴsoʊʔsɛʔ
ဖုန်းနံပါတ်	pʰóʊɴnàɴbaʔ
ဖုံး	pʰóʊɴ
ဖုဿ	pʰoʊʔθa̰
ဖုဿဘုရား	pʰoʊʔθa̰pʰəjá
ဖူး	bú
ဖေဖော်ဝါရီ	pʰèpʰɔ̀wàɹì
ဖေါ်ပြချက်	pʰɔ̀pja̰t͡ɕʰɛʔ
ဖောက်	pʰaʊʔ
ဖောက်သည်	pʰaʊʔθè
ဖောင်	pʰàʊɴ
ဖော့ဖျက်	pʰɔ̰bjɛʔ
ဖော့လုံး	pʰɔ̰lóʊɴ
ဖော်	pʰɔ̀
ဖော်ပြ	pʰɔ̀pja̰
ဖဲ	pʰɛ́
ဖဲကြိုး	pʰɛ́d͡ʑó
ဖျင်ဖျင်	pʰjɪ̀ɴbjɪ̀ɴ
ဖျာ	pʰjà
ဖျား	pʰjá
ဖျောက်ဆိပ်	pʰjaʊʔsʰeɪʔ
ဖျံ	pʰjàɴ
ဖြစ်	pʰjɪʔ
ဖြည့်	pʰjḛ
ဖြည်းဖြည်း	pʰjébjé
ဖြည်းဖြည်းချင်း	pʰjípʰjít͡ɕʰɪ́ɴ
ဖြားယောင်း	pʰjájáʊɴ
ဖြီး	pʰí
ဖြူ	pʰjù
ဖြူး	pʰjú
ဖြေ	pʰjè
ဖြေဖျောက်	pʰjèbjaʊʔ
ဖြေရှင်း	pʰjèʃɪ́ɴ
ဖြောင့်	pʰja̰ʊɴ
ဖြောဖြော	pʰjɔ́bjɔ́
ဖြော်ဖြော်	pʰjɔ̀bjɔ̀
ဖွင့်	pʰwɪ̰ɴ
ဖွား	pʰwá
ဖွဲ့စည်းပုံ	pʰwɛ̰zíbòʊɴ
ဖွဲ့စည်းပုံအခြေခံဥပဒေ	pʰwɛ̰zíbòʊɴʔət͡ɕʰèɡàɴʔṵbədè
ဗက်တီးရီးယား	bɛʔtíɹíjá
ဗင်နီဇွဲလား	bɪ̀ɴnìzwɛ́lá
ဗညား	bəɲá
ဗထက်ခြိုက်	ba̰tʰɛʔt͡ɕʰaɪʔ
ဗန်တို	bàɴdò
ဗန်ရှည်	bàɴʃè
ဗန်းမော်	báɴmɔ̀
ဗမာ	bəma̰
ဗမာ	bəmà
ဗမာ့	bəma̰
ဗလ	bəla̰
ဗလဝ	bələwa̰
ဗလာစာအုပ်	bəlàsàʔoʊʔ
ဗလီ	bəlì
ဗဟို	bəhò
ဗဟုသုတ	bəhṵθṵta̰
ဗာတီကန်	bàtìkàɴ
ဗာတီကန်မြို့ပြနိုင်ငံ	bàtìkàɴmjo̰pja̰nàɪɴŋàɴ
ဗာဒံ	bàdàɴ
ဗာလ	bàla̰
ဗာလချောင်	bàla̰t͡ɕʰàʊɴ
ဗားနစ်	bánɪʔ
ဗိန္ဒု	bèɪɴdṵ
ဗိမာန်	beɪʔmàɴ
ဗိသုကာ	bḭðəɡà
ဗိုက်	baɪʔ
ဗိုက်ကြီး	baɪʔt͡ɕí
ဗိုက်ဆာတယ်	baɪʔsʰàtɛ̀
ဗိုင်း	báɪɴ
ဗိုင်းရပ်စ်	báɪɴɹaʔs
ဗိုလ်	bò
ဗိုလ်ကျ	bòt͡ɕa̰
ဗိုလ်ကြီး	bòd͡ʑí
ဗိုလ်ချုပ်	bòd͡ʑoʊʔ
ဗိုလ်ချုပ်ကြီး	bòd͡ʑoʊʔd͡ʑí
ဗိုလ်ချုပ်မှူးကြီး	bòd͡ʑoʊʔm̥úd͡ʑí
ဗိုလ်မှူး	bòm̥ú
ဗိုလ်မှူးကြီး	bòm̥úd͡ʑí
ဗိုလ်မှူးချုပ်	bòm̥úd͡ʑoʊʔ
ဗိုလ်လောင်း	bòláʊɴ
ဗို့	bo̰
ဗို့အား	bo̰ʔá
ဗိဿနိုး	beɪʔθənó
ဗီဇ	bìza̰
ဗီဇာ	bìzà
ဗီတာမင်	bìtàmɪ̀ɴ
ဗီဒီယို	bìdìjò
ဗီယက်နမ်	bìjɛʔnàɴ
ဗီယင်ကျန်း	bìjɪ̀ɴt͡ɕáɴ
ဗီရို	bìjò
ဗုဒ္ဓ	boʊʔda̰
ဗုဒ္ဓဘာသာ	boʊʔda̰bàθà
ဗုဒ္ဓသာသနာ	θàðənà
ဗုဒ္ဓဟူး	boʊʔda̰hú
ဗုန်း	bóʊɴ
ဗုံး	bóʊɴ
ဗေဒ	bèda̰
ဗောဓိညောင်	bɔ́dḭɲàʊɴ
ဗောဓိသတ်	bɔ́dḭθaʔ
ဗော့ဒ်ကာ	bɔ̰dkà
ဗေ့စဘော	bḛsəbɔ́
ဗျစ်	bjɪʔ
ဗျည်း	bjí
ဗျာဓိ	bjàdḭ
ဗျိုင်း	bjáɪɴ
ဗျုပ္ပတ်	bjoʊʔpaʔ
ဗျူရို	bjùɹò
ဗြဟ္မစိုရ်တရား	bjəməzòjtəjá
ဗြဟ္မာ	bjəmà
ဗြာဟ္မဏ	bjàhma̰na̰
ဗြိစ္ဆာ	bjeɪʔsʰà
ဗြိတိန်	bjḭtèɪɴ
ဗြိတိသျှ	bəɹḭtḭʃa̰
ဗြဲတိုက်	bjɛ́daɪʔ
ဗွေ	bwè
ဘ	ba̰
ဘကကျောင်း	ba̰ka̰t͡ɕáʊɴ
ဘကုန်း	ba̰kóʊɴ
ဘက္ကဒီးအစ်	bɛʔkədíʔɪʔ
ဘက်	bɛʔ
ဘက်ထရီ	bɛʔtʰa̰ɹì
ဘကြီး	ba̰d͡ʑí
ဘင်	bɪ̀ɴ
ဘင်နာ	bɪ̀ɴnà
ဘင်း	bɪ́ɴ
ဘင်္ဂလားဒေ့ရှ်	bɪ̀ɴládḛʃ
ဘင်္ဂါလီ	bɪ̀ɴɡàlì
ဘဏ္ဍာ	bàndà
ဘဏ္ဍာရေး	bàndàjé
ဘဏ်	bàɴ
ဘဏ်တိုက်	bàɴdaɪʔ
ဘတ်	baʔ
ဘတ်	pʰaʔ
ဘတ်ဂျက်	baʔd͡ʑɛʔ
ဘတ်စ်ကား	baʔsəká
ဘထွေး	ba̰tʰwé
ဘဒ္ဒန္တ	baʔdàɴta̰
ဘန်ကောက်	bàɴkaʊʔ
ဘယာ	bəjà
ဘယ်	bɛ̀
ဘယ်တုန်းက	bɛ̀dóʊɴɡa̰
ဘယ်တော့	bɛ̀dɔ̰
ဘယ်နှ	bɛ̀n̥a̰
ဘယ်နှစ်	bɛ̀n̥ə
ဘယ်မှ	bɛ̀m̥a̰
ဘယ်ရီလီယမ်	bɛ̀ɹìlìjàɴ
ဘယ်လို	bɛ̀lò
ဘယ်လောက်	bɛ̀laʊʔ
ဘယ်လ်ဂျီယမ်	bɛ̀ld͡ʑìjàɴ
ဘယ်သူ	bəθù
ဘယ်သူ့	bəθṵ
ဘရင်ဂျီ	bəjɪ̀ɴd͡ʑì
ဘရဏီ	ba̰jənì
ဘရာစီယာ	bəɹàsìjà
ဘရာဇီး	bəɹàzí
ဘရိတ်	bəɹeɪʔ
ဘရူနိုင်း	bəɹùnáɪɴ
ဘလိဇ်	bəlìz
ဘလောက်	ba̰laʊʔ
ဘလော့ဂ်	bəloʊʔ
ဘလေး	ba̰lé
ဘဝ	ba̰wa̰
ဘဝဲ	bəwɛ́
ဘဟားမား	ba̰hámá
ဘာ	bà
ဘာကီးနားဖားဆို	bàkínápʰásʰò
ဘာရိန်း	bàɹéɪɴ
ဘာလင်	bàlɪ̀ɴ
ဘာလိ	bàlḭ
ဘာသာ	bàðà
ဘာသာစကား	bàθàzəɡá
ဘာသာပြန်	bàðàpjàɴ
ဘာသာဗေဒ	bàθàbèda̰
ဘား	bá
ဘား	pʰá
ဘိက္ခု	beɪʔkʰṵ
ဘိက္ခုနီ	bìkkʰṵnì
ဘိန်း	béɪɴ
ဘိန်းမုန့်	béɪɴmo̰ʊɴ
ဘိဘိသန	bḭbḭθəna̰
ဘိလပ်	bḭlaʔ
ဘိသိက်	beɪʔθeɪʔ
ဘိုကလေး	bòɡəlé
ဘိုက်	baɪʔ
ဘိုင်	bàɪɴ
ဘိုင်စကယ်	bàɪɴsəkɛ̀
ဘိုင်စကုတ်	bàɪɴsəkoʊʔ
ဘိုရွန်	bòɹʊ̀ɴ
ဘိုလီးဗီးယား	bòlíbíjá
ဘိုးဘိုး	pʰópʰó
ဘီ	bì
ဘီစကွတ်	bìsəkʊʔ
ဘီနင်	bìnɪ̀ɴ
ဘီယာ	bìjà
ဘီလာရုဇ်	bìlàɹùz
ဘီလူး	bəlú
ဘီး	béɪɴ
ဘီး	bí
ဘီးကြယ်	bít͡ɕɛ̀
ဘု	bṵ
ဘုဉ်းပေး	bóʊɴpé
ဘုတ်	boʊʔ
ဘုန်း	pʰóʊɴ
ဘုန်းကြီး	pʰóʊɴd͡ʑí
ဘုန်းကြီးကျောင်း	pʰóʊɴd͡ʑít͡ɕáʊɴ
ဘုန်းကြီးပျံ	pʰóʊɴd͡ʑíbjàɴ
ဘုန်းတော်ကြီးဘုရား	pʰóʊɴdɔ̀d͡ʑípʰəjá
ဘုန်းဘုန်း	pʰóʊɴpʰóʊɴ
ဘုမ္မစိုး	bòʊɴməzó
ဘုရင်	bəjɪ̀ɴ
ဘုရင်ခံ	bəjɪ̀ɴɡàɴ
ဘုရင်မ	ba̰jɪ̀ɴma̰
ဘုရား	pʰəjá
ဘုရားကိုးဆူ	pʰəjákósʰù
ဘုရားကျောင်း	pʰəjád͡ʑáʊɴ
ဘုရားရှိခိုးကျောင်း	pʰəjáʃḭkʰód͡ʑáʊɴ
ဘုရားလောင်း	pʰəjáláʊɴ
ဘုရားအလောင်း	pʰəjáʔəláʊɴ
ဘုံကျောင်း	bòʊɴd͡ʑáʊɴ
ဘုံပိုင်	bòʊɴbàɪɴ
ဘူ	bù
ဘူဂေးရီးယား	bùɡéɹíjá
ဘူတန်	bùtàɴ
ဘူတာရုံ	bùdàjòʊɴ
ဘူမိဗေဒ	bùmḭbèda̰
ဘူမိရူပဗေဒ	bùmḭjùpa̰bèda̰
ဘူရွန်ဒီ	bùɹʊ̀ɴdì
ဘူး	bú
ဘူးသီး	búθí
ဘူးသီးတောင်	búðídàʊɴ
ဘော	bɔ́
ဘောက်ဆူး	baʊʔsʰú
ဘောဂဗေဒ	bɔ́ɡa̰ta̰bèda̰
ဘောင်းဘီ	báʊɴbì
ဘောပင်	bɔ́pɪ̀ɴ
ဘောပွဲ	bɔ́pwɛ́
ဘောလုံး	bɔ́lóʊɴ
ဘော့ဆွာနာ	bɔ̰sʰwànà
ဘော်ဒါ	bɔ̀dà
ဘော်ဒါကြေး	bɔ̀dàt͡ɕé
ဘော်လီဘော	bɔ̀lìbɔ́
ဘေ့စ်ဘော	bḛsbɔ́
ဘေး	bé
ဘေးဆိုး	bézó
ဘေးဆီးရန်ကာ	bézíjàɴɡà
ဘဲ	bɛ́
ဘဲလေး	bɛ́lé
ဘွား	bwá
ဘွားဘွား	pʰwápʰwá
ဘွဲ့	bwɛ̰
ဘွဲ့ချဉ်	bwɛ̰d͡ʑɪ̀ɴ
မ	ma̰
မ	mə
မကန်း	məɡáɴ
မကိုဋ်	məɡaɪʔ
မကုဋ	məkṵta̰
မက္ကဆီကို	mɛʔkəsʰìkò
မက်	mɛʔ
မက်စီဒိုးနီးယား	mɛʔsìdóníjá
မက်မွန်	mɛʔmʊ̀ɴ
မကြာမတင်	mət͡ɕàmətɪ̀ɴ
မကွေး	məɡwé
မဂ္ဂင်ရှစ်ပါး	mɛʔɡɪ̀ɴʃɪʔbá
မဂ္ဂဇင်း	mɛʔɡa̰zɪ̀ɴ
မင့်စ်	mɪ̰ɴs
မင်	m̥ɪ̀ɴ
မင်း	mɪ́ɴ
မင်းကြီး	mɪ́ɴd͡ʑí
မင်းကွတ်	mɪ́ɴɡʊʔ
မင်းတရား	mɪ́ɴtəjá
မင်းဘူး	mɪ́ɴbú
မင်းမြောက်တန်ဆာ	mɪ́ɴmjaʊʔdəzà
မင်းသမီး	mɪ́ɴðəmí
မင်းသား	mɪ́ɴðá
မင်္ဂလ	mɪ̀ɴɡəla̰
မင်္ဂလဘုရား	mɪ̀ɴɡəla̰pʰəjá
မင်္ဂလသုတ်	mɪ̀ɴɡəla̰θoʊʔ
မင်္ဂလာ	mɪ̀ɴɡəlà
မင်္ဂလာဆောင်	mɪ̀ɴɡəlàsʰàʊɴ
မင်္ဂလာပါ	mɪ̀ɴɡəlàbà
မစင်	ma̰sɪ̀ɴ
မဆလာ	ma̰sʰəlà
မဇ္ဈဒေသ	mɪʔza̰dèθa̰
မဉ္ဇူ	mjɪ̀ɴzù
မည်	mjì
မည်စည်	mɛ̀zɛ̀
မည်သည်	mìðì
မည်သူ	mìðù
မည်း	mɛ́
မဏိ	mənḭ
မဏိတော်	mənḭdɔ̀
မဏိပူရ	mənḭpùja̰
မဏိမေခလာ	mənḭmèkʰəlà
မဏိဩဂ	mənḭʔɔ́ɡa̰
မဏ္ဍပ်	máɴdaʔ
မဏ္ဍိုင်	màɴdàɪɴ
မတော်တဆ	mətɔ̀təsʰa̰
မတော်တဆမှု	mətɔ̀təsʰa̰m̥ṵ
မတ်	maʔ
မတ်ခွက်	maʔkʰwɛʔ
မတ်စေ့	maʔsḭ
မတ်ပဲ	maʔpɛ́
မတ်မတ်	maʔmaʔ
မဒါဂတ်စကား	ma̰dàɡaʔsəká
မနက်	mənɛʔ
မနက်ဖြန်	mənɛʔpʰjàɴ
မနုပ်တာနီ	mənoʊʔtànì
မနုဿ	ma̰noʊʔθà
မနုဿဗေဒ	mənoʊʔθa̰bèda̰
မနုဿီဟ	mənoʊʔθìha̰
မနော	mənɔ́
မနောကံ	mənɔ́ɡàɴ
မနေ့က	mənḛɡa̰
မန္တန်	màɴdàɴ
မန္တလေး	màɴdəlé
မန်ကျည်း	məd͡ʑí
မန်နေဂျာ	màɴnèd͡ʑà
မန်း	máɴ
မနှစ်	mən̥ɪʔ
မယား	məjá
မယ်	mɛ̀
မယ်ဇယ်	mɛ̀zɛ̀
မယ်ဇလီ	mɛ̀zəlì
မယ်တော်	mɛ̀dɔ̀
မယ်သီတာ	mɛ̀θìdà
မယ်သီလ	mɛ̀ðìla̰
မရဏ	məɹəna̰
မရန်း	məjáɴ
မရမာ	məɹəmà
မရမာကြီး	məɹəmàd͡ʑí
မရီး	məjí
မလိုင်	ma̰làɪɴ
မလုပ်တာနီ	məloʊʔtànì
မလေး	məlé
မလေးရှား	məléʃá
မလ္လိကာ	màɴlḭkà
မသာ	məθà
မသိပါဘူး	ma̰θḭbàbú
မသိဘူး	ma̰θḭbú
မဟာ	ma̰hà
မဟာကဿပ	məhàkaʔθəpa̰
မဟာဂီတ	məhàɡìta̰
မဟာပညာဗလ	məhàpjɪ̀ɴɲàbəla̰
မဟာပိန္နဲ	məhàpèɪɴnɛ́
မဟာဘာရတ	məhàbàɹəta̰
မဟာဘွဲ့	məhàbwɛ̰
မဟာမိတ်	məhàmeɪʔ
မဟာမောဂ္ဂလာန်	məhàmaʊʔɡəlàɴ
မဟာယာန	məhàjàna̰
မဟာရဋ္ဌ	məhàjətʰa̰
မဟာလတာ	məhàlətà
မဟာဝင်	məhàwɪ̀ɴ
မဟာဝိဇ္ဇာဘွဲ့	məhàweɪʔzàbwɛ̰
မဟာသာဝက	məhàθàwəka̰
မဟာသိပ္ပံဘွဲ့	məhàθeɪʔpàɴbwɛ̰
မဟေ	məhè
မဟေသီ	məhèθì
မအေလိုး	məʔèló
မာ	mà
မာကျောက်	màt͡ɕaʊʔ
မာစကတ်	màsəkaʔ
မာတိကာ	màtḭkà
မာန်	màɴ
မာန်အောင်	mànʔàʊɴ
မာရ်	mà
မာရ်နတ်	mànaʔ
မာလကာ	màləkà
မာလကာသီး	màləkàθí
မာလဝီ	màla̰wì
မာလာ	màlà
မာလာရှမ်းကော	màlàʃáɴkɔ́
မာလာဟင်း	màlàhɪ́ɴ
မာလီ	màlì
မိ	mḭ
မိကျောင်း	mḭd͡ʑáʊɴ
မိခင်	mḭɡɪ̀ɴ
မိငယ်	mḭŋɛ̀
မိတ္တူ	meɪʔtù
မိတ္ထီလာ	meɪʔtʰìlà
မိတ်	meɪʔ
မိတ်ကပ်	meɪʔkaʔ
မိတ်ဆွေ	meɪʔsʰwè
မိထွေး	mḭdwé
မိနစ်	mḭnɪʔ
မိန်းကလေး	méɪɴɡəlé
မိန်းမ	méɪɴma̰
မိန်းမလျာ	méɪɴməʃà
မိဖုရား	mḭbəjá
မိဘ	mḭba̰
မိဘမဲ့	mḭba̰mɛ̰
မိသားစု	mḭðázṵ
မိုက်	maɪʔ
မိုက်ကယ်	maɪʔkɛ̀
မိုင်	màɪɴ
မိုင်လို	màɪɴlò
မိုင်း	máɪɴ
မိုဇမ်ဘစ်	mòzàɴbɪʔ
မိုတယ်	mòtɛ̀
မိုနာကို	mònàkò
မိုဘိုင်းလ်ဖုန်း	mòbáɪɴpʰóʊɴ
မိုး	mó
မိုးကာအင်္ကျီ	móɡàʔɪ̀ɴd͡ʑì
မိုးကုတ်	móɡoʊʔ
မိုးကုပ်စက်ဝိုင်း	móɡoʊʔsɛʔwáɪɴ
မိုးကြိုး	mód͡ʑó
မိုးခေါ်	mókʰɔ̀
မိုးရာသီ	mójàðì
မိုးလေဝသ	mólèwəθa̰
မီတာ	mìtà
မီနူး	mìnú
မီး	mí
မီးခတ်	míkʰaʔ
မီးခတ်	míɡaʔ
မီးခိုး	míɡó
မီးခိုးရောင်	míɡójàʊɴ
မီးခေါင်း	míɡáʊɴ
မီးခံသေတ္တာ	míɡàɴθɪʔtà
မီးခြစ်	míd͡ʑɪʔ
မီးခွက်	míɡwɛʔ
မီးတောင်	mídàʊɴ
မီးပန်း	míbáɴ
မီးပူ	míbù
မီးပြတိုက်	míbja̰daɪʔ
မီးပွား	míbwá
မီးပွိုင့်	mípwa̰ɪɴ
မီးဖို	míbò
မီးဖို	mípʰò
မီးဖိုချောင်	míbòd͡ʑàʊɴ
မီးယပ်	míjaʔ
မီးယပ်ပညာ	míjaʔpjɪ̀ɴɲà
မီးယပ်ရောဂါ	míjaʔjɔ́ɡà
မီးရထား	míjətʰá
မီးရထားတွဲ	míjətʰádwɛ́
မီးရှူးမီးပန်း	míʃúmíbáɴ
မီးလင်းဖို	mílɪ́ɴbò
မီးသင်္ဘော	míθɪ̀ɴbɔ́
မီးသီး	míθí
မီးသုံးပါး	míθóʊɴbá
မီးသွေး	míðwé
မီးအိမ်	míʔèɪɴ
မုခ်	moʊʔ
မုစလိန္ဒ	mṵsəlèɪɴda̰
မုဆိုး	moʊʔsʰò
မုဆိုးဖို	mṵsʰóbò
မုဆိုးမ	mṵsʰóma̰
မုတ္ထမ	moʊʔtəma̰
မုတ်ခွံ	moʊʔkʰʊ̀ɴ
မုတ်ဆိတ်	moʊʔsʰeɪʔ
မုဒိမ်း	mədéɪɴ
မုဒိမ်း	mṵdéɪɴ
မုဒ္ဓဇ	mùddəza̰
မုဒြာ	mṵdɹà
မုနိ	mṵnḭ
မုန့်	mo̰ʊɴ
မုန့်ကျွဲသည်း	mo̰ʊɴt͡ɕwɛ́ðɛ́
မုန့်ကွမ်းယာ	mo̰ʊɴkʊ́ɴjà
မုန့်ညက်	mo̰ʊɴɲɛʔ
မုန့်တီ	mo̰ʊɴtì
မုန့်လက်ကောက်	mo̰ʊɴlɛʔkaʊʔ
မုန့်လက်ဆောင်း	mo̰ʊɴlɛʔsʰáʊɴ
မုန့်လင်မယား	mo̰ʊɴlɪ̀ɴməjá
မုန့်လုံးရေပေါ်	mo̰ʊɴlóʊɴjèbɔ̀
မုန့်ဟင်းခါး	mo̰ʊɴhɪ́ɴɡá
မုန့်အုပ်ကလေး	mo̰ʊɴʔoʊʔɡəlé
မုန့်ဦးနှောက်	mo̰ʊɴʔóʊɴðí
မုန်ညင်း	mòʊɴɲɪ́ɴ
မုန်ညင်းဆီ	mòʊɴɲɪ́ɴsʰì
မုန်ညင်းဖြူ	mòʊɴɲɪ́ɴpʰjù
မုန်ညှင်းဖြူ	mòʊɴɲ̊ɪ́ɴbjù
မုန်တိုင်း	mòʊɴdáɪɴ
မုန်လာ	mòʊɴlà
မုန်လာထုပ်	mòʊɴlàdoʊʔ
မုန်လာဥ	mòʊɴlàʔṵ
မုန်လာဥနီ	mòʊɴlàʔṵnì
မုန်လာဥဝါ	mòʊɴlàʔṵwà
မုန်း	móʊɴ
မုရား	məjá
မုသား	mṵðá
မုံ	mòʊɴ
မုံရွာ	mòʊɴjwà
မူကြို	mùd͡ʑò
မူကြိုကျောင်း	mùd͡ʑòd͡ʑáʊɴ
မူလ	mùla̰
မူလတန်း	mùla̰táɴ
မူလတန်းကြိုကျောင်း	mùla̰dáɴd͡ʑòd͡ʑáʊɴ
မူလီ	mùlì
မူး	mú
မေ	mè
မေဃာလယ	mèɡàləja̰
မေတ္တာ	mjɪʔtà
မေတ္တေယျ	mjɪʔtèja̰
မေဓင်္ကရာ	mèdɪ̀ɴkəɹà
မေဓင်္ကရာဘုရား	mèdɪ̀ɴkəɹàpʰəjá
မေမေ	mèmè
မော	mɔ́
မောက်ချ	maʊʔt͡ɕʰa̰
မောင်	màʊɴ
မောင်တော	màʊɴtɔ́
မောင်နှမ	màʊɴn̥əma̰
မောင်း	máʊɴ
မောင်းမမိဿံ	máʊɴma̰meɪʔθàɴ
မောရစ်ရှ	mɔ́ɹɪʔʃa̰
မော်စကို	mɔ̀səkò
မော်ဇာ	mɔ̀zà
မော်တော်ဆိုင်ကယ်	mɔ̀tɔ̀sʰàɪɴkɛ̀
မော်ရိုကို	mɔ̀ɹòkò
မော်ရီတေးနီးယား	mɔ̀ɹìténíjá
မော်လတာ	mɔ̀lətà
မော်လဒိုက်	mɔ̀lədaɪʔ
မော်လမြိုင်	mɔ̀ləmjàɪɴ
မော်လီကျူး	mɔ̀lìt͡ɕú
မော်လ်ဒိုဗာ	mɔ̀ldòbà
မေ့	mḛ
မေး	mé
မေးခိုင်ရောဂါ	mékʰàɪɴjɔ́ɡà
မေးခွန်း	méɡʊ́ɴ
မေးစေ့	mézḭ
မဲ	mɛ́
မဲခေါင်မြစ်	mɛ́kʰàʊɴmjɪʔ
မဲဆန္ဒ	mɛ́sʰàɴda̰
မဲဆန္ဒနယ်	mɛ́sʰàɴda̰nɛ̀
မဲဆန္ဒရှင်	mɛ́sʰàɴda̰ʃɪ̀ɴ
မဲဆောက်	mɛ́sʰaʊʔ
မဲဇလီ	mɛ́zəlì
မဲပေး	mɛ́pé
မံ	màɴ
မံသ	màɴθa̰
မျက်ခုံး	mjɛʔkʰóʊɴ
မျက်ခွံ	mjɛʔkʰʊ̀ɴ
မျက်စိ	mjɛʔsḭ
မျက်တောင်	mjɛʔtàʊɴ
မျက်နှာ	mjɛʔn̥à
မျက်နှာကြက်	mjɛʔn̥àd͡ʑɛʔ
မျက်နှာဖုံး	mjɛʔn̥əpʰóʊɴ
မျက်နှာသုတ်ပဝါ	mjɛʔn̥àθoʊʔpa̰wà
မျက်ပါး	mjɛʔpá
မျက်မှန်	mjɛʔm̥àɴ
မျက်ရည်	mjɛʔjè
မျက်လုံး	mjɛʔlóʊɴ
မျက်လွှာ	mjɛʔl̥wà
မျက်လှည့်	mjɛʔl̥ɛ̰
မျည်းတံ	mjídàɴ
များ	mjá
များများ	mjámjá
မျို	mjò
မျိုး	mjó
မျိုးချစ်စိတ်	mjót͡ɕʰɪʔseɪʔ
မျိုးစိတ်	mjózeɪʔ
မျိုးစု	mjózṵ
မျိုးဆက်	mjózɛʔ
မျိုးဥအိမ်	mjóʔṵʔèɪɴ
မျော	mjɔ́
မျောက်	mjaʊʔ
မျောက်ချော	mjaʊʔt͡ɕʰɔ́
မျောက်လုတ်	mjaʊʔloʊʔ
မျောက်လောင်း	mjaʊʔláʊɴ
မျှင်	m̥jɪ̀ɴ
မျှစ်	m̥jɪʔ
မျှို့	m̥jo̰
မျှော်	m̥jɔ̀
မျှော်လင့်	m̥jɔ̀lɪ̰ɴ
မျှော်လင့်ချက်	m̥jɔ̀lɪ̰ɴd͡ʑɛʔ
မြ	mja̰
မြက်	mjɛʔ
မြက်ခင်း	mjɛʔkʰɪ́ɴ
မြက်ခုတ်ဓား	mjɛʔkʰoʊʔdá
မြက်ခြောက်	mjɛʔt͡ɕʰaʊʔ
မြင့်	mjɪ̰ɴ
မြင်	mjɪ̀ɴ
မြင်း	mjɪ́ɴ
မြင်းကလေး	mjɪ́ɴɡəlé
မြင်းကျား	mjɪ́ɴd͡ʑá
မြင်းခြံ	mjɪ́ɴd͡ʑàɴ
မြင်းခွာ	mjɪ́ɴkʰwà
မြင်းခွာရွက်သုပ်	mjɪ́ɴkʰwàjwɛʔθoʊʔ
မြင်းစားဂျုံ	mjɪ́ɴzád͡ʑòʊɴ
မြင်းဆေး	mjɪ́ɴzé
မြင်းမ	mjɪ́ɴma̰
မြင်းမကလေး	mjɪ́ɴma̰ɡəlé
မြင်းမိုရ်	mjɪ́ɴmò
မြင်းမိုရ်တောင်	mjɪ́ɴmòtàʊɴ
မြင်းလှည်း	mjɪ́ɴl̥ɛ́
မြင်းသံခွာ	mjɪ́ɴθàɴkʰwà
မြစ်	mjɪʔ
မြစ်ကြီးနား	mjɪʔt͡ɕíná
မြည်း	mjí
မြတ်လေး	mjaʔlé
မြန်	mjàɴ
မြန်နှုန်းပြကိရိယာ	mjàɴn̥óʊɴpja̰kḭjḭjà
မြန်မာ	mjàɴmà
မြန်မာ့	mjàɴma̰
မြန်မြန်	mjàɴmjàɴ
မြမ္မာ	mjàɴmà
မြဝတီ	mja̰wədì
မြား	m̥já
မြိတ်	beɪʔ
မြို့	mjo̰
မြို့စား	mjo̰zá
မြို့တော်	mjo̰dɔ̀
မြို့တော်ဝန်	mjo̰dɔ̀wʊ̀ɴ
မြို့နယ်	mjo̰nɛ̀
မြို့ပြနိုင်ငံ	mjo̰pja̰nàɪɴŋàɴ
မြို့ဝန်	mjo̰wʊ̀ɴ
မြီ	mjì
မြီးရှေ	mjíʃè
မြုံ	mjòʊɴ
မြူ	mjù
မြူစွမ်	mjùswàɴ
မြေ	mjè
မြေကွက်	mjèɡwɛʔ
မြေခွေး	mjèɡwé
မြေစာ	mjèzà
မြေနင်းခွာစိုက်	mjènɪ́ɴkʰwàzaɪʔ
မြေနုကျွန်းပေါ်	mjènṵt͡ɕʊ́ɴbɔ̀
မြေပုံ	mjèbòʊɴ
မြေပုံသီး	mjèbòʊɴðí
မြေပဲ	mjèbɛ́
မြေပြင်	mjèbjɪ̀ɴ
မြေပြန့်	mjèbja̰ɴ
မြေဖြူခဲ	mjèbjùɡɛ́
မြေရိုင်း	mjèjáɪɴ
မြေရှင်	mjèʃɪ̀ɴ
မြေအောက်	mjèʔaʊʔ
မြေအောက်မီးရထား	mjèʔaʊʔmíjətʰá
မြေဩဇာ	mjèʔɔ́zà
မြောက်	mjaʊʔ
မြောက်ကိုရီးယား	mjaʊʔkòɹíjá
မြောင်း	mjáʊɴ
မြေး	mjé
မြေးမ	mjéma̰
မြံမာ	mjàɴmà
မြွက်	mjwɛʔ
မြွေ	mwè
မြွေပါ	mwèbà
မြွေဟောက်	mjwèhaʊʔ
မြှား	m̥já
မြှောက်	m̥jaʊʔ
မြှောက်ရကိန်း	m̥jaʊʔja̰kéɪɴ
မွတ်	mʊʔ
မွတ်စလင်	mʊʔsəlɪ̀ɴ
မွန်	mʊ̀ɴ
မွန်ဂိုးလီးယား	mʊ̀ɴɡólíjá
မွန်တီနီဂရိုး	mʊ̀ɴtìnìɡəɹó
မွာချီး	mwàt͡ɕʰí
မွေး	mwé
မွေးနေ့	mwénḛ
မွေးနေ့မင်္ဂလာပါ	mwénḛmɪ̀ɴɡəlàbà
မွဲ	mwɛ́
မွှား	m̥wá
မွှေး	m̥wé
မှ	m̥a̰
မှတ်ကျောက်	m̥aʔt͡ɕaʊʔ
မှတ်စု	m̥aʔsṵ
မှတ်စုစာအုပ်	m̥aʔsṵsàʔoʊʔ
မှတ်ဉာဏ်	m̥aʔɲàn
မှတ်တိုင်	m̥aʔtàɪɴ
မှတ်မိ	m̥aʔmḭ
မှန်	m̥àɴ
မှန်စာ	m̥àɴzà
မှန်စီရွှေချ	m̥àɴzìʃwèt͡ɕʰa̰
မှန်တော့	m̥àɴdɔ̰
မှန်ပါ့ဘုရား	m̥àɴba̰pʰəjá
မှန်ပြောင်း	m̥àɴbjáʊɴ
မှန်ဖြူ	m̥àɴbjù
မှန်ဘီလူး	m̥àɴbəlú
မှန်မှန်	m̥àɴm̥àɴ
မှန်လာ	m̥àɴlà
မှာ	m̥à
မှား	m̥á
မှို	m̥ò
မှု	m̥ṵ
မှုတ်	m̥oʊʔ
မှုန့်	m̥o̰ʊɴ
မှုန်	m̥òʊɴ
မှဲ့	m̥ɛ̰
ယက်	jɛʔ
ယခု	jəkʰṵ
ယင်	jɪ̀ɴ
ယင်ကောင်	jɪ̀ɴɡàʊɴ
ယင်းမာ	jɪ́ɴmà
ယစ်ထုတ်	jɪʔtʰoʊʔ
ယဉ်	jɪ̀ɴ
ယဉ်ကျေးမှု	jɪ̀ɴt͡ɕém̥ṵ
ယတြာ	jədəjà
ယနေ့	ja̰nḛ
ယန္တရား	jàɴdəjá
ယပက်လက်	ja̰pɛʔlɛʔ
ယပင့်	ja̰pɪ̰ɴ
ယပ်	jaʔ
ယမက	jəməka̰
ယမင်း	jəmɪ́ɴ
ယမနေ	jəmənè
ယမန်နှစ်	jəmàɴn̥ɪʔ
ယမမင်း	jəma̰mɪ́ɴ
ယမုန်နာ	jəmòʊɴnà
ယမ်း	jáɴ
ယမ်းတောင့်	jáɴda̰ʊɴ
ယမ်းမှုန့်	jáɴm̥o̰ʊɴ
ယဝဒီပ	ja̰wa̰dìpa̰
ယသောဓရာ	ja̰θɔ́dəjà
ယာဉ်	jɪ̀ɴ
ယာဉ်မောင်း	jɪ̀ɴmàʊɴ
ယာဉ်ရပ်	jɪ̀ɴjaʔ
ယာဘ	jàba̰
ယာမာ	jàmà
ယာယီ	jàjì
ယို	jò
ယိုးဒယား	jódəjá
ယီမင်	jìmɪ̀ɴ
ယုဂ်	joʊʔ
ယုဇန	jṵza̰na̰
ယုတ္တိ	joʊʔtḭ
ယုတ္တိဗေဒ	joʊʔtḭbèda̰
ယုန်	jòʊɴ
ယုံ	jòʊɴ
ယုံကြည်	jòʊɴt͡ɕì
ယူ	jù
ယူကရိန်း	jùkəɹéɪɴ
ယူဂန်းဒါး	jùɡáɴdá
ယူနိုက်တက်ကင်းဒမ်း	jùnaɪʔtɛʔkɪ́ɴdáɴ
ယူနီယန်	jùnìjàɴ
ယူရို	jùɹò
ယူရေးရှား	jùɹéʃá
ယေရှု	jèʃṵ
ယောက္ခထီး	jaʊʔkʰətʰí
ယောက္ခမ	jaʊʔkʰəma̰
ယောက်	jaʊʔ
ယောက်ဖ	jaʊʔpʰa̰
ယောက်မ	jáʊɴma̰
ယောက်ျား	jaʊʔt͡ɕá
ယောက်ျားလျာ	jaʊʔkəʃà
ယောဂ	jɔ́ɡa̰
ယောဇနာ	jɔ́zənà
ယောနိ	jɔ́nḭ
ယဲ့ယဲ့	jɛ̰jɛ̰
ယွန်း	jʊ́ɴ
ယွန်းထည်	jʊ́ɴtʰɛ̀
ယွန်းယွန်း	jʊ́ɴjʊ́ɴ
ယှဉ်ဖက်	ʃɪ̀ɴpʰɛʔ
ယှဉ်း	ʃɪ́ɴ
ရ	ja̰
ရ	ɹa̰
ရကောက်	ja̰kaʊʔ
ရက်	jɛʔ
ရက်ကန်း	jɛʔkáɴ
ရက်ကန်းစင်	jɛʔkáɴzɪ̀ɴ
ရက်စွဲ	jɛʔswɛ́
ရက်ရာဇာ	jɛʔjàzà
ရက်သတ္တပတ်	jɛʔθaʔdəbaʔ
ရခိုင်	jəkʰàɪɴ
ရင်	jɪ̀ɴ
ရင်ခံ	jɪ̀ɴkʰàɴ
ရင်ထိုးတံဆိပ်	jɪ̀ɴdódəzeɪʔ
ရင်ပတ်	jɪ̀ɴbaʔ
ရင်ပြင်	jɪ̀ɴbjɪ̀ɴ
ရင်ဘတ်	jɪ̀ɴbaʔ
ရင်းရဲ	jɪ́ɴjɛ́
ရည်	jì
ရည်းစား	jízá
ရတနာ	jɛ̀dənà
ရတနာပုံ	jɛ̀dənàbòʊɴ
ရတနာပူရ	jɛ̀dənàpùɹa̰
ရတနာသိင်္ဃ	jədənàθèɪɴɡa̰
ရတနာသုံးပါး	jɛ̀dənàθóʊɴbá
ရတီ	jətì
ရတု	ja̰tṵ
ရထား	jətʰá
ရနံ့	jəna̰ɴ
ရန်	jàɴ
ရန်ကုန်	jàɴɡòʊɴ
ရန်ပြု	jàɴpjṵ
ရန်ဖြစ်	jàɴpʰjɪʔ
ရန်သူ	jàɴðù
ရန်သူမျိုးငါးပါး	jàɴðùmjóŋábá
ရပါတယ်	ja̰bàdɛ̀
ရပ်	jaʔ
ရပ်ကွက်	jaʔkwɛʔ
ရမ္မက်	jəmɛʔ
ရမ်	ɹàɴ
ရမ်းရမ်း	jáɴjáɴ
ရယ်	jì
ရရစ်	ja̰jɪʔ
ရဝမ်ဒါ	ɹəwàɴdà
ရဝိန်	jəwèɪɴ
ရဝေ	jəwè
ရသ	ja̰ðà
ရဟတ်	jəhaʔ
ရဟန်း	jəháɴ
ရာ	jà
ရာခိုင်နှုန်း	jàkʰàɪɴn̥óʊɴ
ရာဂ	jàɡa̰
ရာစု	jàzṵ
ရာစုနှစ်	jàzṵn̥ɪʔ
ရာဇ	jàza̰
ရာဇဂုရု	jàza̰ɡṵɹṵ
ရာဇဌာန်	ɹàzətʰàn
ရာဇဝင်	jàzəwɪ̀ɴ
ရာဇဝတ်	jàzəwʊʔ
ရာဇဝတ်ကောင်	jàzəwʊʔkàʊɴ
ရာဇသတ်	jàzəθaʔ
ရာဇာ	jàzà
ရာဇာဓိရာဇဂုရု	jàza̰dḭjàza̰ɡṵɹṵ
ရာဘ	jàba̰
ရာဘာ	jàbà
ရာမ	jàma̰
ရာမည	ɹàməɲa̰
ရာဝဏ	ɹàwəna̰
ရာသီ	jàðì
ရာသီဥတု	jàðìʔṵdṵ
ရာဟုလာ	jàhṵlà
ရိက္ခါ	jeɪʔkʰà
ရိက္ခာ	jeɪʔkʰà
ရိတ်	jeɪʔ
ရိတ်သိမ်း	jeɪʔθéɪɴ
ရိပ်ရိပ်	jeɪʔjeɪʔ
ရိုက်	jaɪʔ
ရိုင်ဖယ်	ɹàɪɴpʰɛ̀
ရိုင်ရိုင်	jàɪɴjàɪɴ
ရိုဟင်ဂျာ	ɹòhɪ̀ɴd͡ʑà
ရိုး	jó
ရိုးရာအမည်	jójàʔəmjì
ရိုးရိုး	jójó
ရုက္ခစိုး	joʊʔɡəzó
ရုက္ခဗေဒ	joʊʔkʰa̰bèda̰
ရုပ်	joʊʔ
ရုပ်ကလာပ်	joʊʔkəlaʔ
ရုပ်တု	joʊʔtṵ
ရုပ်ပုံ	joʊʔpòʊɴ
ရုပ်မြင်သံကြား	joʊʔmjɪ̀ɴθàɴd͡ʑá
ရုပ်ရှင်	joʊʔʃɪ̀ɴ
ရုပ်ရှင်ရုံ	joʊʔʃɪ̀ɴjòʊɴ
ရုပ်သေး	joʊʔθé
ရုပ်သေးအစိုးရ	joʊʔθéʔəsója̰
ရုရု	jṵjṵ
ရုရှား	ɹṵʃá
ရုံ	jòʊɴ
ရုံး	jóʊɴ
ရုံးပတီ	jóʊɴbətì
ရူပ	jùpa̰
ရူပကအလင်္ကာ	jùpəka̰ʔəlìɡà
ရူပနက္ခတ္တဗေဒ	jùpa̰nɛʔkʰaʔta̰bèda̰
ရူပဗေဒ	jùpa̰bèda̰
ရူမေးနီးယား	ɹùméníjá
ရေ	jè
ရေကတော့	jèɡədɔ̰
ရေကာတာ	jèɡàdà
ရေကူး	jèkú
ရေကူးကန်	jèkúɡàɴ
ရေကြီး	jèt͡ɕí
ရေကြီးခြင်း	jèt͡ɕíd͡ʑɪ́ɴ
ရေခဲ	jèɡɛ́
ရေခဲမုန့်	jèɡɛ́mo̰ʊɴ
ရေခဲသေတ္တာ	jèɡɛ́θɪʔtà
ရေချိုး	jèt͡ɕʰó
ရေခွက်	jèɡwɛʔ
ရေငတ်တယ်	jèŋaʔtɛ̀
ရေငွေ့	jèŋwḛ
ရေစစ္စရီ	jèsɪʔsəɹì
ရေညှိ	jèɲ̊ḭ
ရေတပ်	jèdaʔ
ရေတံခွန်	jèdàɡʊ̀ɴ
ရေတွက်	jètwɛʔ
ရေတွင်း	jèdwɪ́ɴ
ရေဒီယို	ɹèdìjò
ရေနဂါး	jènəɡá
ရေနံ	jènàɴ
ရေနံချောင်း	jènàɴt͡ɕʰáʊɴ
ရေနံဆီ	jènàɴzì
ရေပန်း	jèbáɴ
ရေပိုက်	jèpaɪʔ
ရေမိုင်	jèmàɪɴ
ရေမြင်း	jèmjɪ́ɴ
ရေမွှေး	jèm̥wé
ရေမှုတ်	jèm̥oʊʔ
ရေယုန်	jèjòʊɴ
ရေလက်ဝါး	jèlɛʔwá
ရေလုပ်သား	jèloʊʔθá
ရေဝတ	ɹèwəta̰
ရေဝတဘုရား	jèwəta̰pʰəjá
ရေသူ	jèðù
ရေသူမ	jèðùma̰
ရောက်	jaʊʔ
ရောဂန္တရကပ်	jɔ́ɡàɴtəɹa̰kaʔ
ရောဂါ	jɔ́ɡà
ရောဂါဗေဒ	jɔ́ɡàbèda̰
ရောင်	jàʊɴ
ရောင်ခြည်	jàʊɴd͡ʑì
ရောင်း	jáʊɴ
ရောမ	ɹɔ́ma̰
ရော်ဘာ	ɹɔ̀bà
ရေး	jé
ရေးချ	jét͡ɕʰa̰
ရေးရေး	jéjé
ရဲ	jɛ́
ရဲစခန်း	jɛ́səkʰáɴ
ရဲတိုက်	jɛ́daɪʔ
ရဲဘော်	jɛ́bɔ̀
ရဲရင့်	jɛ́jɪ̰ɴ
ရဲရဲ	jɛ́jɛ́
ရဲသား	jɛ́ðá
ရဲ့	jɛ̰
ရွတ်ရွတ်	jʊʔjʊʔ
ရွပ်ရွပ်	jʊʔjʊʔ
ရွရွ	jwa̰jwa̰
ရွာ	jwà
ရွာစား	jwàzá
ရွာသူ	jwàðù
ရွေး	jwé
ရွေးကောက်ပွဲ	jwékaʊʔpwɛ́
ရွှေ	ʃwè
ရွှေကြည်	ʃwèd͡ʑì
ရွှေချည်ထိုး	ʃwèd͡ʑìdó
ရွှေချီ	ʃwèd͡ʑì
ရွှေတိုက်	ʃwèdaɪʔ
ရွှေတောင်	ʃwèdàʊɴ
ရွှေတောင်ခေါက်ဆွဲ	ʃwèdàʊɴkʰaʊʔsʰwɛ́
ရွှေထမင်း	ʃwètʰəmɪ́ɴ
ရွှေနန်းရွှေပြာသာဒ်သခင်	ʃwènáɴʃwèpjaʔθaʔθəkʰɪ̀ɴ
ရွှေနန်းရှင်ဘုရား	ʃwènáɴʃɪ̀ɴpʰəjá
ရွှေပြည်စိုး	ʃwèpjìsó
ရွှေဖရုံသီး	ʃwèpʰəjòʊɴðí
ရွှေဖြူ	ʃwèbjù
ရွှေဘို	ʃwèbò
ရွှေမျက်ပါး	ʃwèmjɛʔpá
ရွှေရင်အေး	ʃwèjɪ̀ɴʔé
ရွှေ့	ʃwḛ
ရွှဲ	ʃwɛ́
ရွှံ့	ʃʊ̰ɴ
ရွှံ့ပွက်	ʃʊ̰ɴbwɛʔ
ရှက်	ʃɛʔ
ရှင့်	ʃɪ̰ɴ
ရှင်	ʃɪ̀ɴ
ရှင်တို့	ʃɪ̀ɴdo̰
ရှင်ပြု	ʃɪ̀ɴpjṵ
ရှင်ဘုရင်	ʃɪ̀ɴbəjɪ̀ɴ
ရှင်ရှင်	ʃɪ̀ɴʃɪ̀ɴ
ရှင်းရှင်း	ʃɪ́ɴʃɪ́ɴ
ရှစ်	ʃɪʔ
ရှစ်လ	ʃɪʔla̰
ရှဉ့်	ʃɪ̰ɴ
ရှည်	ʃè
ရှည်မျော	ʃèmjɔ́
ရှမ်း	ʃáɴ
ရှမ်းခေါက်ဆွဲ	ʃáɴkʰaʊʔsʰwɛ́
ရှယ်	ʃɛ̀
ရှလကာရည်	ʃàləkàjè
ရှလပတ်ရည်	ʃa̰ləpaʔjè
ရှာ	ʃà
ရှား	ʃá
ရှိ	ʃḭ
ရှိန်းခို	ʃéɪɴɡò
ရှိုက်	ʃaɪʔ
ရှို့	ʃo̰
ရှိုး	ʃó
ရှူ	ʃù
ရှူတင်	ʃùtɪ̀ɴ
ရှူရှိုက်	ʃùʃaɪʔ
ရှူးဖိနပ်	ʃúpʰənaʔ
ရှောက်	ʃaʊʔ
ရှောက်နု	ʃaʊʔnṵ
ရှေ့	ʃḛ
ရှေ့ဆက်	ʃḛzɛʔ
ရှေ့နေ	ʃḛnè
ရှေ့ရုံး	ʃḛjóʊɴ
ရှေး	ʃé
ရဿ	ɹaʔθa̰
လ	la̰
လက္ခဏ	lɛʔkʰəna̰
လက္ခဏာ	lɛʔkʰənà
လက္ခဏာရေးသုံးပါး	lɛʔkʰənàjéθóʊɴbá
လက်	lɛʔ
လက်ကိုင်ပဝါ	lɛʔkàɪɴpa̰wà
လက်ကောက်	lɛʔkaʊʔ
လက်ကွက်	lɛʔkwɛʔ
လက်ခံ	lɛʔkʰàɴ
လက်ချောင်း	lɛʔt͡ɕʰáʊɴ
လက်စွပ်	lɛʔsʊʔ
လက်ဆောင်	lɛʔsʰàʊɴ
လက်ဆွဲသေတ္တာ	lɛʔsʰwɛ́θɪʔtà
လက်တင်	lɛʔtɪ̀ɴ
လက်တင်အမေရိက	lɛʔtɪ̀ɴʔəmèɹḭka̰
လက်တန်း	lɛʔtáɴ
လက်ထပ်	lɛʔtʰaʔ
လက်နက်	lɛʔnɛʔ
လက်နှိပ်စက်	lɛʔn̥eɪʔsɛʔ
လက်ပတ်နာရီ	lɛʔpaʔnàjì
လက်ပံ	lɛʔpàɴ
လက်ပံခါး	lɛʔpàɴɡá
လက်ဖက်	ləpʰɛʔ
လက်ဖက်	lɛʔpʰɛʔ
လက်ဖက်ထုပ်	ləpʰɛʔtʰoʊʔ
လက်ဖက်ရည်	ləpʰɛʔjè
လက်ဖက်ရည်ဆိုင်	ləpʰɛʔjèzàɪɴ
လက်ဖက်သုပ်	ləpʰɛʔθoʊʔ
လက်ဘနွန်	lɛʔbənʊ̀ɴ
လက်မှတ်	lɛʔm̥aʔ
လက်ရန်း	lɛʔjáɴ
လက်ဝါး	lɛʔwá
လက်ဝါးကပ်တိုင်	lɛʔwəɡaʔtàɪɴ
လက်ဝှေ့	lɛʔʍḛ
လက်သည်	lɛʔθɛ̀
လက်သည်း	lɛʔθɛ́
လက်သည်းကွင်း	lɛʔθéɡwɪ́ɴ
လက်သမား	lɛʔθa̰má
လက်သီး	lɛʔθí
လက်သုတ်ပဝါ	lɛʔθoʊʔpa̰wà
လက်သုပ်စုံ	lɛʔθoʊʔsòʊɴ
လက်အိတ်	lɛʔʔeɪʔ
လကွယ်	la̰ɡwɛ̀
လခြမ်း	la̰d͡ʑáɴ
လခြမ်းဆိုင်း	la̰d͡ʑáɴsʰáɪɴ
လငယ်	la̰ŋɛ̀
လင်	lɪ̀ɴ
လင်ကောင်ပိုး	lɪ̀ɴɡàʊɴbó
လင်ပန်း	lɪ̀ɴbáɴ
လင်မယား	lɪ̀ɴməjá
လင်း	lɪ́ɴ
လင်းဆွဲ	lɪ́ɴzwɛ́
လင်းဇင်း	lɪ́ɴzɪ́ɴ
လင်းတ	lɪ́ɴda̰
လင်းနို့	lɪ́ɴno̰
လင်းပိုင်	lɪ́ɴbàɪɴ
လင်းယဉ်	lɪ́ɴjɪ̀ɴ
လင်းယုန်	lɪ́ɴjòʊɴ
လစဉ်	la̰zɪ̀ɴ
လစ်	lɪʔ
လစ်တန်စတိန်း	lɪʔtàɴsətéɪɴ
လစ်ဗျား	lɪʔbjá
လစ်သူယေးနီးယား	lɪʔθùjéníjá
လဆန်း	la̰záɴ
လဆုတ်	la̰zoʊʔ
လဆွဲ	la̰sʰwɛ́
လည်	lɛ̀
လည်ချောင်း	lɛ̀d͡ʑáʊɴ
လည်စည်း	lèzí
လည်ပင်း	lɛ̀bɪ́ɴ
လည်ပင်းကြီးရောဂါ	lìbɪ́ɴd͡ʑíjɔ́ɡà
လည်း	lí
လည်း	lɛ́
လတ်	laʔ
လတ်ဗီယာ	laʔbìjà
လန်ဒန်	làɴdàɴ
လပို့	ləbo̰
လပ်	laʔ
လပြည့်	la̰pjḛ
လပြည့်နေ့	la̰pjḭnḛ
လပြည့်ဝန်း	la̰bjḛwʊ́ɴ
လမု	ləmṵ
လမုန့်	la̰mo̰ʊɴ
လမ်း	láɴ
လမ်းကြား	láɴd͡ʑá
လမ်းဆုံ	láɴzòʊɴ
လမ်းပြ	láɴpja̰
လမ်းဘေးဆိုင်	láɴbézàɪɴ
လမ်းလျှောက်	láɴʃaʊʔ
လမ်းသရဲ	láɴθəjɛ́
လယ်	lɛ̀
လယ်ထွန်	lɛ̀tʰʊ̀ɴ
လယ်ထွန်မင်္ဂလာ	lɛ̀tʰʊ̀ɴmɪ̀ɴɡəlà
လယ်ပြင်	lɛ̀bjɪ̀ɴ
လယ်ယာ	lɛ̀jà
လယ်သမား	lɛ̀ðəmá
လဟု	ləhṵ
လာ	là
လာဘ်	laʔ
လာအို	làʔò
လား	lá
လိင်	lèɪɴ
လိင်ဆက်ဆံ	lèɪɴsʰɛʔsʰàɴ
လိင်တံ	lèɪɴdàɴ
လိင်ပညာ	lèɪɴpjɪ̀ɴɲà
လိပ်	leɪʔ
လိပ်ကျောက်	leɪʔt͡ɕaʊʔ
လိပ်ခေါင်း	leɪʔɡáʊɴjɔ́ɡà
လိပ်ခေါင်းရောဂါ	leɪʔɡáʊɴjɔ́ɡà
လိပ်စာ	leɪʔsà
လိပ်ပြာ	leɪʔpjà
လိမ္မော်	lèɪɴmɔ̀
လိမ်	lèɪɴ
လိမ်း	léɪɴ
လိမ်းဆေး	léɪɴzé
လို	lò
လိုက်	laɪʔ
လိုက်ချီး	laɪʔt͡ɕʰí
လိုက်ပြေး	laɪʔpjé
လိုက်ဘေးရီးယား	laɪʔbéɹíjá
လိုချင်	lòd͡ʑɪ̀ɴ
လိုင်စင်	làɪɴsɪ̀ɴ
လိုင်း	láɪɴ
လိုဏ်	l̥àɪɴ
လိုဏ်ခေါင်း	l̥àɪɴɡáʊɴ
လိုအပ်	lòʔaʔ
လို့	lo̰
လိုး	ló
လီဆိုသို	lìsʰòθò
လီဆူ	lìsʰù
လီတာ	lìtà
လီသီယမ်	lìθìjàɴ
လီး	lí
လုပ်	loʊʔ
လုပ်ခ	loʊʔkʰa̰
လုပ်ငန်း	loʊʔŋáɴ
လုပ်ရတ်	loʊʔjaʔ
လုပ်သား	loʊʔθá
လုပ်အား	loʊʔʔá
လုံချည်	lòʊɴd͡ʑì
လုံခြုံရေး	lòʊɴd͡ʑòʊɴjé
လုံး	lóʊɴ
လုံးလုံး	lóʊɴlóʊɴ
လူ	lù
လူကြီး	lùd͡ʑí
လူငယ်	lùŋɛ̀
လူစုလူဝေး	lùzṵlùwé
လူဇင်ဘတ်	lùzɪ̀ɴbaʔ
လူတော	lùdɔ́
လူပျို	lùbjò
လူပျိုနာ	lùbjònà
လူမျိုး	lùmjó
လူမျိုးစုလွှတ်တော်	lùmjózṵl̥ʊʔtɔ̀
လူမျိုးရေးဝါဒ	lùmjójéwàda̰
လူမှုကွန်ရက်	lùm̥ṵkʊ̀ɴjɛʔ
လူဝင်မှုကြီးကြပ်ရေး	lùwɪ̀ɴm̥ṵt͡ɕít͡ɕaʔjé
လူဝံ	lùwʊ̀ɴ
လူသတ်မှု	lùðaʔm̥ṵ
လူသား	lùðá
လူဦးရေ	lùʔújè
လူ့ဘောင်	lṵbàʊɴ
လူ့အဖွဲ့အစည်း	lṵʔəpʰwɛ̰ʔəsí
လေ	lè
လေကတော့	lèɡədɔ̰
လေချဉ်တက်	lèd͡ʑɪ̀ɴtɛʔ
လေချွန်	lèt͡ɕʰʊ̀ɴ
လေစုန်	lèzòʊɴ
လေဆိပ်	lèzeɪʔ
လေထိုးတံ	lètʰódàɴ
လေထီး	lèdí
လေထု	lèdṵ
လေပွေ	lèbwè
လေဖိအား	lèpʰḭʔá
လေဖုတ်	lèpʰoʊʔ
လေဖြတ်ရောဂါ	lèpʰjaʔjɔ́ɡà
လေမုန်တိုင်း	lèmòʊɴdáɪɴ
လေယာဉ်	lèjɪ̀ɴ
လေယာဉ်ပျံ	lèjɪ̀ɴbjàɴ
လေရဟတ်	lèjəhaʔ
လေလည်	lèlè
လေသာခန်း	lèðàɡáɴ
လေသာပေါက်	lèðàbaʊʔ
လေသိုက်	lèθaɪʔ
လေအေးစက်	lèʔézɛʔ
လောက	lɔ́ka̰
လောကနတ်	lɔ́ka̰naʔ
လောကဝတ်	lɔ́ɡəwʊʔ
လောက်	laʊʔ
လောင်	làʊɴ
လောင်စာ	làʊɴzà
လောင်း	láʊɴ
လောဘ	lɔ́ba̰
လောလော	lɔ́lɔ́
လေ့ကျင့်	lḛt͡ɕɪ̰ɴ
လေ့ကျင့်ခန်း	lḛt͡ɕɪ̰ɴɡáɴ
လေ့လာ	lḛlà
လေး	lé
လေးကြိုး	léd͡ʑó
လေးညှင်း	léɲ̊ɪ́ɴ
လေးညှင်းပွင့်	léɲ̊ɪ́ɴbwɪ̰ɴ
လေးထောင့်	léda̰ʊɴ
လေးလ	léla̰
လေးလံ	lélàɴ
လဲ	lɛ́
လဲ့လဲ့	lɛ̰lɛ̰
လံဗား	làɴbá
လျက်	jɛʔ
လျားလျား	jájá
လျောင်း	ljáʊɴ
လျှင်	l̥jɪ̀ɴ
လျှပ်	l̥jaʔ
လျှပ်စစ်ဓာတ်	l̥jaʔsɪʔdaʔ
လျှပ်စီး	l̥jaʔsí
လျှာ	ʃà
လျှာနာခွာနာ	ʃànàkʰwànà
လျှာရည်	ʃàjì
လျှောက်	ʃaʊʔ
လွတ်လပ်	lʊʔlaʔ
လွတ်လပ်ခွင့်	lʊʔlaʔkʰwɪ̰ɴ
လွတ်လပ်ရေးနေ့	lʊʔlaʔjénḛ
လွန်	lʊ̀ɴ
လွန်ဆွဲ	lʊ̀ɴsʰwɛ́
လွယ်	lwɛ̀
လွိုင်ကော်	lwàɪɴkɔ̀
လွှ	l̥wa̰
လွှတ်တော်	l̥ʊʔtɔ̀
လွှတ်ရုံးငါးရပ်	l̥ʊʔjóʊɴŋájaʔ
လှ	l̥a̰
လှည့်	l̥ɛ̰
လှည်း	l̥ɛ́
လှည်းကူး	l̥íkú
လှပ	l̥a̰pa̰
လှပ်လှပ်	l̥aʔl̥aʔ
လှလှ	l̥a̰l̥a̰
လှိုင်း	l̥áɪɴ
လှုပ်ရှား	l̥oʊʔʃá
လှုပ်လှုပ်	l̥oʊʔl̥oʊʔ
လှုလှု	l̥ṵl̥ṵ
လှုံ	l̥òʊɴ
လှေ	l̥è
လှေကား	l̥èɡá
လှောက်	l̥aʊʔ
လှော်ကား	l̥ɔ̀ɡá
လှေး	l̥é
လှဲ	l̥ɛ́
လှံ	l̥àɴ
ဝ	wa̰
ဝက်	wɛʔ
ဝက်ကြွပ်	wɛʔt͡ɕʊʔ
ဝက်ခြံ	wɛʔt͡ɕʰàɴ
ဝက်ဆီ	wɛʔsʰì
ဝက်ထီး	wɛʔtʰí
ဝက်ဘ်ဆိုဒ်	wɛʔbsʰaɪʔ
ဝက်မ	wɛʔma̰
ဝက်မှင်ဘီး	wɛʔm̥ɪ̀ɴbí
ဝက်ဝံ	wɛʔwʊ̀ɴ
ဝက်သား	wɛʔθá
ဝက်သားချဉ်	wɛʔθát͡ɕʰɪ̀ɴ
ဝက်သားတုတ်ထိုး	wɛʔθádoʊʔtʰó
ဝက်သားမျှစ်ချဉ်	wɛʔθám̥jɪʔt͡ɕʰɪ̀ɴ
ဝက်အူ	wɛʔʔù
ဝက်အူချောင်း	wɛʔʔùd͡ʑáʊɴ
ဝင်	wɪ̀ɴ
ဝင်ရိုး	wɪ̀ɴjó
ဝင်း	wɪ́ɴ
ဝစီ	wəzì
ဝစီကံ	wəzìɡàɴ
ဝစ်ရှင်နရီ	wɪʔʃɪ̀ɴnəɹì
ဝဆွဲ	wa̰sʰwɛ́
ဝဇီရာ	wəzìjà
ဝဏ္ဏ	wʊ̀ɴna̰
ဝတီ	wədì
ဝတ္ထု	wʊʔtʰṵ
ဝတ်	wʊʔ
ဝတ်ကျောင်း	wʊʔt͡ɕáʊɴ
ဝတ်စုံ	wʊʔsòʊɴ
ဝတ်လုံ	wʊʔlòʊɴ
ဝနာ	wənà
ဝန်	wʊ̀ɴ
ဝန်ကြီး	wʊ̀ɴd͡ʑí
ဝန်ကြီးချုပ်	wʊ̀ɴd͡ʑíd͡ʑoʊʔ
ဝန်ကြီးချုပ်ကတော်	wʊ̀ɴd͡ʑíd͡ʑoʊʔɡədɔ̀
ဝန်ကြီးဌာန	wʊ̀ɴd͡ʑítʰàna̰
ဝန်ခံ	wʊ̀ɴkʰàɴ
ဝန်စည်စလယ်	wʊ̀ɴzìzəlɛ̀
ဝန်ထောက်	wʊ̀ɴdaʊʔ
ဝန်ရှင်တော်	wʊ̀ɴʃɪ̀ɴdɔ̀
ဝပ်	waʔ
ဝပ်	wʊʔ
ဝမ်း	wʊ́ɴ
ဝမ်းကျ	wáɴd͡ʑa̰
ဝမ်းဆက်	wʊ́ɴsʰɛʔ
ဝမ်းဆွဲ	wʊ́ɴzwɛ́
ဝမ်းတဖိုး	wʊ́ɴda̰pʰó
ဝမ်းနည်း	wáɴné
ဝမ်းဘဲ	wʊ́ɴbɛ́
ဝမ်းရောဂါ	wʊ́ɴjɔ́ɡà
ဝမ်းသာ	wʊ́ɴθà
ဝယ်	wɛ̀
ဝရဏဗေဒ	wəjəna̰da̰bèda̰
ဝရန်တာ	wəɹàɴdà
ဝလာဟကမြင်း	wəlàhəka̰mjɪ́ɴ
ဝသန္တ	wa̰θàɴta̰
ဝသုန္ဓရာ	wəθòʊɴdəɹà
ဝသုန္ဓရေ	wəθòʊɴdəɹè
ဝါ	wà
ဝါကျ	weɪʔt͡ɕa̰
ဝါခေါင်	wàɡàʊɴ
ဝါဂွမ်း	wàɡwáɴ
ဝါစင်္ဂ	wàzɪ̀ɴɡa̰
ဝါဆို	wàsʰò
ဝါဆော	wàsʰɔ́
ဝါဏိဇ္ဇ	wàneɪʔza̰
ဝါဏိဇ္ဇပဋိပက္ခ	wàneɪʔza̰pədḭpɛʔkʰa̰
ဝါဏိဇ္ဇဗေဒ	wàneɪʔza̰bèda̰
ဝါဒ	wàda̰
ဝါရှင်တန်	wàʃɪ̀ɴtàɴ
ဝါရှာ	wàʃà
ဝါသနာ	wàða̰nà
ဝါသနာရှင်	wàðənàʃɪ̀ɴ
ဝါး	wá
ဝိဇယပူရ	wḭzəja̰pùɹa̰
ဝိဇ္ဇာ	weɪʔzà
ဝိဇ္ဇာပညာ	weɪʔzàpjɪ̀ɴɲà
ဝိဇ္ဇာဘွဲ့	weɪʔzàbwɛ̰
ဝိညာဉ်	wèɪɴɲɪ̀ɴ
ဝိတိုရိယ	wḭtòɹḭja̰
ဝိတ်	weɪʔ
ဝိတ်ချ	weɪʔt͡ɕʰa̰
ဝိတ်လျှော့	weɪʔʃɔ̰
ဝိနည်း	wḭní
ဝိနိစ္ဆယ	wḭneɪʔsəja̰ja̰
ဝိပတ္တိတရားလေးပါး	wḭpaʔtḭtəjálébá
ဝိပဿနာ	wḭpaʔθənà
ဝိပဿီ	wḭpətθì
ဝိပဿီဘုရား	wḭpaʔθìpʰəjá
ဝိဘတ်	wḭbaʔ
ဝိသေသ	wḭθèθa̰
ဝိသေသလက္ခဏာ	wḭθèθa̰lɛʔkʰənà
ဝိဟာရ	wḭhàja̰
ဝိုက်ချ	waɪʔt͡ɕʰa̰
ဝိုင်	wàɪɴ
ဝိုင်ယာကြိုး	wàɪɴjàd͡ʑó
ဝိုင်း	wáɪɴ
ဝီကီပိဒိယ	wìkìpḭdḭja̰
ဝီကီပီးဒီးယား	wìkìpídíjá
ဝီစကီ	wìsəkì
ဝီစီ	wìsì
ဝီရ	wìja̰
ဝီရိယ	wəɹḭja̰
ဝေဒနာ	wèdənà
ဝေလ	wèla̰
ဝေလငါး	wèla̰ŋá
ဝေသာလီ	wèθàlì
ဝေဟင်	wèhɪ̀ɴ
ဝေါ	wɔ́
ဝေါဟာရ	wɔ́hàɹa̰
ဝေါဟာရဗေဒ	θaʔda̰bèda̰
ဝေး	wé
ဝေးကွာ	wékwà
ဝေဿ	wɪʔθa̰
ဝေဿဘူ	wètθəbù
ဝေဿဘူဘုရား	wètθa̰bùpʰəjá
ဝံ	wʊ̀ɴ
ဝံပုလွေ	wʊ̀ɴbəlwè
ဝံသ	wʊ̀ɴθa̰
ဝှက်	ʍɛʔ
ဝှေးစေ့	ʍézḭ
သ	θa̰
သ	θə
သကာ	ðəɡà
သကုဏဗေဒ	θa̰kṵna̰bèda̰
သက္ကတ	θɛʔkəta̰
သက်ဆိုင်	θɛʔsʰàɪɴ
သက်တင်	θɛʔtɪ̀ɴ
သက်တံ	θɛʔtàɴ
သက်သာ	θɛʔθà
သက်သေ	θɛʔθè
သက်ဦးဆံပိုင်	θɛʔʔúsʰàɴbàɪɴ
သကြား	ðəd͡ʑá
သကြားလုံး	ðəd͡ʑálóʊɴ
သခွား	θəkʰwá
သခွားမသီး	θəkʰəma̰ðí
သင်	θɪ̀ɴ
သင်ကြား	θɪ̀ɴt͡ɕá
သင်ခန်းစာ	θɪ̀ɴɡáɴzà
သင်တုန်းဓား	θɪ̀ɴdóʊɴdá
သင်ပန်း	θɪ̀ɴbáɴ
သင်ပေါင်း	θɪ̀ɴbáʊɴ
သင်း	θɪ́ɴ
သင်းဝင်	θɪ́ɴwɪ̀ɴ
သင်္ကဒူး	θɪ́ɴɡədú
သင်္ကန်း	θɪ̀ɴɡáɴ
သင်္ကေတ	θɪ̀ɴkèta̰
သင်္ကြန်	θɪ́ɴd͡ʑàɴ
သင်္ကြန်ထမင်း	ðəd͡ʑàɴtʰəmɪ́ɴ
သင်္ကြန်မိုး	θɪ̀ɴd͡ʑàɴmó
သင်္ချာ	θɪ̀ɴt͡ɕʰà
သင်္ချိုင်း	θɪ̀ɴd͡ʑáɪɴ
သင်္ဂဟ	θɪ̰ɴɡəha̰
သင်္ဂဟတရားလေးပါး	θɪ̀ɴɡa̰ha̰ta̰jálépá
သင်္ဘော	θɪ́ɴbɔ́
သင်္ဘောကြမ်း	θɪ̀ɴbɔ́d͡ʑáɴ
သင်္ဘောဆိပ်	θɪ̀ɴbɔ́zeɪʔ
သင်္ဘောမညှိုးပန်း	θɪ́ɴbɔ́məɲ̊óbáɴ
သင်္ဘောသီး	θɪ́ɴbɔ́ðí
သင်္ဘောသီးသုပ်	θɪ̀ɴbɔ́θíθoʊʔ
သင်္သကရိုက်	θɪ̀ɴθəkəɹaɪʔ
သစ္စာ	θɪʔsà
သစ္စာဖောက်	θɪʔsàpʰaʊʔ
သစ္စာလေးပါး	θɪʔsàlépá
သစ်	θɪʔ
သစ်ကတိုး	θɪʔɡədó
သစ်ကုလားအုတ်	θɪʔkələʔoʊʔ
သစ်ကျုတ်	θɪʔt͡ɕoʊʔ
သစ်ကြံပိုး	θɪʔd͡ʑəbó
သစ်စေး	sɪʔsí
သစ်ဆိမ့်	θɪʔsʰḛɪɴ
သစ်တို	θɪʔtò
သစ်တော	θɪʔtɔ́
သစ်ပင်	θɪʔpɪ̀ɴ
သစ်ပုပ်	θɪʔpoʊʔ
သစ်ဖြူ	θɪʔpʰjù
သစ်သစ်	θɪʔθɪʔ
သစ်သီး	θɪʔθí
သစ်သီးရည်	θɪʔθíjè
သဇင်	ðəzɪ̀ɴ
သဉ္ဇာ	θɪ̀ɴzà
သဉ္ဇာလီ	θɪ̀ɴzàlì
သည့်	θḭ
သည်	θè
သည်မှာ	ðìm̥à
သည်း	θí
သည်းခြေ	θíd͡ʑè
သဏ္ဍာန်	θədàɴ
သတင်း	ða̰dɪ́ɴ
သတင်းစာ	ðədɪ́ɴzà
သတင်းစာဆရာ	ðədɪ́ɴzàsʰəjà
သတင်းပို့	ðədɪ́ɴpo̰
သတို့သမီး	ðədo̰θəmí
သတို့သား	ðədo̰θá
သတ္တဗေဒ	θaʔta̰bèda̰
သတ္တမ	θaʔtəma̰
သတ္တဝါ	θaʔtəwà
သတ္တိ	θaʔtḭ
သတ္တု	θaʔtṵ
သတ္တုစပ်	θaʔtṵzaʔ
သတ္တုတွင်း	θaʔtṵdwɪ́ɴ
သတ္တုဗေဒ	θaʔtṵbèda̰
သတ္တုရိုင်း	θaʔtṵjáɪɴ
သတ္ထန္တရကပ်	θaʔtʰàɴtəɹa̰kaʔ
သတ်	θaʔ
သတ်ဖြတ်	θaʔpʰjaʔ
သဒ္ဒဗေဒ	θaʔda̰bèda̰
သဒ္ဒါ	ðədà
သဒ္ဒါဆယ်ပါး	ðədàsʰɛ̀bá
သဒ္ဓါ	θàddà
သဒ္ဓါကြေး	θədàt͡ɕé
သနပ်	θənaʔ
သနပ်ခါး	θənəkʰá
သန္တာ	θàɴdà
သန္ဓေ	θàɴdè
သန္ဓေဗေဒ	θàɴdèbèda̰
သန္ဓေသား	ðədèðá
သန်ကောင်	θàɴɡàʊɴ
သန်တူ	θàɴtù
သန်လျက်	θàɴjɛʔ
သန်လျင်	θəɲɪ̀ɴ
သန်လျင်း	θàɴləjɪ́ɴ
သန်လျင်းချိတ်	θàɴjɪ́ɴd͡ʑeɪʔ
သန်း	θáɴ
သန်းခေါင်	ðəɡàʊɴ
သပိတ်	ðəbeɪʔ
သပ်	θaʔ
သပြု	ðəbjṵ
သပြေ	ðəbjè
သဘက်ခါ	θəbɛʔkʰà
သဘာပတိ	θəbàpətḭ
သဘာဝ	ðəbàwa̰
သဘာဝတ္ထဗေဒ	θəbàwʊʔtʰa̰bèda̰
သဘော	ðəbɔ́
သဘောတူ	ðəbɔ́tù
သမက်	θəmɛʔ
သမဂ္ဂ	θa̰mɛʔɡa̰
သမင်	θəmɪ̀ɴ
သမင်မ	θəmɪ̀ɴma̰
သမာသမတ်	θəmàθəmaʔ
သမား	θəmá
သမိန်	θəmèɪɴ
သမိုင်း	θəmáɪɴ
သမီး	θəmí
သမုဒ္ဒရာ	θəmoʊʔdəjà
သမ္ဗန္ဓ	θàɴbàɴda̰
သမ္မတ	θəməda̰
သမ္မတကတော်	θəma̰da̰ɡədɔ̀
သမ္မတနိုင်ငံ	θəməda̰nàɪɴŋàɴ
သမ္မာကျမ်း	θəmàt͡ɕáɴ
သမ်း	θáɴ
သယ်	θɛ̀
သရ	θəɹa̰
သရက်	θəjɛʔ
သရက်ရွက်	θəjɛʔjwɛʔ
သရက်သီးသနပ်	θəjɛʔθíθa̰naʔ
သရဏဂုံသုံးပါး	θəjənəɡòʊɴθóʊɴbá
သရဏင်္ကရာ	θəɹənɪ̀ɴkəɹà
သရဏင်္ကရာဘုရား	θəɹənɪ̀ɴkəɹàpʰəjá
သရဖူ	θəɹəpʰù
သရီရ	θəɹìɹa̰
သရုပ်	θəjoʊʔ
သရုပ်ဆောင်	θəjoʊʔsʰàʊɴ
သရုပ်ဖော်	θəjoʊʔpʰɔ̀
သရဲ	θəjɛ́
သလား	θa̰lá
သလိပ်	θəleɪʔ
သလုံး	θəlóʊɴ
သလဲသီး	θəlɛ́θí
သလွဲ	θəlwɛ́
သဝဏ်လွှာ	θəwʊ̀ɴl̥wà
သာဂူ	θàɡù
သာဂူပြင်	θàɡùbjɪ̀ɴ
သာဓက	θàda̰ka̰
သာဓု	θàdṵ
သာမဏေ	θàmənè
သာမိုမီတာ	θàmòmìtà
သာယာဝတီ	θàjàwədì
သာရိပုတ္တရာ	θàjḭpoʊʔtəjà
သာဝက	θàwəka̰
သာဝတ္ထိ	θàwʊʔtʰḭ
သာသနာ	θàðənà
သာသနာ့အာဇာနည်	θàθəna̰ʔàzànì
သား	θá
သားကြီး	θád͡ʑí
သားပိုက်ကောင်	θábaɪʔkàʊɴ
သားမြီးယပ်	θámjíjaʔ
သားရေ	θəjè
သားလောင်း	θáláʊɴ
သားလှောင်	θál̥àʊɴ
သားသတ်ရုံ	θáðaʔjòʊɴ
သားအိမ်	θəʔèɪɴ
သားအိမ်ခေါင်း	θəʔèɪɴɡáʊɴ
သားအိမ်လမ်းကြောင်း	θəʔèɪɴláɴd͡ʑáʊɴ
သားဥ	θáʔṵ
သားဥအိမ်	θáʔṵʔèɪɴ
သိ	θḭ
သိက္ခါ	θeɪʔkʰà
သိကြား	ðəd͡ʑá
သိခီဘုရား	θḭkʰìpʰəjá
သိင်္ဂီ	θèɪɴɡì
သိထိလ	θḭtʰḭla̰
သိဒ္ဓတ္ထ	θeɪʔdaʔtʰa̰
သိဒ္ဓတ္ထဘုရား	θìddaʔtʰa̰pʰəjá
သိဒ္ဓတ်မင်း	θeɪʔdaʔmɪ́ɴ
သိဒ္ဓိ	θeɪʔdḭ
သိန်း	θéɪɴ
သိပ္ပံ	θeɪʔpàɴ
သိပ္ပံဘွဲ့	θeɪʔpàɴbwɛ̰
သိပ်	θeɪʔ
သိမ်	θèɪɴ
သိရှိ	θḭʃḭ
သိဝ	θḭwa̰
သိုက်	θaɪʔ
သို့ပေမဲ့	ðo̰bèmɛ̰
သို့မဟုတ်	ðo̰məhoʊʔ
သို့ရာတွင်	ðo̰jàdwɪ̀ɴ
သို့သော်	ðo̰ðɔ̀
သိုး	θó
သိုးဆောင်း	θósʰáʊɴ
သိုးထိန်း	θódéɪɴ
သိုးထီး	θódí
သိုးမ	θóma̰
သိုးမွေး	θómwé
သိုးအုပ်	θóʔoʊʔ
သီချင်း	θət͡ɕʰɪ́ɴ
သီဂိရိယ	θìɡḭɹḭja̰
သီတဂူ	θìdəɡù
သီတင်း	ðədɪ́ɴ
သီတင်းကျွတ်	ðədɪ́ɴd͡ʑʊʔ
သီတင်းသီလ	ðədɪ́ɴθìla̰
သီတာ	θìdà
သီတာဒေဝီ	θìdàdèwì
သီရိ	θìɹḭ
သီရိလင်္ကာ	θìɹḭlɪ̀ɴkà
သီလ	θìla̰
သီလရှင်	θìla̰ʃɪ̀ɴ
သီဟ	θìha̰
သီဟိုဠ်	θìhò
သီဟိုဠ်သရက်	θìhòθəjɛʔ
သီအိုရီ	θìʔòɹì
သီး	θí
သီးစုံချဉ်ရည်	θízòʊɴt͡ɕʰɪ̀ɴjì
သီးပင်	θíbɪ̀ɴ
သီးသီး	θíðí
သု	θṵ
သုက်	θoʊʔ
သုက်ကောင်	θoʊʔkàʊɴ
သုက်ပိုး	θoʊʔpó
သုက်ရည်	θoʊʔjè
သုခ	θṵkʰa̰
သုခေါဒယ	θṵkʰɔ́dəja̰
သုဇာတဘုရား	θṵzàta̰pʰəjá
သုည	θòʊɴɲa̰
သုတ	θṵta̰
သုတေသန	θṵtèθəna̰
သုတေသီ	θṵtèθì
သုတ်	θoʊʔ
သုဒ္ဒ	θoʊʔda̰
သုဒ္ဒကိန်း	θoʊʔda̰kéɪɴ
သုဒ္ဒကြိယာ	θoʊʔda̰kəɹḭjà
သုဒ္ဓေါဒန	θùddɔ́dəna̰
သုဓမ္မပူရ	θṵdəma̰pùɹa̰
သုဓမ္မသိင်္ဂီ	θṵdàɴma̰θèɪɴɡì
သုဓာ	θoʊʔdà
သုပ်	θoʊʔ
သုမန	θṵməna̰
သုမနဘုရား	θṵməna̰pʰəjá
သုမေဓာ	θṵmèdà
သုမေဓာဘုရား	θṵmèdàpʰəjá
သုဝဏ္ဏ	θṵwʊ̀ɴna̰
သုသာန်	θoʊʔθàɴ
သုံး	θóʊɴ
သုံးဆယ်	θóʊɴsʰɛ̀
သုံးဆောင်	θóʊɴsʰàʊɴ
သုံးလ	θóʊɴla̰
သူ	θù
သူကောင်	θùɡàʊɴ
သူကောင်တင်	θùɡàʊɴdɪ̀ɴ
သူကောင်း	θùɡáʊɴ
သူကောင်းပြု	θùɡáʊɴpjṵ
သူကောင်းမြှောက်	θùɡáʊɴm̥jaʊʔ
သူကောင်းသား	θùɡáʊɴðá
သူကျက်	θùd͡ʑɛʔ
သူကြီး	θùd͡ʑí
သူကြွယ်	θùt͡ɕwɛ̀
သူခိုး	θəkʰó
သူငယ်	θəŋɛ̀
သူငယ်ချင်း	θəŋɛ̀d͡ʑɪ́ɴ
သူငယ်တန်း	θùŋɛ̀dáɴ
သူငယ်မ	θəŋɛ̀ma̰
သူစိမ်း	ðəzéɪɴ
သူစိမ်းတစ်ရံဆံ	ðəzéɪɴtəjàɴzàɴ
သူဆင်းရဲ	θùsʰɪ́ɴjɛ́
သူဇာ	θùzà
သူဌေး	θətʰé
သူတကာ	θùdəɡà
သူတစ်ခွန်းငါတစ်ခွန်း	θùtəkʰʊ́ɴŋàtəkʰʊ́ɴ
သူတစ်ထူး	θùtətʰú
သူတစ်ပါး	θùdəbá
သူတစ်ပြန်ငါတစ်ပြန်	θùdəbjàɴŋàdəbjàɴ
သူတစ်လူငါတစ်မင်း	θùtəlùŋàtəmɪ́ɴ
သူတို့	θùdo̰
သူတောင်းစား	ðədáʊɴzá
သူတော်	θùdɔ̀
သူတော်ကောင်း	θùdɔ̀ɡáʊɴ
သူတော်စင်	θùdɔ̀zɪ̀ɴ
သူတော်သူမြတ်	θùdɔ̀θùmjaʔ
သူနာ	θùnà
သူနာတင်ကား	θùnàtɪ̀ɴká
သူနာတင်ယာဉ်	θùnàtɪ̀ɴjɪ̀ɴ
သူနာပြု	θùnàbjṵ
သူနိုင်ငါညှဉ်းလုပ်	θùnàɪɴŋàɲ̊ɪ́ɴloʊʔ
သူပုန်	ðəbòʊɴ
သူပုန်ထ	ðəbòʊɴtʰa̰
သူပုန်သူကန်	ðəbəðùɡàɴ
သူပြောငါပြော	θùpjɔ́ŋàpjɔ́
သူဖုန်းစား	θùpʰóʊɴsá
သူမ	θùma̰
သူမသာကိုယ်မသာ	θùməθàkòjməθà
သူမသာငါမသာ	θùməθàŋàməθà
သူမိုက်	θùmaɪʔ
သူများ	θùmjá
သူများနည်းတူ	θùmjánítù
သူယုတ်မာ	θùjoʊʔmà
သူယောင်	θùjàʊɴ
သူယောင်မယ်	θùjàʊɴmɛ̀
သူရ	θùja̰
သူရကန်	θùɹəkàɴ
သူရင်းငှား	θəjɪ́ɴŋ̊á
သူရင်းတိုင်	θəjɪ́ɴdàɪɴ
သူရသတ္တိ	θùja̰θaʔtḭ
သူရိန်	θùjèɪɴ
သူရိယမာသ	θùɹḭja̰màθa̰
သူရဲ	θəjɛ́
သူရဲကောင်း	θùjɛ́ɡáʊɴ
သူရဲကြီး	θùjɛ́d͡ʑí
သူရဲကြီးအလံ	θùjɛ́d͡ʑíʔəlàɴ
သူရဲခို	θəjɛ́kʰò
သူရဲပြေး	θəjɛ́pjé
သူရဲဘောကြောင်	θəjɛ́bɔ́d͡ʑàʊɴ
သူရဲဘောနည်း	θəjɛ́bɔ́ní
သူရဿတီ	θùɹa̰θətì
သူလိုငါလို	θùlòŋàlò
သူလျှို	ðəʃò
သူသူငါငါ	θùθùŋàŋà
သူသေ	θùθè
သူဟောင်းစကား	θùháʊɴzəɡá
သူအို	θùʔò
သူ့	θṵ
သေ	θè
သေခြင်း	θèd͡ʑɪ́ɴ
သေတ္တာ	θɪʔtà
သေနတ်	θənaʔ
သော	θɔ́
သောက္ကတဲ	θaʊʔkətɛ́
သောက်	θaʊʔ
သောကြာ	θaʊʔt͡ɕà
သောကြာဂြိုဟ်	θaʊʔt͡ɕàd͡ʑò
သောင်း	θáʊɴ
သောင်းသောင်း	θáʊɴðáʊɴ
သောဘိတ	θɔ́bḭta̰
သောဘိတဘုရား	θɔ́bḭta̰pʰəjá
သောမနဿ	θɔ́mənaʔθa̰
သောသော	θɔ́ðɔ́
သော့	θɔ̰
သော့တံ	θɔ̰dàɴ
သော်	ðɔ̀
သော်တာ	θɔ̀dà
သေး	θé
သဲ	θɛ́
သဲကန္တာရ	θéɡàɴdàja̰
သဲကျောက်	θɛ́d͡ʑaʊʔ
သဲ့သဲ့	θɛ̰ðɛ̰
သံ	θàɴ
သံကြိုး	θàɴd͡ʑó
သံကြိုးစာ	θàɴd͡ʑózà
သံကြွပ်	θàɴd͡ʑʊʔ
သံချပ်	θəd͡ʑaʔ
သံချေး	θàɴd͡ʑí
သံခွာ	θàɴkʰwà
သံဃာ	θàɴɡà
သံစုံတီးဝိုင်း	θàɴzòʊɴtíwáɪɴ
သံတမန်	θàɴtəmàɴ
သံတော်ဆင့်	θàɴdɔ̀zɪ̰ɴ
သံတွဲ	θàɴdwɛ́
သံပန်း	θàɴbáɴ
သံပရာ	θàɴbəjà
သံပရို	θàɴba̰jò
သံပေါက်	θàɴbaʊʔ
သံပြိုင်	θàɴbjàɪɴ
သံဖြူ	θàɴbjù
သံမဏိ	θàɴmənḭ
သံရုံး	θàɴjóʊɴ
သံလမ်း	θàɴláɴ
သံလမ်းရထား	θàɴláɴjətʰá
သံလိုက်	θàɴlaɪʔ
သံလိုက်စက်ကွင်း	θàɴlaɪʔsɛʔkwɪ́ɴ
သံလွင်	θàɴlwɪ̀ɴ
သံဝါသ	θàɴwàθa̰
သံသယ	θàɴθəja̰
သံအမတ်	θàɴʔəmaʔ
သံ့သံ့	θa̰ɴða̰ɴ
သျှင်	ʃɪ̀ɴ
သျှမ်း	ʃáɴ
သျှောင်	jàʊɴ
သွင်သွင်	θwɪ̀ɴðwɪ̀ɴ
သွင်း	θwɪ́ɴ
သွတ်သွတ်	θʊʔθʊʔ
သွန်းသွန်း	θʊ́ɴðʊ́ɴ
သွပ်	θʊʔ
သွား	θwá
သွားကြားထိုးတံ	θwád͡ʑátʰódàɴ
သွားတိုက်ဆေး	θwádaɪʔsʰé
သွားပွတ်တံ	ðəbʊʔtàɴ
သွားဖုံး	θəpʰóʊɴ
သွားရည်	θəjì
သွေ	θwè
သွေး	θwé
သွေးကြော	θwéd͡ʑɔ́
သွေးတိုးရောဂါ	θwétójɔ́ɡà
သွေးပေါ်	θwépɔ̀
သွေးအုပ်စု	θwéʔoʊʔsṵ
ဟ	ha̰
ဟင့်အင်း	hɪ̰ɴʔɪ́ɴ
ဟင်း	hɪ́ɴ
ဟင်းခါး	hɪ́ɴɡá
ဟင်းရည်	hɪ́ɴjè
ဟင်းသီးဟင်းရွက်	hɪ́ɴðíhɪ́ɴjwɛʔ
ဟင်္သာ	hɪ́ɴθà
ဟင်္သာတ	hɪ̀ɴθəta̰
ဟထိုး	ha̰tʰó
ဟနူမာန်	hənùmàn
ဟန်ဂေရီ	hàɴɡèɹì
ဟန်နီ	hàɴnì
ဟမ်ဘာဂါ	hàɴbàɡà
ဟယ်လီကော့ပတာ	hɛ̀lìkɔ̰pətà
ဟရိဘုဉ္ဇ	həɹḭbòʊɴza̰
ဟလဝါ	ha̰ləwà
ဟာနွိုင်း	hànwáɪɴ
ဟာသ	hàθa̰
ဟားခါး	hákʰá
ဟိတ်	heɪʔ
ဟိန္ဒီ	hèɪɴdì
ဟိန္ဒူ	hèɪɴdù
ဟိမဝန္တာ	hḭma̰wʊ̀ɴtà
ဟိမာလယ	hḭmàləja̰
ဟို	hò
ဟိုက်ဒရိုဂျင်	haɪʔdəɹòd͡ʑɪ̀ɴ
ဟိုင်းအီနာ	háɪɴʔìnà
ဟိုတယ်	hòtɛ̀
ဟိုမှာ	hòm̥à
ဟိုဟာ	hòhà
ဟီ	hì
ဟီနယာန	hìna̰jàna̰
ဟီလီယမ်	hìlìjàɴ
ဟုတ်	hoʊʔ
ဟုတ်ကဲ့	hoʊʔkɛ̰
ဟုတ်တာပေါ့	hoʊʔtàpɔ̰
ဟူ	hù
ဟူးရား	hújá
ဟူးဟူး	húhú
ဟေတီ	hètì
ဟေမန္တ	hèmàɴta̰
ဟေမန်	hèmàɴ
ဟေမာ	hèmà
ဟော	hɔ́
ဟောက်	haʊʔ
ဟောင်ကောင်	hàʊɴkàʊɴ
ဟောင်း	háʊɴ
ဟော်	hɔ̀
ဟော်ကီ	hɔ̀kì
ဟော်တယ်	hɔ̀tɛ̀
ဟော်လန်	hɔ̀làɴ
ဟဲလို	hɛ́lò
ဟွန်ဒူးရပ်စ်	hʊ̀ɴdúɹaʔs
ဠ	la̰
ဠကြီး	la̰t͡ɕí
အ	ʔa̰
အက	ʔəka̰
အကယ်၍	ʔəkɛ̀jwḛ
အကာ	ʔəkà
အကိတ်	ʔəkeɪʔ
အကို	ʔəkò
အကိုင်း	ʔəkáɪɴ
အကုန်	ʔəkòʊɴ
အကူ	ʔəkù
အကောက်	ʔəkaʊʔ
အကောက်ဆိပ်	ʔəkaʊʔsʰeɪʔ
အကောင့်	ʔəka̰ʊɴ
အကော်ဒီယံ	ʔəkɔ̀dìjàɴ
အက္ခရာ	ʔɛʔkʰəjà
အက်	ʔɛʔ
အက်စစ်	ʔɛʔsɪʔ
အက်စတိုးနီးယား	ʔɛʔsətóníjá
အက်တမ်	ʔɛʔtàɴ
အကျဉ်း	ʔət͡ɕɪ́ɴ
အကျဉ်းထောင်	ʔət͡ɕɪ́ɴdàʊɴ
အကျည်း	ʔət͡ɕí
အကျည်းတန်	ʔət͡ɕítàɴ
အကျယ်	ʔət͡ɕɛ̀
အကျိတ်	ʔət͡ɕeɪʔ
အကျိုး	ʔət͡ɕó
အကျော်	ʔət͡ɕɔ̀
အကျော်ဇေယျ	ʔət͡ɕɔ̀zèja̰
အကြမ်းဖက်ဝါဒ	ʔət͡ɕáɴpʰɛʔwàda̰
အကြမ်းဖက်သမား	ʔət͡ɕáɴpʰɛʔθəmá
အကြောင်း	ʔət͡ɕáʊɴ
အကြော်	ʔa̰t͡ɕɔ̀
အကြေး	ʔət͡ɕé
အကြံ	ʔət͡ɕàɴ
အကြံပေးချက်	ʔət͡ɕàɴpéd͡ʑɛʔ
အကြွေး	ʔət͡ɕwé
အကြွေးဝယ်ကတ်ပြား	ʔət͡ɕwéwɛ̀kaʔpjá
အကွ	ʔəkwa̰
အကွာအဝေး	ʔəkwàʔəwé
အခန်း	ʔəkʰáɴ
အခမဲ့	ʔəkʰa̰mɛ̰
အခါတစ်ပါး	ʔəkʰàdəbá
အခိုး	ʔəkʰó
အခု	ʔəkʰṵ
အခေါက်	ʔəkʰaʊʔ
အချက်	ʔət͡ɕʰɛʔ
အချင်း	ʔət͡ɕʰɪ́ɴ
အချင်းဝက်	ʔət͡ɕʰɪ́ɴwɛʔ
အချစ်	ʔət͡ɕʰɪʔ
အချပ်	ʔət͡ɕʰaʔ
အချိတ်	ʔət͡ɕʰeɪʔ
အချိန်	ʔət͡ɕʰèɪɴ
အချိန်စာရင်း	ʔət͡ɕʰèɪɴsəjɪ́ɴ
အချို	ʔət͡ɕʰò
အချိုပွဲ	ʔət͡ɕʰòbwɛ́
အချိုမှုန့်	ʔət͡ɕʰòm̥o̰ʊɴ
အချို့	ʔət͡ɕʰo̰
အချိုး	ʔət͡ɕʰó
အချုပ်ခန်း	ʔət͡ɕʰoʊʔkʰáɴ
အချုပ်အခြာအာဏာ	ʔət͡ɕʰoʊʔʔət͡ɕʰàʔànà
အချွဲ	ʔət͡ɕʰwɛ́
အခြား	ʔət͡ɕʰá
အခြေ	ʔət͡ɕʰè
အခြောက်	ʔət͡ɕʰaʊʔ
အခွင့်	ʔəkʰwɪ̰ɴ
အခွင့်ထူးခံ	ʔəkʰwɪ̰ɴtʰúɡàɴ
အခွင့်အရေး	ʔəkʰwɪ̰ɴʔəjé
အခွန်	ʔəkʰʊ̀ɴ
အခွံ	ʔəkʰʊ̀ɴ
အခွံမာသီး	ʔəkʰʊ̀ɴmàðí
အဂတိ	ʔa̰ɡədḭ
အဂ္ဂမဟာပဏ္ဍိတ	ʔɛʔɡa̰məhàpàɴdḭta̰
အဂ္ဂမဟာသေနာပတိ	ʔɛʔɡa̰məhàθènàpətḭ
အဂ္ဂမဟေသီ	ʔɛʔɡa̰məhèθì
အငတ်	ʔəŋaʔ
အင်ဂိုလာ	ʔɪ̀ɴɡòlà
အင်ဂျင်	ʔɪ̀ɴd͡ʑɪ̀ɴ
အင်ဂျင်နီယာ	ʔɪ̀ɴd͡ʑɪ̀ɴnìjà
အင်တာနက်	ʔɪ̀ɴtànɛʔ
အင်တာဗျူး	ʔɪ̀ɴtəbjú
အင်ဒိုချိုင်းနား	ʔɪ̀ɴdòt͡ɕʰáɪɴná
အင်ဒိုနီးရှား	ʔɪ̀ɴdòníʃá
အင်ဒိုရာ	ʔɪ̀ɴdòɹà
အင်ပါယာ	ʔɪ̀ɴpàjà
အင်း	ʔɪ́ɴ
အင်းကျီ	ʔɪ́ɴd͡ʑì
အင်းစိန်	ʔɪ́ɴsèɪɴ
အင်းဆက်	ʔɪ́ɴsʰɛʔ
အင်းဝ	ʔəwa̰
အင်းဝ	ʔɪ́ɴwa̰
အင်းသား	ʔɪ́ɴðá
အင်္ကျီ	ʔɪ́ɴd͡ʑì
အင်္ဂတေ	ʔɪ̀ɴɡədè
အင်္ဂလန်	ʔɪ̀ɴɡəlàɴ
အင်္ဂလိပ်	ʔɪ̀ɴɡəleɪʔ
အင်္ဂါ	ʔɪ̀ɴɡà
အင်္ဂါဇာတ်	ʔɪ̀ɴɡàzaʔ
အငြိမ့်	ʔəɲḛɪɴ
အငြိမ့်တီးမျိုး	ʔa̰ɲḛɪɴtímjó
အငွေ့	ʔa̰ŋwḛ
အစ	ʔəsa̰
အစက်	ʔəsɛʔ
အစဉ်	ʔəsɪ̀ɴ
အစည်းအရုံး	ʔəsíʔəjóʊɴ
အစည်းအဝေး	ʔəsíʔəwé
အစမ်း	ʔəsáɴ
အစား	ʔəsá
အစားအစာ	ʔəsáʔəsà
အစိမ်း	ʔəséɪɴ
အစိုးရ	ʔəsója̰
အစီရင်	ʔəsìjɪ̀ɴ
အစီရင်ခံ	ʔəsìjɪ̀ɴkʰàɴ
အစီရင်ခံစာ	ʔəsìjɪ̀ɴkʰàɴzà
အစီအစဉ်	ʔəsìʔəsɪ̀ɴ
အစီအလျဉ်	ʔəsìʔəljɪ̀ɴ
အစု	ʔəsṵ
အစုရှင်	ʔəsṵʃɪ̀ɴ
အစုံအစုံ	ʔəsòʊɴʔəsòʊɴ
အစေအပါး	ʔəsèʔəpá
အစောင့်	ʔəsa̰ʊɴ
အစေ့	ʔəsḭ
အစ္စရေး	ʔɪʔzəɹé
အစ္စလမ်	ʔɪʔsəlàɴ
အစ်	ʔɪʔ
အစ်ကို	ʔəkò
အစ်မ	ʔəma̰
အစွန်း	ʔəsʊ́ɴ
အဆင့်	ʔəsʰɪ̰ɴ
အဆန်	ʔəsʰàɴ
အဆိပ်	ʔəsʰeɪʔ
အဆိုတော်	ʔəsʰòdɔ̀
အဆီ	ʔəsʰì
အဆုတ်	ʔəsʰoʊʔ
အဆုတ်ရောင်ရောဂါ	ʔa̰sʰoʊʔjàʊɴjɔ́ɡà
အဆုံး	ʔəsʰóʊɴ
အဆောက်အအုံ	ʔəsʰaʊʔʔəʔú
အဆောက်အဦ	ʔəsʰaʊʔʔəʔù
အဆောင်	ʔəsʰàʊɴ
အဆွေး	ʔəsʰwé
အဇာဘိုင်ဂျန်	ʔa̰zəbàɪɴd͡ʑàɴ
အဉ္ဇလီ	ʔɪ̀ɴzəlì
အညစ်အကြေး	ʔəɲɪʔʔət͡ɕé
အညစ်အထည်း	ʔəɲɪʔʔətʰí
အညာသား	ʔəɲàðá
အညို	ʔəɲò
အညီ	ʔəɲì
အဋ္ဌမ	ʔaʔtʰəma̰
အဏုဇီဝဗေဒ	ʔənṵzìwa̰bèda̰
အဏ္ဏဝါ	ʔàɴnəwà
အဏ္ဏဝါဗေဒ	ʔànnəwàbèda̰
အတင်း	ʔətɪ́ɴ
အတန်း	ʔətáɴ
အတာ	ʔətà
အတာအိုး	ʔətàʔó
အတိတ်	ʔəteɪʔ
အတိုင်ပင်ခံ	ʔətàɪɴbɪ̀ɴɡàɴ
အတိုင်း	ʔətáɪɴ
အတိုး	ʔətó
အတီမျှ	ʔətìm̥ja̰
အတူ	ʔətù
အတူတူ	ʔətùdù
အတောင်	ʔətàʊɴ
အတ္တဒဿီ	ʔaʔta̰daʔθì
အတ္တဒဿီဘုရား	ʔaʔta̰dətθìpʰəjá
အတွင်း	ʔətwɪ́ɴ
အတွင်းခံ	ʔətwɪ́ɴɡàɴ
အတွင်းစကား	ʔətwɪ́ɴzəɡá
အတွင်းတာရာ	ʔətwɪ́ɴtàjà
အတွင်းရန်	ʔətwɪ́ɴjàɴ
အတွင်းဝန်	ʔətwɪ́ɴwʊ̀ɴ
အတွဲ	ʔətwɛ́
အထက်	ʔətʰɛʔ
အထက်လွှတ်တော်	ʔətʰɛʔl̥ʊʔtɔ̀
အထက်သား	ʔətʰɛʔðá
အထင်	ʔətʰɪ̀ɴ
အထပ်	ʔətʰaʔ
အထိ	ʔətʰḭ
အထိန်း	ʔətʰéɪɴ
အထိမ်းအမှတ်	ʔətʰéɪɴʔəm̥aʔ
အထီး	ʔətʰí
အထုပ်	ʔətʰoʊʔ
အထုံးအဖွဲ့	ʔətʰóʊɴʔəpʰwɛ̰
အထဲ	ʔətʰɛ́
အဓမ္မ	ʔədəma̰
အဓိက	ʔa̰dḭɡa̰
အဓိကရုဏ်း​	ʔədḭka̰jóʊɴ
အဓိဌာန်	ʔədeɪʔtʰàɴ
အဓိပ္ပါယ်	ʔədeɪʔbɛ̀
အနက်	ʔənɛʔ
အနန္တ	ʔənàɴda̰
အနန္တောအနန္တငါးပါး	ʔənàɴdɔ́ʔənda̰ŋápá
အနာကြီးရောဂါ	ʔənàd͡ʑíjɔ́ɡà
အနာဂတ်	ʔənàɡaʔ
အနား	ʔəná
အနားယူ	ʔənájù
အနိစ္စ	ʔənèssa̰
အနို့	ʔəno̰
အနီ	ʔənì
အနုတ်လက္ခဏာ	ʔən̥oʊʔlɛʔkʰənà
အနုပညာ	ʔənṵpjɪ̀ɴɲà
အနုရာဓပူရ	ʔənṵjàda̰pùɹa̰
အနုရုဒ္ဓါ	ʔənṵjoʊʔdà
အနောက်	ʔənaʊʔ
အနောက်ဝန်	ʔənaʊʔwʊ̀ɴ
အနောမဒဿီ	ʔənɔ́mədətθì
အနောမဒဿီဘုရား	ʔənɔ́mədaʔθìpʰəjá
အနော်ရထာ	ʔənɔ̀jətʰà
အနံ့	ʔəna̰ɴ
အန္တရာယ်	ʔàɴdəjɛ̀
အန္တာတိက	ʔàɴtàtḭka̰
အန်	ʔàɴ
အန်ကယ်	ʔàɴkɛ̀
အန်တီ	ʔàɴtì
အန်နီမဲ	ʔàɴnìmɛ́
အနွယ်	ʔənwɛ̀
အနှစ်	ʔən̥ɪʔ
အနှိပ်	ʔən̥eɪʔ
အနှီဟာ	ʔən̥ìhà
အနှီး	ʔən̥í
အပင်	ʔəpɪ̀ɴ
အပတ်စဉ်	ʔa̰paʔzɪ̀ɴ
အပိုင်း	ʔəpáɪɴ
အပိုဒ်	ʔəpaɪʔ
အပူ	ʔəpù
အပေါင်	ʔəpàʊɴ
အပေါင်းလက္ခဏာ	ʔəpáʊɴlɛʔkʰənà
အပေါ့	ʔəpɔ̰
အပေါ်	ʔəpɔ̀
အပ်	ʔaʔ
အပ်ချည်	ʔaʔt͡ɕʰì
အပ်ချုပ်စက်	ʔaʔt͡ɕʰoʊʔsɛʔ
အပ်ထောက်	ʔaʔtʰaʊʔ
အပြင်	ʔəpjɪ̀ɴ
အပြစ်	ʔəpjɪʔ
အပြာ	ʔəpjà
အပြာကား	ʔəpjàká
အပြာမယ်	ʔəpjàmɛ̀
အပြိုင်	ʔəpjàɪɴ
အပြီးသတ်	ʔəpjíðaʔ
အပြုအမူ	ʔəpjṵʔəmù
အပြုံး	ʔəpjóʊɴ
အပြော	ʔəpjɔ́
အပွင့်	ʔəpwɪ̰ɴ
အဖ	ʔəpʰa̰
အဖတ်	ʔəpʰaʔ
အဖို	ʔəpʰò
အဖို့	ʔəpʰo̰
အဖိုး	ʔəpʰó
အဖိုးကြီး	ʔəpʰót͡ɕí
အဖုံဖုံ	ʔəpʰòʊɴbòʊɴ
အဖုံး	ʔəpʰóʊɴ
အဖေ	ʔəpʰè
အဖော်	ʔəpʰɔ̀
အဖေ့	ʔəpʰḛ
အဖျား	ʔəpʰjá
အဖျားဖြတ်ဆေး	ʔa̰pʰjápʰjaʔsʰé
အဖြူ	ʔəpʰjù
အဖြေ	ʔəpʰjè
အဖွဲ့	ʔəpʰwɛ̰
အဖွဲ့ချုပ်	ʔəpʰwɛ̰d͡ʑoʊʔ
အဖွဲ့ဝင်	ʔəpʰwɛ̰wɪ̀ɴ
အဘိဓာန်	ʔəbḭdàɴ
အဘိုး	ʔəpʰó
အဘိုးကြီး	ʔəpʰód͡ʑí
အဘွား	ʔəpʰwá
အမ	ʔəma̰
အမည်	ʔəmjì
အမည်း	ʔəmɛ́
အမတ်	ʔəmaʔ
အမယ်	ʔəmɛ̀
အမရပူရ	ʔəməja̰pùja̰
အမာ	ʔa̰mà
အမိ	ʔəmḭ
အမိန့်	ʔəmḛɪɴ
အမိန့်ရှိပါ	ʔəmḛɪɴʃḭbà
အမိုး	ʔəmó
အမူအရာ	ʔəmùʔəjà
အမေ	ʔəmè
အမေရိက	ʔəmèɹḭka̰
အမေရိကန်	ʔəmèɹḭkàɴ
အမေရိကန်ပြည်ထောင်စု	ʔəmèɹḭkàɴpjìdàʊɴzṵ
အမေလိုး	ʔəmèló
အမေး	ʔəmé
အမဲလိုက်	ʔəmɛ́laɪʔ
အမဲသား	ʔəmɛ́ðá
အမဲသားမစားပါဘူး	ʔəmɛ́ðáməsábàbú
အမျိုး	ʔəmjó
အမျိုးဇာတ်	ʔəmjózaʔ
အမျိုးလေးပါး	ʔəmjólébá
အမျိုးသမီး	ʔəmjóðəmí
အမျိုးသမီးလစဉ်သုံးပစ္စည်း	ʔa̰mjóðəmíla̰zɪ̀ɴθóʊɴpjɪʔsí
အမျိုးသား	ʔəmjóðá
အမျိုးသားစိတ်	ʔəmjóðáseɪʔ
အမျိုးသားနေ့	ʔəmjóðánḛ
အမျိုးသားလွှတ်တော်	ʔəmjóðál̥ʊʔtɔ̀
အမျိုးသားသီချင်း	ʔəmjóðáθət͡ɕʰɪ́ɴ
အမျိုးအနွယ်	ʔəmjóʔənwɛ̀
အမျှင်	ʔəm̥jɪ̀ɴ
အမြစ်	ʔəmjɪʔ
အမြန်	ʔəmjàɴ
အမြီး	ʔəm̥í
အမြောက်	ʔəmjaʊʔ
အမြဲ	ʔəmjɛ́
အမြဲတမ်း	ʔəmjɛ́dáɴ
အမြွှာ	ʔəm̥wà
အမြှုပ်	ʔəm̥joʊʔ
အမြှောက်လက္ခဏာ	ʔəm̥jaʊʔlɛʔkʰənà
အမွေ	ʔəmwè
အမွေခံ	ʔəmwèkʰàɴ
အမွေခံ	ʔəmwèɡàɴ
အမွေခွဲ	ʔəmwèkʰwɛ́
အမွေအနှစ်	ʔəmwèʔən̥ɪʔ
အမွေး	ʔəmwé
အမွှေး	ʔəm̥wé
အမွှေးတိုင်	ʔəm̥wédàɪɴ
အမှတ်	ʔəm̥aʔ
အမှတ်တံဆိပ်	ʔəm̥aʔdəzeɪʔ
အမှန်တရား	ʔəm̥àɴtəjá
အမှာ	ʔəm̥à
အမှား	ʔəm̥á
အမှိုက်	ʔəm̥aɪʔ
အမှုန့်	ʔəm̥o̰ʊɴ
အမှုန်	ʔəm̥òʊɴ
အယုဓျာ	ʔəjoʊʔdəjà
အယူ	ʔəjù
အယူဝါဒ	ʔəjùwàda̰
အယ်ဆာဗေဒို	ʔɛ̀sʰàbèdò
အယ်လဘမ်	ʔɛ̀ləbàɴ
အယ်လ်ဂျီးရီးယား	ʔɛ̀ld͡ʑíɹíjá
အယ်လ်ဘေးနီးယား	ʔɛ̀lbéníjá
အရက်	ʔəjɛʔ
အရက်ဆိုင်	ʔəjɛʔsʰàɪɴ
အရင်း	ʔəjɪ́ɴ
အရင်းရှင်ဝါဒ	ʔəjɪ́ɴʃɪ̀ɴwàda̰
အရည်	ʔəjì
အရမ်း	ʔəjáɴ
အရသာ	ʔəja̰ðà
အရာ	ʔəjà
အရာခံဗိုလ်	ʔəjàɡàɴbò
အရိပ်	ʔəjeɪʔ
အရိမဒ္ဒနာပူရ	ʔa̰ɹḭmàddənàpùɹa̰
အရိုး	ʔəjó
အရိုးစု	ʔəjózṵ
အရိုးပျော့နာ	ʔa̰jópjɔ̰nà
အရီး	ʔəjí
အရီးကြီး	ʔəjíd͡ʑí
အရီးလေး	ʔəjílé
အရုဏ်	ʔəjùn
အရုပ်	ʔəjoʊʔ
အရုပ်စာ	ʔəjoʊʔsà
အရေ	ʔəjè
အရေပြား	ʔəjèbjá
အရေပြားရောဂါ	ʔəjèbjájɔ́ɡà
အရောင်	ʔəjàʊɴ
အရောင်တင်မှုန့်	ʔəjàʊɴtɪ̀ɴm̥o̰ʊɴ
အရောင်းအဝယ်	ʔəjáʊɴʔəwɛ̀
အရေး	ʔa̰jé
အရေးကြီး	ʔa̰jét͡ɕí
အရေးတော်ပုံ	ʔəjédɔ̀bòʊɴ
အရံဂြိုဟ်	ʔəjàɴd͡ʑò
အရွက်	ʔəjwɛʔ
အရွတ်	ʔəjʊʔ
အရွယ်ဆယ်ပါး	ʔəjwɛ̀sʰɛ̀bá
အရှင်	ʔəʃɪ̀ɴ
အရှင်ဘုရား	ʔəʃɪ̀ɴpʰəjá
အရှိန်	ʔəʃèɪɴ
အရှေ့	ʔəʃḛ
အလက်	ʔəlɛʔ
အလင်း	ʔəlɪ́ɴ
အလင်းတန်း	ʔəlɪ́ɴdáɴ
အလင်္ကာ	ʔəlɪ̀ɴɡà
အလား	ʔəlá
အလို	ʔəlò
အလီ	ʔəlì
အလုပ်	ʔəloʊʔ
အလုပ်ပိတ်ရက်	ʔəloʊʔpeɪʔjɛʔ
အလုပ်ရုံ	ʔəloʊʔjòʊɴ
အလုပ်ရှင်	ʔəloʊʔʃɪ̀ɴ
အလုပ်လုပ်	ʔəloʊʔloʊʔ
အလုပ်သမား	ʔəloʊʔθəmá
အလုပ်သမားနေ့	ʔəloʊʔθəmánḛ
အလုံး	ʔəlóʊɴ
အလူမီနီယမ်	ʔəlùmìnìjàɴ
အလောင်း	ʔəláʊɴ
အလေး	ʔəlé
အလံ	ʔəlàɴ
အလ္လာဟ်	ʔàllàh
အလျင်	ʔəjɪ̀ɴ
အလျင်	ʔəljɪ̀ɴ
အလျား	ʔəljá
အလွန်	ʔəlʊ̀ɴ
အလှဆီ	ʔəl̥a̰zì
အလှမ်း	ʔəl̥áɴ
အလှူရှင်	ʔəl̥ùʃɪ̀ɴ
အဝင်	ʔəwɪ̀ɴ
အဝတာရ	ʔa̰wa̰tàja̰
အဝတ်	ʔəwʊʔ
အဝတ်လျှောက်စက်	ʔəwʊʔʃaʊʔsɛʔ
အဝတ်အစား	ʔəwʊʔʔəsá
အဝါ	ʔəwà
အသက်	ʔəθɛʔ
အသက်ဦးဆံပိုင်	ʔəθɛʔʔúsʰàɴbàɪɴ
အသင်	ʔəθɪ̀ɴ
အသင်း	ʔəθɪ́ɴ
အသည်း	ʔəθɛ́
အသည်းနှလုံး	ʔəθɛ́n̥əlóʊɴ
အသတ်	ʔa̰θaʔ
အသား	ʔəθá
အသားညှပ်မုန့်	ʔəθáɲ̊aʔmo̰ʊɴ
အသားမာ	ʔəθəmà
အသားဝါရောဂါ	ʔa̰θáwàjɔ́ɡà
အသိ	ʔəθḭ
အသိတရား	ʔəθḭtəjá
အသိပညာ	ʔəθḭpjɪ̀ɴɲà
အသိပညာရှင်	ʔəθḭpjɪ̀ɴɲàʃɪ̀ɴ
အသိုက်	ʔəθaɪʔ
အသီး	ʔəθí
အသုပ်	ʔəθoʊʔ
အသုပ်စုံ	ʔəθoʊʔsòʊɴ
အသုဘ	ʔa̰θṵba̰
အသုံး	ʔəθóʊɴ
အသုံးပြု	ʔəθóʊɴpjṵ
အသေ	ʔəθè
အသော	ʔəθɔ́
အသံ	ʔəθàɴ
အသံထွက်	ʔəθàɴdwɛʔ
အသျှင်	ʔəʃɪ̀ɴ
အသွားအလာ	ʔəθwáʔəlà
အာကာသ	ʔàkàθa̰
အာကာသစိုး	ʔàkàθa̰zó
အာကာသယာဉ်	ʔàkàθa̰jɪ̀ɴ
အာခါ	ʔàkʰà
အာဂျင်တီးနား	ʔàd͡ʑɪ̀ɴtíná
အာဃာတ	ʔàɡàta̰
အာစရိယ	ʔàsa̰ɹḭja̰
အာဇာနည်	ʔàzànì
အာဇာနည်နေ့	ʔàzànìnḛ
အာဏာ	ʔànà
အာဏာရှင်	ʔànàʃɪ̀ɴ
အာဏာသား	ʔànàðá
အာဏာသိမ်း	ʔànàθéɪɴ
အာတိတ်	ʔàteɪʔ
အာနီ	ʔànì
အာနုဘော်	ʔànṵbɔ̀
အာဖဂန်နစ်စတန်	ʔàpʰəɡàɴnɪʔsətàɴ
အာဖရိက	ʔàpʰəɹḭka̰
အာမခံ	ʔàma̰ɡàɴ
အာမခံသေတ္တာ	ʔàma̰ɡàɴθɪʔtà
အာမေဍိတ်	ʔàmèdeɪʔ
အာမေးနီးယား	ʔàméníjá
အာယုဗ္ဗေဒ	ʔàjoʊʔbèda̰
အာရပ်	ʔàɹaʔ
အာရာမ	ʔàjàma̰
အာရာမ်	ʔàjàɴ
အာရိုက်	ʔàjaɪʔ
အာရုံကြော	ʔàjòʊɴd͡ʑɔ́
အာရှ	ʔàʃa̰
အာလယ	ʔàləja̰
အာလာပသလ္လာပ	ʔàlàpa̰θəlàpa̰
အာလူး	ʔàlú
အာလူးပူရီ	ʔàlúpùjì
အာလူးဖုတ်	ʔàlúpʰoʊʔ
အာဝါဟဝိဝါဟ	ʔàwàha̰wḭwàha̰
အာဟာရ	ʔàhàja̰
အာဟာရဗေဒ	ʔàhàja̰bèda̰
အား	ʔá
အားကစား	ʔáɡəzá
အားကိုး	ʔákó
အားနည်း	ʔánɛ́
အားနာ	ʔánà
အားနာပါးနာ	ʔánàpánà
အားလပ်ရက်	ʔálaʔjɛʔ
အားလုံး	ʔálóʊɴ
အိတ်	ʔeɪʔ
အိန္ဒိယ	ʔèɪɴdḭja̰
အိန္ဒြာ	ʔèɪɴdɹà
အိန္ဒြေ	ʔèɪɴdɹè
အိပ်	ʔeɪʔ
အိပ်ခန်း	ʔeɪʔkʰáɴ
အိပ်မက်	ʔeɪʔmɛʔ
အိပ်ရာ	ʔeɪʔjà
အိပ်ရာလိပ်	ʔeɪʔjàleɪʔ
အိမ်	ʔèɪɴ
အိမ်တက်မင်္ဂလာ	ʔèɪɴtɛʔmɪ̀ɴɡəlà
အိမ်ထောင်	ʔèɪɴdàʊɴ
အိမ်ထောင်	ʔèɪɴtʰàʊɴ
အိမ်ထောင်ပြု	ʔèɪɴdàʊɴpjṵ
အိမ်နီးချင်း	ʔèɪɴníd͡ʑɪ́ɴ
အိမ်မြှောင်	ʔèɪɴm̥jàʊɴ
အိမ်ရှေ့မင်း	ʔèɪɴʃḛmɪ́ɴ
အိမ်ရှေ့မင်းသား	ʔèɪɴʃḛmɪ́ɴðá
အိမ်လည်	ʔèɪɴlè
အိမ်သာ	ʔèɪɴðà
အိမ်သူ	ʔèɪɴðù
အို	ʔò
အိုက်စလန်	ʔaɪʔsəlàɴ
အိုက်တင်	ʔaɪʔtɪ̀ɴ
အိုင်ဒီယာ	ʔàɪɴdìjà
အိုင်ဗရီကို့စ်	ʔàɪɴbəɹìko̰s
အိုင်ယာလန်	ʔàɪɴjəlàɴ
အိုင်အိုင်	ʔàɪɴʔàɪɴ
အိုဗာတင်း	ʔòbàtɪ́ɴ
အိုမန်	ʔòmàɴ
အိုရှန်းနီးယား	ʔòʃáɴníjá
အိုလံပစ်	ʔòlàɴpɪʔ
အိုး	ʔó
အီကြာကွေး	ʔìt͡ɕàkwé
အီကွေတာ	ʔìkwètà
အီကွေတာဂီနီ	ʔìkwètàɡìnì
အီကွေဒေါ	ʔìkwèdɔ́
အီဂျစ်	ʔìd͡ʑɪʔ
အီစတာ	ʔìsətà
အီတလီ	ʔìta̰lì
အီနောင်	ʔìnàʊɴ
အီရတ်	ʔìɹaʔ
အီရန်	ʔìɹàɴ
အီရီထရီးယား	ʔìɹìtʰəɹíjá
အီသီယိုးပီးယား	ʔìθìjópíjá
အီး	ʔí
အီးပေါက်	ʔípaʊʔ
အီးမေးလ်	ʔímél
အုတ်	ʔoʊʔ
အုတ်ကြွပ်	ʔoʊʔt͡ɕʊʔ
အုန်း	ʔóʊɴ
အုန်းဆီ	ʔóʊɴzì
အုန်းထမင်း	ʔóʊɴtʰəmɪ́ɴ
အုန်းနို့	ʔóʊɴno̰
အုန်းနို့ခေါက်ဆွဲ	ʔóʊɴno̰kʰaʊʔsʰwɛ́
အုန်းမှန်ကူ	ʔóʊɴm̥àɴɡù
အုံး	ʔóʊɴ
အူ	ʔù
အူမကြီး	ʔùma̰d͡ʑí
အောက်	ʔaʊʔ
အောက်ဆီဂျင်	ʔaʊʔsʰìd͡ʑɪ̀ɴ
အောက်တိုဘာ	ʔaʊʔtòbà
အောက်မြစ်	ʔaʊʔmjɪʔ
အောက်လွှတ်တော်	ʔaʊʔl̥ʊʔtɔ̀
အောက်သား	ʔaʊʔðá
အောင်	ʔàʊɴ
အောင်ပွဲ	ʔàʊɴbwɛ́
အောင်လံ	ʔàʊɴlàɴ
အော့	ʔɔ̰
အော့အန်	ʔɔ̰ʔàɴ
အော်	ʔɔ̀
အော်ကေ့ကြည်	ʔɔ̀kḛt͡ɕì
အော်တိုမေးရှင်း	ʔɔ̀tòméʃɪ́ɴ
အော်ဒါ	ʔɔ̀dà
အော်ပရာ	ʔɔ̀pəɹà
အေး	ʔé
အဲဒါ	ʔɛ́dà
အဲဒါဘာလဲ	ʔɛ́dàbàlɛ́
အဲဒီ	ʔɛ́dì
အဲဒီဟာ	ʔɛ́dìhà
အဲလစ်ဇဘက်	ʔɛ́lɪʔza̰bɛʔ
ဣ	ʔḭ
ဣန္ဒာ	ʔḭndà
ဣန္ဒြေ	ʔèɪɴdɹè
ဣရိယာပုတ်	ʔḭɹḭjàboʊʔ
ဥ	ʔṵ
ဥက္ကဋ္ဌ	ʔoʊʔkəθa̰
ဥက္ကာ	ʔoʊʔkà
ဥက္ကာခဲ	ʔoʊʔkàɡɛ́
ဥက္ကာပျံ	ʔoʊʔkàbjàɴ
ဥဂ္ဂါ	ʔṵɡɡà
ဥစ္စာ	ʔoʊʔsà
ဥဇဘက်ကစ္စတန်	ʔṵzəbɛʔkɪʔsətàɴ
ဥဏ္ဏလုံ	ʔòʊɴnəlòʊɴ
ဥဏ္ဏလုံမွေးရှင်	ʔòʊɴnəlòʊɴm̥wéʃɪ̀ɴ
ဥဏှဂူ	ʔòʊɴn̥əɡù
ဥဏှိဿ	ʔṵn̥eɪʔθa̰
ဥတု	ʔṵdṵ
ဥတ္တရ	ʔoʊʔtəja̰
ဥတ္တရခဏ္ဍ	ʔoʊʔtəɹa̰kʰànda̰
ဥဒေါင်း	ʔṵdáʊɴ
ဥပဒေ	ʔṵba̰dè
ဥပဒေပညာ	ʔṵbədèpjɪ̀ɴɲà
ဥပဓိရုပ်	ʔṵpa̰dḭjoʊʔ
ဥပမာ	ʔṵbəmà
ဥပရာဇာ	ʔṵpəɹàzà
ဥပါကြယ်	ʔṵpàt͡ɕɛ̀
ဥပါဒါန်	ʔṵpàdàn
ဥပါယ်	ʔṵpɛ̀
ဥပါလိ	ʔṵpàlḭ
ဥပုသ်	ʔṵboʊʔ
ဥပေက္ခါ	ʔṵpɛʔkʰà
ဥမင်	ʔṵmɪ̀ɴ
ဥမ္မာ	ʔṵmmà
ဥယျာဉ်	ʔṵjɪ̀ɴ
ဥရုဂွေး	ʔṵɹṵʔṵɡwé
ဥရောပ	ʔṵɹɔ́pa̰
ဥသျှစ်	ʔoʊʔʃɪʔ
ဥုံ	ʔòʊɴ
ဥဿဖရား	ʔoʊʔθəpʰəjá
ဦလန်ဘာတာ	ʔùlàɴbàtà
ဦး	ʔú
ဦးကြီး	ʔúd͡ʑí
ဦးခိုက်	ʔúkʰaɪʔ
ဦးချ	ʔút͡ɕʰa̰
ဦးချို	ʔúd͡ʑò
ဦးခွံ	ʔúɡʊ̀ɴ
ဦးထုပ်	ʔoʊʔtʰoʊʔ
ဦးနှောက်	ʔóʊɴn̥aʊʔ
ဦးပဉ္စင်း	ʔúbəzɪ́ɴ
ဦးလေး	ʔúlé
ဧက	ʔèka̰
ဧကရာဇ်	ʔèɡəjɪʔ
ဧကရာဇ်	ʔèɡəɹɪʔ
ဧကရီ	ʔèkəjì
ဧကာဒသမ	ʔèkàda̰θəma̰
ဧည့်	ʔḛ
ဧည့်သည်	ʔḛðè
ဧဏီ	ʔènì
ဧပြီ	ʔèbjì
ဩကာသ	ʔɔ́ɡàθa̰
ဩဂုတ်	ʔɔ́ɡoʊʔ
ဩစတြီးယား	ʔɔ́sətəɹìja̰
ဩစတြေးလျ	ʔɔ́sətəɹélja̰
ဩဇာ	ʔɔ́zà
ဩဇာသီး	ʔɔ́zàθí
ဩဌဇ	ʔɔ́tʰəza̰
ဩရသ	ʔɔ́jəθa̰
ဩရိဿ	ʔɔ́ɹeɪʔθa̰
ဩသဓ	ʔɔ́θəda̰
၌	n̥aɪʔ
၍	jwḛ
၎	ləɡáʊɴ
၎င်း	ləɡáʊɴ
၏	ʔḭ
