a	aˀ
a	æːˀ
a'er	æːˀɐ
a'erne	æːɐnə
a'ernes	æːɐnəs
a'ers	æːɐs
a'et	æːəd̥
a'ets	æːəd̥s
a's	æːs
aalborg	ʌlpɒːˀ
ab	æːˀb̥
ab	ɑb̥
abbed	ab̥eð
abbed	ɑb̥eð
abbedi	ab̥ed̥iˀ
abbedi	ɑb̥ed̥iˀ
abbedisse	ɑb̥ed̥isə
abc	æb̥eseːˀ
abe	æːb̥ə
abonnement	ab̥onəmɑŋ
abonnement	ab̥ɔnəmɑŋ
abonnement	ɑb̥onəmɑŋ
abonnement	ɑb̥ɔnəmɑŋ
abrikos	ɑb̥ʁikʰoːˀs
abstrakt	ɑpstχakt
absurd	ɑbsuɐ̯ˀd̥
accent	ɑɡ̊sɑŋ
accent	ɑɡ̊sɛnˀd̥
accenten	ɑɡ̊sɑŋˀŋ̩
accenten	ɑɡ̊sɛnˀd̥n̩
accentens	ɑɡ̊sɑŋˀŋ̩s
accentens	ɑɡ̊sɛnˀd̥n̩s
accenter	ɑɡ̊sɑŋˀɐ
accenter	ɑɡ̊sɛnˀd̥ɐ
accenterne	ɑɡ̊sɑŋˀɐnə
accenterne	ɑɡ̊sɛnˀd̥ɐnə
accenternes	ɑɡ̊sɑŋˀɐnəs
accenternes	ɑɡ̊sɛnˀd̥ɐnəs
accenters	ɑɡ̊sɑŋˀɐs
accenters	ɑɡ̊sɛnˀd̥ɐs
accents	ɑɡ̊sɑŋˀs
accents	ɑɡ̊sɛnˀd̥s
acceptabel	ɑɡ̊sɜb̥tˢaːˀb̥əl
acetone	asətˢoːnə
achilles	akʰiləs
achilleus	akʰilœwˀs
ad	a
ad	að
ad	aðˀ
adgang	aðɡ̊ɑŋˀ
adgangskode	aðɡ̥ɑŋskʰoːðə
adjektiv	aðjɛɡ̊tˢiwˀ
adjunkt	aðjɔŋˀd̥
adjø	ad̥jø
adr	aðˀɐ
adresse	ad̥ʁasə
advare	aðvɑˀɑ
advarsel	aðvɑːsəl
advent	aðvɛnˀd̥
adverbium	að̠ˠʋæɐ̯ˀb̥jɔm
ae	æːæ
af	a
af	æːˀ
afart	ɑʊ̯ɑːˀd̥
afbilde	awb̥elˀə
afbilde	awb̥ilˀə
afbildning	ɑwb̥elˀneŋ
afbildning	ɑwb̥ilˀneŋ
afbryde	ɑwb̥ʁyˀðə
afføring	ɑwføːˀɐ̯eŋ
afgøre	ɑwɡ̊ɶˀɐ
afgørende	ɑwɡ̊ɶˀɐnə
afhold	ɑwhʌlˀd̥
afholde	ɑwhʌlˀə
afholdende	ɑwhʌlˀənə
afholdenhed	ɑwhʌlˀənheðˀ
afholder	ɑwhʌlˀd̥ɐ
afholdes	ɑwhʌlˀəs
afholdt	ɑwhʌlˀd̥
afholdte	ɑwhʌlˀd̥ə
afholdtes	ɑwhʌlˀd̥əs
afhænge	ɑwhɛŋˀə
afklæde	ɑwkʰl̥ɛðˀə
afklæde	ɑwkʰl̥ɛˀðə
aflede	awleðˀð̩
afledt	ɑwleˀd̥
afledte	ɑwleˀd̥ə
aflevere	ɑʊ̯leʋeːˀɐ
aflevering	ɑwleveːˀɐ̯eŋ
aflive	ɑʊ̯ːliʋə
aflyd	ɑʊløð
aflyse	ɑwlyˀsə
afløb	ɑwløːˀb̥
afmagt	ɑwmɑɡ̊d̥
afpresning	ɑwpʰʁ̥asneŋ
afrikaner	ɑfʁikʰæːˀnɐ
afrikansk	ɑfʁikʰæːˀnsɡ̊
afrodisiakum	afʁ̥od̥isiːˀakʰɔm
afrodite	ɑfʁod̥iːd̥ə
afsked	ɑʊ̯sɡ̊eð̠ˠˀ
afskrift	awsɡ̊ʁæfd̥
afskyelig	ɑwsɡ̊yːˀəli
afslutte	ɑʊ̯slud̥ə
afstand	ɑwsd̥anˀ
afstemning	ɑwsd̥ɛmˀneŋ
aftale	ɑwtˢæːlə
aftale	ɑwtˢæːˀlə
aften	ɑfd̥ən
aftener	ɑfd̥ənɐ
aftener	ɑfnɐ
aftenerne	ɑfnɐnə
aftes	ɑfd̥əs
aftnen	ɑfd̥ənən
aftnen	ɑfnən
aftner	ɑfd̥ənɐ
aftner	ɑfnɐ
aftnerne	ɑfnɐnə
aftægt	ɑwtˢɛɡ̊d̥
afvige	ɑwʋiˀi
afvise	ɑwʋiˀsə
age	æːjə
age	æːæ
ager	aɡ̊eɐ̯ˀ
ager	aɡ̊eˀɐ̯
ager	æˀjɐ
ager	æːjɐ
agern	æˀjɐn
agern	æˀɐn
agt	ɑɡ̊d̥
agte	ɑɡ̊d̥ə
agurk	akuɐ̯k
ahornsirup	ahoɐ̯nsiːˀʁɔb̥
ajour	aɕuɐ̯
akillessene	akʰiləsseːnə
akkumulator	akʰumulæːtˢɐ
akkumulator	ɑkʰumulæːtˢɐ
akkumulatorer	akʰumulatˢoːɐ
akkumulatorer	ɑkʰumulatˢoːɐ
akkumulere	akʰumuleːˀɐ
akkumulere	ɑkʰumuleːˀɐ
akkusativ	akʰusatˢiwˀ
akkusativ	akʰusatˢiːˀw
aksel	ɑɡ̊sl̩
akt	ɑɡ̊d̥
aktie	ɑɡ̊ɕə
aktiv	ɑɡ̊tˢiwˀ
aktivist	ɑɡ̊tˢivisd̥
al	al
albue	alb̥uˀə
albue	alb̥uːə
album	alb̥ɔm
albumin	alb̥umiːˀn
aldrig	ɑld̥ʁi
alen	æːln̩
alenlang	æːlənlɑŋ
alfahan	alfahan
alfons	alfʌnˀs
alfons	alfʌŋs
alfons	alfʌŋˀs
algoritme	alɡ̊oʁid̥mə
alle	alə
alle	æleːˀ
allegori	aləɡ̊oʁiˀ
allegorisk	aləɡ̊oɐ̯ˀisɡ̊
allesammen	aləsɑmn̩
allike	alˀəɡ̊ə
allokering	alokʰeːˀɐ̯eŋ
allé	aleˀ
almen	almeˀn
almennyttig	almennød̥i
alskens	alˀsɡ̊n̩s
altan	altˢæːˀn
alter	ald̥ɐ
altergang	ald̥ɐɡ̊ɑŋˀ
altid	alˀtˢið
altid	alˀtˢiðˀ
alting	altˢeŋˀ
alting	alˀtˢeŋ
alting	alˀtˢeŋˀ
altruistisk	altˢʁ̥uisd̥isɡ̊
aluminium	alumiˀnjɔm
alverden	alvæɐ̯d̥ən
alvor	alʋɒˀ
alvorlig	alvɒːˀli
alvorligt	alvɒːˀlid̥
amager	ɑmɑːˀɑ
amagerkaner	ɑmɑkæːˀnɐ
amagerkaner	ɑmɑːkæːˀnɐ
amalie	amæːˀljə
amanuensis	amanuɛnsis
ambitiøs	ɑmb̥iɕøːˀs
ambolt	ɑmb̥ʌlˀd̥
ambra	ɑmb̥ʁɑ
amerika	ameɐ̯ˀikʰa
amerika	ameːˀʁikʰa
amerika	ɑmeɐ̯ˀikʰa
amerikaner	ɑmɑikʰæˀnɐ
amerikaner	ɑmʁikʰæˀnɐ
amerikaner	ɑmʁikʰæːnɐ
ametyst	ɑmətˢysd̥
amnesi	ɑmnəsiːˀ
amt	ɑmˀd̥
an	an
an	æˀn
analsex	anæːˀlsɛɡ̊s
ananas	ananas
anciennitet	ɑŋɕənitˢeːˀd̥
and	anˀ
andefedt	anəfed̥
andemad	anəmað
anden	anən
anden	anˀən
anders	ɑnɐs
andersen	ɑnɐsn̩
andre	ɑnd̥ʁɐ
andrik	and̥ʁæɡ̊
androide	and̥ʁoiːðə
anerkende	anɐkʰɛnˀə
anfange	anfɑŋˀə
anglofil	ɑŋlofiːˀl
anglofil	ɑŋɡ̊lofiːˀl
angreb	anɡ̊ʁɛˀb̥
angribe	anɡ̊ʁiːb̥ə
angriber	anɡ̊ʁiːˀb̥ɐ
angstskrig	ɑŋˀsd̥sɡ̊ʁiˀ
anholde	anhʌlˀə
anholdelse	anhʌlˀəlsə
anke	ɑŋɡ̊ə
ankomst	ankʰʌmˀsd̥
anmeldelse	anmɛlˀəlsə
anmode	anmoðˀð̩
anmode	anmoˀð̩
annektering	anɛɡ̊tˢeːˀɐ̯eŋ
anordne	anɒˀd̥nə
anordning	anɒˀd̥neŋ
ansat	ansad̥
ansatte	ansad̥ə
ansattes	ansad̥əs
anse	anseˀ
anseelse	anseˀəlsə
anselig	anseˀli
anser	anseɐ̯ˀ
anset	anseˀd̥
ansete	anseˀd̥ə
ansigt	anseɡd
anstand	ansd̥anˀ
ansvar	ansʋ̥ɑˀ
ansvarlig	ansvɑːˀli
anså	ansɔˀ
ansætte	ansɛd̥ə
antage	antˢæːˀ
antropomorf	antˢʁ̥opʰomɒːf
antyder	antˢyðˠˀɐ
antydning	antˢyðˀneŋ
anæstesi	anɛsd̥əsiːˀ
aorist	ɑoʁisd̥
aorist	ɑwʁisd̥
apanage	apʰanæːɕə
aphrodite	ɑfʁod̥iːd̥ə
apollon	apʰʌlʌn
apostrof	ab̥osd̥ʁʌf
apostrof	ɑb̥osd̥ʁʌf
apoteker	ab̥otˢeːˀɡ̊ɐ
apparat	ɑb̥ɑʁɑːˀd̥
apparat	ɑb̥əʁɑːˀd̥
appelsin	ɑb̥l̩siːˀn
appelsinjuice	ɑb̥l̩siːˀnd̥juːs
aprilsnar	apʰʁ̥iːˀlsnɑːˀ
apropos	apʰʁ̥opʰo
apropos	ɑpʰʁ̥opʰo
ar	ɑːˀ
ara	ɑːʁɑ
araber	aʁɑːˀb̥ɐ
araber	ɑʁɑːˀb̥ɐ
arabien	aʁɑːˀb̥iən
arabien	ɑʁɑːˀb̥iən
arabisk	aʁɑːˀb̥isɡ̊
arabisk	ɑʁɑːˀb̥isɡ̊
aramæer	ɑɑmɛːˀɐ
arbejde	ɑːb̥ɑjˀd̥ə
arbejder	ɑːb̥ɑjˀd̥ɐ
arbejdsdag	ɑːb̥ɑɪ̯d̥sd̥æːˀ
arbejdsgiver	ɑːb̥ɑjd̥sɡ̊iːvɐ
arbejdsløs	ɑːb̥ɑjd̥sløˀs
ard	ɑˀd̥
areal	ɑːeæːˀl
argentiner	ɑɡ̊ɛntˢiːˀnɐ
argon	ɑːɡʌn
aristofanes	ɑisd̥oˀfanɛs
aristophanes	ɑisd̥oˀfanɛs
aristoteles	ɑisd̥oˀd̥əlɛs
ark	ɑːɡ̊
arkitekt	ɑɡ̊itˢɛɡ̊d̥
arkiv	ɑkʰiwˀ
arkivar	ɑkivɑˀ
arkæologi	ɑkʰeoloɡ̊iˀ
arkæologi	ɑkʰɛoloɡ̊iˀ
arm	ɑːˀm
armbrøst	ɑːmb̥ʁœ̞sd̥
arme	ɑmeːˀ
arme	ɑːmə
armhule	ɑːmhuːlə
armod	ɑːmoˀð
arne	ɑːnə
arp	ɑːb̥
arrangement	ɑɑŋɕəmɑŋ
arrangere	ɑɑŋɕeˀɐ
arre	ɑːɑ
arrest	aʁasd̥
arrest	aʁɑsd̥
arrester	aʁasd̥ɐ
arrester	aʁɑsd̥ɐ
arrester	ɑɑsd̥eɐ̯ˀ
arrestere	ɑɑsd̥eˀɐ
arresterede	ɑɑsd̥eˀɐðə
arresterer	ɑɑsd̥eˀɐ
arresteres	ɑɑsd̥eˀɐs
arresteret	ɑɑsd̥eˀɐð
arrig	ɑːˀi
arrigtrold	ɑːˀitˢʁ̥ʌlˀ
arsen	ɑːsen
art	ɑˀd̥
arte	ɑːd̥ə
artikel	ɑtˢiɡ̊əl
artikler	ɑtˢiɡ̊lɐ
arv	ɑwˀ
arv	ɑːˀw
arve	ɑːvə
arvelig	ɑːvəli
arving	ɑːveŋ
asien	æˀɕən
asparges	asb̥ɑˀs
astma	asd̥ma
astronaut	asd̥ʁonɑwˀd̥
asyl	asyːˀl
at	a
at	ad̥
at	ʌ
athen	atˢeˀn
athena	atˢeːna
athene	atˢeːnə
athener	atˢeˀnɐ
athenienser	atˢeniɛnˀsɐ
atheniensisk	atˢeniɛnˀsisɡ̊
athensk	atˢeˀnsɡ̊
athenæer	atˢenɛˀɐ
athenæisk	atˢenɛˀisɡ̊
atom	atˢoˀm
atombombe	atˢoˀmb̥ɔmb̥ə
atomer	atˢoˀmɐ
atomerne	atˢoˀmɐnə
atomet	atˢoˀməð
atomkerne	atˢoˀmkʰaɐ̯nə
atonal	atˢonæːˀl
atten	ad̥n̩
atter	ad̥ɐ
attisk	atˢisɡ̊
attribut	atˢʁ̥ib̥ud̥
attrå	atˢʁ̥ɔˀ
atypisk	atˢyb̥isɡ̊
aubergine	ob̥æɐ̯ɕinː
aubergine	ob̥æɐ̯ɕiːne
aubergine	ob̥æɐ̯ɕiːn̩
august	ɑwɡ̊ɔsd̥
autodidakt	ɑwtˢod̥id̥aɡ̊d̥
autofokus	ɑwtˢofoːɡ̊us
autoritet	ɑwtˢoɐ̯itˢeːˀd̥
autoritet	ɑwtˢɒitˢeːˀd̥
avance	avɑŋsə
avancere	avɑŋseːˀɐ
avancere	ɑvɑŋseːˀɐ
avanceret	avɑŋseːˀɐð
avanceret	ɑvɑŋseːˀɐð
avenue	ævəny
avl	ɑwˀl
avle	ɑwlə
avlede	ɑwləð̩
avler	ɑwlɐ
avler	ɑwˀlɐ
avlet	ɑwləð
avocado	aʋokʰæːd̥o
avokado	avokʰæːd̥o
babylem	b̥ɛɪ̯b̥ilɛmˀ
babyvræl	b̥ɛɪ̯b̥iʋʁɛːˀl
bad	b̥að
bad	b̥æðˀ
bad	b̥æˀð
bade	b̥æːðə
bade	b̥æːð̩
bader	b̥æːðɐ
badet	b̥aðˀəd̥
badet	b̥æːðəd̥
badminton	b̥ad̥məntˢʌn
bag	b̥æˀ
bag	b̥æˀj
bagage	b̥aɡ̊æːɕə
bagatel	b̥ɑɡ̊atˢɛlˀ
bagbord	b̥ɑwb̥oːˀɐ̯
bagdel	b̥ɑwd̥eˀl
bage	b̥æːjə
bage	b̥æːæ
bagefter	b̥æːˀjɛfd̥ɐ
bager	b̥æːjɐ
bager	b̥æːɐ
bageri	b̥æɪ̯ɐʁiːˀ
baggrund	b̥ɑwɡ̊ʁɔnˀ
bagklogskab	b̥ɑwkʰlɔwsɡ̊æːˀb̥
bagt	b̥ɑɡ̊d̥
bagte	b̥ɑɡ̊d̥ə
bajer	b̥ɑjˀɐ
bakke	b̥ɑɡ̊ə
balkon	b̥alkʰʌŋ
ballet	b̥alɛd̥
ballon	b̥alʌŋ
balsamisk	b̥alsæˀmisɡ̊
balstyrig	b̥alsd̥yːˀɐ̯i
balstyrisk	b̥alsd̥yːˀɐ̯isɡ̊
bamse	b̥ɑmsə
band	b̥ænˀ
band	b̥æːnd̥
bandage	b̥and̥æːɕə
bande	b̥and̥ə
bande	b̥anə
banegård	b̥æːnəɡ̊ɒˀ
bange	b̥ɑŋŋ̩
bankkonto	b̥ɑŋɡ̊kʰʌntˢo
bar	b̥ɑˀ
barbar	b̥ɑb̥ɑːˀ
bare	b̥ɑːɑ
barfodet	b̥ɑːfoːˀðəd̥
bark	b̥ɑːɡ̊
barken	b̥ɑːɡ̊n̩
barmhjertig	b̥ɑːmjaɐ̯d̥i
barn	b̥ɑˀn
barndom	b̥ɑːnd̥ʌmˀ
barnebarn	b̥ɑːnəb̥ɑˀn
barre	b̥ɑːɑ
barsle	b̥ɑːslə
bart	b̥ɑːˀd̥
basisk	b̥æːˀsisɡ̊
basket	b̥ɑːsɡ̊əd̥
basketball	b̥ɑːsɡ̊əd̥b̥ɒːl
basketballkurv	b̥ɑːsɡ̊əd̥b̥ɒːlkʰuɐ̯ˀv
bast	b̥asd̥
bastard	b̥asd̥ɑːˀ
bastard	b̥asd̥ɑːˀd̥
bat	b̥ad̥
batte	b̥ad̥ə
battet	b̥ad̥əð
bebyrde	b̥eb̥yɐ̯ˀd̥ə
bed	b̥eð
bed	b̥eðˀ
bed	b̥eˀ
bed	b̥eˀð
bedare	b̥ed̥ɒˀɒ
bede	b̥eðð̩
bede	b̥eˀ
bedemand	b̥eːðəmanˀ
bedene	b̥eːðənə
bedrag	b̥ed̥ʁɑwˀ
bedrag	b̥ed̥ʁɑˀw
bedrage	b̥ed̥ʁɑwˀə
bedrage	b̥ed̥ʁɑˀwə
bedrager	b̥ed̥ʁɑwˀɐ
bedrager	b̥ed̥ʁɑˀwɐ
bedrift	b̥ed̥ʁæfd̥
bedrive	b̥ed̥ʁiwˀʊ
bedrive	b̥ed̥ʁiˀʋə
bedrøve	b̥ed̥ʁœwˀʊ
bedrøve	b̥ed̥ʁœˀʋə
bedrøvede	b̥ed̥ʁœwˀð̩ð̩
bedrøvede	b̥ed̥ʁœðˀð̩ð̩
bedrøvede	b̥ed̥ʁœˀʋð̩ð̩
bedrøvet	b̥ed̥ʁœwˀð̩
bedrøvet	b̥ed̥ʁœðˀð̩
bedrøvet	b̥ed̥ʁœˀʋð̩
bedst	b̥ɛsd̥
bedt	b̥eˀd̥
bedyre	b̥ed̥yˀɐ
bedårende	b̥ed̥ɒˀnə
bedårende	b̥ed̥ɒˀɒnə
befolkningstæthed	befʌlˀɡneŋstɛdheð
begge	b̥ɛɡ̊ə
begreb	b̥eɡ̊ʁɛˀb̥
begrebsforvirring	b̥eɡ̊ʁæˀb̥sfʌviɐ̯ˀeŋ
begribe	b̥eɡ̊ʁiˀb̥ə
begynde	b̥eɡ̊ønˀə
begyndelse	b̥eɡ̊ønˀəlsə
begynder	b̥eɡ̊ønˀɐ
behold	b̥ehʌlˀ
beholde	b̥ehʌlˀə
beholder	b̥ehʌlˀɐ
beholdes	b̥ehʌlˀəs
beholdt	b̥ehʌlˀd̥
beholdte	b̥ehʌlˀd̥ə
beholdtes	b̥ehʌlˀd̥əs
behov	b̥ehʌw
behændig	b̥ehɛnˀd̥i
bekende	b̥ekʰɛnˀə
bekendelse	b̥ekʰɛnˀl̩sə
bekenden	b̥ekʰɛnˀn̩
bekendende	b̥ekʰɛnˀənə
bekender	b̥ekʰɛnˀd̥ɐ
bekendes	b̥ekʰɛnˀəs
bekendt	b̥ekʰɛnˀd̥
bekendte	b̥ekʰɛnˀd̥ə
bekendtes	b̥ekʰɛnˀd̥əs
bekostning	b̥ekʰʌsd̥neŋ
bekvem	b̥ekʰvɛmˀ
belgisk	b̥ɛlˀɡ̊isɡ̊
belortet	b̥eloɐ̯d̥əð
belyse	b̥elyˀsə
belysning	b̥elyˀsneŋ
belægge	b̥elɛɡə
beløb	beløːˀb̥
ben	b̥eˀn
benklæder	b̥eːnkʰl̥ɛɐ̯
benytte	b̥enød̥ə
berede	b̥eʁæðˀð̩
berede	b̥eʁæˀðð̩
beretning	pe̝ʁɑtniŋ
berette	b̥eʁad̥ə
berette	b̥eʁɑd̥ə
berlin	b̥aɐ̯liˀn
bersærk	b̥æɐ̯sæɐ̯ɡ̊
berømt	b̥eʁɶmˀd̥
berøre	b̥eʁɶˀɐ
berøringsangst	pe̝ʁɶɐ̯ˀiŋsɑŋˀst
besat	b̥esad̥
besatte	b̥esad̥ə
besidde	b̥esiðˀə
besjæle	b̥eɕɛˀlə
besjælede	b̥eɕɛˀləðə
besjælet	b̥eɕɛˀləð
besk	b̥eːˀsɡ̊
besked	b̥esɡ̊eðˀ
besked	b̥esɡ̊eˀð
beskeden	b̥esɡ̊eðˀn̩
beskeden	b̥esɡ̊eˀðn̩
beskidt	b̥esɡ̊id̥
beskrive	b̥esɡ̊ʁiwˀʊ
beskrive	b̥esɡ̊ʁiˀʋə
beskrivelse	b̥esɡ̊ʁiːˀvəlsə
beslutsom	b̥eslud̥sʌmˀ
beslutte	b̥eslud̥ə
bestemme	b̥esd̥ɛmˀə
bestemt	b̥esd̥ɛmˀd̥
bestemte	b̥esd̥ɛmˀd̥ə
bestialsk	b̥esd̥jæːˀlsɡ̊
bestjæle	b̥esd̥jɛˀlə
bestyrtelse	b̥esd̥yɐ̯ˀd̥əlsə
bestå	b̥esd̥ɔˀ
beståen	b̥esd̥ɔˀən
bestående	b̥esd̥ɔˀənə
besudle	b̥esuðˠˀlə
besvare	b̥esʋ̥ɑˀɑ
besætte	b̥esɛd̥ə
besættelse	b̥esɛd̥əlsə
besøg	b̥esøˀ
besøg	b̥esøˀj
besøge	b̥esøˀjə
besøge	b̥esøˀø
besøger	b̥esøˀjɐ
besøger	b̥esøˀɐ
besøgt	b̥esøɡ̊d̥
besøgte	b̥esøɡ̊d̥ə
besørge	b̥esɶwˀə
besørge	b̥esɶɐ̯ˀwə
betablokker	b̥eːtˢab̥lʌɡ̊ɐ
betale	b̥etˢæˀlə
betegnelse	betˢɑjˀnəlsə
betinge	beteŋˀə
betyde	betyˀðə
bevæge	b̥evɛˀjə
bevæge	b̥evɛˀə
bevægelse	b̥evɛˀjəlsə
bevægelse	b̥evɛˀl̩sə
bevæget	b̥evɛˀjəð
bevæget	b̥evɛˀð̩
bi	b̥iˀ
bibel	b̥iˀb̥əl
bibliotek	bibliotˢeˀɡ
bid	b̥ið
bid	b̥iðˀ
bid	b̥iˀð
bidder	b̥iðɐ
biddet	b̥iðˀð̩
bide	b̥iːðə
bidsel	b̥isəl
bidt	b̥id̥
bie	b̥iːi
bil	b̥iːˀl
bilde	b̥elə
bilde	b̥ilə
bilist	b̥ilisd̥
billede	b̥elð̩
billede	b̥elð̩ð̩
billeder	b̥elðɐ
billeder	b̥eðlɐ
billig	b̥ili
billige	b̥ilii
billigst	b̥ilisd̥
bilvask	b̥iːlʋasɡ̊
binde	b̥enə
biologi	b̥ioloɡ̊iːˀ
biord	b̥ioɐ̯ˀ
bipolar	b̥ipʰolɑːˀ
bipolær	b̥ipʰolɛːˀɐ̯
birkes	b̥iɐ̯ɡ̊əs
biskop	b̥isɡ̊ʌb̥
bistro	b̥isd̥ʁo
bisætning	b̥isɛd̥neŋ
biting	b̥itˢeŋˀ
bivuak	b̥ivuɑɡ̊
bizar	b̥isɑːˀ
bjerg	b̥jaɐ̯ˀw
bjerge	b̥jæɐ̯wə
bjælde	b̥jɛlə
bjørn	b̥jœ̞ɐ̯ˀn
blad	b̥lað
blad	b̥laðˀ
blad	b̥laːˀð
blasfemi	b̥lasfəmiːˀ
blev	b̥lewˀ
blevet	b̥leːwð̩
blevet	b̥leːð̩
blevet	b̥leːʋəð
blik	b̥leɡ̊
blinke	b̥leŋɡ̊ə
blive	b̥liːi
blive	b̥liːʊ
blive	b̥liːʋə
bliver	b̥liwˀɐ
bliver	b̥liɐ̯ˀ
blod	b̥loðˀ
blod	b̥loˀð
blodbad	b̥loðb̥að
blodig	b̥loːði
blodlegeme	b̥loðlɛːɪmə
blodmangel	ploðmɑŋˀl̩
blodplade	b̥loðpʰlæːðə
blok	b̥lʌɡ̊
blokere	b̥lokʰeːˀɐ
blokere	b̥lʌkʰeːˀɐ
blomkål	b̥lʌmkʰɔːˀl
blomme	b̥lʌmə
blomst	b̥lʌmˀsd̥
blomsterbed	b̥lʌmˀsd̥ɐb̥eð
blomstre	b̥lʌmsd̥ʁɐ
blot	b̥loˀd̥
blot	b̥lʌd̥
blote	b̥loːd̥ə
blotlægge	b̥lʌd̥lɛɡ̊ə
blotte	b̥lʌd̥ə
blottede	b̥lʌd̥əðə
blottelse	b̥lʌd̥əlsə
blotter	b̥lʌd̥ə
blottet	b̥lʌd̥əð
blues	b̥lʊəs
blufærdig	b̥lufæɐ̯ˀd̥i
bly	b̥lyːˀ
blå	b̥lɔːˀ
blåbær	b̥lʌb̥æɐ̯
blåskimmelost	b̥lʌsɡ̊eməlɔsd̥
blåtand	b̥lʌtˢanˀ
blåøjet	b̥lʌʌjˀəð
blæksprutte	b̥lɛɡ̊sb̥ʁud̥ə
blæse	b̥lɛːsə
blæst	b̥lɛsd̥
blæst	b̥lɛːˀsd̥
blød	b̥løðˀ
bo	b̥oːˀ
bod	b̥oðˀ
bod	b̥oˀð
boede	b̥oðð̩
boer	b̥oːˀɐ
boet	b̥oðˀð̩
boet	b̥oˀð̩
bog	b̥ɔwˀ
bog	b̥ɔˀw
bogklub	b̥ɔwkʰlub̥
bogorm	b̥ɔwoɐ̯ˀm
boheme	b̥oɛːm
bold	b̥ʌlˀd̥
bolle	b̥ʌlə
bolt	b̥ʌlˀd̥
bolværk	b̥ʌlvæɐ̯ɡ̊
bom	b̥ɔmˀ
bomb	b̥ɔmˀb̥
bombardement	b̥ɔmb̥ɑd̥əmɑŋ
bombe	b̥ɔmb̥ə
bomben	b̥ɔmb̥m̩
bomber	b̥ɔmb̥ɐ
bombes	b̥ɔmb̥əs
bombet	b̥ɔmb̥ð̩
bomuld	b̥ʌmulˀ
bon	b̥oˀn
bon	b̥ʌŋ
bon	b̥ʌŋˀ
bonde	b̥ɔnə
bondegård	b̥ɔnəɡ̊ɒːˀ
bone	b̥oːnə
bone	b̥ʌŋə
bonede	b̥oːnəðə
bonede	b̥ʌŋəðə
bonen	b̥ʌŋˀŋ̩
bonen	b̥ʌŋˀən
boner	b̥oːnɐ
boner	b̥ɔwnɐ
boner	b̥ʌŋɐ
boner	b̥ʌŋˀɐ
bonet	b̥oːnəð
bonet	b̥ʌŋəð
bonus	b̥oːnus
bonussen	b̥oːnusən
bonusser	b̥oːnusɐ
bonusserne	b̥oːnusɐnə
bopæl	b̥opʰɛːˀl
bor	b̥oɐ̯ˀ
bord	b̥oɐ̯ˀ
bord	b̥oˀɐ̯
borde	b̥oːɐ
bordeaux	b̥ɒd̥o
bordel	b̥ɒd̥ɛlˀ
bordtennis	b̥oɐ̯tˢɛnis
borg	pɒwˀ
borg	pɒˀw
borge	b̥ɒːʊ
borgen	b̥ɒːˀwən
borgmester	b̥ɒmɛsd̥ɐ
borgmester	b̥ɒwmɛsd̥ɐ
boring	b̥oːɐ̯eŋ
bort	b̥oɐ̯ˀd̥
bort	b̥ɒːd̥
borte	b̥ɒːd̥ə
botanik	b̥otˢaniɡ̊
botanisere	botaniseˀʌ
boulevard	b̥uləʋɑˀd̥
bouquet	b̥ukʰe
bouquet	b̥ukʰɛ
bov	b̥ɒwˀ
bove	b̥ɒːʊ
bowle	b̥ɒwlə
bowling	b̥ɒwleŋ
boykot	b̥ʌjkʰʌd̥
boykotte	b̥ʌjkʰʌd̥ə
brad	b̥ʁɑð
brad	b̥ʁɑˀð
bragt	b̥ʁɑɡ̊d̥
bragte	b̥ʁɑɡ̊d̥ə
branche	b̥ʁɑŋɕə
brand	b̥ɹæːnd̥
brand	b̥ʁɑnˀ
brasilianer	b̥ʁɑsiljæːˀnɐ
brasiliansk	b̥ʁɑsiljæːˀnsɡ̊
brasilien	b̥ʁɑsilˀjən
brat	b̥ʁɑd̥
bratsch	b̥ʁɑːˀd̥ɕ
bred	b̥ʁæð
bred	b̥ʁæðˀ
bred	b̥ʁæˀð
bredde	b̥ʁæˀd̥ə
bredden	b̥ʁæðˀn̩
bredden	b̥ʁæˀd̥n̩
breddens	b̥ʁæðˀn̩s
breddens	b̥ʁæˀd̥n̩s
bredder	b̥ʁæðɐ
bredder	b̥ʁæˀd̥ɐ
bredderne	b̥ʁæðɐnə
bredderne	b̥ʁæˀd̥ɐnə
breddernes	b̥ʁæðɐnəs
breddernes	b̥ʁæˀd̥ɐnəs
bredders	b̥ʁæðɐs
bredders	b̥ʁæˀd̥ɐs
breddes	b̥ʁæˀd̥əs
brede	b̥ʁæðð̩
breds	b̥ʁæðs
breds	b̥ʁæðˀs
bredt	b̥ʁæd̥
bredt	b̥ʁæˀd̥
bregne	b̥ʁɑjnə
brev	b̥ʁæwˀ
breve	b̥ʁeːvə
breve	b̥ʁeːw̩
bridge	b̥ʁid̥ɕ
brik	b̥ʁæɡ̊
brillant	b̥ʁilianˀd̥
brillant	b̥ʁiljanˀd̥
brille	b̥ʁɛlə
bringe	b̥ʁæŋŋ̩
bringe	b̥ʁæŋə
brint	b̥ʁænˀd̥
brintbombe	b̥ʁænd̥b̥ɔmb̥ə
brinten	b̥ʁænˀd̥n̩
brise	b̥ʁiːsə
brist	b̥ʁɛsd̥
briste	b̥ʁɛsd̥ə
britannien	b̥ʁitˢanˀjən
brite	b̥ʁid̥ə
britisk	b̥ʁid̥isɡ̊
britiske	b̥ʁid̥isɡ̊ə
bro	b̥ʁoːˀ
brod	b̥ʁʌð
broder	b̥ʁoːðɐ
broderskab	bʁoːðʌsɡæˀb
brom	bʁoˀm
bronze	b̥ʁʌŋsə
bror	b̥ʁoɐ̯
bros	b̥ʁoˀs
browser	bɹɑwsɐ
brud	b̥ʁuð
brud	b̥ʁuðˀ
brud	b̥ʁuˀð
brudepige	b̥ʁuːðəpʰiːə
brug	b̥ʁoˀ
brug	b̥ʁuˀ
brugbar	b̥ʁoːb̥ɑˀ
brugbar	b̥ʁuːb̥ɑˀ
bruge	b̥ʁoːo
bruge	b̥ʁuːu
brugelig	b̥ʁoːoli
brugelig	b̥ʁuːəli
bruger	b̥ʁoːɐ
bruger	b̥ʁuːɐ
brugs	b̥ʁoˀs
brugs	b̥ʁuˀs
brugt	b̥ʁɔɡ̊d̥
brugte	b̥ʁɔɡ̊d̥ə
brumme	b̥ʁɔmə
brun	b̥ʁuːˀn
brunch	b̥ɹʌnɕ
brunch	b̥ɹʌnˀɕ
brunch	b̥ʁʌnɕ
brunch	b̥ʁʌnˀɕ
brunche	b̥ɹʌnɕə
brunche	b̥ʁʌnɕə
brunette	b̥ʁunɛd̥ə
brusk	b̥ʁusɡ̊
brutal	b̥ʁutˢæːˀl
bruxelles	b̥ʁysɛl
bryd	b̥ʁyðˀ
bryde	b̥ʁyðð̩
bryder	b̥ʁyðˀɐ
bryder	b̥ʁyːðɐ
brydes	b̥ʁyðð̩s
brydning	b̥ʁyðneŋ
bryg	b̥ʁœɡ̊
brygge	b̥ʁœɡ̊ə
bryllup	b̥ʁœlɔb̥
bryllup	b̥ʁœlʌb̥
brynje	b̥ʁønjə
bryst	b̥ʁœsd̥
brystvorte	b̥ʁœsd̥vɒːd̥ə
brædder	b̥ʁaðɐ
brædder	b̥ʁɑðɐ
bræk	b̥ʁaɡ̊
brække	b̥ʁaɡ̊ə
brændenælde	b̥ʁannɛlə
brændenælde	b̥ʁɑnnɛlə
brændpunkt	b̥ʁanpʰɔŋˀd̥
brændpunkt	b̥ʁɑnpʰɔŋˀd̥
brændstof	b̥ʁansd̥ʌf
brændte	b̥ʁand̥ə
brændte	b̥ʁanˀd̥ə
brændte	b̥ʁɑnd̥ə
brændte	b̥ʁɑnˀd̥ə
bræt	b̥ʁad̥
bræt	b̥ʁɑd̥
brød	b̥ʁœðˀ
brøde	b̥ʁœðð̩
brødes	b̥ʁœðð̩s
brødet	bʁœðˀð̩
brødflov	b̥ʁœðflɒwˀ
brødre	b̥ʁœðʁɐ
brøk	b̥ʁœ̞ˀɡ̊
brøkdel	b̥ʁœˀɡ̊d̥eˀl
brøst	b̥ʁœsd̥
bud	b̥uð
buddhisme	b̥ud̥ismə
bude	b̥uːðə
bue	b̥uːə
bueskytte	b̥uəsɡ̊ød̥ə
bug	b̥uˀ
bugne	b̥uːnə
bugt	b̥ɔɡ̊d̥
bugte	b̥ɔɡ̊d̥ə
buket	b̥ukʰɛd̥
bukser	b̥ɔɡ̊sɐ
bulgarer	b̥ulɡ̊ɑːˀɑ
bulgarsk	b̥ulɡ̊ɑːˀsɡ̊
bullet	b̥uləd̥
bump	b̥ɔmˀb̥
bumpe	b̥ɔmb̥ə
bumper	b̥ɔmb̥ər
bumpes	b̥ɔmb̥əs
bumpet	b̥ɔmb̥ð̩
bumpet	b̥ɔmˀb̥ð̩
bund	b̥ɔnˀ
bunde	b̥ɔnə
bunden	b̥ɔnən
bunden	b̥ɔnˀən
bundne	b̥ɔnnə
bundt	b̥ɔnˀd̥
bur	b̥uɐ̯ˀ
bur	b̥uːˀɐ̯
burde	b̥oɐ̯d̥ə
burde	b̥uɐ̯d̥ə
burdet	b̥oɐ̯d̥əð
burdet	b̥uɐ̯d̥əð
bus	b̥us
bussemand	b̥usəmanˀ
busser	b̥usɐ
butik	b̥utˢiɡ̊
butikken	b̥utˢiɡ̊ən
butikker	b̥utˢiɡ̊ɐ
butikkerne	b̥utˢiɡ̊ɐnə
by	b̥yˀ
byde	b̥yːðə
byg	b̥yɡ̊
bygd	b̥yɡ̊d̥
bygge	b̥yɡ̊ə
bygning	b̥yɡ̊neŋˀ
byrd	b̥yɐ̯ˀd̥
byrde	b̥yɐ̯d̥ə
bytte	b̥yd̥ə
byzans	b̥ysanˀs
båd	b̥ɔðˀ
både	b̥ɔðð̩
bådhus	b̥ɔðˠhuːˀs
bånd	b̥ʌnˀ
båndoptager	b̥ʌnʌb̥tˢaˀjɐ
båndoptager	b̥ʌnʌb̥tˢaˀɐ
båre	b̥ɒːɒ
båret	b̥ɒːɒð
bæ	b̥ɛːˀ
bæger	b̥æːɐ
bæger	b̥ɛːjɐ
bæger	b̥ɛːɐ
bæk	b̥ɛɡ̊
bær	b̥aɐ̯
bær	b̥ɛɐ̯ˀ
bær	b̥ɛˀɐ̯
bære	b̥æːɐ
bære	b̥ɛːɐ
bærer	b̥aɐ̯ˀ
bærer	b̥æːɐ
bærer	b̥ɛːɐ
bærret	b̥aɐ̯ˀɐð
bæskubber	b̥ɛːˀsɡ̊ɔb̥ɐ
bæst	b̥ɛˀsd̥
bæve	b̥ɛːvə
bæve	b̥ɛːʊ
bæven	b̥ɛːʊn
bæven	b̥ɛːʋən
bød	b̥øðˀ
bøde	b̥øðð̩
bødker	b̥øðˀɡ̊ɐ
bødker	b̥øˀɡ̊ɐ
bøf	b̥øf
bøffel	b̥øfəl
bøflen	b̥øflən
bøfler	b̥øflɐ
bøg	b̥øˀj
bøger	b̥øjˀɐ
bøger	b̥œˀɐ̯
bøje	b̥ʌɪ
bøjle	b̥ʌjlə
bøjning	b̥ʌjneŋ
bølge	b̥øljə
bølgen	b̥øljən
bøn	bœnˀ
bønder	b̥œnˀɐ
bønne	b̥œnə
bønnen	b̥œnən
bønnen	b̥œnˀən
bønner	b̥œnɐ
bør	b̥øɐ̯ˀ
bør	b̥øˀɐ̯
bør	b̥ɶɐ̯
børe	b̥øːɐ
børen	b̥øˀɐn
børene	b̥øːɐnə
børje	b̥ɶɐ̯jə
børn	b̥ɶɐ̯ˀn
børnebørn	b̥ɶɐ̯nəb̥ɶɐ̯ˀn
børnene	b̥ɶɐ̯ˀnnə
børnenes	b̥ɶɐ̯ˀnnəs
børneporno	b̥œɐ̯nəpʰɒːno
børnepornografi	b̥œɐ̯nəpʰɒnoɡ̊ʁɑfiːˀ
børnesygdom	b̥œ̞ɐ̯nəsyːd̥ʌm
børs	b̥øɐ̯ˀs
børste	b̥œ̞ɐ̯sd̥ə
bøsse	b̥øsə
bøssebar	b̥øsəb̥ɑˀ
bøssepar	b̥øsəpʰɑ
bøsserøv	b̥øsəʁɶwˀ
bøv	b̥œʊ̯ˀ
bøvet	b̥œʊ̯əðˠ
bøvl	b̥œwˀl
bøvle	b̥œwlə
bøvlede	b̥œwlð̩ð̩
bøvler	b̥œwlɐ
bøvlet	b̥œwlð̩
bøvlet	b̥œwˀlð̩
bøvs	b̥œwˀs
bøvse	b̥œwsə
cadeau	kʰad̥o
caffelatte	kʰafəlad̥ə
camper	kʰæːmb̥ɐ
camper	kʰɑmpʰeːˀɐ̯
campere	kʰæːmb̥ɐɐ
campere	kʰɑmpʰeːˀɐ
campingvogn	kambeŋvɔu̯ˀn
canadier	kʰanæːˀd̥jɐ
candyfloss	kʰand̥iflʌs
candyfloss	kʰæːnd̥iflʌs
carbon	kʰɑːb̥ʌn
carbondioxid	kʰɑːbʌnd̥iʌɡ̊ksiðˀ
caribisk	kʰaʁiːˀb̥isɡ̊
caribisk	kʰɑʁiːˀb̥isɡ̊
castiliansk	kasdiljæˀnsɡ
catalansk	kʰatˢalæːˀnsɡ̊
cd	sed̥eˀ
cd	seˀd̥eˀ
celle	sɛlə
cellekerne	sɛləkʰaɐ̯nə
cellofan	selofæːˀn
cellofan	sɛlofæːˀn
cerebral	serəb̥ʁɑːˀl
chaiselong	ɕɛsəlʌŋ
champignon	ɕɑmpʰinjʌŋ
chance	ɕɑŋsə
changere	ɕɑŋseˀɐ
changere	ɕɑŋɕeˀɐ
charabanc	ɕɑɑb̥ɑŋ
charm	tɕɑːm
charm	ɕɑˀm
charmant	ɕɑˀmɐnˀd̥
charme	ɕɑːmə
charmere	ɕɑmeˀɐ
chateau	ɕatˢo
chauffør	ɕaføɐ̯ˀ
chauffør	ɕaføˀɐ̯
chauffør	ɕoføɐ̯ˀ
chauffør	ɕoføˀɐ̯
check	ɕɛɡ̊
chef	ɕɛːˀf
chikane	ɕikʰæːnə
chips	tɕib̥s
chok	ɕʌɡ̊
chokolade	ɕoɡ̊olæːðə
chokoladekage	ɕoɡ̊olæːðəkʰæːjə
christian	kʰʁɛsd̥jan
cicero	sisəʁo
cigar	siɡ̊ɑːˀ
cigaret	siɡ̊aʁad̥
cigaret	siɡ̊əʁad̥
citer	sid̥ɐ
citer	sitˢeɐ̯ˀ
citere	sid̥ɐɐ
citere	sitˢeːˀɐ
citron	sitˢʁ̥oˀn
citronsyre	sitˢʁoːˀnsyːɐ
cognac	kʰʌnˀjɑɡ̊
collie	kʰʌli
computer	kʰʌmpʰj̊uːd̥ɐ
cowboy	kʰɒwb̥ʌj
cowboybukser	kʰɒwb̥ʌjb̥ɔɡ̊sɐ
cowboyder	kʰɒwb̥ʌjˀd̥ɐ
cowboyer	kʰɒwb̥ʌjˀɐ
creme	kʰʁ̥ɛˀm
cremefraiche	kʰʁ̥ɛmfrɛːs
cremefraiche	kʰʁ̥ɛmfrɛːɕ
cremen	kʰʁ̥ɛˀmm̩
cremen	kʰʁ̥ɛˀmən
cremer	kʰʁ̥ɛˀmɐ
cremer	kʰʁ̥ɛːmɐ
cykel	siɡ̊l̩
cykel	syɡ̊l̩
cykelhjelm	syɡ̊l̩jɛlˀm
cykle	syɡ̊lə
cyklen	syɡ̊lən
cykler	syɡ̊lɐ
cyklist	syɡ̊lisd̥
cyklus	sykʰl̥us
cyklus	syɡ̊lus
cylinder	sylenˀd̥ɐ
cylinder	sylenˀɐ
cylindrisk	sylenˀd̥ʁisɡ̊
cypres	sypʰʁ̥as
cypres	sypʰʁ̥ɑs
dag	d̥æˀ
dag	d̥æˀj
dagbog	d̥ɑwb̥ɔːˀw
daglig	d̥ɑwli
daglige	d̥ɑwlii
dagligliv	d̥ɑwliliwˀ
dagligliv	d̥ɑwliliˀw
dagligstue	d̥ɑwlisd̥uːu
dagligstue	d̥ɑwlisd̥uːə
dagligt	d̥ɑwlid̥
dagligvare	d̥ɑwliʋɑːɑ
dagligvarebutik	d̥ɑwlib̥utˢiɡ̊
dagligvaren	d̥ɑwliʋɑːɑn
dagligvarer	d̥ɑwliʋɑːɑ
dagligvarerne	d̥ɑwliʋɑːɑnə
dal	dæːˀl
dale	d̥æːlə
daler	d̥æːlɐ
daler	d̥æːˀlɐ
damask	d̥amasɡ̊
dame	d̥æːmə
dampskib	d̥ɑmb̥sɡ̊iːˀb̥
danablu	dæːnabluˀ
danablu	dæːnabluː
danbo	da̝nboˀ
dandere	dɑŋdeˀʌ
danefæ	d̥æːnəfɛˀ
danegæld	d̥æːnəɡ̊ɛlˀ
daner	d̥æˀnɐ
danerne	d̥æˀnɐnə
daniel	d̥æːˀnjəl
danisere	daniseˀʌ
danmark	d̥anmɑɡ̊
dannebrog	d̥anəb̥ʁoːˀ
danserinde	d̥ansɐenə
dansk	d̥anˀsɡ̊
danske	d̥ansɡ̊ə
dansken	d̥ansɡ̊ŋ̩
dansken	d̥anˀsɡ̊ŋ̩
dansker	d̥ansɡ̊ɐ
danskere	d̥ansɡ̊ɐɐ
danskeren	d̥ansɡ̊ɐɐn
database	d̥æːtˢab̥æːsə
datid	d̥atˢiðˀ
datter	tatɐ
dav	d̥ɑwˀ
davre	d̥ɑwʁɐ
de	d̥i
ded	d̥eðˀ
definerlig	defineɐ̯ˀli
definitorisk	definitoˀɐ̯isɡ
dejlig	d̥ɑjli
del	d̥eˀl
delagtig	d̥elɑɡ̊d̥i
dele	d̥eːlə
delikat	d̥elikʰæːˀd̥
dels	d̥eˀls
dem	b̥m̩
dem	d̥m̩
dem	d̥ɛm
demokrati	d̥emokʰʁ̥ɑtˢiˀ
demokratisk	d̥emokʰʁ̥ɑˀd̥isɡ̊
demokratiske	d̥emokʰʁ̥ɑˀd̥isɡ̊ə
demontere	d̥emɔntˢeːˀɐ
den	d̥n̩
den	d̥ɛn
den	d̥ɛnˀ
dendrokronologi	dɛndʁokʁonoloɡiˀ
denne	d̥ɛnə
der	d̥eˀɐ̯
der	d̥ɑ
der	d̥ɛˀɐ̯
deres	d̥aɐs
des	d̥is
desavouere	d̥esavueːˀɐ
desuagtet	d̥esuɑɡ̊d̥əð
desuagtet	d̥ɛsuɑɡ̊d̥əð
desværre	d̥esʋaɐ̯ɐ
det	d̥e
dette	d̥ɛd̥ə
deviere	devieˀʌ
diagonal	d̥iaɡ̊onæːˀl
dialekt	d̥ialɛɡ̊d̥
die	d̥iːə
diftong	d̥iftˢʌŋ
dig	d̥ɑ
dig	d̥ɑj
dige	d̥iːə
diger	d̥iːɐ
diger	d̥iːˀɐ
digt	d̥eɡ̊d̥
digte	d̥eɡ̊d̥ə
digter	d̥eɡ̊d̥ɐ
diminutiv	diminutˢiwˀ
din	d̥iːˀn
dionysos	d̥ionysʌs
diplomat	d̥ipʰl̥omæːˀd̥
direkte	d̥iʁaɡ̊d̥ə
discipel	d̥isib̥əl
disciplin	disipʰliːˀn
diskret	d̥iskʰʁ̥ɛːˀd̥
diskret	d̥isɡ̊ʁɛːˀd̥
disse	d̥isə
distance	d̥isd̥ɑŋsə
djævel	d̥jɛːʊl
djævel	d̥jɛːʋl̩
djævelsk	d̥jɛːvəlsɡ̊
dobbelt	d̥ʌb̥əld̥
dobbeltgænger	d̥ʌb̥l̩d̥ɡ̊ɛŋɐ
dobbeltgænger	d̥ʌb̥l̩ɡ̊ɛŋɐ
dogme	d̥ɒwmə
doktor	d̥ʌɡ̊d̥ɐ
doktorer	d̥ʌɡ̊d̥ɐɐ
doktorer	d̥ʌɡ̊tˢoːɐ
doktorerne	d̥ʌɡ̊d̥ɐnə
doktorerne	d̥ʌɡ̊tˢoːɐnə
dolk	d̥ʌlɡ̊
dom	d̥oˀm
dom	d̥oːm
dom	d̥ʌmˀ
domkirke	d̥ʌmkʰiɐ̯ɡ̊ə
drage	d̥ʁɑɕe
drage	d̥ʁɑːwə
drage	d̥ʁɑːʊ
drager	d̥ʁɑːwɐ
drej	d̥ʁɑjˀ
dreje	d̥ʁɑːɪ
dreng	d̥ʁa̝ŋˀ
drenge	d̥ʁa̝ŋə
drengen	d̥ʁa̝ŋˀŋ̩
drengene	d̥ʁa̝ŋn̩ə
drev	d̥ʁæw
drev	d̥ʁæwˀ
dreven	d̥ʁæwn̩
dreven	d̥ʁæːʋn̩
drevne	d̥ʁæwnə
drift	d̥ʁæfd̥
drikke	d̥ʁɛɡ̊ə
drikkepenge	d̥ʁeɡ̊əpʰɛŋŋ̩
drikker	d̥ʁeɡ̊ɐ
dril	d̥ʁælˀ
drille	d̥ʁœlə
drive	d̥ɹɑjʋ
drive	d̥ʁiːʊ
drive	d̥ʁiːʋə
drivhus	d̥ʁiwhuˀs
drog	d̥ʁowˀ
drog	d̥ʁɒw
droge	d̥ʁoːwə
dronning	d̥ʁʌneŋ
drot	d̥ʁʌd̥
drue	d̥ʁuːə
drukken	d̥ʁɔɡ̊ŋ̩
drukne	d̥ʁɔɡ̊nə
drukne	d̥ʁɔːɡ̊nə
drys	d̥ʁœ̞s
dræbe	d̥ʁɛːb̥ə
dræber	d̥ʁɛˀb̥ə
dræber	d̥ʁɛːb̥ə
dræbt	d̥ʁab̥d̥
dræbt	d̥ʁɑb̥d̥
dræbte	d̥ʁab̥d̥ə
dræbte	d̥ʁɑb̥d̥ə
drøbel	d̥ʁœʊ̯ˀəl
drøm	d̥ʁɶmˀ
drømme	d̥ʁɶmə
drømmekage	d̥ʁɶməkʰaɪ̯ə
drømmeverden	d̥ʁɶməʋaɐ̯d̥n̩
drømmeverdenen	d̥ʁɶməʋaɐ̯d̥nən
drømmeverdener	d̥ʁɶməʋaɐ̯d̥nɐ
drømmeverdenerne	d̥ʁɶməʋaɐ̯d̥nɐnə
drømmeverdner	d̥ʁɶməʋaɐ̯d̥nɐ
drømmeverdnerne	d̥ʁɶməʋaɐ̯d̥nɐnə
drøn	d̥ʁœ̞ːˀn
drøne	d̥ʁœ̞ːnə
drøv	d̥ʁɶw
du	d̥u
du	d̥uːˀ
dubiøs	d̥ub̥iøːˀs
due	d̥uːu
duel	d̥uɛlˀ
duellere	d̥uəleːˀɐ
duft	d̥ɔfd̥
dufte	d̥ɔfd̥ə
dug	d̥uɡ̊
dug	d̥uˀ
duge	d̥uːu
dukke	d̥ɔɡ̊ə
dulgt	d̥ulˀd̥
dulgte	d̥uld̥ə
dulgte	d̥ulˀd̥ə
dum	d̥ɔmˀ
dumt	d̥ɔmˀd̥
dun	d̥uːˀn
dus	d̥us
dusin	d̥usiːˀn
dværg	d̥væɐ̯ˀw
dyb	d̥yˀb̥
dybde	d̥yb̥d̥ə
dybe	d̥yːb̥ə
dybhav	d̥yb̥hɑw
dybt	d̥yb̥d̥
dyd	d̥yðˀ
dyd	d̥yˀð
dyne	dyːnə
dyr	d̥yɐ̯ˀ
dyre	d̥yːɐ
dyrisk	d̥yɐ̯ˀisɡ̊
dyrke	d̥yɐ̯ɡ̊ə
dyrskue	d̥yɐ̯sɡ̊uːə
dyse	d̥ysə
dyse	d̥yːsə
dysfori	dysfoʁiˀ
dysse	d̥ysə
dyst	dʏsd
dåb	d̥ɔˀb̥
dåne	d̥ɔːnə
dåre	d̥ɒːɒ
dårlig	d̥ɒːli
dårligst	d̥ɒːlisd̥
dårligste	d̥ɒːlisd̥ə
dåse	d̥ɔːsə
dåseøl	d̥ɔːsəøl
dæmon	d̥ɛmoːˀn
dæmpe	d̥ɛmb̥ə
dø	d̥øˀ
døb	d̥øˀb̥
døbe	d̥øːb̥ə
døber	d̥øˀb̥ɐ
døber	d̥øːb̥ɐ
døbt	d̥øb̥d̥
døbte	d̥øb̥d̥ə
død	d̥øðˀ
død	d̥øˀð
døde	d̥øːðə
dødt	d̥ød̥
dødvande	d̥øðvanə
døende	d̥øˀənə
døgn	d̥ʌjˀn
dølge	d̥øljə
døm	d̥œmˀ
dømme	d̥œmə
dømmer	d̥œmɐ
dømte	d̥œmd̥ə
dømte	d̥œmˀd̥ə
dør	d̥øɐ̯ˀ
dør	d̥øːˀɐ̯
dør	d̥œ̞ɐ̯ˀ
dør	d̥œ̞ːˀɐ̯
døtre	d̥ød̥ʁɐ
døv	d̥øˀʊ̯
eagle	iːɡəl
eddikesur	æðiɡ̊əsuɐ̯ˀ
eddikesur	æðɡ̊əsuɐ̯ˀ
eder	eːðɐ
effen	ɛfən
efter	ɛfd̥ɐ
efterligne	ɛfd̥ɐliːˀnə
efterspørgsel	ɛfdɐsbɶɐ̯səl
efterspørgsel	ɛfdɐsbɶɐ̯ˀsəl
efterår	ɛfd̥ɐɒˀ
eg	eːˀj
egentlig	eˀjn̩d̥li
egentlig	eˀnli
egern	eːˀjɐn
eget	ɑjəð
egetræ	eːjətˢʁ̥ɛːˀ
egn	ɑjˀn
egon	eːɡ̊ʌn
ej	ɑj
ej	ɑjˀ
eje	ɑjə
ejendel	ɑːjənd̥eˀl
ejendel	ɑːɪnd̥eˀl
ejendom	ɑːjənd̥ʌmˀ
ejendom	ɑːɪnd̥ʌmˀ
ejerløs	ɑjɐløːˀs
eklektisk	ekʰlɛɡ̊tˢisɡ̊
eklektisk	ɛɡ̊lɛɡ̊tˢisɡ̊
eksamen	eɡ̊sæːmm̩
eksamen	ɛɡ̊sæːmm̩
eksaminand	eɡ̊saminanˀd̥
eksaminand	ɛɡ̊saminanˀd̥
eksaminer	ɛɡ̊samineɐ̯ˀ
eksaminer	ɛɡ̊samineːˀɐ̯
eksaminer	ɛɡ̊samiːˀnɐ
eksem	eɡ̊seːˀm
eksem	ɛɡ̊seːˀm
eksempel	eɡ̊sɛmˀb̥əl
eksempel	ɛɡ̊sɛmˀb̥əl
eksplicit	ɛɡ̊sb̥lisid̥
eksponentiel	ɛɡ̊sb̥onɛnɕɛlˀ
ekstra	ɛɡ̊sd̥ʁɐ
ekstra	ɛɡ̊sd̥ʁɑ
ekstraordinær	ɛɡ̊stˢʁ̥ɑɒd̥inɛɐ̯ˀ
ekstravagant	ɛɡ̊stˢʁ̥ɑvaɡ̊anˀd̥
el	ɛl
el	ɛlˀ
elben	ɛlˀb̥m̩
elcykel	ɛlsyɡ̊l̩
elefant	eləfanˀd̥
elegant	eləɡ̊anˀd̥
elementær	eləmɛntˢɛˀɐ̯
elendig	elɛnˀd̥i
elev	eleːˀw
elfenben	ɛlˀfənb̥eˀn
elfenbenstårn	ɛlˀfənbenstˢɒːˀn
elg	ɛlˀj
eliksir	eləɡ̊siɐ̯ˀ
elitær	elitˢɛːˀɐ̯
elkedel	ɛlkʰeðəl
elleve	ɛlvə
ellevte	ɛlfd̥ə
elsdyr	ɛlˀsd̥yɐ̯ˀ
elske	ɛlsɡ̊ə
elsker	ɛlsɡ̊ɐ
elskerinde	ɛlsɡ̊ɐenə
elskov	ɛlsɡ̊ɒwˀ
elskværdig	ɛlsɡ̊væɐ̯ˀd̥i
elv	ɛlˀʋ
emballage	ɑmb̥alæːɕə
emballage	ɛmb̥alæːɕə
embede	ɛmb̥eːðð̩
embedsmand	ɛmb̥eðsmanˀ
emne	ɛmnə
emotikon	emoːˀtˢikʰʌn
en	en
en	eːˀn
enbenet	eːnb̥eːˀnəð
encyklopædi	ɑŋsykʰlopʰəd̥iːˀ
encyklopædi	ɛnsykʰlopʰəd̥iːˀ
ende	ɛnn̩
ende	ɛnə
endestation	ɛnəsd̥aɕoˀn
endt	ɛnˀd̥
enebarn	eːnəb̥ɑːˀn
enebær	eːnəb̥æɐ̯
ener	eːnɐ
ener	eːˀnɐ
eneste	eːnəsd̥ə
enfold	eːnfʌlˀ
eng	ɛŋˀ
engang	enɡ̊ɑŋ
engel	ɛŋəl
engelsk	ɛŋˀl̩sɡ̊
engelsk	ɛŋˀəlsk
englænder	ɛŋlɛnˀɐ
engsnarre	ɛŋsnɑːɑ
enhjørning	eːnjœ̞ɐ̯neŋ
enig	eːni
enke	ɛŋɡ̊ə
enlig	eːnli
enorm	enɒˀm
ens	eːˀns
ensilere	ɛnsileːˀɐ
enten	ɛnd̥n̩
episk	eːpʰisɡ̊
epistemologi	episdəmoloɡiˀ
epoke	epʰoːɡ̊ə
epos	eːpʰʌs
er	æɐ̯
erantis	eʁɑntˢis
erektion	eɐ̯əɡ̊ɕoːˀn
erfare	aɐ̯fɑˀɑ
erhverv	æɐ̯væɐ̯ˀw
erindre	eʁɛnˀd̥ʁɐ
erkende	aɐ̯kʰɛnˀə
erklære	æɐ̯kʰlɛːˀɐ
erklæring	æɐ̯klɛˀɐ̯eŋ
ernst	ænsd̥
erotica	eʁoˀtˢikʰa
erotik	eʁotˢiɡ̊
erotika	eʁoˀtˢikʰa
erstatning	aɐ̯sd̥ad̥neŋ
erstatte	aɐ̯sd̥ad̥ə
esbjerg	ɛsb̥jæɐ̯ˀ
eskimo	ɛsɡ̊imoːˀ
eskimoisk	ɛsɡ̊imoːˀisɡ̊
eskimologi	ɛsɡ̊imoloɡ̊iːˀ
esoterisk	esotˢeːˀɐ̯isɡ̊
est	ɛsd̥
estisk	ɛsd̥isɡ̊
et	ed̥
etage	etˢæˀɕə
etage	etˢæːɕə
etbenet	ed̥b̥eːˀnəð
eufori	œwfoʁiːˀ
eufori	ɛwfoʁiːˀ
euripides	œwʁib̥id̥ɛs
euro	ewʁo
euro	juɹɔw
euro	œwʁo
euro	ʌjʁo
europa	eʁoːpʰa
europæer	œwʁopʰɛˀɐ
europæer	ɛwʁopʰɛˀɐ
europæisk	œwʁopʰɛˀisɡ̊
europæisk	ɛwʁopʰɛˀisɡ̊
evangelium	evɑŋɡ̊eːljɔm
eventyr	ɛwn̩tˢyɐ̯ˀ
eventyr	ɛːʋn̩tˢyˀɐ̯
eventyrlig	ɛwn̩tˢyɐ̯ˀli
eventyrlysten	ewn̩tsʰyɐ̯løsdn̩
evig	eːʋi
evindelig	eʋenˀn̩li
evindeligt	evenˀəlid̥
evne	ɛwnə
fabel	fæːˀb̥l̩
fabel	fæːˀb̥əl
fabelagtig	fab̥əlɑɡ̊d̥i
fabelagtig	fæˀb̥əlɑɡ̊d̥i
facade	fasæːðə
facet	fasɛd̥
facon	fasʌŋ
faconen	fasʌŋˀən
faconer	fasʌŋˀɐ
fadervor	fæːðɐvɒ
fadervor	fæːðɐvɒˀ
fadøl	faðøl
fag	fæˀ
fag	fæˀj
fager	fæˀjɐ
fager	fæˀɐ
fagert	fæˀjɐd̥
fagert	fæˀɐd̥
fagidiot	fɑwidioˀd̥
faglitteratur	fɑwlid̥əʁɑtˢuɐ̯ˀ
fagot	faɡ̊ʌd̥
fagot	fɑɡ̊ʌd̥
fagre	fɑwʁɐ
fagreste	fɑwʁɐsd̥ə
fagter	fɑɡ̊d̥ɐ
fajance	fajɑŋsə
fakkel	fɑɡ̊l̩
fakta	fɑɡ̊tˢa
faktisk	fɑɡ̊d̥isɡ̊
faktisk	fɑɣd̥isɡ̊
faktisk	fɑɾisɡ̊
faktum	fɑɡ̊tˢɔm
fakultet	faɡ̊ultˢeˀd̥
fakultet	fɑɡ̊ultˢeˀd̥
falafel	falɑfl̩
fald	falˀ
falde	falə
faldgrube	falɡ̊ʁuːb̥ə
faldgruppe	falɡ̊ʁub̥ə
faldskærm	falsɡ̊aɐ̯ˀm
falk	falˀɡ̊
falleret	faleːˀɐð
falsk	falˀsɡ̊
familie	familˀjə
familie	fɑmilˀjə
famle	fɑmlə
fanden	fanən
fanden	fæːæn
fandens	fanəns
fandt	fanˀd̥
fandtes	fand̥əs
fange	fɑŋŋ̩
fange	fɑŋə
fangenskab	fɑŋŋ̩sɡ̊æˀb̥
fangenskab	fɑŋənsɡ̊æˀb̥
far	fɑː
farao	fɑːʁɑo
farao	fɑːʁɑw
fare	fɑːɑ
faren	fɑːɑn
farfar	fɑˀfɑː
farmor	fɑˀmoɐ̯
fars	fɑːs
fars	fɑːˀs
farsot	fɑːsoˀd̥
fart	fɑˀd̥
fartøj	fɑːtˢʌj
farvel	fɑvɛl
farvel	fʌvɛl
farvestof	fɑːvəsd̥ʌf
fashionabel	faɕonæˀb̥əl
fast	fasd̥
fast	fæːˀsd̥
faste	fasd̥ə
faste	fæːsd̥ə
fastelavn	fasd̥əlɑwˀn
faster	fasd̥ɐ
fatal	fatˢæːˀl
fatamorgana	fatˢamɒɡ̊æːna
fattig	fad̥i
fattigdom	fad̥id̥ʌmˀ
fatwa	fæd̥ʋa
feber	feˀb̥ɐ
feberen	feˀb̥ɐɐn
febre	feˀb̥ʁɐ
fed	feð
fed	feðˀ
fed	feˀð
fed	feːˀð
fede	feːðə
fedme	feðmə
fedt	fed̥
fedtet	fed̥əð
fej	fɑjˀ
fejde	fɑjd̥ə
feje	fɑːjə
feje	fɑːɪ
fejlagtig	fɑjlɑɡ̊d̥i
fejle	fɑɪ̯lə
fejre	fɑjʁɐ
fem	fɛmˀ
femte	fɛmˀd̥ə
femten	fɛmd̥n̩
femti	fɛmtˢi
ferie	feɐ̯ˀiə
ferie	feɐ̯ˀjə
fersken	faɐ̯sɡ̊ŋ̩
fersken	faɐ̯sɡ̊ən
fertilitet	fæɐ̯tˢilitˢeːˀd̥
fest	fɛsd̥
festskrift	fɛsd̥sɡ̊ʁæfd̥
figen	fiːin
figen	fiːən
fik	feɡ̊
fiks	feɡ̊s
fikse	feɡ̊sə
fiksstjerne	feɡ̊ssd̥jaɐ̯nə
fiktion	fiɡ̊ɕoˀn
fiktiv	fiɡ̊tˢiwˀ
fil	fiːˀl
filet	file
filetere	filətˢeːˀɐ
filigran	filiɡ̊ʁɑn
filigran	filiɡ̊ʁɑnˀ
filippinsk	filipʰiːˀnsɡ̊
film	film
filolog	filoloˀ
filologi	filoloɡiˀ
filologisk	filoloˀisɡ
filosof	filosʌf
filsben	fiˀlsb̥eˀn
fin	fiˀn
find	fenˀ
finde	fenə
finder	fenɐ
finder	fenˀɐ
findes	fenəs
finer	fineːˀɐ̯
finger	feŋɡ̊eɐ̯ˀ
finger	feŋɡ̊eːˀɐ̯
finger	feŋˀɐ
fingerbøl	feŋɐb̥øl
fingere	feŋɡ̊eːˀɐ
finmark	fenmɑːɡ̊
finne	fenɘ
finér	fineːˀɐ̯
fire	fiːɐ
firs	fiɐ̯ˀs
firsindstyve	fiɐ̯ˀsn̩stˢyːʋə
firti	fiɐ̯tˢi
fisk	fesɡ̊
fiske	fesɡ̊ə
fiskehandler	fesɡ̊əhanlɐ
fiskehandler	fesɡ̊əhanˀlɐ
fiskeolie	fesɡ̊əoljə
fisker	fesɡ̊ɐ
fiskerbåd	fesɡ̊ɐb̥ɔðˀ
fiskerbåd	fesɡ̊ɐb̥ɔːˀð
fiskestang	fesɡ̊əsd̥ɑŋˀ
fisse	fisə
fjeder	fjeðˀɐ
fjeld	fjɛlˀ
fjende	fjenə
fjende	fjɛnə
fjendskab	fjensɡ̊æˀb̥
fjendskab	fjɛnsɡ̊æˀb̥
fjendtlig	fjend̥li
fjendtlig	fjɛnd̥li
fjer	fjeɐ̯ˀ
fjer	fjeˀɐ̯
fjerde	fjeːɐ
fjerde	fjɛːɐ
fjerdedel	fjeːɐd̥eˀl
fjerdedel	fjɛːɐd̥eˀl
fjern	fjæɐ̯ˀn
fjert	fjæɐ̯ˀd̥
fjols	fjʌlˀs
fjor	fjoɐ̯ˀ
fjor	fjoˀɐ̯
fjord	fjoɐ̯ˀ
fjorten	fjoɐ̯d̥n̩
fjært	fjæɐ̯ˀd̥
fjæs	fj̊ɛˀs
flad	flæˀð
fladt	flad̥
flage	flæːjə
flagermus	flɑwɐmuːˀs
flakon	flakʰʌŋ
flamboyant	flɑmb̥oɐ̯janˀd̥
flamboyant	flɑmb̥oɑjanˀd̥
flammekaster	flɑməkasdʌ
flange	flɑŋɕɘ
flanør	flanøːˀɐ̯
flaske	fl̥asɡ̊ə
flaskehals	fl̥asɡ̊əhalˀs
flaskepost	flasɡ̊əpʰʌsd̥
flere	fleːɐ
flertal	fleɐ̯tˢal
flertals	fleɐ̯tˢals
flest	fleˀsd̥
flette	flɛd̥ə
flimmerkasse	flemˀɐkʰasə
flimre	flemʁɐ
flink	fleŋˀɡ̊
flov	flɒwˀ
flue	fluːu
flue	fluːə
flueknepperi	fl̥uːəkʰneb̥ɐʁiːˀ
flueknepperi	fl̥uːəkʰnɛb̥ɐʁiːˀ
fluepapir	fluːəpʰapʰiɐ̯ˀ
fluesmækker	fluːsmɛɡ̊ɐ
flugt	flɔɡ̊d̥
fluks	flɔɡ̊s
fluor	fluːɐ
fluorescens	fluɐəsɛnˀs
fluorescens	fluɐɛsɛnˀs
fly	flyˀ
flyde	flyðð̩
flydende	flyːðənə
flyder	flyðˀɐ
flyder	flyˀðɐ
flyder	flyːðɐ
flydt	flyd̥
flygel	flyːˀəl
flygte	fløɡ̊d̥ə
flygtning	fløɡ̊d̥neŋ
flygtning	fløɡ̊neŋ
flynder	flønɐ
flytte	flød̥ə
flyve	fl̥yːʊ
flyve	fl̥yːʋə
flyvemaskine	flyːʊ̯masɡ̊iːnə
flyver	flywˀɐ
flyver	flyˀʋɐ
flyver	flyːwɐ
flyver	flyːʋɐ
flyvestation	flyːʊsd̥aɕoˀn
flyvning	flywneŋ
flå	flɔˀ
flåde	flɔðð̩
flæsk	fl̥ɛsɡ̊
flæskesteg	fl̥ɛsɡ̊əsd̥ɑjˀ
flæskesvær	flɛsɡ̊əsʋɛɐ̯ˀ
flød	fløðˀ
flød	fløˀð
fløde	fløðð̩
flødede	fløðð̩ð̩
flødeis	fløːðəiːˀs
flødeskum	fløðð̩sɡ̊ɔmˀ
flødet	fløðð̩d̥
fløjl	flʌjˀl
fløjte	fl̥ʌjd̥ə
fod	foðˀ
fod	foˀð
fodbold	foðb̥ʌlˀd
fodboldspiller	foðb̥ʌlsb̥elɐ
fodgænger	foðɡ̊ɛŋɐ
fodkold	foðkʰʌlˀ
fodring	foðɹeŋ
fold	fʌlˀ
folde	fʌlə
folk	fɔwɡ̊
folk	fʌlˀɡ̊
folkedragt	fʌlɡ̊əd̥ʁɑɡ̊d̥
folketing	fʌlɡ̊ətˢeŋˀ
folketinget	fʌlɡ̊ətˢeŋˀəð
folklore	fʌlkʰloːɐ
folklore	fʌlɡ̊loːɐ
fond	fʌnˀd̥
fond	fʌŋ
fonetisk	foneːˀd̥isɡ̊
for	foɐ̯ˀ
for	foˀɐ̯
for	fʌ
foragt	fʌɑɡ̊d̥
foranderlig	fʌɑnˀɐli
forandre	fʌɑnˀd̥ʁɐ
foranstalte	fʌansdalˀdə
foranstaltning	fʌansdalˀdneŋ
forbud	fɒːb̥uð
forbuden	fɒb̥uðˀən
forbuden	fɒb̥uˀðən
forbudne	fɒb̥uðˀnə
forbudt	fɒb̥ud̥
forbudte	fɒb̥ud̥ə
forbyd	fɒb̥yðˀ
forbyd	fɒb̥yˀð
forbyde	fɒb̥yðˀə
forbyde	fɒb̥yˀðə
forbyden	fɒb̥yðˀən
forbyden	fɒb̥yˀðən
forbydende	fɒb̥yðˀənə
forbydende	fɒb̥yˀðənə
forbyder	fɒb̥yðˀɐ
forbyder	fɒb̥yˀðɐ
forbydes	fɒb̥yðˀəs
forbydes	fɒb̥yˀðəs
forbød	fɒb̥øðˀ
forbød	fɒb̥øˀð
forbødes	fɒb̥øðˀəs
forbødes	fɒb̥øˀðəs
fordel	foɐ̯d̥eːˀl
fordele	foɐ̯d̥eːlə
fordele	foɐ̯d̥eːˀlə
fordi	fʌd̥iˀ
fordøje	fʌdʌjˀə
foregangsmand	fɒːɒɡ̊ɑŋsmanˀ
forekomme	fɒːɒkʰʌmə
forelske	fɒɛlsɡ̊ə
forelsket	fɒɛlsɡ̊əð
forelægge	fɒːɒlɛɡ̊ə
foretrække	fɒːɒtˢʁ̥aɡ̊ə
forfatte	fɒfad̥ə
forfatter	fɒfad̥ɐ
forfængelig	fʌfɛŋˀŋ̩li
forglemme	fɒɡ̊lɛmˀə
forglemmigej	fɒɡ̊lɛmˀiɑjˀ
forglemmigej	fɒɡ̊lɛmˀmɑɑjˀ
forgårs	fɒːɡ̊ɒːˀs
forgæves	fʌɡ̊ɛːˀvəs
forholdsord	fɒːhʌlsoɐ̯ˀ
forhud	fɒːhuðˀ
forhåbentlig	fʌhɔˀb̥m̩li
forhåbentlig	fʌhɔˀb̥ənd̥li
forhøje	fʌhʌjˀə
forhøjelse	fʌhʌjˀəlsə
forjætte	fʌjɛd̥ə
forjættede	fʌjɛd̥ð̩ð̩
forjætter	fʌjɛd̥ɐ
forjættet	fʌjɛd̥ð̩
fork	fɒːɡ̊
forkert	fʌkʰeɐ̯ˀd̥
forkortelse	fʌkʰɒːd̥l̩sə
forlag	fɒːlæˀ
forlag	fɒːlæˀj
forlange	fʌlɑŋˀə
forleden	fʌleðˀn̩
forleden	fʌleˀðən
forlide	fʌliðˀə
forlide	fʌliˀðə
forlig	fʌliˀ
forlige	fʌliˀi
forligede	fʌliðˀð̩ð̩
forligede	fʌliˀð̩ð̩
forligelig	fʌliˀili
forliget	fʌliðˀð̩
forliget	fʌliˀð̩
forligs	fʌliˀs
forlis	fʌliˀs
forlise	fʌliˀsə
forloren	fʌloːˀɐn
forlyd	fɒːlyðˀ
forlyd	fʌlyðˀ
forlyde	fɒːlyðð̩
forlyde	fʌlyðˀð̩
forlyden	fɒːlyðˀn̩
forlyste	fʌløsd̥ə
forlystelse	fʌløsd̥l̩sə
forlæg	fɒːlɛˀɡ̊
forlæg	fʌlɛɡ̊
forlægge	fʌlɛɡ̊ə
form	fɒːˀm
forme	fɒːmə
former	fɒːmɐ
former	fʌmeɐ̯ˀ
formiddag	fɒːmed̥a
formiddag	fɒːmed̥æːˀ
formode	fʌmoðˀð̩
formode	fʌmoˀð̩
formue	fɒːmuːə
formular	fɒmulɑːˀ
formå	fʌmɔˀ
formåen	fʌmɔˀən
fornem	fɒːnɛmˀ
fornem	fʌnɛmˀ
fornemme	fɒːnɛmˀə
fornemme	fʌnɛmˀə
fornuft	fʌnɔfd̥
forord	fɒːoˀɐ̯
forrest	fɒːˀɒsd̥
forresten	fʌʁasd̥n̩
forresten	fʌʁɑsd̥n̩
forråd	fɒːʁɔðˀ
forråd	fɒːʁɔˀð
forråd	fʌʁɔˀð
forråde	fʌʁɔˀðə
forråden	fʌʁɔˀðən
forrådende	fʌʁɔˀð̩nə
forråder	fʌʁɔˀðɐ
forrådes	fʌʁɔˀðəs
forrådt	fʌʁɔˀd̥
forrådte	fʌʁɔˀd̥ə
forrådtes	fʌʁɔˀd̥əs
forræder	fʌʁaðˀɐ
forræder	fʌʁɛðˀɐ
forræderi	fʌʁaðɐʁiˀ
forræderi	fʌʁɛðɐʁiˀ
forsigtig	fɒseɡ̊d̥i
forsker	fɒːsɡ̊ɐ
forskertse	fʌsɡ̊aɐ̯d̥sə
forskrække	fʌsɡ̊ʁaɡ̊ə
forsoning	fʌsoˀneŋ
forstand	fʌsd̥anˀ
forstå	fʌsd̥ɔˀ
forstår	fʌsd̥ɔɐ̯ˀ
forstørre	fʌsd̥ɶɐ̯ˀɐ
forstørre	fʌsd̥ɶˀɐ
forstørrelse	fʌsd̥ɶɐ̯ˀɐleə
forstørrelse	fʌsd̥ɶˀɐlsə
forsvinde	fʌsvenˀə
forsøde	fʌsøːˀðə
forsøge	fʌsøːˀjə
forsøgt	fʌsøɡ̊d̥
forsømme	fʌsœmˀə
forsørge	fʌsɶwˀə
forsørge	fʌsɶɐ̯ˀwə
forsørger	fɒsɶwˀɐ
forsørger	fɒsɶɐ̯ˀwɐ
fortalt	fʌtˢalˀd̥
fortalte	fʌtˢalˀd̥ə
fortaltes	fʌtˢalˀd̥əs
forte	fɒːd̥ə
fortolke	fʌtˢʌlˀɡ̊ə
fortolkning	fʌtˢʌlˀɡ̊neŋ
fortov	fɒːtˢɒw
fortov	fɒːtˢɔw
fortryde	fʌtˢʁ̥yðˀə
fortryde	fʌtˢʁ̥yˀðə
fortrække	fʌtˢʁ̥aɡ̊ə
fortsat	fɒːd̥sad̥
fortsat	fɒːsad̥
fortsatte	fɒːd̥sad̥ə
fortsatte	fɒːsad̥ə
fortsætte	fɒːd̥sɛd̥ə
fortsætte	fɒːsɛd̥ə
fortælle	fʌtˢɛlˀə
fortæller	fʌtˢɛlˀɐ
forudse	fɒuðseˀ
forudsige	fɒuðsiˀɘ
forulykke	fɒuløɡ̊ə
forvente	fʌʋɛnˀd̥ə
forår	fɒːɒˀ
forårsage	fɒɒsæːˀjə
forårsagtig	fɒːɒsɑɡ̊d̥i
forårsrulle	fɒːɒsʁulə
forældelse	fʌɛlˀəlsə
fosfor	fʌsfɒ
fosforescere	fʌsfʌəseːˀɐ
foto	fod̥o
fotograf	fod̥oɡ̊ʁɒːˀf
fotograf	fotˢoɡ̊ʁɒːˀf
fotografer	fod̥oɡ̊ʁɑfeɐ̯ˀ
fotografer	fod̥oɡ̊ʁɑːˀfɐ
fotografer	fotˢoɡ̊ʁɑfeɐ̯ˀ
fotografer	fotˢoɡ̊ʁɑːˀfɐ
fotosyntese	fotˢosyntˢeːsə
fra	fʁ̥ɑ
fragt	fʁɑɡ̊d̥
franker	fʁɑŋˀkʰisɡ̊
franker	fʁɑŋˀɡ̊ɐ
frankisk	fʁɑŋˀkʰisɡ̊
frankisk	fʁɑŋˀɡ̊isɡ̊
frankrig	fʁɑŋkʰʁ̥i
fransk	fʁɑnˀsɡ̊
franskbrød	fʁɑnsb̥ʁœðˀ
fred	fʁ̥æð
fred	fʁ̥æðˀ
fred	fʁ̥æˀð
fredag	fʁæˀd̥a
frede	fʁ̥æðð̩
fredelig	fʁ̥æːðəli
freden	fʁ̥æðn̩
freden	fʁ̥æðˀn̩
freden	fʁ̥æˀðn̩
frelse	fʁalsə
frelse	fʁɑlsə
frelser	fʁalsɐ
frelser	fʁalˀsɐ
frelser	fʁɑlsɐ
frelser	fʁɑlˀsɐ
frelst	fʁalsd̥
frelst	fʁɑlsd̥
frelste	fʁalsd̥ə
frelste	fʁalˀsd̥ə
frelste	fʁɑlsd̥ə
frelste	fʁɑlˀsd̥ə
frem	fʁamˀ
frem	fʁɑmˀ
fremmed	fʁamð̩
fremmed	fʁɑmð̩
fremmede	fʁaməðə
fremmede	fʁɑməðə
fremmedfjendtlig	framəðfjenˀd̥li
fremmedfjendtlig	frɑməðfjɛnˀd̥li
fremmedlegeme	fʁamð̩lɛːɪmə
fremmedlegeme	fʁɑmð̩lɛːmə
fremragende	fʁamʁɑˀwn̩nə
fremragende	fʁɑmʁɑwˀn̩nə
fri	fʁitʃː
fri	fʁiːˀ
frihed	fʁiheðˀ
frikadelle	fʁiɡ̊ad̥ɛlə
frikadelle	fʁæɡ̊əd̥ɛlə
frikadeller	fʁiɡ̊əd̥ɛlɐ
frikvarter	fʁiɡ̊ʋɑtˢeɐ̯ˀ
frikvarter	fʁɛɡ̊ʋɑtˢeɐ̯ˀ
frimurer	fʁimuːɐ
frisisk	fʁiːˀsisɡ̊
frisk	fʁæsɡ̊
frist	fʁɛsd̥
friste	fʁɛsd̥ə
fristelse	fʁɛsd̥ɭ̩sə
fritstående	fʁ̥id̥sd̥ɔːˀənə
frivillig	fʁ̥iʋilˀi
fro	fʁ̥oˀ
frokost	fʁ̥ɔɡ̊ʌsd
from	fʁ̥ʌmˀ
frosne	fʁ̥ɔsnə
frosne	fʁ̥ʌsnə
frossen	fʁ̥ɔsn̩
frossen	fʁ̥ʌsn̩
frossent	fʁ̥ɔsn̩d̥
frossent	fʁ̥ʌsn̩d̥
frosset	fʁ̥ɔsð̩
frosset	fʁ̥ʌsð̩
frost	fʁ̥ʌsd̥
fru	fʁ̥o
fru	fʁ̥u
frue	fʁ̥oːo
frue	fʁ̥uːu
frugt	fʁ̥ɔɡ̊d̥
frugtbar	fʁ̥ʌɡ̊d̥b̥ɑːˀ
fryd	fʁ̥yðˀ
fryd	fʁ̥yˀð
frygt	fʁ̥œɡ̊d̥
frygte	fʁ̥œɡ̊d̥ə
frygtelig	frœɡ̊d̥li
frygtelig	frœɡ̊d̥əli
frygtelig	frœɡ̊li
frygtsom	fʁœɡ̊d̥sʌmˀ
frys	fʁ̥yːˀs
fryse	fʁ̥yːsə
fryser	fʁ̥yˀsɐ
fryser	fʁ̥yːsɐ
fråse	fʁ̥ɔːsə
frænde	fʁanə
frænde	fʁɑnə
frænke	fʁaŋɡ̊ə
frø	fʁ̥œːˀ
frøken	fʁ̥œɡ̊ŋ̩
frøken	fʁ̥œˀɡ̊ŋ̩
frømand	fʁ̥œ̞manˀ
frøs	fʁ̥œˀs
fuchsia	fɔɡ̊ɕa
fuchsier	fɔɡ̊ɕʌ
fugl	fou̯ːˀl
fugl	fuu̯ːˀl
fugl	fuˀl
fugl	føʉ̯ːl
fugl	fɑʊ̯ːl
fugl	fɔu̯ːl
fugl	fɔu̯ːˀl
fugl	fɛu̯ːˀl
fugle	fuːlə
fugt	fɔɡ̊d̥
fugte	fɔɡ̊d̥ə
fugtig	fɔɡ̊d̥i
ful	fuˀl
fuld	fulˀ
fuldkommen	fulkʰʌmˀən
fuldmagt	fulmɑɡ̊d̥
fuldstændig	fulsd̥ɛnˀd̥i
fuldtallig	fultˢalˀi
fulgt	fulˀd̥
fulgte	fuld̥ə
fulgte	fulˀd̥ə
fund	fɔnˀ
fundamental	fɔnd̥aməntˢæːˀl
fundamentalisme	fɔnd̥aməntˢalismə
fundere	fɔnd̥eːˀɐ
funktionel	fɔŋɕonɛlˀ
furie	fuɐ̯ˀɪ̯ə
furore	fuʁoːɐ
fyld	fylˀ
fylde	fylə
fyn	fyːˀn
fyr	fyɐ̯
fyr	fyɐ̯ˀ
fyraften	fyɐ̯ɑfd̥n̩
fyre	fyːɐ
fyrre	fyɐ̯ɐ
fyrre	fyːɐ
fyrre	fɶɐ̯ɐ
fyrretyve	fɶɐ̯ɐtˢyːʋə
fyrste	fyɐ̯sd̥ə
fyrstedømme	fyɐ̯sd̥əd̥œmə
fyrstendømme	fyɐ̯sd̥n̩d̥œmə
fysik	fysiɡ̊
fysisk	fyˀsisɡ̊
få	fɔˀ
fåfængt	fɔˀfɛŋˀd̥
får	fɒˀ
fårehund	fɒːɒhunˀ
fæ	fɛˀ
fæces	fɛːsəs
fædre	fɛðʁɐ
fædreland	fɛðʁɐlanˀ
fædrene	fɛðɐnə
fædrene	fɛðʁɐnə
fæl	fɛːˀl
fælde	fɛlə
fælle	fɛlə
fælled	fɛlð̩
fælles	fɛlˀəs
fællesskab	fɛlˀəssɡ̊æˀb̥
fællig	fɛli
fængsel	fɛŋˀsl̩
fængsle	fɛŋslə
fængsler	fɛŋslɐ
fængsler	fɛŋˀslɐ
fængslet	fɛŋsləð
fængslet	fɛŋˀsləð
færd	fɛɐ̯ˀ
færd	fɛˀɐ̯
færden	faɐ̯d̥n̩
færden	fɛˀɐn
færdes	faɐ̯d̥əs
færdsel	faɐ̯sl̩
færdsel	faɐ̯ˀsl̩
færg	faɐ̯ˀw
færge	faɐ̯wə
færge	faɐ̯ʊ
færgen	faɐ̯wən
færgen	faɐ̯ʊn
færger	faɐ̯wɐ
færing	fɛːɐ̯eŋ
færre	faɐ̯ɐ
færrest	faɐ̯ɐsd̥
færreste	faɐ̯ɐsd̥ə
færøerne	fɛɐ̯øːˀɐnə
færøsk	fɛɐ̯øːˀsɡ̊
fæste	fɛsd̥ə
fæstebonde	fɛsd̥əb̥ɔnə
fætter	fɛd̥ɐ
fødder	føðˀɐ
fødderne	føðˀɐnə
føddernes	føðˀɐnəs
fødders	føðˀɐs
føde	føːðə
fødsel	føsl̩
fødselsdag	føsl̩sd̥æˀ
født	føˀd̥
fødte	føˀd̥ə
fødte	føːd̥ə
føje	fʌɪ
føjning	fʌjneŋ
føl	føl
føl	føˀl
føle	føːlə
følelse	føːləlsə
følelse	føːl̩sə
føler	føˀlɐ
føler	føːlɐ
følge	føljə
følge	følə
følger	føljɐ
følger	følɐ
føllet	følˀð̩
følsom	føːlsʌmˀ
følt	føˀld̥
følte	føˀld̥ə
følte	føːld̥ə
føn	føːˀn
føniks	føːniɡ̊s
før	føɐ̯ˀ
før	fœ̞ɐ̯
før	fœ̞ɐ̯ˀ
føre	føːɐ
fører	føːɐ
først	fɶsd̥
først	fɶɐ̯sd̥
første	fɶsd̥ə
første	fɶɐ̯sd̥ə
ført	føɐ̯ˀd̥
førte	føɐ̯d̥ə
førte	føɐ̯ˀd̥ə
gad	ɡ̊æðˀ
gad	ɡ̊æˀð
gade	ɡ̊æːðə
gadekøkken	ɡ̊æːðəkʰøɡ̊ən
gadekøkken	ɡ̊æːð̩kʰøɡ̊n̩
gaffel	ɡ̊ɑfəl
gak	ɡ̊ɑɡ̊
gal	ɡ̊æˀl
galde	ɡ̊alə
gale	ɡ̊æːlə
galehus	ɡ̊æːləhuːˀs
galge	ɡ̊aljə
galgenhumor	ɡ̊aljənhuːmɒ
gallien	ɡ̊alˀjən
galoche	ɡ̊alʌɕə
galop	ɡ̊alʌb̥
galoper	ɡ̊alopʰeɐ̯ˀ
galopere	ɡ̊alopʰeːɐ
gamache	ɡ̊amaɕə
gamer	ɡ̊ɛjmʌ
gammel	ɡ̊ɑml̩
gammeldansk	ɡ̊ɑml̩d̥anˀsɡ̊
gammen	ɡ̊ɑmən
gang	ɡoŋˀ
gang	ɡɑ̃
gang	ɡɑ̃ɪ̃ˀ
gang	ɡɑ̃ʊ̃
gang	ɡɑ̃ˀ
gang	ɡɔŋˀ
gang	ɡɔɲ
gang	ɡ̊ɑŋˀ
gangræn	ɡ̊ɑŋɡ̊ʁæːˀn
gardin	ɡ̊ɑd̥iːˀn
garn	ɡ̊ɑːˀn
gasturbine	ɡ̊astˢuɐ̯b̥iːnə
gav	ɡ̊æwˀ
gav	ɡ̊æˀ
gav	ɡ̊æˀw
gave	ɡ̊æːʊ
gave	ɡ̊æːʋə
gaves	ɡ̊æːʊs
gaves	ɡ̊æːʋəs
gavmild	ɡɑwmilˀ
gavn	ɡ̊ɑwˀn
gavne	ɡ̊ɑwnə
gavnet	ɡ̊ɑwnəð
gavnet	ɡ̊ɑwnˀəð
gavnlig	ɡ̊ɑwnli
gebrokken	ɡ̊eb̥ʁʌɡ̊ŋ̩
gebrokkent	ɡ̊eb̥ʁʌɡ̊ŋ̩d̥
gebrokne	ɡ̊eb̥ʁʌɡ̊nə
gebyr	ɡ̊eb̥yɐ̯ˀ
gebærde	ɡ̊eb̥æɐ̯d̥ə
gebærde	ɡ̊eb̥æɐ̯ˀd̥ə
gebærde	ɡ̊eb̥ɛɐ̯ˀd̥ə
ged	ɡ̊eðˀ
ged	ɡ̊eːˀð
gedder	ɡ̊eðɐ
geder	ɡ̊eːðɐ
geek	ɡ̊iːɡ̊
gejst	ɡ̊ɑjˀsd̥
gejstlig	ɡ̊ɑjsd̥li
gejstlig	ɡ̊ɑjsli
gejstlige	ɡ̊ɑjsd̥lii
gejstligt	ɡ̊ɑjsd̥lid̥
gele	ɕele
geled	ɡ̊eleð
geleddet	ɡ̊eleðˀð̩
gelé	ɕele
gemen	ɡ̊emeˀn
gemme	ɡ̊ɛmə
gemmer	ɡ̊ɛmɐ
gemmested	ɡ̊ɛməsd̥ɛð
gemt	ɡ̊ɛmˀd̥
gemte	ɡ̊ɛmd̥ə
gemte	ɡ̊ɛmˀd̥ə
genbrug	ɡ̊ɛnb̥ʁuːˀ
gene	ɕeːnə
gener	ɕeseɐ̯ˀ
gener	ɕeːnɐ
gener	ɡ̊eˀnɐ
genere	ɕeneˀɐ
generer	ɕeneˀɐ
generer	ɡ̊enəʁæɐ̯ˀ
generere	ɡ̊enəʁæˀɐ
genert	ɕeneɐ̯ˀd̥
gengive	ɡɛnɡiˀ
gengæld	ɡ̊ɛnɡ̊ɛlˀ
gengælde	ɡ̊ɛnɡ̊ɛlˀə
genlæse	ɡ̊ɛnlɛːˀsə
gennem	iɡ̊ɛmˀm̩
gennem	ɡ̊ɛmˀm̩
genre	ɕɑŋʁɐ
gensidig	ɡ̊ɛnsiðˀi
genstand	ɡ̊ɛnsd̥anˀ
genus	ɡ̊eːnus
geometri	ɡ̊eomətˢʁ̥iːˀ
germansk	ɡ̊aɐ̯mæˀnsɡ̊
gerne	ɡæɐ̯nə
gerningssted	ɡ̊æɐ̯neŋssd̥ɛð
gestus	ɡ̊ɛsd̥us
gevaldig	ɡ̊evalˀd̥iɡ
gevinst	ɡ̊evenˀsd̥
geværild	ɡ̊eʋɛˀɐ̯ilˀ
gid	ɡ̊iðˀ
gide	ɡ̊iːðə
gider	ɡ̊iðˀɐ
gidet	ɡ̊iːðəd̥
gift	ɡ̊ifd̥
gifte	ɡ̊ifd̥ə
giftig	ɡ̊ifd̥i
gigt	ɡiɡd
gilde	ɡ̊ilə
giraf	ɡ̊iʁɑf
giro	ɕiːo
giv	ɡ̊i
giv	ɡ̊iːˀ
give	ɡ̊i
give	ɡ̊iˀ
give	ɡ̊iːʋə
given	ɡ̊iːʊn
given	ɡ̊iːʋən
givende	ɡ̊iːʊnə
givende	ɡ̊iːʋənə
givent	ɡ̊iːʊnd̥
givent	ɡ̊iːʋənd̥
giver	ɡ̊iwˀɐ
giver	ɡ̊iɐ̯ˀ
giver	ɡ̊iˀʋɐ
giver	ɡ̊iːwɐ
giver	ɡ̊iːʋɐ
gives	ɡ̊iˀs
gives	ɡ̊iːʊs
gives	ɡ̊iːʋəs
givet	ɡ̊iːwð̩
givet	ɡ̊iːð̩
givet	ɡ̊iːʋəð
givne	ɡ̊iwnə
gjalde	ɡ̊jalə
gjord	ɡ̊joɐ̯ˀ
gjord	ɡ̊joɐ̯ˀd̥
gjord	ɡ̊joˀɒ̯
gjorde	ɡ̊joɐ̯d̥ə
gjorde	ɡ̊joːɐ
gjort	ɡ̊joɐ̯ˀd̥
glad	ɡ̊læð
glamour	ɡ̊lamuːɐ̯
glamour	ɡ̊lamɒ
glansbillede	ɡ̊lanˀsb̥eləðə
glansbillede	ɡ̊lanˀsb̥eləð̩
glemte	ɡ̊lɛmd̥ə
glemte	ɡ̊lɛmˀd̥ə
glimt	ɡ̊lemˀd̥
glo	ɡ̊loːˀ
globe	ɡ̊loːb̥ə
globus	ɡ̊loːb̥us
glæde	ɡ̊lɛːðə
glædelig	ɡ̊lɛːðəli
gløgg	ɡ̊løɡ̊
gløgg	ɡ̊lœɡ̊
gnaver	ɡ̊næːvɐ
gnide	ɡ̊niːðɘ
gnide	ɡ̊niːð̩
gnist	ɡ̊nisd̥
gnom	ɡ̊noːˀm
gnosticisme	ɡ̊nʌsd̥isismə
gnu	ɡ̊nuːˀ
go'	ɡ̊oːˀ
god	ɡ̊oðˀ
god	ɡ̊oˀ
god	ɡ̊oˀð
godaften	ɡoɑfd̥ən
godbid	ɡ̊oðb̥iðˀ
goddag	ɡ̊od̥æˀ
goddag	ɡ̊od̥ɑwˀ
gode	ɡ̊oːo
gode	ɡ̊oːðə
godmorgen	ɡ̊omɒːɒn
godnat	ɡonɑd̥
gods	ɡ̊ɔs
godt	ɡ̊ʌd̥
godthåb	ɡ̊ʌd̥hɔːˀb̥
gold	ɡ̊ʌlˀ
gotisk	ɡ̊oˀtˢisɡ̊
grad	ɡ̊ʁɑðˀ
grafit	ɡ̊ʁɑfid̥
gram	ɡ̊ʁɑmˀ
grammatik	ɡ̊ʁɑmatˢiɡ̊
grammatiker	ɡ̊ʁɑmatˢiɡ̊ɐ
grape	ɡ̊ɹɛjb̥
grape	ɡ̊ʁɛjb̥
gratis	ɡ̊ʁɑːd̥is
grav	ɡ̊ʁɑwˀ
grave	ɡ̊ʁɑːvə
gravid	ɡ̊ʁɑviðˀ
gravsten	ɡ̊ʁɑwsd̥eːˀn
gregoriansk	ɡ̊ʁɛɡ̊oɐ̯iæːˀnsɡ̊
gregoriansk	ɡ̊ʁɛɡ̊ɒɐ̯iæːˀnsɡ̊
grej	ɡ̊ʁɑjˀ
greje	ɡ̊ʁɑːɪ
grejer	ɡ̊ʁɑjɐ
grejerne	ɡ̊ʁɑjɐnə
grejernes	ɡ̊ʁɑjɐnəs
grejers	ɡ̊ʁɑjɐs
grejet	ɡ̊ʁɑjˀð̩
grejet	ɡ̊ʁɑðˀð̩
grejets	ɡ̊ʁɑjˀð̩s
grejets	ɡ̊ʁɑðˀð̩s
grejs	ɡ̊ʁɑjˀs
grel	ɡ̊ʁalˀ
gren	ɡ̊ʁæˀn
grene	ɡ̊ʁæːnə
grev	ɡ̊ʁæʊ
greve	ɡ̊ʁæːʊ
greve	ɡ̊ʁæːʋə
grim	ɡ̊ʁɛmˀ
grimassere	ɡ̊ʁimaseːˀɐ
grin	ɡ̊ʁiːˀn
grine	ɡ̊ʁiːnə
grine	ɡ̊ʁiːn̩
grinen	ɡ̊ʁiːnə
grinen	ɡ̊ʁiːn̩
gris	ɡ̊ʁis
gris	ɡ̊ʁiˀs
grise	ɡ̊ʁisə
grise	ɡ̊ʁiːsə
grisede	ɡ̊ʁisəðə
griser	ɡ̊ʁisɐ
griset	ɡ̊ʁisəð
grotte	ɡ̊ʁʌd̥ə
grov	ɡ̊ʁɒwˀ
gru	ɡ̊ʁuːˀ
grube	ɡ̊ʁuːb̥ə
grund	ɡ̊ʁɔnˀ
grundlag	ɡ̊ʁɔnlæj
grundlov	ɡ̊ʁɔnlɒw
grundlovsdag	ɡ̊ʁɔnlɒwsdæːˀ
gruppe	ɡ̊ʁub̥ə
grupperabat	ɡ̊ʁub̥əʁɑb̥ɑd̥
grus	ɡ̊ʁuːˀs
grusom	ɡ̊ʁuːsʌmˀ
gryn	ɡ̊ʁyːˀn
grynt	ɡ̊ʁœ̞nˀd̥
gryr	ɡ̊ʁyɐ̯ˀ
gråd	ɡ̊ʁɔðˀ
gråd	ɡ̊ʁɔˀð
grådig	ɡ̊ʁɔːði
gråne	ɡ̊ʁɔːnə
græd	ɡ̊ʁaˀð
græd	ɡ̊ʁɑðˀ
græde	ɡ̊ʁaðð̩
græde	ɡ̊ʁɑðð̩
græder	ɡ̊ʁaˀðɐ
græder	ɡ̊ʁɑðˀɐ
grædt	ɡ̊ʁad̥
grædt	ɡ̊ʁɑd̥
grækenland	ɡ̊ʁɛˀɡ̊ŋ̩lanˀ
grænse	ɡ̊ʁansə
grænse	ɡ̊ʁɑnsə
græshoppe	ɡ̊ʁashʌb̥ə
græsk	ɡ̊ʁasɡ̊
græsk	ɡ̊ʁɑsɡ̊
græskar	ɡ̊ʁaskʰɑ
græskar	ɡ̊ʁɑskʰɑ
grævling	ɡ̊ʁawleŋ
grævling	ɡ̊ʁɛwleŋ
grød	ɡ̊ʁœðˠˀ
grøft	ɡ̊ʁœfd̥
grøn	ɡ̊ʁɶnˀ
grønland	ɡ̊ʁɶnlanˀ
grønlandsk	ɡ̊ʁɶnlanˀsɡ̊
grønlænder	ɡ̊ʁɶnlɛnˀɐ
grønsvær	ɡ̊ʁɶnsʋɛɐ̯ˀ
grønt	ɡ̊ʁɶnˀd̥
grøntsag	ɡ̊ʁɶnsæˀ
gud	ɡ̊uð
gudbarn	ɡ̊uðb̥ɑːˀn
guddom	ɡ̊uðd̥ʌmˀ
guddommelig	ɡ̊uðd̥ʌmˀəli
gudenå	ɡ̊uðˀn̩ɔˀ
gudenåen	ɡ̊uðˀn̩ɔˀn̩
gudløs	ɡ̊uðløːˀs
gudskelov	ɡ̊usɡ̊əlɒw
gudskelov	ɡ̊uðsɡ̊əlɒw
guirlande	ɡ̊iɐ̯land̥ə
guitar	ɡ̊itˢɑːˀ
guitarist	ɡ̊itˢɑʁisd̥
gul	ɡ̊uːˀl
guld	ɡ̊ul
guldet	ɡ̊ulˀəð
guldfisk	ɡ̊ulfesɡ̊
guldsmed	ɡ̊ulsmeð
guldur	ɡ̊uluɐ̯ˀ
gule	ɡ̊uːl̩
gulerod	ɡ̊uləʁoðˀ
gulerod	ɡ̊uləʁoˀð
gulerød	ɡ̊uləʁœðˀ
gulv	ɡ̊ɔl
gulve	ɡ̊ɔlvə
gulvene	ɡ̊ɔlnə
gulvene	ɡ̊ɔlvənə
gulvenes	ɡ̊ɔlnəs
gulvenes	ɡ̊ɔlvənəs
gulvet	ɡ̊ɔlˀvəð
gulvet	ɡ̊ɔlˀəð
gummi	ɡ̊ɔmi
gut	ɡ̊ud̥
guvernørpost	ɡ̊uʋɐnøːˀɐ̯pʰʌsd̥
gyd	ɡ̊yðˀ
gyde	ɡ̊yːðə
gylden	ɡ̊ylˀən
gylle	ɡ̊ylə
gymnasium	ɡ̊ymnæːˀɕɔm
gynækologi	ɡ̊ynɛkoloɡ̊iːˀ
gå	ɡ̊ɔˀ
går	ɡ̊ɒːˀ
gård	ɡ̊ɒˀ
gårsdag	ɡ̊ɑːsd̥æːˀ
gårsdag	ɡ̊ɑːˀsd̥æːˀ
gås	ɡ̊ɔˀs
gåsen	ɡ̊ɔˀsən
gåsepotentil	ɡ̊ɔːsəpʰotˢəntˢilˀ
gåsepotentil	ɡ̊ɔːsəpʰotˢəntˢiːˀl
gåseøjne	ɡ̊ɔːsəʌjnə
gæld	ɡ̊ɛlˀ
gælde	ɡ̊ɛlə
gælle	ɡ̊ɛlə
gænger	ɡ̊ɛŋɐ
gær	ɡ̊ɛːˀɐ̯
gærdesmutte	ɡ̊ɛːɐsmud̥ə
gæs	ɡ̊ɛs
gæst	ɡ̊ɛsd̥
gæv	ɡ̊ɛwˀ
gæv	ɡ̊ɛˀw
gø	ɡ̊øːˀ
gød	ɡ̊øðˀ
gøde	ɡ̊øːðə
gøgle	ɡ̊ʌjlə
gøgler	ɡ̊ʌjlɐ
gør	ɡ̊ø̞ɐ̯ˀ
gør	ɡ̊ø̞ˀɐ̯
gør	ɡ̊ɶɐ̯
gøre	ɡ̊ɶːɐ
gøteborg	ɡøːd̥əbɒwˀ
ha	ha
ha	hɑ
ha'	ha
hacke	haɡ̊ə
hacker	haɡ̊ɐ
hade	hæːðə
hadet	haðˀəd̥
hadet	hæːðəd̥
haft	hɑfd̥
hage	hæːjə
hagel	hæˀjl̩
hagel	hæˀl̩
hagl	hɑwˀl
haitianer	haitˢiæːˀnɐ
haitiansk	haitˢiæːˀnsɡ̊
haj	hajˀ
hal	halˀ
hal	hæːˀl
hale	hæːlə
haler	hæːlɐ
haler	hæːˀlɐ
hall	hɒːl
hallo	halɔ
hallo	halɔː
halm	halˀm
hals	halˀs
halshugge	halshɔɡ̊ə
halstørklæde	halsd̥ɐkʰl̥ɛːðə
halstørklæde	halstˢɶɐ̯kʰl̥ɛːðə
halte	haldə
halv	halˀ
halvanden	halanən
halvandet	halanð̩
halve	hall̩
halve	halvə
halvfems	halfɛmˀs
halvfemsindstyve	halfɛmˀsn̩stˢyːʋə
halvfemte	halfɛmd̥ə
halvfjerde	halfjɛːɐ
halvfjerds	halfjaɐ̯s
halvfjerdsindstyve	halfjaɐ̯sn̩stˢyːʋə
halvmåne	halmɔːnə
halvt	halˀd̥
halvtredje	haltˢʁ̥ɛðjə
halvtreds	haltˢʁ̥æs
halvtredser	haltˢʁɛsɐ
halvtredsindstyve	haltˢʁ̥æsn̩stˢyːʋə
halvtredsindstyvende	haltˢʁ̥æsn̩stˢyːʋənə
ham	hɑm
ham	hɑmˀ
hamborg	hɑmb̥ɒˀ
hammer	hɑmɐ
hamp	hɑmˀb̥
hamster	hɑmˀsd̥ɐ
hamstere	hɑmˀsd̥ɐɐ
hamsteren	hɑmˀsd̥ɐɐn
hamsterne	hɑmˀsd̥ɐnə
hamstre	hɑmsd̥ʁɐ
hamstrer	hɑmsd̥ʁɐ
hamstrere	hɑmsd̥ʁɐɐ
hamstreren	hɑmsd̥ʁɐɐn
hamstrerne	hɑmsd̥ʁɐnə
han	han
handle	hanlə
handske	ha̝nsɡ̥ə
hang	hɑŋˀ
hankat	haŋkʰad̥
hannem	hanəm
hannen	hanˀn̩
hans	hans
hans	hanˀs
hansen	hanˀsn̩
har	hɑˀ
hare	hɑːɑ
harekilling	hɑːɑkʰileŋ
harme	hɑːmə
harmoni	hɑmoniˀ
harmonika	hɑmoːˀnikʰa
harpe	hɑːb̥ə
harsk	hɑːsɡ̊
harve	hɑːwə
hash	haɕ
hat	had̥
hav	ha
hav	hɑw
havde	hæːðə
have	ha
have	hæˀ
have	hæːʊ
have	hæːʋə
havet	hæˀvəð
havet	hæˀwð̩
havfrue	hɑʊ̯fʁ̥uːə
havn	hɑʊ̯ˀn
havre	hɑwʁɐ
havørn	hɑwɶɐ̯ːˀn
hebraisk	heb̥ʁɑːˀisɡ̊
hedde	heðə
hede	heːðə
hedensk	heðˀənsɡ̊
hedensk	heːˀðənsɡ̊
hedning	heðneŋ
hejre	hɑjʁʌ
hejse	hɑjsə
hel	heˀl
held	hɛlˀ
heldig	hɛld̥i
helg	hɛlˀj
helgen	hɛljən
helgen	hɛlˀjən
helhest	hɛlhɛsd̥
heliotrop	heliotˢʁ̥oːˀb̥
helle	hɛlə
hellig	hɛli
helligdag	hɛlidæˀ
hellige	hɛlii
helliget	hɛliið
helsen	hɛlsn̩
helsinge	hɛlseŋə
helst	hɛlˀsd̥
helt	heˀld̥
helt	hɛlˀd̥
heltinde	hɛld̥enə
helvede	hɛ̝lvð̩ə
hemmelig	hɛmli
hemmelig	hɛmm̩li
hen	hɛn
hen	hɛnˀ
hende	henə
hende	hinn̩
hendes	henəs
hendes	hinn̩s
henne	hɛnn̩
henne	hɛnə
henriette	hɛnʁiɛd̥ə
hente	hɛndə
hera	heːɐ
hera	heːʁɑ
herberg	haɐ̯b̥aɐ̯w
herberg	haɐ̯b̥aɐ̯wˀ
herberg	haɐ̯b̥aɐ̯ˀw
herkomst	haɐ̯kʰʌmˀsd̥
herodot	heod̥oˀd̥
herre	haɐ̯ɐ
herske	hæɐ̯sɡ̊ə
hersker	hæɐ̯sɡ̊ɐ
herskere	hæɐ̯sɡ̊ɐɐ
herskeren	hæɐ̯sɡ̊ɐɐn
herskerne	hæɐ̯sɡ̊ɐnə
hertz	hæɐ̯d̥s
hest	hɛsd̥
hierarki	hiɑkʰiːˀ
hierarkisk	hiʁɑːˀkʰisɡ̊
hieroglyf	hioɡ̊lyf
hieroglyffen	hioɡ̊lyfn̩
hieroglyffer	hioɡ̊lyfɐ
hieroglyfferne	hioɡ̊lyfɐnə
hieroglyfs	hioɡ̊lyfs
hik	heɡ̊
hikke	heɡ̊ə
hilse	hilsə
hilsen	hilsn̩
himmel	heml̩
himmellegeme	heml̩lɛːmə
himmellegeme	heml̩lɛːɪmə
himmelstormer	heml̩sd̥ɒːmɐ
himmerige	heməʁiːə
hin	hin
hin	hiˀn
hinanden	henann̩
hinanden	hinann̩
hind	henˀ
hindbær	hemb̥æɐ̯
hindbær	henb̥æɐ̯
hindbærsnitte	henb̥æɐ̯snid̥ə
hinde	henə
hinden	henn̩
hinden	henˀn̩
hinder	henɐ
hinder	henˀd̥ɐ
hinder	henˀɐ
hindre	henˀd̥ʁɐ
hinduisme	hend̥uismə
hine	hiːnə
hingst	heŋˀsd̥
hinsides	hensiːðəs
hinsides	hinsiːðəs
hint	henˀd̥
hint	hind̥
hint	hiˀnd̥
historie	hisd̥oɐ̯ˀjə
hit	hid̥
hitte	hid̥ə
hittebarn	hid̥əb̥ɑˀn
hittegods	hid̥əɡ̊ɔs
hittegodskontor	hid̥əɡ̊ɔskontˢoɐ̯ˀ
hittegodskontor	hid̥əɡ̊ɔskɔntˢoɐ̯ˀ
hittepåsom	hid̥əpʰɔˀsʌmˀ
hjald	jalˀ
hjalp	jalˀb̥
hjelm	jɛlˀm
hjelme	jɛlmə
hjelme	jɛlˑm̩
hjem	jɛmˀ
hjemlig	jɛmli
hjemme	jɛmm̩
hjemme	jɛmə
hjemmeside	jɛməsiːðə
hjemve	jɛmveːˀ
hjerne	jæɐ̯nə
hjerte	jaɐ̯d̥ə
hjertens	jaɐ̯d̥n̩s
hjerter	jæɐ̯d̥ɐ
hjertestop	jæɐ̯d̥əsd̥ʌb̥
hjord	jɒˀd̥
hjord	jɒːd̥
hjort	jɒːd̥
hjortekød	jɒːd̥əkʰøðˠ
hjul	juːˀl
hjulpen	jɔlb̥m̩
hjulpen	jɔlb̥ən
hjulpet	jɔlb̥əð
hjulpne	jɔlb̥nə
hjælp	jɛlˀb̥
hjælpe	jɛlb̥ə
hjælpen	jɛlb̥m̩
hjælpen	jɛlb̥ən
hjælpen	jɛlˀb̥m̩
hjælpen	jɛlˀb̥ən
hjælpende	jɛlb̥ənə
hjælper	jɛlb̥ɐ
hjælper	jɛlˀb̥ɐ
hjælpes	jɛlb̥əs
hjørne	jœ̞ɐ̯nə
hob	hoˀb̥
hobe	hoːb̥ə
hoben	hoˀb̥m̩
hof	hʌf
hofmarskal	hʌfmɑːɕal
hofmarskal	hʌfmɑːɕalˀ
hofteben	hʌfd̥əb̥eːˀn
hofteholder	hʌfd̥əhʌlɐ
hold	hʌlˀ
holde	hʌlə
holden	hʌlən
holdende	hʌlnə
holdende	hʌlənə
holdent	hʌlənd̥
holder	hʌlɐ
holder	hʌlˀɐ
holdes	hʌləs
holdne	hʌlnə
holdning	hʌlneŋ
holdt	hʌlˀd̥
holdte	hʌld̥ə
holdte	hʌlˀd̥ə
holdtes	hʌld̥əs
holland	hʌlanˀ
hollandsk	hʌlanˀsɡ̊
hollænder	hʌlɛnˀɐ
homer	homeɐ̯ˀ
homer	homeˀɐ̯
homofili	homofiliːˀ
homoseksuel	hoːmosɛɡ̊suɛlˀ
honning	hʌneŋ
hop	hʌb̥
hoppe	hʌb̥ə
hor	hoɐ̯ˀ
horehus	hoːɐhuːˀs
hornhinde	hoɐ̯nhenə
horrorfilm	hɒɹɒfilm
hors	hɒːs
hos	hɔs
hospital	hosb̥itˢæːˀl
hospital	hɔsb̥itˢæːˀl
hoste	hoːsd̥ə
hoste	hɔwsd̥e
hostesaft	hoːsd̥əsɑfd̥
hotdog	hʌd̥d̥ʌɡ̊
hov	hɒw
hov	hɒwˀ
hoved	hoːð̩
hovedbanegård	hoːðb̥æːnɡ̊ɒˀ
hovedbanegård	hoːəðb̥æːnəɡ̊ɒˀ
hovedpine	hoːð̩pʰiːn̩
hovedpine	hoːəðpʰiːnə
hovedpulsåre	hoːəð̩pʰulsɑːɑ
hovedsag	hoːð̩sæˀj
hovedsagelig	hoːð̩sæˀjəli
hovedsagelig	hoːð̩sæˀli
hovedstad	hoːð̩sd̥að
hovedstæder	hoːð̩sd̥ɛːðɐ
hovedsætning	hoːð̩sɛd̥neŋ
hovedtelefon	hoðð̩tˢeləfoˀn
hovedtørklæde	hoːð̩tˢɶɐ̯kʰl̥ɛːðə
hovmod	hɒwmoðˀ
hovmod	hɒwmoˀð
hovmodig	hɒwmoðˀi
hovmodig	hɒwmoˀði
hu	huˀ
hu	huː
hud	huð
hud	huðˀ
hudfarve	hufɑːvə
hudfarve	hufɑːw̩
hudløs	huðløːˀs
hug	huɡ̊
hug	hɔɡ̊
hugge	hɔɡ̊ə
hukommelse	hukʰʌmˀɭ̩sə
hul	huˀl
hul	hɔl
hule	huːlə
hulens	huːln̩s
humor	huːmɐ
humør	humøˀɐ̯
hun	hun
hund	hunˀ
hundekold	hunəkʰʌlˀ
hunden	hunˀn̩
hundestejle	hunəsd̥ɑjlə
hundestjernen	hunəsd̥jæɐ̯nən
hundred	hunɐð
hundrede	hunɐðə
hundreder	hunɐðɐ
hunnen	hunˀn̩
hunner	hunˀɐ
hurtig	hoɐ̯d̥i
hurtig	huɐ̯d̥i
hus	huˀs
husbond	husb̥ɔn
husbond	husb̥ʌn
husbåd	husb̥ɔðˀ
husbåd	husb̥ɔːˀð
huse	huːsə
husgeråd	husɡ̊eʁɔˀð
husk	husɡ̊
huske	husɡ̊ə
huslig	husli
husmand	husmanˀ
hva'	ʋɑ
hvad	vað
hvad	vɑ
hvalp	ʋalˀb̥
hvas	ʋas
hvedebrød	ʋeːð̠ˠəb̥ʁœð̠ˠˀ
hvedemel	ʋeːð̩ˠmeːˀl
hvem	ʋɛmˀ
hvepsetalje	veb̥sətˢaljə
hvepsetalje	vɛb̥sətˢaljə
hver	ʋɛɐ̯
hver	ʋɛɐ̯ˀ
hver	ʋɛˀɐ̯
hverandre	ʋæɐ̯ɑnd̥ʁɐ
hverandre	ʋɛɐ̯ɑnd̥ʁɐ
hverken	ʋaɐ̯ɡ̊ŋ̩
hvi	ʋiˀ
hvid	ʋiðˀ
hvid	ʋiˀð
hviderusser	ʋiːðˠəʁusɐ
hvidt	vid̥
hvidvin	viðviːˀn
hvil	viːˀl
hvile	viːlə
hvilke	ʋelɡ̊ə
hvilken	ʋelɡ̊ən
hvilket	ʋelɡ̊əð
hvirveldyr	viɐ̯wəld̥yɐ̯ˀ
hvis	ves
hviske	ʋesɡ̊ə
hvisken	ʋesɡ̊ŋ̩
hvisken	ʋesɡ̊ən
hvo	voːˀ
hvordan	ʋɔd̥ən
hvordan	ʋʌd̥an
hvordan	ʋʌd̥ən
hvordan	ʋʌnˀn
hvorledes	vɒleːðɘs
hvornår	vɒnɒːˀ
hvæse	vɛːsə
hvæsse	ʋɛsə
hybris	hyːb̥ʁis
hydrat	hyd̥ʁɑːˀd̥
hydrere	hyd̥ʁ̥eːˀɐ
hygge	hyɡ̊ə
hykle	hyɡ̊lə
hykler	hyɡ̊lɐ
hykleri	hyɡ̊lɐʁiˀ
hyklerisk	hyɡ̊lɐʁiˀ
hylde	hylə
hyle	hyːlə
hylle	hylə
hymne	hymnə
hyppig	hyb̥i
hyrde	hya̯d̥ə
hyt	hyd̥
hytte	hyd̥ə
hyttede	hyd̥ð̩ð̩
hyttefad	hyd̥əfað
hytten	hyd̥n̩
hyttens	hyd̥n̩s
hytteost	hyd̥əɔsd̥
hytter	hyd̥ɐ
hytterne	hyd̥ɐnə
hytternes	hyd̥ɐnəs
hyttes	hyd̥əs
hyttet	hyd̥ð̩
håb	hɔːˀb̥
håbe	hɔːb̥ə
hån	hɔːˀn
hånd	hʌnˀ
håndgemæng	hʌnɡ̊emɛŋ
håndjern	hʌnjæɐ̯ˀn
håndklæde	hʌnkʰl̥ɛːðə
håndklæde	hʌŋkʰl̥ɛːðə
håndtaske	hʌntˢasɡ̊ə
håndværk	hʌnʋaɐ̯ɡ̊
håndværker	hʌnʋaɐ̯ɡ̊ɐ
hår	hɒˀ
hårbørste	hɒːb̥œ̞ɐ̯sd̥ə
hård	hɒˀ
hårdt	hɒːd̥
hårfin	hɒːfiˀn
hæder	hɛːˀðɐ
hæfte	hɛfd̥ə
hæl	hɛˀl
hæle	hɛːlɐ
hæler	hɛːlɐ
hæleren	hɛːlɐɐn
hæmatologi	hɛmatoloɡiˀ
hænde	hɛnə
hænder	hɛnɐ
hænder	hɛnˀɐ
hæng	hɛŋˀ
hænge	hɛŋə
hænger	hɛŋˀɐ
hængt	hɛŋˀd̥
hængte	hɛŋd̥ə
hængte	hɛŋˀd̥ə
hærg	haɐ̯ˀwəð
hærge	haɐ̯wə
hærge	haɐ̯ʊ
hærgede	haɐ̯wəðə
hærgede	haɐ̯ʊðə
hærgende	haɐ̯wənə
hærgende	haɐ̯ʊnə
hærger	haɐ̯wɐ
hærget	haɐ̯wəð
hærget	haɐ̯ʊð
hæv	hɛwˀ
hævd	hɛwˀd̥
hævde	hɛwd̥ə
hæve	hɛːwə
hævngerrig	hɛwnɡ̊æɐ̯i
hævngerrig	hɛwnɡ̊æɐ̯ˀi
hø	heːˀ
hø	hyø
hø	hyːˀə
hø	høtʃː
hø	høɪ̯ˀ
hø	høɪ̯ː
hø	høːˀ
hø	hɔɪ̯ˀ
høde	høðð̩
høg	høˀj
høj	hʌjˀ
højde	hʌjˀd̥ə
højdepunkt	hʌjˀd̥əpʰɔŋˀd̥
højforræderi	hʌjfʌʁaðɐʁiˀ
højforræderi	hʌjfʌʁɛðɐʁiˀ
højre	hʌjʁɐ
højredrejning	hʌɪ̯ʁʌd̥ʁɑɪ̯niŋ
højredrejning	hʌɪ̯ʌd̥ʁɑɪ̯niŋ
højst	hʌɪ̯ˀsd̥
højtaler	hʌjtˢæːlɐ
højtaler	hʌjtˢæːˀlɐ
højttaler	hʌjtˢæːlɐ
højttaler	hʌjtˢæːˀlɐ
højtysk	hʌjtˢysɡ̊
høker	høˀɡ̊ɐ
høkre	høːɡ̊ʁɐ
høl	høl
høl	høˀl
høne	hœːnə
høne	hœːn̩
høns	hœnˀs
hør	høɐ̯ˀ
hør	hœ̞ɐ̯
høre	høːɐ
hørelse	høːɐlsə
høretelefon	høːɐtˢeləfoˀn
hørfrøolie	hɶɐ̯fʁœoljə
høst	høsd̥
høstak	høsd̥ɑɡ̊
høste	høsd̥ə
høvl	hœwˀl
høvle	hœwlə
i	i
idiomatisk	id̥iomæːˀtˢisɡ̊
idræt	idʁad̥
idræt	iːdʁad̥
idyllisk	id̥ylˀisɡ̊
idé	id̥eˀ
ifølge	iføljə
igennem	iɡ̊ɛmˀm̩
igle	iːlə
iglo	iɡ̊lo
ignorant	enjoʁɑnˀd̥
ignorant	injoʁɑnˀd̥
ignorant	inoʁɑnˀd̥
ignorere	enjoʁɛˀɐ
ignorere	injoʁɛˀɐ
ignorere	inoʁɛˀɐ
ignorerede	enjoʁɛˀɐðə
ignorerede	injoʁɛˀɐðə
ignorerede	inoʁɛˀɐðə
ignorerer	enjoʁɛˀɐ
ignorerer	injoʁɛˀɐ
ignorerer	inoʁɛˀɐ
ignoreret	enjoʁɛˀɐð
ignoreret	injoʁɛˀɐð
ignoreret	inoʁɛˀɐð
ihjel	ijɛl
ihukomme	ihukʰʌmˀə
ihukomme	ihuˀkʰʌmˀə
ihukommelse	ihukʰʌmˀɭ̩sə
ihukommelse	ihuˀkʰʌmˀɭ̩sə
ikke	eɡ̊ə
ild	ilˀ
ilddåb	ild̥ɔˀb̥
ilde	ilə
ildebrand	iləb̥ʁɑnˀ
ildflue	ilfluːə
ildhu	ilhuˀ
ildkugle	ilkʰuːlə
ildløs	illøˀs
ildsjæl	ilɕɛˀl
ildslukker	ilslɔɡ̊ɐ
ildsted	ilsd̥ɛð
ildsvåde	ilˀsʋɔðð̩
ile	iːlə
ilt	ilˀd̥
ilte	ild̥ə
ilter	ild̥ɐ
ilter	ilˀd̥ɐ
imellem	imɛlˀəm
imidlertid	imið̠ˠˀlʌtið̠ˠˀ
imitere	imitˢeˀɐ
immigration	emiɡ̊ʁɑɕoːˀn
immigration	imiɡ̊ʁɑɕoːˀn
immigrere	emiɡ̊ʁæːˀɐ
immigrere	imiɡ̊ʁæːˀɐ
imod	imoðˀ
imod	imoˀð
imponere	empʰoneːˀɐ
imponerede	empʰoneːˀɐðˠə
imponeres	empʰoneːˀɐs
imposant	empʰosanˀd̥
impulsiv	empʰulsiwˀ
incidens	e̝nsid̥enˀs
indavl	enɑwˀl
indbilde	enb̥ilˀə
indbildning	enb̥ilˀniŋ
indbygger	enb̥yɡ̊ɐ
indebrændt	enəbʁanˀd
indenlands	enn̩lanˀs
indenlandsk	enn̩lanˀsɡ̊
indflydelse	enfl̥yðɭ̩sə
indgang	enɡ̊ɑŋˀ
indhøste	enhøsd̥ə
indianer	ind̥ijæˀnɐ
indianer	ind̥iæˀnɐ
indimellem	enˀimɛlˀəm
individ	end̥iviðˀ
indkomst	enkʰʌmˀsd̥
indlemme	enlɛmˀə
indlysende	enlyˀsn̩nə
indoeuropæisk	end̥oœwʁopʰɛˀisɡ̊
indre	end̥ʁɐ
indspist	ensb̥iːˀsd̥
indtil	enˀtˢe
indtægt	entˢɛɡ̊d̥
indvortes	enʋɒˀd̥əs
indvortes	enʋɒːd̥əs
infinitesimalregning	enfinitˢesimæːˀlʕɑɪ̯neŋ
ingen	eŋŋ̩
ingenting	eŋŋ̩teŋˀ
insekt	ensɛɡ̊d̥
intelligent	entˢeliɡ̊ɛnˀd̥
interessant	entˢʁ̥əsɑnˀd̥
interesse	entˢɐˀʁɑsə
interessere	entˢʁ̥ɐseˀɐ
international	entˢɐnaɕonæˀl
intervention	entˢɐvənɕoːˀn
intetkøn	end̥əðkʰœnˀ
introducere	entʁ̥od̥useːˀɐ
introduktion	entˢʁod̥ukʰɕoːn
inuit	inuid̥
ir	iɐ̯
ir	iɐ̯ˀ
irer	iˀɐ
irland	iɐ̯lanˀ
ironi	iʁoniːˀ
irrationel	iʁɑɕonɛlˀ
irritabel	iɐ̯itˢæːˀb̥əl
irriterende	iɐ̯itˢeˀɐnə
irriterende	iɐ̯tˢeɐ̯ˀnə
irsk	iɐ̯ˀsɡ̊
iscenesætte	iseːnəsɛd̥ə
islænding	islɛnˀeŋ
ispind	ispʰenˀ
istanbul	isd̥amb̥ul
iste	istˢeːˀ
isvin	iːsʋiːˀn
især	isɛːˀɐ̯
italesætte	itˢæːləsɛd̥ə
italesættelse	itˢæːləsɛd̥l̩sə
italien	itˢæˀljən
italiener	itˢaljeˀnɐ
italiener	itˢaljɛˀnɐ
italiensk	itˢaljeˀnsɡ̊
italiensk	itˢaljɛˀnsɡ̊
itu	itˢuːˀ
iver	iwˀɐ
iver	iːˀvɐ
iver	iːˀwɐ
ivrig	iwri
ja	jæɐ̯
ja	jɛ
jade	jæːð̩
jag	jæjˀ
jage	jæːjə
jage	jæːɪ
jaloux	ɕælu
japaner	japʰæːˀnɐ
japansk	japʰæːˀnsɡ̊
jasmin	ɕasmiːˀn
jeg	jɑj
jeger	jɑjˀɐ
jegerne	jɑjˀɐnə
jegernes	jɑjˀɐnəs
jeget	jɑjˀəð
jeget	jɑðˀð̩
jegets	jɑjˀəðs
jegets	jɑðˀð̩s
jegs	jɑjs
jensen	jɛnsn̩
jer	jaɐ̯
jeres	jaːɐs
jern	jaɐ̯ˀn
jernbane	jaɐ̯nb̥æːnə
jernbanefløjl	jæɐ̯nb̥ænəflʌjˀl
jernbaneoverskæring	jæɐ̯nb̥æːnəɒʊ̯ʌsɡ̊ɛɐ̯ˀeŋ
jernbanespor	jæɐ̯nb̥æːnəsb̥oːˀɐ̯
jernene	jaɐ̯ˀnənə
jernenes	jaɐ̯ˀnənəs
jernet	jaɐ̯ˀnəð
jespersen	jɛsb̥ɐsn̩
jesus	je̝ːsus
jiddisch	jid̥iɕ
jo	jo
jo	jɔʊ̯ˀ
job	d̥jʌb̥
jodle	jʌd̥lə
jodle	jʌðlə
johannes	johanəs
johannes	johanˀəs
joho	jɔhɔʊ̯ˀ
joke	d̥jɔwɡ̊
joke	d̥jɔwɡ̊ə
joke	d̥jɔwˀɡ̊
jomfru	jʌmfʁ̥o
jomfru	jʌmfʁ̥u
jomfruelig	jʌmfʁoˀoli
jomfruelig	jʌmfʁuˀuli
jomfrufødsel	jʌmfʁ̥oføsl̩
jomfrufødsel	jʌmfʁ̥uføsl̩
jord	jeʊːɐ
jord	jokwɐ
jord	joɐ̯ˀ
jord	joːˀə
jord	juoɹ
jord	juːˀɐ
jordisk	joɐ̯d̥isɡ̊
jordnød	joɐ̯nøðˠˀ
jordnøddeolie	joɐ̯nøð̩ˠoljə
jordnøddesmør	joɐ̯nøðəsmœ̞ɐ̯
jordskælv	joɐ̯sɡ̊ɛlˀv
journalistik	ɕonalisd̥iɡ̊
journalistik	ɕoɐ̯nalisd̥iɡ̊
jubilæum	jub̥ilɛːɔm
juice	d̥juːs
jul	juˀl
juleaften	juːləɑfd̥n̩
julefrokost	juːləfʁɔɡ̊ʌsd
julekort	juːləkʰɑːd̥
julelys	juːləlyːˀs
julemand	julemæˀ
juletræ	juːlətˢʁ̥ɛːˀ
juli	juːˀli
jungle	d̥jɔŋlə
juni	juːˀni
jura	juːɑ
juridisk	juʁiˀðisɡ̊
jurist	juʁisd̥
juvel	juveːˀl
juveler	juveːˀlɐ̯
juveler	juvɘleɐ̯ˀ
juveler	juvɘleːˀɐ̯
jyde	jyːð̩
jylland	jylanˀ
jysk	jysɡ̊
jytte	jyd̥ə
jæger	jɛːjʌ
jætte	jɛd̥ə
jættestue	jɛd̥əsd̥uːu
jævn	jɛwˀn
jævnfør	jɛwnføˀɐ̯
jævnføre	jɛwnføˀɐ
jævnstrøm	jɛʊ̯nsd̥ʁɶmˀ
jøde	jøːðə
jøde	jøːð̩
jødinde	jøðenə
kaffe	kʰɑfə
kaffebønne	kʰɑfəb̥œnə
kaffekande	kʰɑfəkʰanɘ
kage	kʰæːjə
kage	kʰæːæ
kager	kʰæːjɐ
kager	kʰæːɐ
kagers	kʰæːjɐs
kagers	kʰæːɐs
kagle	kʰɑʊ̯lə
kakao	kʰakʰæːo
kakaosmør	kʰakʰæːosmɶɐ̯
kakkel	kʰɑɡ̊l̩
kakkelovn	kʰɑɡ̊l̩lɒwˀn
kakofoni	kʰɑɡ̊afoniːˀ
kakofoni	kʰɑɡ̊ofoniːˀ
kaktus	kʰɑɡ̊tˢus
kalv	kʰalˀ
kalv	kʰalˀʋ
kamme	kʰɑmə
kammer	kʰɑmɐ
kammer	kʰɑmˀɐ
kampsport	kʰɑmb̥sb̥ɒːd̥
kan	kʰa
kan	kʰan
kan	kʰanˀ
kanalje	kʰanaljə
kanapé	kʰanapʰe
kanapé	kʰanapʰeːˀ
kandestøber	kʰanəsd̥øːb̥ɐ
kanel	kʰaneːˀl
kanelsnegl	kʰaneːˀlsnɑɪ̯ˀl
kanin	kʰaniˀn
kanonisere	kanoniseˀʌ
kaos	kʰæːɐs
kaos	kʰæːʌs
kapers	kʰæːˀb̥ɐs
kappe	kʰɑb̥ə
kapring	kʰæːb̥ʁæŋ
kar	kʰɑ
karakter	kʰɑɑɡ̊tˢeːˀɐ̯
karikatur	kʰɑikʰatˢuɐ̯ˀ
karisma	kʰaʁisma
karisma	kʰɑʁisma
karl	kʰæˀl
karl	kʰɑl
karl	kʰɑːˀl
karle	kʰæːlə
karle	kʰɑːlə
karnap	kanɑb̥
karnap	kɑnɑb̥
karpe	kʰɑːb̥ə
karry	kʰɑːi
kartoffel	katˢʌfəl
kasserolle	kʰasəʁʌlə
kastanje	kʰasd̥anjə
kastanje	kʰasd̥anˀjə
kaste	kʰasd̥ə
kastel	kʰasd̥ɛlˀ
kaster	kʰasd̥ɐ
kat	kʰad̥
katastrofe	kʰad̥asd̥ʁoːfə
kateder	kʰatˢeːˀd̥ɐ
kattejammer	kʰad̥əjɑmˀɐ
katten	kʰad̥n̩
kaudervælsk	kʰɑwd̥ɐvɛlˀsɡ̊
kavaleri	kʰaʋaləʁiˀ
kavaleri	kʰaʋləʁiˀ
kavalerist	kʰaʋaləʁisd̥
kavalerist	kʰaʋləʁisd̥
kaviar	kʰaviɑːˀ
ked	kʰeðˀ
ked	kʰeˀð
kedel	kʰeðəl
kejsersnit	kʰɑjsɐsnid̥
kejthåndet	kʰɑjd̥hʌnˀəð
kel	kʰeːˀl
kende	kʰɛnə
kendeord	kʰɛnəoɐ̯ˀ
kendetegn	kʰɛnətˢɑjˀn
kendetegne	kʰɛnətˢɑjˀnə
kendt	kʰɛnˀd̥
kendte	kɛnd̥ə
kendte	kɛnˀd̥ə
kere	kʰeːɐ
kerne	kʰaɐ̯nə
kernekraft	kʰaɐ̯nəkʰʁ̥ɑfd̥
kernekraftværk	kʰaɐ̯nəkʰʁ̥ɑfd̥ʋaɐ̯ɡ̊
kerte	kʰæɐ̯d̥ə
ketchup	kʰɛd̥ɕub̥
ketsjer	kʰɛd̥ɕɐ
kigge	kʰiɡ̊ə
kikke	kʰiɡ̊ə
kikkert	kʰiɡ̊ɐd̥
kiks	kʰiɡs
kil	kʰiːˀl
kilde	kʰill̩
kilde	kʰilə
kilder	kʰilɐ̯
kile	kʰiːlə
kileskrift	kʰiːləsɡ̊ʁæfd̥
killing	kʰileŋ
kim	kʰiːˀm
kind	kʰenˀ
kinesisk	kʰinɛsisɡ̊
kirke	kʰiɐ̯ɡ̊ə
kirsten	kʰiɐ̯sdn̩
kirtel	kiɐ̯dəl
kiste	kʰiːsd̥ə
kiwi	kʰiːvi
kjole	kʰj̊oːlə
klage	kʰl̥æːjə
klage	kʰl̥æːæ
klan	kʰlæːˀn
klapperslange	kʰlɑb̥ɐslɑŋə
klapvogn	kʰlɑb̥vɔwˀn
klar	kʰl̥ɑˀ
klassiker	kʰl̥asiɡ̊ɐ
klassisk	kʰl̥asisɡ̊
klaviatur	kl̥aʋiatˢuɐ̯ˀ
klejn	kʰl̥ɑjˀn
klient	kʰliɛnˀd̥
klientel	kʰliəntˢɛlˀ
klipse	kl̥eb̥sə
klitoris	kʰlitˢoʁis
kloakdyr	kl̥oɑɡ̊d̥yɐ̯ˀ
klods	kl̥ʌs
klog	kʰlɔːˀw
klokke	kʰl̥ʌɡ̊ə
klokken	kʰl̥ʌɡ̊ŋ̩
klokkeren	kʰlʌɡ̊ɐən
klokkeren	kʰlʌɡ̊əʁæːˀn
klokkeslæt	kʰl̥ʌɡ̊əslɛd̥
klor	kʰloːˀɐ̯
kloster	kʰl̥ʌsd̥ɐ
klovn	kʰlɒwˀn
klovne	kʰlɒwnə
klud	kʰl̥uðˀ
kludder	kʰluðˀɐ
kludre	kʰluðʁɐ
klynge	kʰløŋə
klæd	kʰl̥ɛˀ
klæde	kʰl̥ɛˀ
klæde	kʰl̥ɛːðə
klædende	kʰl̥ɛˀənə
klædende	kʰl̥ɛːðənə
klæder	kʰl̥ɛɐ̯
klæder	kʰl̥ɛɐ̯ˀ
klæder	kʰl̥ɛːðɐ
klæderne	kʰl̥ɛɐ̯nə
klæderne	kʰl̥ɛːðɐnə
klædernes	kʰl̥ɛɐ̯nəs
klædernes	kʰl̥ɛːðɐnəs
klæders	kʰl̥ɛɐ̯s
klæders	kʰl̥ɛːðɐs
klædes	kʰl̥ɛˀs
klædes	kʰl̥ɛːðəs
klædet	kʰl̥ɛːðəd̥
klædets	kʰl̥ɛːðəd̥s
klædt	kʰl̥ɛˀd̥
klædte	kʰl̥ɛˀd̥ə
klædte	kʰl̥ɛːd̥ə
klædtes	kʰl̥ɛːd̥əs
klør	kʰløɐ̯ˀ
klør	kʰløːˀɐ̯
kløve	kʰløːvə
kløver	kʰløːvɐ
kløver	kʰløːˀvɐ
knagende	kʰnæːjənə
knald	kʰnalˀ
knalde	kʰnalə
knap	kʰnɑb̥
knar	kʰnɑːˀ
knarr	kʰnɑːˀ
kneppe	kʰneb̥ə
kneppe	kʰnɛb̥ə
kniv	kʰniwˀ
kno	kʰnoːˀ
knob	kʰnoːˀb̥
knogle	kʰnɒwlə
knor	kʰnoːˀɐ̯
knud	knuðˀ
knud	knuˀð
knurre	kʰnoːɐ
knus	kʰnuːˀs
knusende	kʰnuːsənə
knække	kʰn̥ɛɡ̊ə
ko	kʰoˀ
koagulere	kʰoaɡ̊uleːˀɐ
koagulere	kʰoɑɡ̊uleːˀɐ
kobber	kʰɒwˀɐ
kobberrør	kʰɒʊ̯ˀɐʁɶːˀɐ̯
koben	kʰoːˀb̥eːˀn
koffein	kʰofəiːˀn
koffein	kʰʌfəiːˀn
koge	kʰɔːʊ
koger	kʰɔːwɐ
kogger	kʌwˀɐ
kogger	kʌɡ̊ɐ
kogt	kʰʌɡ̊d̥
kogte	kʰʌɡ̊d̥ə
kok	kʰʌɡ̊
kokosnød	kʰoːɡ̊osnøðˀ
kokosnød	kʰoːɡ̊usnøðˀ
kokosolie	kʰoːɡ̊osoljə
kold	kʰʌlˀ
koldbrand	kʰʌlb̥ʁɑnˀ
koldt	kʰʌlˀd̥
kolerisk	kʰoleːˀɐ̯isɡ̊
kolibri	kʰolib̥ʁiːˀ
kollega	kʰole̝ːka
kolleger	kʰole̝ːjɐ
koloenorm	kʰoloenɑːˀm
kolonial	kʰoloniæːˀl
kolonialisme	kʰolonialismə
kolonorm	kʰolonɑːˀm
kolos	kʰolʌs
kolossal	kʰolosæːˀl
kom	kʰʌm
kom	kʰʌmˀ
koma	kʰoːma
komedie	kʰomeðˀjə
komisk	kʰoˀmisɡ̊
komme	kʰʌmm̩
komme	kʰʌmə
kommen	kʰʌmm̩
kommentar	kʰɔməntˢɑːˀ
kommentar	kʰʌməntˢɑːˀ
kommer	kʰʌmˀɐ̯
kommet	kʰʌmð̩
kommode	kʰomoːðˠə
kompagnon	kʰɔmpʰanjʌŋ
kompleks	kʰʌmpʰl̥ɛɡ̊s
komplet	kʰɔmpʰlɛd̥
komplet	kʰʌmpʰlɛd̥
komposition	kʰɔmpʰosiɕoːˀn
komposition	kʰʌmpʰosiɕoːˀn
kompost	kʰɔmpʰʌsd̥
komtesse	kʰɔmtˢɛsə
komtesse	kʰʌmtˢɛsə
koncept	kʰʌnsɛb̥d̥
koncert	kʰʌnsæɐ̯d̥
kondom	kʰond̥oːˀm
kondom	kʰɔnd̥oːˀm
kondom	kʰʌnd̥oːˀm
kone	kʰoːnə
kong	kʰʌŋ
konge	kʰʌŋə
kongeblå	kʰʌŋəb̥lɔːˀ
kongerige	kʰʌŋəʁiːə
kongruens	kʰʌŋɡ̊ʁuɛnˀs
konjunktion	kʰʌnjɔŋɡ̊ɕoːˀn
konkurs	kʰʌŋkʰuɐ̯ˀs
konsekvens	kʰʌnsəkʰvɛnˀs
konsensus	kʰʌnsɛnsus
konservativ	kʰɔnsæɐ̯vatˢiwˀ
konservativ	kʰʌnsæɐ̯vatˢiwˀ
konservator	kʰʌnsæɐ̯væːtˢɐ
konspiration	kʰʌnsb̥iɑɕoˀːn
konstantinopel	kʰʌnsd̥antˢinoˀb̥l̩
konstruktion	kʰɔnsd̥ʁuɡ̊ɕoːˀn
kontinuitet	kʰʌntˢinuitˢeːˀd̥
kontor	kʰontˢoɐ̯ˀ
kontor	kʰɔntˢoɐ̯ˀ
kontrovers	kʰʌntˢʁovæɐ̯s
konvoj	kʰʌnvʌjˀ
kop	kʰʌb̥
koparret	kʰʌb̥ɑˀɑð
koparret	kʰʌb̥ɑːɑð
kopiere	kʰopj̊eːˀɐ
kopiere	kʰopʰiːˀɐ
kopper	kʰʌb̥ɐ
kopulere	kʰob̥uleːˀɐ
kor	kʰoɐ̯ˀ
koreansk	kʰoɐ̯eæːˀnsɡ̊
kork	kʰɒːɡ̊
korkeg	kʰɑːɡ̊eːˀj
korn	kʰokwɐ
korn	kʰoɐ̯ˀn
korps	kʰɒːb̥s
korrigere	kʰoɐ̯iɡ̊eːˀɐ
korrigere	kʰɒiɡ̊eːˀɐ
kors	kʰɒːs
korset	kʰɒsəd̥
korset	kʰɒsɛd̥
korskilde	kʰɒːskʰilə
kort	kʰɒːd̥
kost	kʰɔsd̥
kost	kʰʌsd̥
kostume	kʰosd̥yːmə
kovs	kʰɒwˀs
kradse	kʰʁ̥ɑsɘ
kraft	kʰʁ̥ɑfd̥
kraftværk	kʰʁ̥ɑfd̥ʋaɐ̯ɡ̊
krage	kʁ̥ɑːʊ
krammer	kʁ̥ɑmɐ
krans	kʰʁ̥ɑnˀs
krans	kʰʁ̥ɑːˀns
kransekage	kʁ̥ɑnsəkʰæːjə
krav	kʰʁ̥ɑwˀ
krav	kʰʁ̥ɑˀw
kravle	kʰʁ̥ɑwlə
krebs	kʰʁ̥ab̥s
krebs	kʰʁ̥ɑb̥s
kreds	kʰʁ̥æːˀs
kreds	kʰʁ̥ɛːˀs
kredse	kʰʁ̥æːsə
kredse	kʰʁ̥ɛːsə
kredsen	kʰʁ̥æːˀsn̩
kredsen	kʰʁ̥ɛːˀsn̩
kreta	kʰʁ̥æːtˢa
kreta	kʰʁ̥ɛːtˢa
krig	kʰʁ̥iˀ
kriger	kʰʁ̥iːɐ
krigshelt	kʰʁ̥ishɛlˀd̥
krigstid	kʰʁ̥istˢiðˀ
kriminel	kʰʁiminɛlˀ
krise	kʰʁ̥iːsə
kristen	kʰʁ̥ɛsd̥ən
kristendom	kʰʁ̥ɛsd̥ənd̥ʌmˀ
kristenhed	kʰʁ̥ɛsd̥ənheðˀ
kristian	kʰʁæsd̥jan
kristne	kʰʁ̥ɛsd̥nə
kristne	kʰʁ̥ɛsnə
kriterium	kʰʁ̥itˢeːˀɐ̯iɔm
kro	kʁoˀ
kroatisk	kʰʁoæːˀtˢisɡ̊
krog	kʰʁɔwˀ
kroge	kʰʁ̥ɔːwə
krokodilletåre	kʁoɡədilətɒːɒ
krokodilletåre	kʁɔɡədilətɒːɒ
krone	kʰʁ̥oːnə
kronprins	kʰʁ̥oːˀnpʰʁ̥ɛnˀs
kronprinsesse	kʰʁ̥oːnpʰʁ̥ɛnsɛsə
krop	kʰʁ̥ʌb̥
kropslig	kʰʁ̥ʌb̥sli
krudt	kʰʁ̥od̥
krudt	kʰʁ̥ud̥
krukke	kʰʁɔɡ̊ə
krus	kʰʁ̥oːˀs
kruse	kʰʁ̥oːsɘ
kryb	kʰʁ̥ywˀ
kryb	kʰʁ̥yːˀb̥
krybdyr	kʰʁ̥yb̥d̥yɐ̯ˀ
krybe	kʰʁ̥yːb̥ə
krybe	kʰʁ̥yːʊ
krybskytte	kʰʁ̥yb̥sɡ̊ød̥ə
krydderbolle	kʰʁ̥yðɐb̥ʌlə
krydderbolle	kʰʁ̥œðɐb̥ʌlə
kryddernellike	kʰʁ̥yðɐnelˀeɡ̊ə
kryddernellike	kʰʁ̥œðɐnelˀeɡ̊ə
kryddersild	kʰʁ̥yðɐsilˀ
kryddersild	kʰʁ̥œðɐsilˀ
krydderurt	kʰʁ̥yðɐuɐ̯d̥
krydderurt	kʰʁ̥œðɐuɐ̯d̥
krydre	kʰʁ̥yðʁɐ
krydre	kʰʁ̥œðʁɐ
kryds	kʰʁ̥ys
krydse	kʰʁysə
krydsermissil	kʰʁysɐmisiːˀl
kryster	kʰʁ̥ysd̥ɐ
kræft	kʁ̥afd̥
kræft	kʁ̥æfd̥
kræft	kʁ̥ɑfd̥
kræfter	kʰrafd̥ɐ
kræfter	kʰrɑfd̥ɐ
kræfterne	kʰrafd̥ɐnə
kræfterne	kʰrɑfd̥ɐnə
kræfternes	kʰrafd̥ɐnəs
kræfternes	kʰrɑfd̥ɐnəs
kræmmer	kʁ̥ɑmɐ
krænke	kʰʁ̥aŋɡ̊ə
kræs	kʰʁ̥æˀs
kræs	kʰʁ̥ɛˀs
kræse	kʰʁ̥æːsə
kræse	kʰʁ̥ɛːsə
kræsen	kʰʁ̥æːsn̩
kræsen	kʰʁ̥ɛːsn̩
kræset	kʰʁ̥æˀsð̩
kræset	kʰʁ̥æːsð̩
kræset	kʰʁ̥ɛˀsəð
kræset	kʰʁ̥ɛːsəð
kræve	kʰʁ̥æːʊ
kræve	kʰʁ̥æːʋə
krævede	kʰʁ̥æwð̩ð̩
krævede	kʰʁ̥æðð̩
krævede	kʰʁ̥æːʋð̩ð̩
krævet	kʰʁ̥æwð̩
krævet	kʰʁ̥æðð̩
krævet	kʰʁ̥æːʋð̩
krøsus	kʰʁ̥øːsus
kubikmeter	kʰub̥iɡ̊meːˀd̥ɐ
kugle	kʰuːlə
kugleramme	kʰuːləʁɑmə
kul	kʰuˀl
kul	kʰɔl
kulde	kʰull̩
kuldegysning	kʰuləɡ̊ysneŋ
kuldioxid	kʰɔld̥iʌɡ̊ksiðˀ
kuldkaste	kʰulkʰasd̥ə
kule	kʰuːlə
kuller	kʰulˀɐ
kulturchok	kʰultˢuɐ̯ˀɕʌɡ̊
kulturrevolution	kʰultˢuɐ̯ˀʁɛvoluɕoːˀn
kultveilte	kʰɔltˢʋ̥eild̥ə
kulør	kʰuløɐ̯ˀ
kulør	kʰuløːˀɐ̯
kulørt	kʰuløɐ̯ˀd̥
kun	kʰɔn
kunde	kʰɔnə
kundskab	kʰɔnsɡ̊æˀb̥
kunne	kʰu
kunne	kʰunə
kunnen	kʰunən
kunnet	kʰunəð
kunst	kʰɔnˀsd̥
kunstgalleri	kʰɔnsd̥ɡ̊aləʁiˀ
kunstner	kʰɔnˀsd̥nɐ
kure	kʰuːɐ
kurer	kʰuʁɛːˀɐ̯
kurer	kʰuːɐ
kuriøs	kʰuɐ̯iøːˀs
kurv	kʰoɐ̯ˀw
kurv	kʰuɐ̯ˀw
kusine	kʰusiːnə
kusk	kʰusɡ̊
kusse	kusə
kustode	kʰusd̥oːðə
kutyme	kʰutˢyːmə
kvad	kʰvað
kvad	kʰvæðˀ
kvad	kʰvæːˀð
kvaj	kʰʋ̥ɑj
kvaj	kʰʋ̥ɑjˀ
kvaje	kʰʋ̥ɑjə
kvalt	kʰʋ̥æˀld̥
kvalte	kʰʋ̥æˀld̥ə
kvalte	kʰʋ̥æːld̥ə
kvan	kvan
kvan	kvanˀ
kvan	kvæˀn
kvark	kʰvɑːɡ̊
kvart	kʰʋ̥ɑːd̥
kvartal	kʰʋ̥ɑtˢæˀl
kvartalsvis	kʰʋ̥ɑtˢæˀlsʋiˀs
kvarte	kʰʋ̥ɑːd̥ə
kvarten	kʰʋ̥ɑːd̥ən
kvarter	kʰʋ̥ɑtˢeɐ̯ˀ
kvarter	kʰʋ̥ɑːd̥ɐ
kvartet	kʰʋ̥ɑtˢɛd̥
kvartets	kʰʋ̥ɑtˢɛd̥s
kvartetten	kʰʋ̥ɑtˢɛd̥ən
kvartetter	kʰʋ̥ɑtˢɛd̥ɐ
kvartetterne	kʰʋ̥ɑtˢɛd̥ɐnə
kvarts	kʰʋ̥ɑːd̥s
kvik	kʰʋ̥iɡ̊
kviksølv	kʰʋiɡ̊søl
kvinde	kʰʋ̥enə
kvit	kʰvid̥
kvæde	kʰʋ̥ɛːð̩
kvæg	kʰʋ̥ɛˀ
kvæg	kʰʋ̥ɛˀj
kvæge	kʰʋ̥ɛːjə
kvæge	kʰʋ̥ɛːɛ
kvæk	kvɛɡ̊
kvækerfinke	kvɛˀɡʌfeŋɡə
kvække	kʰvɛɡ̊ə
kvæl	kʰʋ̥ɛˀl
kvæld	kʰʋ̥ɛlˀ
kvæle	kʰʋ̥ɛːlə
kvælende	kʰʋ̥ɛːlənə
kvæler	kʰʋ̥ɛˀlɐ
kvæler	kʰʋ̥ɛːlɐ
kvælstof	kʰʋɛːlsd̥ʌf
kvær	kʰʋ̥ɛˀɐ̯
kværke	kʰvæɐ̯ɡ̊ə
kykkeliky	kʰyɡ̊əlikʰyː
kyklop	kʰykʰl̥oˀb̥
kyl	kʰyːˀl
kylling	kʰyleŋ
kynisk	kʰyːˀnisɡ̊
kynofobi	kʰynofob̥iːˀ
kynologi	kʰynoloɡ̊iːˀ
kys	kʰyːˀs
kys	kʰøs
kyse	kʰyːsə
kysk	kʰysɡ̊
kysse	kʰøsə
kyst	kʰyːˀsd̥
kyst	kʰøsd̥
kystlinje	kʰøsd̥lenjə
kår	kʰɒˀ
kæde	kʰɛðð̩
kæk	kʰɛɡ̊
kæl	kʰɛːˀl
kælder	kɕɔʎə
kælder	kʰɛlɐ
kæledyr	kʰɛːləd̥yɐ̯ˀ
kælling	kʰɛleŋ
kæmpe	kʰɛmb̥ə
kæmpehagl	kʰɛmb̥ehɑwˀl
kænguru	kʰɛŋɡ̊uːʁu
kæp	kʰɛb̥
kær	kæˀɐ̯
kær	kɛˀɐ̯
kære	kɛːɐ
kæreste	kʰaɐ̯sd̥ə
kæreste	kʰaːɐsd̥ə
kæreste	kʰɛːɐsd̥ə
kærlig	kaɐ̯li
kærlighed	kaɐ̯liheðˀ
kærne	kʰaɐ̯nə
kærnemælk	kʰaɐ̯nəmɛlˀɡ̊
kærte	kʰæɐ̯d̥ə
kærtegne	kɛɐ̯tˢɑɪ̯nə
kætter	kɛdʌ
köln	kʰølˀn̩
kø	kʰøˀ
køb	kʰøˀb̥
købe	kʰøːb̥ə
købe	kʰøːʊ
københavn	kʰøb̥m̩hɑwˀn
københavn	tɕœwnhɑwˀn
køber	kʰøwˀɐ
køber	kʰøˀb̥ɐ
køber	kʰøːb̥ɐ
købet	kʰøˀb̥əð
købmand	kʰømanˀ
købstad	kʰøb̥sd̥að
købt	kʰøb̥d̥
købte	kʰøb̥d̥ə
kød	kʰøð
kødet	kʰøðˀəd̥
kødets	kʰøðˀəd̥s
køds	kʰøðs
køer	kʰøɐ̯ˀ
køer	kʰøˀɐ
køer	kʰøˀɐ̯
køl	kʰøˀl
køle	kʰøːlə
køleskab	kʰøːləsɡ̊æːˀb̥
kølsvin	kʰøːlsviːˀn
køn	kʰœnˀ
køre	kʰøːɐ
kørende	kʰøːɐnə
kører	kʰøɐ̯ˀ
kører	kʰøːɐ
køretøj	kʰøːɐtˢʌj
køretøjet	kʰøːɐtˢʌjˀəð
køretøjet	kʰøːɐtˢʌðˀð̩
kørsel	kʰøɐ̯sl̩
kørsel	kʰøɐ̯ˀsl̩
kørt	kʰøɐ̯ˀd̥
kørte	kʰøɐ̯d̥ə
kørte	kʰøɐ̯ˀd̥ə
kørvel	kʰɶɐ̯ʊ̯əl
labil	lab̥iːˀl
lade	la
lade	læːðə
lader	laðˀɐ
lader	læːðɒ
lader	lɑ
ladet	laðˀəd̥
ladet	læːðəd̥
lag	læˀ
lag	læˀj
lagde	læː
lagde	læːjə
lagdes	læːəs
lagdes	lɑwd̥əs
lager	læˀjɐ
lager	læˀɐ
lagkage	lɑwkʰæːɪ
lagt	lɑɡd
lagte	lɑɡ̊d̥ə
lak	lɑɡ̊
lakaj	lakʰɑjˀ
lakonisk	lakʰoˀnisɡ̊
lakonsk	lakʰoˀnsɡ̊
lakrids	lakʰʁ̥is
laks	lɑɡ̊s
lam	lɑmˀ
lampe	lɑmb̥ə
land	lanˀ
landet	lanəð
landet	lanˀəð
landkrabbe	lankʁ̥ɑb̥ə
landmand	lanmanˀ
landsby	lanˀsb̥yːˀ
landskab	lansɡ̊aːˀb̥
lang	lɑŋˀ
lange	lɑŋə
laps	lɑb̥s
larm	lɑːˀm
larme	lɑːmə
larme	lɑːm̩
larsen	lɑːsn̩
lasagne	lasanjə
laser	læːsɐ
laser	lɛɪ̯sɐ
lasers	læjsɐs
lasers	læːsɐs
last	lasd̥
latent	latˢɛnˀd̥
latin	latˢin
latin	latˢiˀn
latinsk	latˢiˀnsɡ̊
latter	lad̥ɐ
laurbær	lɑwɐb̥aɐ̯
laurbær	lɑwˀɐb̥aɐ̯
laurbærkrans	lɑʊ̯ɐb̥æɐ̯kʰʁɑˀns
lav	læwˀ
lav	læˀʋ
lav	lɑw
lav	lɑwˀ
lave	læːʊ
lave	læːʋə
lavede	læːwð̩ð̩
lavede	læːʋəðə
laven	læːwn̩
laven	læːʋn̩
laven	lɑwˀn̩
laver	læːwɐ
laver	læːʋɐ
laver	lɑwˀɐ
lavet	læːwð̩
lavet	læːʋəð
lavet	lɑwˀəð
le	leˀ
led	leð
led	leðˀ
led	leˀð
lede	leðð̩
leder	leːðɐ
ledestjerne	leːðəsd̥jæɐ̯nə
ledning	leðneŋ
ledt	leðˀd̥
ledt	leˀd̥
ledte	leˀd̥ə
ledte	leːd̥ə
leg	lɑjˀ
legal	leɡ̊æːˀl
lege	lɑːɪ
legeme	lɛːmə
legeme	lɛːɪmə
legemlig	lɛːmli
legemlig	lɛːɪmli
legemlige	lɛːmlii
legemlige	lɛːɪmlii
legemligt	lɛːmlid̥
legemligt	lɛːɪmlid̥
legetøj	lɑːɪtˢʌj
legetøjet	lɑːɪtˢʌjˀəð
legetøjet	lɑːɪtˢʌðˀð̩
lej	lɑjˀ
leje	lɑːɪ
lejlighed	lɑjliheðˀ
lejr	lɑjˀɐ
lejre	lɑjʁɐ
leksika	lɛɡ̊sikʰa
leksikon	lɛɡ̊sikʰʌn
leksikoner	lɛɡ̊sikʰʌnˀɐ
leksikonet	lɛɡ̊sikʰʌnˀəð
lektie	lɛɡ̊ɕə
lektor	lɛɡ̊tˢɐ
lem	lɛmˀ
lemfældig	lɛmfɛlˀd̥i
lemme	lɛmə
lemmen	lɛmˀm̩
lemmene	lɛmm̩nə
lemmer	lɛmɐ
lemmerne	lɛmɐnə
lemmet	lɛmˀð̩
len	leˀn
leo	leːʊ
ler	leɐ̯ˀ
ler	leˀɐ̯
lesbisk	lɛsb̥isɡ̊
let	leˀd̥
let	lɛd̥
letmælk	lɛd̥mɛlˀɡ̊
lette	lɛd̥ə
lettisk	lɛd̥isɡ̊
lev	lewˀ
lev	leːˀw
lev	lɛf
leve	leːʊ
leve	leːʋə
leven	lewn̩
leven	lewˀn̩
leven	leˀʋn̩
leven	leːʋn̩
leven	lɛfn̩
lever	lewˀɐ
lever	leʋeɐ̯ˀ
lever	leːwɐ
lever	leːʋɐ
levere	leveˀɐ
levere	lewˀɐɐ
leverpostej	lewˀʌposdɑjˀ
levn	lɛwˀn
levne	lɛwnə
levned	lɛwnð̩
levnedsmiddel	lɛwnð̩smiðˀl̩
levnet	lɛwnð̩
levnet	lɛwˀnð̩
levning	lɛwneŋ
lian	liæːˀn
liberalisme	lib̥ɑːɑlismə
liberalisme	lib̥əʁɑlismə
lide	liˀ
lide	liːðə
liden	liðð̩n
lider	liðˀɐ
lider	liˀðɐ
lidet	liðð̩d̥
lidt	led̥
lidt	lid̥
liechtensteiner	liɡd̥ənsd̥ɑɪ̯nʌ
lig	leɡ̊
lig	liˀ
lig	lɛɡ̊
lige	liːi
lige	liːə
ligeglad	liːəɡ̊lað̠ˠ
ligeledes	liːəleːðˠəs
ligesom	lisʌm
ligestilling	liːɪsd̥elˀeŋ
ligge	leɡ̊ə
ligge	lɛɡ̊ə
liggendefæ	leɡ̊ənəfɛˀ
ligne	liːnə
lignelse	liːnəlsə
lignelsen	liːnəlsəs
lignelser	liːnəlsɐ
lignelserne	liːnəlsɐnə
ligt	liɡ̊d̥
ligt	liˀd̥
like	lɑjɡ̊
lilje	liljə
lille	lill̩
lilleasien	liləæˀɕən
lim	liːˀm
line	liːnɘ
link	leŋɡ̊
linned	lenəð
liv	liwˀ
live	liːʊ
live	liːʊ̯ə
livegen	liweˀen
livegen	liweˀjən
livsforsikring	liʊ̯sfʌseɡ̊ʁiŋ
livsforsikring	liʊ̯sfʌseɡ̊ʁɛŋ
lobbye	lʌb̥iə
lobbye	lʌb̥iːˀə
lod	loðˀ
lod	lʌð
lod	lʌðˀ
lodde	lʌðə
loddekolbe	lʌðəkʰʌlb̥ə
lodden	lʌðn̩
lodden	lʌðən
loft	lʌfd
lokal	lokʰæːˀl
lokale	lokʰæːlə
lokale	lokʰæːˀlə
lokke	lʌɡ̊ə
lokum	lɔkʰɔm
lolland	lʌlanˀ
lomme	lʌmm̩
lommetørklæde	lʌmətˢɶɐ̯kʰl̥ɛːðə
lort	loɐ̯ˀd
louise	luiːsə
lov	lɒw
lov	lɔwˀ
lov	lɔˀw
love	lɔːʊ
love	lɔːʋə
loven	lɒwˀn̩
loven	lɔwˀn̩
loven	lɔˀʋn̩
lovlig	lɒwli
lovlige	lɒwlii
lovligt	lɒwlid̥
lovmæssig	lɒwmɛsi
lovmæssig	lɒwmɛˀsi
loyal	lʌjæːˀl
loyale	lʌjæːˀle
lud	luðˀ
ludder	luðˀɐ
lude	luːðə
luder	luðˀɐ
luder	luːðɐ
luft	lɔfd
luftkastel	lɔfd̥kʰasd̥ɛlˀ
lugt	lɔɡ̊d̥
lugte	lɔɡ̊d̥ə
lukke	lɔɡ̊ə
lun	luːˀn
lund	lɔnˀ
lune	luːnə
lunge	lɔŋə
lunken	lɔŋɡ̊ən
lut	lud̥
lutter	lud̥ɐ
lyd	lyðˀ
lygte	løɡ̊d̥ə
lykke	løɡ̊ə
lykkelig	løɡ̊əli
lykkes	løɡ̊əs
lykønske	løɡ̊ønˀsɡ̊ə
lykønskning	løɡ̊ønˀsɡ̊neŋ
lymfe	lømfə
lyn	lyːˀn
lyne	lyːnə
lys	lyˀs
lyse	lyːsə
lyseblå	lysəb̥lɔːˀ
lysegrøn	lysəɡ̊ʁɶnˀ
lyserød	lysəʁœðˀ
lyserødt	lysəʁœd
lyshåret	lyshɒˀɒð
lysning	lysneŋ
lysning	lyːsneŋ
lyssky	lyssɡ̊yːˀ
lyst	lysd̥
lyst	lyˀsd̥
lyst	løsd̥
lyste	lyːsd̥ə
lyste	løsd̥ə
lysten	løsd̥ən
lyster	lysd̥ɐ
lyster	løsd̥ɐ
lystig	løsd̥i
lyv	lywˀ
lyve	lyːʊ
lyve	lyːʋə
låg	lɔwˀ
låg	lɔˀw
låge	lɔːwə
lån	lɔˀn
låne	lɔːnə
lår	lɒˀ
lårben	lɒːb̥eːˀn
lårt	lɒːd̥
lås	lɔːˀs
læ	lɛˀ
læder	lɛðˀɐ
læg	lɛɡ̊
læg	lɛˀ
læg	lɛˀj
læg	lɛˀɡ̊
læge	lɛːjə
læge	lɛːɪ
læger	lɛːjɐ
læger	lɛːɐ
lægerne	lɛːjɐnə
lægerne	lɛːɐnə
lægge	lɛɡ̊ə
lægge	lɛːɡ̊ə
lægger	lɛɡ̊ɐ
lægt	lɛɡ̊d̥
lægt	lɛˀd̥
lægt	lɛˀjd̥
lægte	lɛɡ̊d̥ə
lækker	lɛɡ̊ɐ
læne	lɛːnə
lænestol	lɛːnəsd̥oːˀl
længde	lɛŋˀd̥ə
længe	lɛŋə
længes	lɛŋəs
længsel	lɛŋˀsəl
længtes	lɛŋd̥əs
lær	læɐ̯ˀ
lærd	læɐ̯ˀd̥
lærd	lɛɐ̯ˀd̥
lærde	læɐ̯ˀd̥ə
lærde	lɛɐ̯ˀd̥ə
lærdom	læɐ̯d̥ʌmˀ
lærdom	lɛɐ̯d̥ʌmˀ
lære	læːɐ
lære	lɛːɐ
lærer	læɐ̯ˀ
lærer	læːɐ
lærer	lɛːɐ
lærerinde	læːɐenə
lærerinde	lɛːɐenə
lærerne	læːɐnə
lærerne	lɛːɐnə
lærling	laɐ̯leŋ
lærred	læɐ̯ð̩
lært	læɐ̯ˀd̥
lært	lɛɐ̯ˀd̥
lærte	læɐ̯d̥ə
lærte	læɐ̯ˀd̥ə
lærte	lɛɐ̯d̥ə
lærte	lɛɐ̯ˀd̥ə
læs	lɛs
læs	lɛˀs
læse	lɛːsə
læsehest	lɛːsəhɛsd̥
læser	lɛˀsɐ
læser	lɛːsɐ
læsesal	lɛːsəsæˀl
læsse	lɛsə
læst	lɛsd̥
læst	lɛˀsd̥
læste	lɛsd̥ə
læste	lɛˀsd̥ə
læste	lɛːsd̥ə
løb	løwˀ
løb	løˀb̥
løbe	løːb̥ə
løbe	løːʊ
løber	løwˀɐ
løber	løˀb̥ɐ
løber	løːb̥ɐ
løbet	løwəð
løbet	løðð̩
løbet	løˀb̥əð
løbet	løːb̥əð
løg	lʌjˀ
løgn	lʌjˀn
løgner	lʌjnɐ
løj	lʌjˀ
løjpe	lʌjb̥ə
løjtnant	lʌjd̥nanˀd̥
løkke	løɡ̊ə
løn	lœnˀ
lønforhøjelse	lœnfʌhʌjˀəlsə
lørdag	lɶɐ̯d̥a
løse	løːsə
løsen	løːsən
løss	løs
løss	lœs
løst	løˀsd̥
løste	løˀsd̥ə
løste	løːsd̥ə
løve	løːʊ
løve	løːʋə
løvinde	løwenə
mad	mað
mad	maˀð
maddike	maðˠˀiɡ̊ə
madding	maðeŋ
madro	maðʁoːˀ
mafioso	mafioːso
mafioso	mɑfioːso
magasin	mɑɡ̊asiːˀn
mage	mæːjə
mage	mæːæ
mageløs	mæːjəløːˀs
magen	mæːjən
magen	mæːæn
mager	mæˀjɐ
mager	mæˀɐ
mager	mæˀɡ̊ɐ
mager	mæːjɐ
mager	mæːɐ
mager	mɑwˀɐ
magert	mæˀjɐd̥
magert	mæˀɐd̥
magert	mɑwˀɐd̥
magnesium	maʊ̯neˀɕɔm
magre	mæjʁʌ
magre	mæːʁʌ
magre	mɑwʁʌ
magt	mɑɡ̊d̥
magten	mɑɡ̊d̥n̩
magter	mɑɡ̊d̥ɐ
maile	mɛjlə
maj	mɑj
majonæse	mɑjonɛːsə
majsolie	mɑɪ̯ˀsoljə
makron	mɑkʰʁ̥oːˀn
maksime	mɑɡ̊siːmə
male	mæːlə
maler	mæːlɐ
maler	mæːˀlɐ
malke	malɡ̊ə
malm	malˀm
malmø	ma̝lmø
malstrøm	malsd̥ʁɶmˀ
malstrøm	mæːlsd̥ʁɶmˀ
man	man
man	mæˀn
mand	mæ̞nˀ
mandag	manˀd̥a
mandel	manˀəl
mandelolie	manˀl̩oljə
mandfolk	manfʌlˀɡ̊
mandig	mand̥i
mane	mæːnə
manen	mæːˀnən
manga	mɑŋɡ̊a
mange	mɑŋə
mangen	mɑŋən
mangle	mɑŋlə
mangt	mɑŋˀd̥
maniodepressiv	mæːˀnjod̥epʰʁ̥ɛsiwˀ
manke	mɑŋɡ̊ə
manko	mɑŋkʰo
manuskript	manusɡ̊ʁɛb̥d̥
maraton	mɑːˀɑtˢʌn
march	mɑːɕ
marchere	mɑɕeˀɐ
marcipan	mɑsipʰæːˀn
mareridt	mɑːɑʁid̥
margrete	mɑɡ̊ʁæːˀd̥ə
margrethe	mɑɡ̊ʁæːˀd̥ə
mariehøne	maʁiːˀəhœːnə
mariehøne	mɑʁiːˀəhœːnə
mark	mɑːɡ̊
marked	mɑːɡ̊ð̩
marker	mɑkʰeˀɐ̯
marker	mɑːɡ̊ɐ
markere	mɑkʰeˀɐ
marmelade	mɑməlæːðə
marsk	mɑːsɡ̊
marskal	mɑːɕal
marskal	mɑːɕalˀ
marsvin	mɑːsviːˀn
martre	mɑːtˢʁ̥ɐ
marts	mɑːd̥s
martyr	mɑːtˢyɐ̯ˀ
mase	mæːsə
maske	masɡ̊ə
masse	masə
masser	maseɐ̯ˀ
masser	masɐ
masturbere	masd̥uɐ̯b̥eːˀɐ
materiale	matˢəɐ̯iœːlə
materiale	mɑtˢʁiœːlə
matrone	matˢʁ̥oːnə
mave	mæːʊ
mave	mæːʋə
mayonnaise	mɑjonɛːsə
med	mɛð
medalje	med̥aljə
medaljon	med̥aljʌŋ
medarbejder	mɛðɑːb̥ɑjˀd̥ɐ
medens	meðˀəns
medie	meːˀd̥jə
meditation	med̥itˢaɕoːˀn
medium	meːˀd̥jɔm
medlem	mɛðlɛmˀ
medley	mɛd̥li
medtrafikant	mɛðtˢʁ̥ɑfikʰanˀd̥
megen	majən
megen	mɑjn̩
meget	mɑjd̥
meget	mɑðð̩
mejeri	mɑjɐʁiˀ
mejerier	mɑjɐʁiˀɐ
mejerierne	mɑjɐʁiˀɐnə
mejeriet	mɑjɐʁiˀəð
mele	meːlə
mellem	mɛlˀm̩
mellem	mɛlˀəm
mellemnavn	mɛləmnɑwˀn
mellemstation	mɛlm̩sd̥aɕoˀn
melodigrandprix	melod̥iɡ̊ʁɑnpʰʁ̥i
memorere	memoʁeːˀɐ
men	meːˀn
men	mɛn
menage	menæːɕə
mene	meːnə
menneske	mɛnn̩sɡ̊ə
menneske	mɛnsɡ̊ə
menneskene	mɛnn̩sɡ̊ənə
menneskene	mɛnsɡ̊nə
mennesker	mɛnn̩sɡ̊ɐ
mennesker	mɛnsɡ̊ɐ
menneskerne	mɛnn̩sɡ̊ɐnə
menneskerne	mɛnsɡ̊ɐnə
mennesket	mɛnn̩sɡ̊əð
mennesket	mɛnsɡ̊əð
mens	mɛns
mentor	mɛntˢɐ
menu	meny
menuen	menyn̩
mere	meːɐ
messe	mɛsə
messehagel	mɛsəhæˀjl̩
messehagel	mɛsəhæˀl̩
metafor	metˢafoːˀɐ̯
metal	metˢal
metallet	metˢalˀð̩
metode	meˀtˢoːðə
metodisk	metˢoːˀd̥isɡ̊
metodisk	metˢoːˀðisɡ̊
mette	mɛd̥ə
mf	ɛmɛf
micelle	miselə
middag	med̥a
middel	miðˀəl
middelalderlitteratur	miðˀəlalˀʌlidəʁɑtuɐ̯ˀ
middelhavet	miðəlhæːˀvəð
middelmådig	miðˀəlmɔːˀði
midler	miðlɐ
midtpunkt	med̥pʰɔŋˀd̥
mig	mɑj
migræne	miɡ̊ʁɛːnə
mikael	mikʰæːˀl
mikrobølge	mikʰʁ̥ob̥øljə
mikrobølgeovn	mikʰʁ̥ob̥øljəɒwˀn
mild	milˀ
mile	miːlə
miljø	miljø
millennium	milɛnˀiɔm
milliard	miliɑˀd̥
milliard	miljɑˀd̥
million	milioˀn
million	miljoˀn
min	miːˀn
minde	menə
mindes	menəs
mindre	mend̥ʁɐ
mine	miːnə
mine	miːn̩
minedrift	miːnəd̥ʁɛfd̥
minimælk	minimɛlˀɡ̊
mis	mis
misbruge	misbʁuˀə
mislykkes	misløɡ̊əs
mislykket	misløɡ̊əð
misse	misə
miste	mesd̥ə
mistelten	misd̥əltˢeːˀn
mistænke	mistɛŋˀɡə
misunde	misɔnˀə
mit	mid̥
mjød	mjøð
mjølner	mjølˀnɐ
mobbe	mʌb̥ə
mobber	mʌb̥ɐ
mobil	mob̥iːˀl
mobilisering	mobiliseˀɐ̯eŋ
mod	moðˀ
mod	moˀð
mode	moːðə
modificere	mod̥ifiseːˀɐ
modig	moːði
modstand	moðsd̥anˀ
modvillig	moðʋilˀi
mogens	mɔːʊ̯ns
mole	moːlə
molestere	moləsd̥eːˀɐ̯
mon	mɔn
monarki	monɑkʰiˀ
monne	mɔnə
monoteist	monoteisd̥
monstro	mɔnstˢʁ̥oˀ
monstro	mʌnstˢʁ̥oˀ
monument	monumɛ̝ˀnd̥
monumental	monuməntˢæːˀl
mord	moɐ̯ˀ
morder	moɐ̯d̥ɐ
morgen	mɒːɒn
morgenfrisk	mɒɒnfʁæsɡ
morgenmad	mɒːɒnmað
morgenmand	mɒɒnmanˀ
mormor	mɒˀmoɐ̯
moræne	moʁɛːnə
mos	moːˀs
mos	mɔs
mose	moːsə
moster	mʌsd̥ɐ
motion	moɕoːˀn
motivation	motˢivaɕoːˀn
motor	moːtˢɒ
mountainbike	mɑwntˢənb̥ɑjɡ̊
mudder	muðˀɐ
muddergrøft	muðˠˀɐɡ̊ʁœfd̥
muldvarp	mulʋɑːb̥
muldvarpe	mulʋɑːb̥ə
muldvarpen	mulʋɑːb̥ən
muldvarpene	mulʋɑːb̥ənə
muldvarper	mulʋɑːb̥ɐ
muldvarperne	mulʋɑːb̥ɐnə
mule	muːlə
mulig	muːli
mulighed	muːliheðˀ
mums	mɔmˀs
mund	mɔnˀ
mundharmonika	mɔnhɑmoːnikʰa
mundhugges	mɔnhɔɡ̊ə
mundtlig	mɔnd̥li
munk	mɔŋˀɡ̊
munke	mɔŋɡ̊ə
munken	mɔŋˀɡ̊ŋ̩
munken	mɔŋˀɡ̊ən
munter	mɔnˀd̥ɐ
munterhed	mɔnˀd̥ɐheðˀ
mur	muɐ̯ˀ
mur	muˀɐ̯
mure	muːɐ
murer	muːɐ
mus	muːˀs
museer	musɛːɐ
museerne	musɛːɐnə
museet	musɛːəð
museum	musɛːɔm
musik	musiɡ̊
musikfolk	musiɡ̊fʌlˀɡ̊
musket	musɡ̊ɛd̥
musketer	musɡ̊ətˢeːˀɐ̯
muskuløs	musɡ̊uløːˀs
musling	musleŋ
musvåge	musʋɔːwə
musvåge	musʋɔːʊ
mut	mud̥
mutant	mutˢanˀd̥
mutter	mud̥ɐ
mutter	mɔd̥ɐ
myg	myɡ̊
myg	myːˀ
myggenæs	myɡ̊ənɛs
mynde	mønə
myrde	myɐ̯d̥ə
myre	myːɐ
mysli	mysli
må	mɔˀ
måde	mɔːðə
måge	mɔːwə
mål	mɔˀl
måle	mɔːlə
måler	mɔːlɐ
måler	mɔːˀlɐ
målløs	mɔːlløˀs
målløs	mʌløˀs
målmand	mɔːlmanˀ
måne	mɔːnə
måned	mɔːnð̩
månefase	mɔːnəfæːsə
måneformørkelse	mɔːnəfɒmœ̞ɐ̯ɡ̊əlsə
måske	mosɡ̊eːˀ
måske	mɔsɡ̊e
måske	mɔsɡ̊eːˀ
måtte	mʌd̥ə
måttet	mʌd̥əð
mægtig	mɛɡ̊d̥i
mæle	mɛːlə
mælk	mɛlˀɡ̊
mælke	mɛlˀɡ̊ə
mælkebøtte	mɛlɡ̊əb̥ød̥ə
mælkechokolade	mɛlɡ̊ɔɕoɡ̊olæːðə
mælken	mɛlɡ̊ən
mælken	mɛlˀɡ̊ən
mælkevej	mɛlɡəvɑjˀ
mænd	mɛ̝nˀ
mængde	mɛŋˀd̥ə
mær	mæɐ̯ˀ
mær	mɛˀɐ̯
mærke	maɐ̯ɡ̊ə
mærkværdig	maɐ̯ɡ̊ʋaɐ̯ˀd̥i
mæslinger	mɛsleŋɐ
mæslinger	mɛsleŋˀɐ
mø	møˀ
møbel	møːˀb̥əl
møde	møːðə
mødes	møːðəs
mødre	møðʁɐ
mødte	mød̥ə
mødte	møˀd̥ə
mødte	møːd̥ə
mødtes	mød̥əs
mødtes	møːd̥əs
møg	mʌɪ̯
møl	møl
mønster	mønˀsd̥ɐ
mønstre	mønsd̥ʁɐ
mør	møɐ̯ˀ
mørbrad	møɐ̯ˀb̥ʁɑ
mørbrad	møɐ̯ˀb̥ʁɑð
mørbrad	møɐ̯ˀb̥ʁɑðˀ
mørk	mɶɐ̯ɡ̊
mørke	mɶɐ̯ɡ̊ə
mørkeræd	mɶɐ̯ɡ̊əʁaðˀ
mørkeræd	mɶɐ̯ɡ̊əʁɑðˀ
mørkhudet	mɶɐ̯ɡ̊huðˀəd̥
mørkhudet	mɶɐ̯ɡ̊huˀðəd̥
mørkhåret	mɶɐ̯ɡ̊hɒˀɒð
mørkning	mœ̞ɐ̯ɡ̊neŋ
mørne	møɐ̯nə
münchen	mønˀɕən
nabo	næːb̥o
nadver	naðvɐ
nagle	nɑwlə
nairobi	najʁoːb̥i
naiv	naiːˀw
nakkeost	nɑɡ̊əɔsd̥
nana	nana
napoleonshat	napʰoːˀljʌnshad̥
narko	nɑːkʰo
narkoman	nɑɡ̊omæːˀn
nation	naɕoˀn
national	naɕonæˀl
natklub	nad̥kʰlub̥
natugle	nad̥uːlə
natur	natˢuɐ̯ˀ
naturligvis	natˢuɐ̯liviːˀs
naturvidenskab	natˢuɐ̯ˀviðn̩sɡ̊æˀb̥
naturvidenskabsmand	natˢuɐ̯ˀviðn̩sɡ̊ab̥smanˀ
naust	nɑʊ̯ˀsd̥
nav	naw
nav	nawˀ
navle	nɑwlə
navnedag	nɑwnədæˀ
navneord	nɑwnəoɐ̯ˀ
nede	neːðə
nederdrægtig	neðɐd̥ʁaɡ̊d̥i
nedprioritere	neðpʁiɒiteˀɐ
nedsættende	neðsɛd̥ənə
neger	neːjɐ
negl	nɑjˀl
nej	nɑjˀ
neje	nɑjə
nektar	nɛɡ̊tˢɑːˀ
nektarin	nɛɡ̊tˢɑʁiːˀn
nem	nɛmˀ
nemme	nɛmə
net	nɛd̥
nettovægt	nɛtˢovɛɡ̊d̥
neutron	nøʊ̯tˢʁoˀn
neutrum	nœwtˢʁ̥ɔm
neutrum	nʌjtˢʁ̥ɔm
nevada	nevɛːdæ
nevada	nevɛːtæ
nevø	neʋø
ngo	ɛnɡ̊eoˀ
ni	niːˀ
nicolai	neɡ̊olaɪ̯
nicolaj	neɡ̊olaɪ̯
nidkær	niðˠkʰɛːˀɐ̯
niece	niɛːsə
nigger	neɡ̊ʌ
nikke	neɡə
nikkel	neɡ̊l̩̩
nikolai	neɡ̊olaɪ̯
nikolaj	neɡ̊olaɪ̯
niks	neɡ̊s
nil	niˀl
nilen	niˀln̩
niti	nitˢi
nitte	ned̥ə
nitten	ned̥n̩
nitten	nid̥n̩
niveau	nivo
nix	neɡ̊s
nogen	noən
nogen	noːn
nogensinde	noːənsenə
noget	nɔðð̩
nogle	noən
nogle	noːlə
nogle	noːn
nok	nʌɡ̊
nominativ	nominatˢiwˀ
nominativ	nɔminatˢiwˀ
nominere	nomineˀɐ
nonne	nʌnə
nonsens	nʌnˀsəns
nord	noɐ̯ˀ
norden	noˀɐn
norden	noːɐn
nordisk	noɐ̯d̥isɡ̊
nordkyst	noɐ̯kʰøsd̥
norge	nɒːwə
norge	nɒːʊ
norsk	nɒːsɡ̊
nu	nu
nukleon	nukʰleoˀn
nul	nɔl
nulpunkt	nɔlpʰɔŋˀd̥
numismatiker	numismæːˀtˢiɡ̊ɐ
nummer	nɔmˀɐ
numre	nɔmʁɐ
numrene	nɔmʁɐnə
nuttet	nud̥əð
ny	nyːˀ
nyd	nyðˀ
nyd	nyːˀð
nyde	nyːðə
nydelig	nyːðəli
nyfigen	nyfiːˀən
nyfødt	nyføˀd̥
nylig	nyːli
nymfe	nøɱfə
nymodens	nymoˀðɘns
nynne	nønə
nyse	nyːsə
nyt	nyd̥
nytte	nød̥ə
nytteløs	nød̥əløːˀs
nyttig	nød̥i
nytår	nyd̥ɒːˀ
nytårsaften	nyd̥ʌsɑfd̥ən
nytårsdag	nyd̥ʌsd̥æːˀ
nå	nɔˀ
nå	nʌ
nåde	nɔðð̩
nådig	nɔːði
nåede	nɔðð̩
nåede	nɔðˀð̩ð̩
nåede	nɔˀð̩ð̩
nået	nɔðˀð̩
nået	nɔˀð̩
når	nɒːˀ
næb	nɛ̝b̥ˀ
næbdyr	nɛːbdyɐ̯ˀ
nænne	nɛnə
næppe	nɛb̥ə
nær	næɐ̯ˀ
nær	næːˀɐ̯
nærhed	nɛɐ̯heðˀ
nærig	nɛːɐ̯i
næse	nɛːsə
næste	nɛsd̥ə
næsten	nɛsd̥ən
nævn	nɛʊ̯ˀn
nævne	nɛʊ̯nə
nød	nøðˀ
nøddeskal	nøðəsɡ̊alˀ
nøde	nøːðə
nødt	nøðˀ
nødt	nøˀd̥
nødte	nøːd̥ə
nødtørft	nøðtˢɶɐ̯fd̥
nødtørftig	nøðtˢɶɐ̯fd̥i
nødvendig	nøðʋɛnˀd̥i
nødvendige	nøðʋɛnˀd̥ii
nødvendigt	nøðʋɛnˀd̥id̥
nødvendigvis	nøðʋɛnˀd̥iʋiˀs
nøgen	nʌjən
nøgle	nʌjlə
nøgleroman	nʌjləʁomæːˀn
nøgtern	nøɡ̊d̥ɐn
nøgtern	nøɡ̊tˢaɐ̯ˀn
nøgtern	nœɡ̊d̥ɐn
nørd	nœ̞ɐ̯ˀd̥
nørre	nɶɐ̯ɐ
nørrebro	nœ̞ɐ̯ɐb̥ʁoːˀ
nøs	nøːˀs
od	ʌðˀ
odde	ʌðð̩
odder	ʌðˀɐ
ode	oːðə
odense	oðˀn̩sə
odense	oˀðənə
odense	oːonsə
odysseus	od̥ysœwˀs
odør	od̥œːɐ̯
odør	od̥œ̞ːɐ̯
offentlig	ʌfn̩li
offentlig	ʌfənd̥li
offentlige	ʌfn̩lii
offentlige	ʌfənd̥liə
offentligt	ʌfn̩lid̥
offentligt	ʌfənd̥lid̥
offergørelse	ʌfɐkɶɐ̯l̩sə
ofte	ʌfd̥ə
oftest	ʌfd̥əsd̥
og	ɒw
og	ʌ
også	ʌsə
okse	ʌɡ̊sə
olav	olɑw
olav	olɑwˀ
old	ʌlˀ
olddansk	ʌld̥anˀsɡ̊
oldefar	ʌləfɑː
oldemor	ʌləmoɐ̯
oldgræsk	ʌlɡ̊ʁasɡ̊
oldgræsk	ʌlɡ̊ʁɑsɡ̊
oldgræske	ʌlɡ̊ʁasɡ̊ə
oldgræske	ʌlɡ̊ʁɑsɡ̊ə
olding	ʌld̥eŋ
oldnordisk	ʌlnoɐ̯ˀd̥isɡ̊
oldtid	ʌltˢiðˀ
oldtidskundskab	ʌltˢiðskʰɔnsɡ̊æˀb̥
olie	oljə
oliven	oliwˀn̩
oliven	oliˀʋn̩
olivengren	oliwˀn̩ɡ̊ʁæˀn
olivengren	oliˀʋn̩ɡ̊ʁæˀn
olivenolie	oliwˀn̩oljə
olivenolie	oliˀʋn̩oljə
olympen	olømˀb̥ən
olympisk	olømˀb̥isɡ̊
om	ʌm
ombudsmand	ʌmb̥uðsmanˀ
ombære	ʌmb̥ɛːˀɐ
omgang	ʌmɡ̊ɑŋˀ
omgikkes	ʌmɡ̊iɡ̊əs
omgåedes	ʌmɡ̊ɔˀð̩s
omgåedes	ʌmɡ̊ɔˀəðəs
omgående	ʌmɡ̊ɔˀnə
omgående	ʌmɡ̊ɔˀənə
omgås	ʌmɡ̊ɔˀs
omgængelig	ʌmɡ̊ɛŋˀli
omgængelig	ʌmɡ̊ɛŋˀəli
omkring	ʌmkʁɛ̝ŋ
omkring	ʌmkʁɛ̝ŋˀ
omsonst	ʌmsʌnˀsd̥
omsorg	ʌmsɒːˀw
onanere	onaneːˀɐ
onanere	ʌnaneːˀɐ
onani	onaniːˀ
onani	ʌnaniːˀ
ond	ɔnˀ
onde	ɔnə
onkel	ɔŋˀɡ̊l̩
onsdag	ɔnˀsd̥a
opdrage	ʌb̥d̥ʁɑːˀwə
opdukke	ʌb̥d̥ɔɡ̊ə
opfinde	ʌb̥fenˀə
ophobe	ʌb̥hoːb̥ə
opholdstilladelse	ʌphʌlstsʰelæˀðl̩sə
ophøre	ʌb̥høːˀɐ
oplagt	ʌb̥lɑɡ̊d̥
oplukke	ʌb̥lɔɡ̊ə
oplyse	ʌb̥lyˀsə
oppebie	ʌb̥əb̥iːi
opportun	ob̥ɐtˢuːˀn
opportun	ʌb̥ɐtˢuːˀn
opretholde	ʌbʁadhʌlˀə
oprette	ʌbʁadə
oprinde	ʌb̥ʁænə
oprindelig	ʌb̥ʁænˀn̩li
oprindelse	ʌbʁænˀl̩sə
oprør	ʌb̥ʁɶɐ̯ˀ
oprør	ʌb̥ʁɶˀɐ̯
oprøre	ʌb̥ʁɶˀɐ
opsigt	ʌb̥seɡ̊d̥
opsigtsvækkende	ʌb̥seɡ̊d̥sʋɛɡ̊n̩nə
opsigtsvækkende	ʌb̥seɡ̊sʋɛɡ̊n̩nə
opslag	ʌb̥sl̥æˀ
opslag	ʌb̥sl̥æˀj
opslagstavle	ʌb̥sl̥æjstˢɑwlə
opslagstavle	ʌb̥sl̥æstˢɑwlə
opslagsværk	ʌb̥sl̥æjsʋaɐ̯ɡ̊
opslagsværk	ʌb̥sl̥æsʋaɐ̯ɡ̊
opstanden	ʌb̥sd̥anˀən
opstige	ʌb̥sd̥iˀə
opstigen	ʌb̥sd̥iˀən
opstigende	ʌb̥sd̥iˀənə
opstå	ʌb̥sd̥ɔˀ
optrådt	ʌb̥tˢʁ̥ʌd̥
optrådte	ʌb̥tˢʁ̥ʌd̥ə
optrådtes	ʌb̥tˢʁ̥ʌd̥əs
optræd	ʌb̥tˢʁ̥aðˀ
optræd	ʌb̥tˢʁ̥ɛˀð
optræde	ʌb̥tˢʁ̥aðˀə
optræde	ʌb̥tˢʁ̥ɛˀðə
optræden	ʌb̥tˢʁ̥aðˀən
optræden	ʌb̥tˢʁ̥ɛˀðən
optrædende	ʌb̥tˢʁ̥ɛˀðənə
optræder	ʌb̥tˢʁ̥aðˀɐ
optræder	ʌb̥tˢʁ̥ɛˀðɐ
optrædes	ʌb̥tˢʁ̥aðˀəs
optrædes	ʌb̥tˢʁ̥ɛˀðəs
opvakt	ʌb̥ʋɑɡ̊d̥
opvække	ʌb̥ʋɛɡ̊ə
ord	oɐ̯ˀ
ordblind	oɐ̯b̥lenˀ
ordbog	oɐ̯b̥ɔwˀ
ordbog	oɐ̯b̥ɔˀw
orden	ɒˀd̥n̩
ordentlig	ɒːˀd̥ənli
ordforråd	oɐ̯fʌʁɔðˀ
ordforråd	oɐ̯fʌʁɔˀð
ordføjning	oɐ̯fʌjneŋ
ordklasse	oɐ̯kʰlasə
ordkløver	oɐ̯kʰløːwɐ
ordne	ɒːd̥nə
ordne	ɒːnə
ordre	ɒˀd̥ʁɐ
ordspil	oɐ̯sb̥el
ordspillene	oɐ̯sb̥elˀɭ̩nə
ordspillenes	oɐ̯sb̥elˀɭ̩nəs
ordspillet	oɐ̯sb̥elˀð̩
ordsprog	oɐ̯sb̥ʁɔwˀ
ordsprog	oɐ̯sb̥ʁɔˀw
organisator	ɒːɡanisæːtɐ
organisme	ɒɡ̊anismə
organist	ɒːɡanisd̥
orgasme	ɒːɡæs̬mə
orgie	ɒːˀɡ̊jə
orientering	ɒiəntˢeːˀɐ̯eŋ
orkestergrav	ɒkʰɛsd̥ɐɡ̊ʁɑwˀ
orm	oɐ̯ˀm
orne	ɒːnə
os	oːˀs
os	ʌs
ost	oˀsd̥
ost	ɔsd̥
otte	ɔːd̥ə
otte	ʌd̥ə
ottesang	ʌd̥əsɑŋˀ
otti	ɔtˢi
otti	ʌtˢi
overbid	ɒwɐb̥ið
overflod	ɒwɐfloˀð
overflødig	ɒwɐfløˀði
overfor	ɒwˀɐfɒ
overhovedet	ɔuəʀhoːðəd
overkrop	ɒwɐkʰʁ̥ʌb̥
overlagt	ɒwɐlɑɡ̊d̥
overlegen	ɒwɐleˀjen
overlegen	ɒwɐlɑjˀən
overlevende	ɒwɐleːˀvənə
overlægge	ɒwɐlɛɡ̊ə
overmorgen	ɒwˀɐmɒɒn
overnatte	ɒwɐnad̥ə
overraske	ɒwɐʁɑsɡ̊ə
overskrævs	ɒwɐsɡ̊ʁawˀs
overskuelig	ɒwɐsɡ̊uːˀəli
overspringshandling	ɒʊ̯ɐsb̥ʁæŋˀshanleŋ
oversætte	ɒwɐsɛd̥ə
oversættelse	ɒwɐsɛd̥l̩sə
oversættelseslån	ɒwɐsɛd̥l̩səslɔˀn
oversætter	ɒwɐsɛd̥ɐ
overtro	ɒwɐtˢʁ̥oːˀ
overveje	ɒwɐʋɑjˀə
overvejelse	ɒwɐʋɑjˀəlsə
overvejende	ɒwɐʋɑjˀənə
overvågningslisten	ɒʊ̯ɐʋɔʊ̯ˀneŋslesd̥n̩
overvægt	ɒwɐʋɛɡ̊d̥
overvægtig	ɒwɐʋɛɡ̊d̥i
overvælde	ɑwɐʋɛlˀə
overvættes	ɒwɐʋɛd̥ə
ovn	ɒwˀn
ozon	osoˀn
padde	pʰaðð̩
padde	pʰaðə
paddehat	pʰaðð̩had̥
paddel	pʰaðˀəl
pagaj	pʰaɡ̊ɑjˀ
pagaj	pʰɑɡ̊ɑjˀ
pakken	pʰɑɡ̊ŋ̩
palaver	pʰalæˀwɐ
palaver	pʰalɒwˀɐ
palmeolie	pʰalməoljə
palæ	pʰalɛːˀ
palæstinenser	pʰaləsd̥inɛnˀsɐ
palæstinensisk	pʰaləsd̥inɛnˀsisɡ̊
pande	pʰanə
pandekage	pʰanəkʰæːjə
pander	pʰanə
panere	pʰaneːˀɐ
panser	pʰanˀsɐ
pap	pʰɑb̥
papegøje	pʰab̥əɡ̊ʌjə
papir	pʰapʰiɐ̯ˀ
papir	pʰapʰiːˀɐ̯
par	pʰɑ
par	pʰɑˀ
par	pʰɑː
paradoks	pʰɑɑd̥ʌɡ̊s
parallel	pʰɑɑlɛlˀ
parallelle	pʰɑɑlɛlˀə
parallellen	pʰɑɑlɛlˀən
paralleller	pʰɑɑlɛlˀɐ
parallellerne	pʰɑɑlɛlˀɐnə
parallelt	pʰɑɑlɛlˀd̥
paraply	pʰɑɑpʰl̥yˀ
parat	pʰɑʁɑˀd̥
paratakse	pʰɑːɑtˢɑɡ̊sə
parcel	pʰɑsɛlˀ
parcelhus	pʰɑsɛlˀhuˀ
parentes	pʰɑɑntˢeˀs
paris	pʰɑʁiˀs
paris	pʰɑːis
park	pʰɑːɡ̊
parker	pʰɑkʰeɐ̯ˀ
parker	pʰɑːɡ̊ɐ
parre	pʰɑːɑ
parti	pʰatˢiːˀ
partikel	pʰɑtˢiɡ̊əl
partnerskab	pɑːdnʌsɡæˀb
parvis	pʰɑːviːˀs
paryk	pʰɑʁœɡ̊
passer	pʰaseɐ̯ˀ
passer	pʰasɐ
passere	pʰaseːˀɐ
passere	pʰasɐːɐ
passiv	pʰasiwˀ
password	pʰɑːswœːd̥
pastel	pʰasd̥ɛlˀ
pat	pʰad̥
pate	pʰatˢe
pateen	pʰatˢeːˀn̩
patetisk	pʰatˢeːˀtˢisɡ̊
patient	pʰaɕɛnˀd̥
patte	pʰad̥
patte	pʰad̥ə
pattedyr	pʰad̥əd̥yɐ̯ˀ
paté	pʰatˢe
patéen	pʰatˢeːˀn̩
paulun	pɑwluˀn
pauver	pʰoːˀvɐ
pauver	pʰɔːˀvɐ
pave	pʰæːwə
peanutbutter	pʰiːnʌb̥b̥ʌd̥ɐ
peb	pʰewˀ
peb	pʰeˀb̥
peber	pʰewɐ
peberkværn	pʰeʊ̯ɐkʰʋæɐ̯ˀn
pebet	pʰeːb̥əð
pebet	pʰeːwð̩
pedel	pʰed̥ɛlˀ
peg	pʰɑjˀ
pege	pʰɑjə
pegefinger	pʰɑjəfeŋɐ
peloponnes	pʰelopʰoneˀs
pels	pʰɛlˀs
pen	pʰɛnˀ
pendant	pʰɑŋd̥ɑŋ
penge	pʰɛŋŋ̩
penge	pʰɛŋə
penne	pʰɛnə
penneven	pʰɛnəvɛn
penning	pʰɛneŋ
pensel	pʰɛnˀsl̩
pensum	pʰɛnsɔm
per	pʰeɐ̯
perfektionist	pʰæɐ̯fəɡ̊ɕonismə
periferi	pʰeɐ̯ifeʁiːˀ
periodisk	pʰeɐ̯ioːˀðisɡ̊
periodisk	pʰæɐ̯ioːˀðisɡ̊
periskop	pʰeɐ̯isɡ̊oːˀb̥
perker	pʰæɐ̯ɡ̊ɐ
perker	pʰæɐ̯ˀɡ̊ɐ
perle	pʰæɐ̯lə
pest	pʰɛsd̥
peter	pʰed̥ɐ
peter	pʰeːˀd̥ɐ
petersen	pʰed̥ɐsn̩
petersen	pʰeˀd̥ɐsn̩
pib	pʰiwˀ
pibe	pʰiːb̥ə
pibe	pʰiːʊ
piber	pʰiwˀɐ
piber	pʰiˀb̥ɐ
piber	pʰiːb̥ɐ
piberi	pʰiʊ̯ɐʁiːˀ
pig	pʰiɡ̊
pige	pʰiːi
pigen	pʰiːn̩
pigtråd	pʰiɡ̊tˢʁ̥ɔðˀ
pigtråd	pʰiɡ̊tˢʁ̥ɔːˀð
pik	pʰeɡ̊
pik	pʰiɡ̊
pikhoved	pʰeɡ̊hoːðð̩
pil	pʰelˀ
pil	pʰiːˀl
pile	pʰiːlə
pilgrim	pʰilɡ̊ʁɛm
pilgrim	pʰilɡ̊ʁɛmˀ
pilgrim	pʰiːlɡ̊ʁɛm
pilgrim	pʰiːlɡ̊ʁɛmˀ
pille	pʰelə
piller	pʰelɐ
pils	pʰilˀs
pils	pʰiːˀls
pincet	pʰensɛd̥
pind	pʰenˀ
pindsvin	pʰensviːˀn
pine	pʰiːnə
piner	pʰiːnɐ
piner	pʰiːˀnɐ
pingpong	pʰeŋpʰʌŋ
pinje	pʰinjə
pinlig	pʰiːnli
pinlige	pʰiːnlii
pinligere	pʰiːnliɐɐ
pinligst	pʰiːnlisd̥
pinligste	pʰiːnlisd̥ə
pinligt	pʰiːnlid̥
pinse	pʰensə
pinselilje	pʰensəliljə
pip	pʰib̥
pirat	pʰiʁɑːˀd̥
pisse	pʰesə
pistol	pʰisd̥oːˀl
pittoresk	pʰitˢoʁæsɡ̊
piv	pʰiwˀ
pizza	pʰid̥sa
pjat	pʰj̊ad̥
pjece	pʰj̊ɛːsə
placere	pʰl̥aseˀɐ
plads	pʰl̥as
plag	pʰlæjˀ
plage	pʰlæːjə
planche	pʰlɑŋɕɘ
plask	pʰl̥asɡ̊
plaske	pʰl̥asɡ̊ə
plat	pʰl̥ad̥
platfod	pʰlad̥foːˀð
platfodet	pʰlad̥foːˀðəd̥
platon	pʰl̥æːtˢʌn
plattysk	pʰl̥ad̥tˢysɡ̊
pleje	pʰl̥ɑːɪ
pligt	pʰl̥eɡ̊d̥
plombe	pʰlɔmb̥ə
plombere	pʰl̥ɔmb̥eːˀɐ
plyndre	pʰlønʁɐ
point	pʰoɛŋ
pointe	pʰoɛŋd̥ə
pointe	pʰʌjnd̥ə
pokal	pʰokʰæːˀl
pokeransigt	pʰoːˀɡ̊ɐanseɡ̊d̥
pokerfjæs	pʰoːˀɡ̊ɐfj̊ɜˀs
pokker	pʰʌɡ̊ɐ
pokkers	pʰʌɡ̊ɐs
polak	pʰolɑɡ̊
police	pʰoliːsə
politi	pʰolitˢiˀ
politibetjent	pʰolitˢib̥etˢjɛnˀd̥
politik	pʰolitˢiɡ̊
politiker	pʰolid̥iɡ̊ɒ
politisk	pʰolid̥isɡ̊
politistation	pʰolitˢisd̥aɕoˀn
polsk	pʰoːˀlsɡ̊
pomfrit	pʰʌmfʁid̥
pomp	pʰʌmˀb̥
porcelæn	pʰɒsəlɛːˀn
pore	pʰoːɐ
porno	pʰɒːno
pornofilm	pʰɒːnofilm
pornografi	pʰɒnoɡ̊ʁɑfiːˀ
porre	pʰoːɐ
port	pʰoɐ̯ˀd̥
portræt	ɒtˢʁ̥ad̥
portugisisk	pʰɒtˢuɡ̊iːˀsisɡ̊
pose	pʰoːsə
post	pʰʌsd̥
postalveolar	pʰʌsd̥alveolɑːˀ
postbud	pʰʌsd̥b̥uð
postbude	pʰʌsd̥b̥uːðə
postfaktuel	pʰɔˀsd̥fɑɡ̊tˢuɛlˀ
potentat	pʰotˢəntˢæːˀd̥
poul	pɒʊ̯l
pragt	pʰʁ̥ɑɡ̊d̥
pragtfuld	pʰʁ̥ɑɡ̊d̥fulˀ
praksis	pʰʁ̥ɑɡ̊sis
praktisk	pʰʁ̥ɑɡ̊d̥isɡ̊
present	pʰʁ̥ɛsɑŋ
presse	pʰʁ̥asə
presse	pʰʁ̥ɑsə
prik	pʰʁ̥æɡ̊
primitiv	pʁimitˢʰiʊ̯ˀ
primær	pʰʁ̥imɛɐ̯ˀ
primær	pʰʁ̥imɛːˀɐ̯
primær	pʰʁ̥iːmɛɐ̯ˀ
primær	pʰʁ̥iːmɛːˀɐ̯
princip	pʁɛ̝nsib̥
prins	pʰʁ̥ænˀs
prinsesse	pʰʁ̥ænsɛsə
prioritere	pʁiɒiteˀɐ
pris	pʰʁiːˀs
prise	pʰʁ̥iːsə
proaktiv	pʰʁ̥oɑɡ̊tˢiwˀ
proaktiv	pʰʁ̥oːˀɑɡ̊tˢiwˀ
probat	pʰʁ̥ob̥æːˀd̥
procent	pʁ̥osɛnˀd̥
producer	pʰʁ̥od̥juːsɐ
producer	pʰʁ̥od̥useɐ̯ˀ
producer	pʰʁ̥od̥useːɐ̯
producere	pʰʁ̥od̥juːsɐɐ
producere	pʰʁ̥od̥useːˀɐ
promiskuøs	pʰʁ̥omisɡ̊uøːˀs
pronomen	pʰʁ̥onoːmən
propel	pʰʁ̥opɛlˀ
propeller	pʰʁ̥opɛlˀɐ
proper	pʰʁ̥oːˀb̥ɐ
prosadigt	pʰʁ̥oːsad̥eɡ̊d̥
prosaisk	pʰʁ̥osɑjˀisɡ̊
protoindoeuropæisk	pʰʁ̥otˢoend̥oœwʁopʰɛˀisɡ̊
proton	pʰʁotˢoˀn
prud	pʰʁ̥uðˀ
prud	pʰʁ̥uˀð
prut	pʰʁ̥ud̥
prutten	pʰʁ̥ud̥ən
præcis	pʰʁ̥æsiˀs
prædike	pʰʁ̥aðɡ̊ə
prædike	pʰʁ̥æːɡ̊ə
prædike	pʰʁ̥ɛðð̩ɡ̊ə
præfiks	pʰʁ̥ɛfeɡ̊s
prægnant	pʰʁ̥ɛjnanˀd̥
prægnant	pʰʁ̥ɛɡ̊nanˀd̥
prægtig	pʰʁ̥aɡ̊d̥i
præposition	pʰʁ̥ɛpʰosiɕoːˀn
præsens	pʰʁ̥ɛsɛnˀs
præsens	pʰʁ̥ɛˀsəns
præsent	pʰʁ̥ɛsɛnˀd̥
præst	pʰʁ̥asd̥
præst	pʰʁ̥ɑsd̥
prøve	pʰʁ̥œːʊ
prøve	pʰʁ̥œːʋə
pseudonym	sœwd̥onyːˀm
psyke	syɡ̊ə
psykiater	syɡ̊iæˀd̥ɐ
psykiatri	syɡ̊iatˢʁ̥iˀ
psykisk	syɡ̊isɡ̊
psykologi	syɡ̊oloɡ̊iːˀ
psykose	sykʰoːsə
ptolemæisk	tˢoləmɛˀisɡ̊
puddel	pʰuðˀəl
pude	pʰuːðə
puh	pʰuː
pule	pʰuːlə
pulver	pʰɔlˀvɐ
pulvere	pʰɔlˀvɐɐ
pulveret	pʰɔlˀvɐð̩
pulverne	pʰɔlˀvɐnə
pumpe	pʰɔmb̥ə
pund	pʰunˀ
punkt	pʰɔŋˀd̥
punktlig	pɔŋd̥li
punktum	pʰɔŋtˢɔm
pupil	pʰupʰilˀ
pure	pʰuːɐ̯
pure	pʰyʁæ
purløg	pʰuɐ̯lʌɪ̯ˀ
putte	pʰud̥ə
pygmæ	pʰyɡ̊mɛˀ
pyjamas	pʰyjæːmas
pynt	pʰønˀd̥
pynte	pʰønd̥ə
på	pʰɔ
på	pʰɔˀ
påfugl	pʰʌfuːˀl
påklædning	pʰʌkʰl̥ɛðˀneŋ
påklædt	pʰʌkʰl̥ɛˀd̥
pålagde	pʰʌlæˀæ
pålagde	pʰʌlæˀə
pålagt	pʰʌlɑɡ̊d̥
pålagte	pʰʌlɑɡ̊d̥ə
pålæg	pʰʌlɛɡ̊
pålæg	pʰʌlɛˀɡ̊
pålægge	pʰʌlɛɡ̊ə
pålæggene	pʰʌlɛˀɡ̊ənə
pålægger	pʰʌlɛɡ̊ɐ
pålægget	pʰʌlɛˀɡ̊əð
påmindelse	pʰʌmenˀelsə
påske	pʰɔːsɡ̊ə
pædagog	pʰɛd̥aɡ̊oˀ
pædagogik	pʰɛd̥aɡ̊oɡ̊iɡ̊
pæderast	pʰɛd̥əʁɑsd̥
pædofil	pʰɛd̥ofiːˀl
pæn	pʰɛːˀn
pæne	pʰɛːnə
pæne	pʰɛːn̩
pøj	pʰʌj
pølse	pʰølsə
qua	kʰvæːˀ
quiz	kʰvis
quiz'	kʰvis
rabarber	ʁɑb̥ɑˀb̥ɐ
race	ɹɛjs
race	ʁɑːsə
race	ʁɛˀs
race	ʁɛːsə
racer	ʁɑːsɐ
racer	ʁɛˀsɐ
racer	ʁɛːsɐ
rad	ʁɑð
rad	ʁɑˀð
radbrække	ʁɑðb̥ʁaɡ̊ə
radbrækket	ʁɑðb̥ʁaɡ̊əð
radikal	ʁɑd̥ikʰæːˀl
radioaktiv	ʁɑd̥joɑɡ̊tˢiwˀ
radioaktiv	ʁɑːˀd̥joɑɡ̊tˢiwˀ
radmager	ʁɑðmæˀjɐ
radmager	ʁɑðmɑwˀɐ
rage	ʁɑːʊ
ragede	ʁɑwð̩ð̩
ragelse	ʁɑːwl̩sə
rager	ʁɑwɐ
raget	ʁɑwð̩
ragout	ʁɑɡ̊u
ragout'en	ʁɑɡ̊uːˀn̩
ragout'er	ʁɑɡ̊uːˀɐ
ragouten	ʁɑɡ̊uːˀn̩
ragouter	ʁɑɡ̊uːˀɐ
rak	ʁɑɡ̊
rakt	ʁɑɡ̊d̥
rakte	ʁɑɡ̊d̥ə
ral	ʁɑlˀ
rambuk	ʁɑmb̥ɔɡ̊
ran	ʁɑːˀn
randers	ʁɑnɐs
randt	ʁɑnˀd̥
rane	ʁɑːnə
rang	ʁɑŋˀ
rapsolie	ʕɑb̥soljə
rar	ʁɑːˀ
raritet	ʁɑitˢeːˀd̥
ras	ʁɑːˀs
rase	ʁɑːsə
rasmussen	ʁɑsmusn̩
rat	ʁɑd̥
ratificere	ʁɑd̥ifiseːˀɐ
rationel	ʁɑɕonɛlˀ
rav	ʁɑw
rav	ʁɑːˀw
rave	ʁɑːwə
ravn	ʁɑʊ̯ˀn
realist	ʁɛalisd̥
recept	ʁɛsɛb̥d̥
red	ʁæðˀ
redde	ʁæðð̩
rede	ʁæðð̩
rede	ʁæˀ
redigere	ʁæd̥iɡ̊eːˀɐ
reel	ɹiːl
reel	ʁeɛlˀ
reel	ʁiːl
reel	ʁiːˀl
reel	ʁɛɛlˀ
referendum	ʁɛfəʁand̥ɔm
reform	ʁɛfɒˀm
refræn	ʁæfr̥aŋ
regel	ʁæˀl
regel	ʁɛjˀəl
regelen	ʁæˀlən
regelen	ʁɛjˀlən
regent	ʁɛɡ̊ɛnˀd̥
regering	ʁæɡeɐ̯eŋ
reglen	ʁæˀlən
reglen	ʁɛjˀlən
regler	ʁæˀlɐ
regler	ʁɛjˀlɐ
regn	ʁɑɪ̯ˀn
regnbue	ʁɑjnb̥uːə
regne	ʁɑjnə
regnskab	ʁɑjnsɡ̊æˀb̥
reje	ʁɑjə
reje	ʁɑːɪ
rejse	ʁɑjsə
rejsebureau	ʁɑjsəb̥yʁo
rejser	ʁɑjsə
rejser	ʁɑjˀsə
rejst	ʁɑjˀsd̥
rejste	ʁɑjsd̥ə
reklame	ʁɛklæːmə
rekonvalescent	ʁɛkʰʌnvaləsɛnˀd̥
rektor	ʁaɡ̊tˢɒ
rekvirere	ʁɛkʰviʁɛːˀɐ
relativ	ʁɛlatˢiʊ̯ˀ
religion	ʁɛliɡjoˀn
religiøs	ʁæliɡ̊jøːˀs
rem	ʁamˀ
rem	ʁɑmˀ
remonce	ʁæmʌŋsə
remoulade	ʁɛmulæːðə
ren	ʁæˀn
rende	ʁanə
rende	ʁɑnə
rendte	ʁand̥ə
rendte	ʁɑnd̥ə
renlig	ʁæːnli
rensdyr	ʁanˀsd̥yɐ̯ˀ
rensdyr	ʁɑnˀsd̥yɐ̯ˀ
rense	ʁansə
rense	ʁɑnsə
rent	ʁæˀnd̥
rente	ʁand̥ə
rente	ʁɑnd̥ə
reol	ʁæjoˀl
reol	ʁæoˀl
reparere	ʁæb̥əʁæːˀɐ
repetere	ʁɛb̥ətˢeːˀɐ
repræsentation	ʁapʰʁ̥asəntˢaɕoːˀn
repræsentation	ʁɛpʰʁ̥ɛsəntˢaɕoːˀn
republik	ʁɛpʰub̥liɡ̊
resistor	ʁasisd̥ʌ
resonere	ʁæsoneˀɐ
respektive	ʁæsb̥əɡ̊tˢiːˀvə
ressource	ʁɛsuɐ̯sə
rest	ʁasd̥
rest	ʁɑsd̥
restaurant	ʁɛsd̥oʁɑŋ
restauranten	ʁɛsd̥oʁɑŋˀŋ̩
restauranten	ʁɛsd̥oʁɑŋˀən
restauranter	ʁɛsd̥oʁɑŋˀɐ
resumere	ʁæsymeːˀɐ
resurse	ʁɛsuɐ̯sə
ret	ʁad̥
ret	ʁɑd̥
retning	ʁad̥neŋ
retning	ʁɑd̥neŋ
rets	ʁad̥s
rets	ʁɑd̥s
retslig	ʁad̥sl̥i
retslig	ʁɑd̥sl̥i
retsløs	ʁad̥sløˀs
retsløs	ʁɑd̥sløˀs
retssal	ʁad̥sæˀl
retssal	ʁɑd̥sæˀl
rette	ʁad̥ə
rette	ʁɑd̥ə
rettelse	ʁad̥l̩sə
rettelse	ʁɑd̥l̩sə
retten	ʁad̥n̩
retten	ʁɑd̥n̩
retter	ʁad̥ɐ
retter	ʁɑd̥ɐ
retterne	ʁad̥ɐnə
retterne	ʁɑd̥ɐnə
rev	ʁæw
rev	ʁæwˀ
rev	ʁæˀw
reven	ʁæːwn̩
revidere	ʁævid̥eːˀɐ
revne	ʁawnə
revne	ʁæwnə
revolution	ʁɛvoluɕoːˀn
revolutionere	ʁɛvoluɕoneːˀɐ
revolutionær	ʁɛvoluɕonɛːˀɐ̯
revy	ʁævy
rhesusabe	ʁɛsusæːb̥ə
rhin	ʁiˀn
rhinen	ʁiˀnn̩
ri	ʁiːˀ
ribbe	ʁib̥ə
ribben	ʁib̥eˀn
ribben	ʁib̥m̩
ribbenssteg	ʁib̥ensd̥ɑjˀ
rid	ʁiðˀ
ridder	ʁiðˀɐ
ride	ʁiðð̩
ridt	ʁid̥
rier	ʁiɐ̯ˀ
rier	ʁiːˀɐ̯
rig	ʁiˀ
rig	ʁɛɡ̊
rigdom	ʁiːd̥ʌmˀ
rige	ʁiːə
rigsdagen	ʁisd̥æˀən
rigsdaler	ʁisd̥æːlɐ
rigsdansk	ʁisd̥anˀsɡ̊
rigt	ʁiɡ̊d̥
rigt	ʁiˀd̥
rigtig	ʁæɡ̊d̥i
rimelig	ʁiːməli
rimeligt	ʁiːməlid̥
rinde	ʁænə
ring	ʁæŋˀ
rir	ʁiɐ̯ˀ
rir	ʁiːˀɐ̯
ris	ʁiːˀs
risalamande	ʁisalamɑŋ
riste	ʁɛsd̥ə
risvin	ʁiːsʋiːˀn
ritual	ʁituæˀl
rive	ʁiːʊ
rive	ʁiːʋə
robot	ʁobʌd
rod	ʁoðˀ
rod	ʁoˀð
rode	ʁoːðə
roer	ʁoːɐ
roer	ʁoːˀɐ
rogn	ʁɒʊ̯ˀn
rokade	ʁokʰæːðə
rollemodel	ʁʌləmod̥ɛlˀ
rollespil	ʁʌləsb̥el
rom	ʁʌmˀ
romer	ʁoˀmɐ
romerriget	ʁoˀmɐʁiːəð
romersk	ʁoˀmɐsɡ̊
ror	ʁoɐ̯ˀ
rose	ʁose
rose	ʁoːsə
rosin	ʁosiˀn
rosé	ʁose
rosévin	ʁoseviːˀn
rov	ʁɒw
rude	ʁuːðə
rugemor	ʁuːəmoɐ̯
rugmel	ʁuːmeːˀl
ruiner	ʁuineɐ̯ˀ
ruiner	ʁuineːˀɐ̯
ruiner	ʁuiːˀnɐ
ruinere	ʁuineːˀɐ
rulle	ʁulə
rum	ʁɔmˀ
rumænsk	ʁumɛːˀnsɡ̊
rund	ʁɔnˀ
runde	ʁɔnd̥ə
runde	ʁɔnə
rundt	ʁɔnˀd̥
rus	ʁus
rus	ʁuːˀs
ruse	ʁoːsə
russisk	ʁusisɡ̊
rust	ʁɔsd̥
rutebil	ʁod̥əb̥iˀl
rutebil	ʁud̥əb̥iˀl
rutebilstation	ʁod̥əb̥ilsd̥aɕoˀn
rutebilstation	ʁud̥əb̥ilsd̥aɕoˀn
rydde	ʁyd̥ə
rydde	ʁyðə
ryg	ʁyˀ
ryg	ʁœɡ̊
ryge	ʁyːy
ryger	ʁyːɐ
ryger	ʁyːˀɐ
ryggesløs	ʁœɡ̊əsløˀs
rygning	ʁyːneŋ
rygning	ʁœ̞ɡ̊neŋ
rygrad	ʁœɡ̊ʁɑð
rygrad	ʁœɡ̊ʁɑðˀ
rygrad	ʁœɡ̊ʁɑˀð
rygsæk	ʁœɡ̊sɛɡ̊
rygte	ʁœɡ̊d̥ə
rygtes	ʁœɡ̊d̥əs
ryk	ʁœɡ̊
rype	ʁyːb̥ə
rytter	ʁyd̥ɐ
rytteri	ʁyd̥ɐʁiˀ
rå	ʁɔˀ
råb	ʁɔwˀ
råb	ʁɔˀb̥
råbe	ʁɔːb̥ə
råbe	ʁɔːʊ
råber	ʁɔwˀɐ
råber	ʁɔˀb̥ɐ
råbt	ʁʌb̥d̥
råbte	ʁʌb̥d̥ə
råd	ʁɔðˀ
råd	ʁɔˀð
råd	ʁʌð
rådden	ʁʌðən
rådden	ʁʌð̩n
råde	ʁɔːðə
rådhus	ʁʌðhuˀs
rådyr	ʁʌd̥yɐ̯ˀ
råen	ʁɔˀən
råens	ʁɔˀəns
råer	ʁɔˀɐ
råerne	ʁɔˀɐnə
råernes	ʁɔˀɐnəs
råers	ʁɔˀɐs
rås	ʁɔˀs
råt	ʁʌd̥
råvildt	ʁʌʋilˀd̥
ræd	ʁaðˀ
ræd	ʁɑjˀ
ræd	ʁɑðˀ
ræddes	ʁaðð̩s
ræddes	ʁɑðð̩s
rædsel	ʁaðˀsɭ̩
rædsel	ʁɑðˀsɭ̩
rædsom	ʁaðsʌmˀ
rædsom	ʁɑðsʌmˀ
ræer	ʁɛˀɐ
ræk	ʁɑɡ̊
række	ʁaɡ̊ə
rækken	ʁaɡ̊ŋ̩
rækken	ʁaɡ̊ən
rær	ʁæɐ̯ˀ
ræson	ʁæsʌŋ
ræsonen	ʁæsʌŋˀŋ̩
ræsonnere	ʁæsoneˀɐ
rætoromansk	ʁɛːtˢoʁomæːˀnsɡ̊
ræv	ʁæwˀ
ræv	ʁæˀw
ræve	ʁæːwə
rævegrav	ʁɛːvəɡ̊ʁɑːˀw
røbe	ʁœ̞ːb̥ə
rød	ʁœðˀ
rød	ʁœˀð
rødder	ʁɶðˀɐ
rødderne	ʁɶðˀɐnə
røddernes	ʁɶðˀɐnəs
rødders	ʁɶðˀɐs
rødhåret	ʁœ̞ðhɑːˀɑð
rødlos	ʁœðˠlʌs
rødt	ʁœd̥
røg	ʁœjˀ
røg	ʁʌjˀ
røgalarm	ʁʌɪ̯alɑːˀm
røge	rʌjə
røge	ʁœ̞ːjə
røgelse	ʁøːjl̩sə
røgelse	ʁøːjəlsə
røget	ʁʌðð̩
røgt	ʁœɡ̊d̥
røgte	ʁœɡ̊d̥ə
røn	ʁɶn
rønnebær	ʁɶnəpɛɐ̯
røntgen	ʁɶnˀd̥ɡ̊ən
røntgen	ʁɶŋˀd̥ən
røntgen	ʁɶŋˀɡ̊ən
rør	ʁœ̞ɐ̯ˀ
røre	ʁɶːɐ
rørende	ʁɶːɐnə
rører	ʁœ̞ːɐ
rørig	ʁœ̞ːɐ̯i
rørsukker	ʁɶɐ̯sɔɡ̊ɐ
rørt	ʁɶɐ̯ˀd̥
rørte	ʁɶɐ̯d̥ə
rørte	ʁɶɐ̯ˀd̥ə
røræg	ʁœ̞ɐ̯ɛːˀɡ̊
røst	ʁœsd̥
røv	ʁœwˀ
røv	ʁœˀw
røv	ʁɶwˀ
røve	ʁœːʊ
røve	ʁœːʋə
røve	ʁɶːʊ
røven	ʁœːʊn
røven	ʁœːʋən
røven	ʁɶwˀən
røver	ʁœ̞ːwɐ
røver	ʁœ̞ːʋɐ
røves	ʁœːʊs
røves	ʁœːʋəs
røves	ʁɶwəs
røves	ʁɶːʊs
røvhul	ʁɶwhɔl
røvs	ʁɶwˀs
sabel	sæːˀb̥əl
sadist	sad̥isd̥
safir	safiɐ̯ˀ
saft	sɑfd̥
saften	sɑfd̥n̩
safter	sɑfd̥ɐ
safterne	sɑfd̥ɐnə
saftig	sɑfd̥i
sag	sæːˀj
sagde	sæː
sagde	sæːæ
sagdes	sæːəs
sagn	sɑwˀn
sagt	sɑɡ̊d̥
sagte	sæjdə
sagte	sæːɡdə
sagte	sɑwdə
sagte	sɑɡ̊d̥ə
sagtne	sæːɡ̊d̥nə
sagtne	sɑɡ̊d̥nə
saks	sɑɡ̊s
sakse	sɑɡ̊sə
sakser	sɑɡ̊sɐ
saksisk	sɑɡ̊sisɡ̊
sal	sæˀl
salathoved	salæːˀd̥hoːəð̠ˠ
salg	salˀ
salg	salˀʝ
salig	sæːli
salt	salˀd̥
salut	salud̥
salve	salvə
samfund	sɑmfɔnˀ
samfundskritisk	sɑmfɔnskʁ̥id̥isɡ̊
samfundskritisk	sɑmfɔnskʁ̥itˢisɡ̊
saml	sɑml
samle	sɑmlə
samleje	sɑmlajə
samler	sɑmlɐ
samme	sɑmə
sammenbrud	sɑmm̩b̥ʁoð
sammenbrud	sɑmm̩b̥ʁuð
sammenføje	sɑmm̩fʌjˀɪ
sammenføjning	sɑmm̩fʌjˀneŋ
sammenhæng	sɑmənhɛŋˀ
sammenstykke	sɑmm̩sd̥øɡ̊ə
sammensværgelse	sɑmənsʋæɐ̯ˀʊ̯əlsə
samsø	sɑmˀsøːˀ
samt	sɑmd̥
samtale	sɑmtˢæːlə
samtale	sɑmtˢæːˀlə
samtidig	sɑmtˢiðˀi
samtykke	sɑmtˢyɡ̊ə
samtykker	sɑmtˢyɡ̊ɐ
samtykket	sɑmtˢyɡ̊əð
samvær	sɑmʋɛɐ̯ˀ
samvær	sɑmʋɛˀɐ̯
sand	sanˀ
sanddru	sand̥ʁoˀ
sanddru	sand̥ʁuˀ
sandelig	sænəli
sandhed	sanheðˠˀ
sandpapir	sanpʰapʰiɐ̯ˀ
sandsten	sansd̥eːˀn
sandstorm	sansd̥ɒˀm
sandwich	sanwid̥ɕ
sandwich	sanʋid̥s
sandwich	sanʋid̥ɕ
sang	sɑŋˀ
sanger	saŋɐ
sanger	sɑŋɐ
sangfugl	sɑŋfuːˀl
sangsvane	sɑŋsvæːnə
sankthans	sɑŋd̥hans
sankthansaften	sɑŋd̥hansɑfd̥n̩
sankthansdag	sɑŋd̥hansd̥æˀj
sara	sɑːʁɑ
sarkasme	sɑkʰasmə
satanisme	satˢanismə
satire	satˢiːɐ
satte	sad̥ə
sav	sæwˀ
sav	sæˀw
save	sæːʊ
save	sæːʋə
savn	sɑwˀn
savne	sɑwnə
savsmuld	sɑwsmulˀ
scene	seːnə
schweiz	sʋɑjˀd̥s
schweizer	sʋɑjˀd̥sɐ
score	sɡ̊oːɐ
se	seˀ
seddel	sɛðˀl̩
seddel	sɛðˀəl
seer	seːˀɐ
segl	sɑjˀl
sej	sɑjˀ
sejd	sɑjˀd̥
sejl	sɑjˀl
sejle	sɑjlə
sejler	sɑjlɐ
sejr	sɑjˀɐ
sejre	sɑjʁɐ
sekretariat	seɡ̊ʁətˢɑiæːˀd̥
seks	sɛɡ̊s
seksten	sɑjsd̥n̩
sekstende	sɑɪ̯sd̥ənə
sekstende	sɑɪ̯snə
seksti	sɛɡ̊stˢi
seksualitet	sɛɡsualiteˀd
seksuel	sɛɡ̊suɛlˀ
selskab	sɛlsɡ̊æˀb̥
selv	sɛlˀ
selv	sɛlˀʋ
selvfølgelig	sɛføli
selvfølgelig	sɛlføljəli
selvindlysende	sɛlenlyˀsn̩nə
selvisk	sɛlˀvisɡ̊
selvlysende	sɛllyˀsn̩nə
selvlysende	sɛllyːsn̩nə
selvportræt	sɛlpʰɒtˢʁ̥ad̥
selvtægt	sɛltˢɛɡ̊d̥
semester	semɛsd̥ɐ
semiotik	semiotˢiɡ̊
semiotiker	semioːˀtˢiɡ̊ɐ
sen	seˀn
send	sɛnˀ
sende	sɛnə
sender	sɛnɐ
sendt	sɛnˀd̥
sendte	sɛnd̥ə
sendte	sɛnˀd̥ə
sene	seːnə
seng	sɛ̝ŋˀ
sennep	senəb̥
september	səb̥tˢɛmˀb̥ɐ
september	sɛb̥tˢɛmˀb̥ɐ
ser	seɐ̯ˀ
seraf	seʁɑːˀf
serbisk	sæɐ̯ˀb̥isɡ̊
ses	seˀs
sesamolie	seːsɑmoljə
sete	seˀd̥ə
sexappeal	sɛɡ̊sapʰiːl
sexet	sɛɡ̊səð
sfære	sfæːɐ
sgu	sɡ̊u
shampoo	ɕæːmpʰuː
shampoo	ɕɑmpʰo
si	siːˀ
sid	seðˀ
sidde	seðə
side	siːð̞ə
siden	siðən
siden	siːðən
sideordning	siːðəɒːd̥neŋ
sidste	sisd̥ə
sig	siːˀ
sig	sɑj
sige	siːi
sige	siːə
sigende	siːənə
sigt	seɡ̊d̥
sigte	seɡ̊d̥ə
sigtede	seɡ̊d̥ð̩ð̩
sigten	seɡ̊d̥n̩
sigter	seɡ̊d̥ɐ
sigtes	seɡ̊d̥əs
sigtet	seɡ̊d̥ð̩
sigøjner	siɡ̊ʌjˀnɐ
sikken	seɡ̊ə
sikker	seɡ̊ɐ
sikkerhedsvagt	seɡ̊ɐheðˠsʋɑɡ̊d̥
sikring	seɡ̊ʁeŋ
sild	silˀ
silikat	silikʰæd̥ˀ
silikone	silikʰoːnə
simulere	simuleːˀɐ
sind	senˀ
sindssyg	senˀsyˀ
sindssygt	senˀsyˀd̥
sine	siːnə
sinecure	sinəkʰyːɐ
sirene	siʁæːnə
sirene	siʁɛːnə
sisyfosarbejde	sisyfʌsɑːb̥ɑjˀd̥ə
siv	siwˀ
siv	siːˀw
sjal	ɕæːˀl
sjette	ɕɛːdə
sjofel	ɕoːˀfəl
sjov	ɕɒwˀ
sjæl	ɕɛˀl
sjælden	ɕɛln̩
sjælland	ɕɛlanˀ
skab	sɡ̊æːˀb̥
skabe	sɡ̊æːb̥ə
skabe	sɡ̊æːʊ
skabe	sɡ̊æ̝ːbə
skabelon	sɡ̊ab̥əloːˀn
skabelon	sɡ̊ɑb̥əloːˀn
skabelse	sɡ̊æːb̥l̩sə
skaber	sɡ̊æːb̥ɐ
skaber	sɡ̊æːwɐ
skabning	sɡ̊æːb̥neŋ
skabt	sɡ̊ɑb̥d̥
skabte	sɡ̊ɑb̥d̥ə
skabtes	sɡ̊ɑb̥d̥əs
skade	sɡ̊æðð̩
skadefro	sɡ̊æːðəfʁ̥oːˀ
skadefryd	sɡ̊æðð̩fʁ̥yðˀ
skadelig	sɡ̊æːðəli
skadestue	sɡ̊æðð̩sd̥uːu
skaffe	sɡ̥ɑfə
skak	sɡ̊ɑɡ̊
skakbrik	sɡ̊ɑɡ̊b̥ʁeɡ̊
skal	sɡ̊a
skal	sɡ̊al
skal	sɡ̊alˀ
skalle	sɡ̊alə
skalte	sɡ̊ald̥ə
skam	sɡ̊ɑm
skam	sɡ̊ɑmˀ
skamme	sɡ̥ɑmə
skandaløs	sɡ̊and̥aløːˀs
skar	sɡ̊ɑˀ
skarpskytte	sɡ̊ɑːb̥sɡ̊ød̥ə
skat	sɡ̊ad̥
skattefar	skætəfɑː
skattekiste	sɡ̊ad̥əkʰiːsd̥ə
ske	sɡ̊eˀ
skede	sɡ̊eːðə
skejs	sɡɑjˀs
skel	sɡ̊ɛlˀ
skele	sɡ̊eːlə
skelen	sɡ̊eːlən
sket	sɡ̊eˀd̥
skete	sɡ̊eˀd̥ə
skete	sɡ̊eːd̥ə
skib	sɡ̊iwˀ
skib	sɡ̊iˀb̥
skid	sɡ̊ið̞ˀ
skide	sɡ̊iðð̩
skildpadde	sɡ̊elpʰaðð̩
skille	sɡ̊elə
skilling	sɡ̊elˀeŋ
skilt	sɡ̊elˀd̥
skilte	sɡ̊eld̥ə
skilte	sɡ̊elˀd̥ə
skinne	sɡ̊enə
skjald	sɡ̊jalˀ
skjold	sɡ̊jʌlˀ
skjorte	sɡ̊joɐ̯d̥ə
skjul	sɡ̊juˀl
skjule	sɡ̊juːlə
sko	sɡ̊oːˀ
skod	sɡ̊ʌð
skod	sɡ̊ʌðˀ
skole	sɡ̊oːlə
skomager	sɡ̊omæːˀjɐ
skomager	sɡ̊omɑːˀ
skomager	sɡ̊ɔmæːˀjɐ
skomager	sɡ̊ɔmɑːˀ
skonnert	sɡ̊ʌnˀɐd̥
skotsk	sɡ̊ʌd̥sɡ̊
skotskternet	sɡ̊ʌd̥sɡ̊tˢæɐ̯nəð
skotskternet	sɡ̊ʌd̥sɡ̊tˢæɐ̯ˀnəð
skov	sɡ̊ɒwˀ
skovl	sɡ̊ɒwˀl
skralde	sɡ̊ʁɑlə
skred	sɡ̊ʁæð
skred	sɡ̊ʁæðˀ
skred	sɡ̊ʁæˀð
skrev	sɡ̊ʁæwˀ
skrev	sɡ̊ʁæˀw
skreven	sɡ̊ʁæwn̩
skreven	sɡ̊ʁæːʋn̩
skrevne	sɡ̊ʁæwnə
skride	sɡ̊ʁiðð̩
skridt	sɡ̊ʁid̥
skrift	sɡ̊ʁæfd̥
skriftlig	sɡ̊ʁæfd̥li
skrin	sɡ̊ʁiːˀn
skriv	sɡ̊ʁiwˀ
skriv	sɡ̊ʁiˀw
skrive	sɡ̊ʁiːʊ
skrive	sɡ̊ʁiːʋə
skrivelse	sɡ̊ʁiwl̩sə
skrivelse	sɡ̊ʁiːʋl̩sə
skrædder	sɡ̊ʁaðɐ
skræddermester	sɡ̊ʁaðɐmɛsd̥ɐ
skræk	sɡ̊ʁaɡ̊
skrække	sɡ̊ʁaɡ̊ə
skrækkelig	sɡ̊ʁaɡ̊li
skrækkelig	sɡ̊ʁaɡ̊əli
skræl	sɡ̊ʁalˀ
skræl	sɡ̊ʁɑlˀ
skræv	sɡ̊ʁaw
skræv	sɡ̊ʁawˀ
skræv	sɡ̊ʁɛˀw
skrævet	sɡ̊ʁawˀəð
skrævet	sɡ̊ʁaðˀð
skrævet	sɡ̊ʁɛˀwəð
skubbe	sɡ̊ɔb̥ɘ
skud	sɡ̊uð
skudt	sɡ̊ud̥
skueproces	sɡ̊uːəpʰʁ̥osɛs
skulder	sɡ̊ulɐ
skuldertræk	sɡ̊ulɐtˢʁ̥aɡ̊
skulle	sɡ̊u
skulle	sɡ̊ulə
skullet	sɡ̊u
skullet	sɡ̊uləð
skulptur	sɡ̊ulb̥tˢuɐ̯ˀ
skum	sɡ̊ɔmˀ
skumbad	sɡ̊ɔmbað
skumme	sɡ̊ɔmm̩
skumme	sɡ̊ɔmə
skummet	sɡ̊ɔmð̩
skummet	sɡ̊ɔmˀð̩
skummetmælk	sɡ̊ɔmð̩mɛlˀɡ̊
skumring	sɡ̊ɔmʁeŋ
skurk	sɡ̊uɐ̯ɡ̊
sky	skyˀ
skyde	sɡ̊yːðə
skyg	sɡ̊yɡ̊
skygge	sɡ̊yɡ̊ə
skyld	sɡ̊ylˀ
skylde	sɡ̊ylə
skyldig	sɡ̊yld̥i
skyllemiddel	sɡ̊øləmiðˀəl
skynde	sɡ̊ønə
skyr	sɡ̊iːɐ̯
skyr	sɡ̊yɐ̯ˀ
skyter	sɡ̊yd̥ɐ
skyts	sɡ̊ød̥s
skytte	sɡ̊ød̥ə
skåne	sɡ̊ɔːnə
skåning	sɡ̊ɔːneŋ
skåren	sɡ̊ɒːɐn
skåret	sɡ̊ɒˀɐð
skåret	sɡ̊ɒːɐð
skårne	sɡ̊ɒːnə
skæbne	sɡ̊ɛːb̥nə
skægget	sɡ̊ɛˀɡ̊əð
skægget	sɡ̊ɛːɡ̊əð
skæl	sɡ̊ɛlˀ
skænde	sɡ̊ɛnə
skændes	sɡ̊ɛnəs
skændes	sɡ̊ɛnˀəs
skændig	sɡ̊ɛnd̥i
skænk	sɡ̊ɛŋˀɡ̊
skænke	sɡ̊ɛŋɡ̊ə
skær	sɡ̊ɛɐ̯ˀ
skær	sɡ̊ɛˀɐ̯
skære	sɡ̊ɛːɐ
skærer	sɡ̊ɛɐ̯
skærer	sɡ̊ɛːɐ
skærf	sɡ̊æɐ̯f
skærgård	sɡ̊ɛɐ̯ɡ̊ɒˀ
skærm	sɡ̊aɐ̯ˀm
skærsild	sɡ̊ɛɐ̯silˀ
skæv	sɡ̊ɛwˀ
skæv	sɡ̊ɛˀʋ
skød	sɡ̊øð
skød	sɡ̊øðˀ
skøder	sɡ̊øːðɐnə
skødet	sɡ̊øðˀəd̥
skødet	sɡ̊øːðəd̥
skøge	sɡ̊øːø
skøge	sɡ̊øːɪ
skøjte	sɡ̊ʌjd̥ə
skøn	sɡ̊œnˀ
skønlitteratur	sɡ̊œnlid̥əʁɑtˢuɐ̯ˀ
skønne	sɡ̊œnə
skør	sɡ̊øˀɐ̯
skørbug	sɡ̊øɐ̯b̥uˀ
skørlevned	sɡ̊øɐ̯lɛwnð̩
skørost	sɡ̊øɐ̯ɔsd̥
skørt	sɡ̊øɐ̯ˀd̥
skørt	sɡ̊øˀɐ̯d̥
skørt	sɡ̊ɶɐ̯d̥
slag	sl̥æˀ
slag	sl̥æˀj
slag	sl̥ɑw
slagen	sl̥æːjən
slagen	sl̥æːæn
slagne	sl̥æːjnə
slagne	sl̥æːnə
slags	sl̥æˀjs
slags	sl̥æˀs
slags	sl̥ɑɡs
slagte	slɑɡ̊d̥ə
slagter	slɑɡ̊d̥ɐ
slaver	slæwˀɐ
slaver	slæˀʋɐ
slaver	slæːwɐ
slaver	slæːʋɐ
slavisk	slæˀʋisɡ̊
sleb	slewˀ
sleb	sleˀb̥
slem	slɛmˀ
slesk	sl̥eːˀsɡ̊
slet	slɛd̥
slette	slɛd̥ə
slibe	sliːb̥ə
slibe	sliːʊ̯ə
sliber	sliwˀɐ
sliber	sliˀb̥ɐ
sliber	sliːb̥ɐ
slide	sliːðə
slig	sliˀ
slige	sliːi
slige	sliːə
sligt	sliɡ̊d̥
sligt	sliˀd̥
slik	sleɡ̊
slikkepot	sleɡ̊əpʰʌd̥
slikket	sleɡ̊əð
slim	sliːˀm
slippe	sl̥eb̥ə
slog	sl̥oˀ
sloges	sl̥oːos
slot	slʌd̥
slotte	slɔd̥ə
slowmotion	slɔwmɔwɕən
sludder	sluðˀɐ
sluge	sluːu
sluge	sluːə
slugt	sluɡ̊d̥
slugte	sluɡ̊d̥ə
slukke	slɔɡ̊ə
slurk	sluɐ̯ɡ̊
slurk	sluɐ̯ˀɡ̊
slut	sl̥ud̥
slutspurt	slud̥sb̥uɐ̯ˀd̥
slutte	slud̥ə
slå	sl̥ɔˀ
slående	sl̥ɔːɔnə
slår	slɒˀ
slås	sl̥ɔˀs
slås	sl̥ʌs
slæb	slɛwˀ
slæb	slɛˀb̥
slæbe	slɛːb̥ə
slæbe	slɛːʊ
slæber	slɛwˀɐ
slæber	slɛˀb̥ɐ
slæber	slɛːb̥ɐ
slæber	slɛːwɐ
slæbt	slɛb̥d̥
slæbte	slɛb̥d̥ə
slægt	slɛɡ̊d̥
slægtning	slɛɡ̊d̥neŋ
slægtning	slɛɡ̊neŋ
slæt	slɛd̥
sløjfe	slʌjfə
slør	sløɐ̯ˀ
sløv	sløwˀ
smage	smæːjə
smage	smæːæ
smagt	smɑɡ̊d̥
smagte	smɑɡ̊d̥ə
smal	smalˀ
smaragd	smɑʁɑwˀd̥
smide	smiːðə
smil	smiːˀl
smile	smiːˀlə
smilet	smiːˀlətˢ
smiley	smɑjli
smitte	smed̥ə
smitte	smid̥ə
smoking	smoːkʰeŋ
smoking	smɔwkʰeŋ
smuk	smɔɡ̊
små	smɔˀ
småbarn	smʌb̥ɑːˀn
småkage	smʌkʰæːjə
småkage	smʌkʰæːæ
smålig	smʌli
småt	smʌd̥
småting	smʌtˢeŋ
smølf	smølf
smørelse	smɶːʌlsə
smørrebrød	smɶɐb̥ʁœðˀ
snakke	snɑɡ̊ə
snakke	snɑːɡ̊ə
snavset	snɑwsɘð
sne	sneˀ
snebold	sneb̥ʌlˀd̥
snedker	sneˀɡ̊ɐ
snefald	snefalˀ
sneg	sneˀ
sneg	sneˀj
snegl	snɑjˀl
snes	sneːˀs
snestorm	snesd̥ɒːˀm
sneugle	sneuːlə
snige	sniːi
snigmorder	sniːmoɐ̯d̥ɐ
snigskytte	sniːsɡ̊ød̥ə
sniksnak	sneɡ̊snɑɡ̊
sniksnak	sniɡ̊snɑɡ̊
snog	snoːˀ
snyde	snyːðə
snyder	snyːðɐ
snyder	snyːˀðɐ
snæver	snɛwˀa̯
social	soɕæˀl
social	ɕoɕæˀl
socialdemokrat	soɕæˀld̥emokʰʁ̥ɑˀd̥
socialdemokrati	soɕæˀld̥emokʰʁ̥ɑtˢiˀ
socialisme	soɕalismə
socialist	soɕalisd̥
socialist	ɕoɕalisd̥
sod	soðˀ
sofavælger	soːfavɛljɐ
sojaolie	sʌjaoljə
sokratisk	sokʁɑˀdisɡ
sol	soːˀl
sol	sʌl
solbær	soːlbæɐ̯
soldug	soːld̥uɡ̊
solgt	sʌlˀd̥
solgte	sʌld̥ə
solgte	sʌlˀd̥ə
solsikkeolie	soːlseɡ̊əoljə
solskoldning	soːlsɡ̊ʌlneŋ
soludbrud	soːluð̠ˠb̥ʁuð̠ˠ
som	sʌm
sommer	sʌmɐ
sondere	sʌnd̥eːˀɐ
sophus	soːfus
sorg	sɒwˀ
sorg	sɒˀw
sorgen	sɒwˀn̩
sorgen	sɒˀwən
sorger	sɒːwɐ
sort	soɐ̯d̥
sort	sɒˀd̥
sot	soˀd̥
sov	sɒwˀ
sove	sɒːʊ
sover	sɒwˀɐ
sover	sɒːwɐ
sovs	sɒwˀs
spadsere	sb̥aseːˀɐ
spand	sb̥anˀ
spare	sb̥æɐ̯
spare	sb̥ɑːɑ
spare	sb̥ɛɐ̯
spark	sb̥ɑːɡ̊
sparsom	sb̥ɑːsʌmˀ
sparsomme	sb̥ɑːsʌmˀə
sparsommelig	sb̥ɑsʌmˀl̩li
sparsomt	sb̥ɑːsʌmˀd̥
sparta	sb̥ɑːtˢa
spartaner	sb̥ɑtˢæˀnɐ
spartansk	sb̥ɑtˢæˀnsɡ̊
sparto	sb̥ɑtˢoːˀ
spas	sb̥æːˀs
spat	sb̥ad̥
spatel	sbæˀdəl
spejl	sb̥ɑjˀl
spejle	sb̥ɑjlə
spejlæg	sb̥ɑjlɛˀɡ̊
spektakel	sb̥etˢɑɡ̊əl
spekulativ	sb̥eɡ̊ulatˢiʊ̯ˀ
spelt	sb̥ɛlˀd̥
spidde	sb̥iðð̩
spilde	sbilə
spille	sb̥elə
spilleliste	sbe̝ləle̝sdə
spiller	sb̥elɐ
spinde	sb̥enə
spindelvæv	sb̥enˀəlvɛːˀw
spinkel	sb̥eŋˀɡ̊əl
spionage	sb̥ionæːɕə
spis	sb̥iːˀs
spise	sb̥iːsə
spiser	sb̥iːsɐ
spiser	sb̥iːˀsɐ
spisestue	sb̥isəsd̥uːu
spist	sb̥iˀsd̥
spiste	sb̥iːsd̥ə
spjætte	sb̥jɛd̥ə
splejse	sb̥lɑjsə
splejset	sb̥lɑjsəð
splitte	sb̥led̥ə
splitternøgen	sb̥led̥ɐnʌjən
spor	sb̥oːˀɐ̯
spore	sb̥oːɐ
spot	sb̥ʌd̥
spotte	sb̥ʌd̥ə
sprede	sb̥ʁæːðə
sprede	sb̥ʁɛːðə
spredt	sb̥ʁæˀd̥
spredt	sb̥ʁɛˀd̥
spredte	sb̥ʁæˀd̥ə
spredte	sb̥ʁæːd̥ə
spredte	sb̥ʁɛˀd̥ə
spredte	sb̥ʁɛːd̥ə
springe	sb̥ʁɛŋə
springer	sb̥ʁeŋɐ
springer	sb̥ʁeŋˀɐ
sprit	sb̥ʁid̥
sprog	sb̥ʁɔwˀ
sprog	sb̥ʁɔˀw
sprogene	sb̥ʁɔwˀənə
sprogenes	sb̥ʁɔwˀənəs
sproget	sb̥ʁɔwˀəð
sprogvidenskab	sb̥ʁɔwviðn̩sɡ̊æˀb̥
sprække	sb̥ʁaɡ̊ə
sprænge	sb̥ʁaŋə
sprød	sb̥ʁœðˀ
sprød	sb̥ʁœˀð
sprøde	sb̥ʁœðð̩
sprødt	sb̥ʁœd̥
sprødt	sb̥ʁœˀd̥
spurgt	sb̥oɐ̯ˀd̥
spurgt	sb̥uɐ̯ˀd̥
spurgte	sb̥oɐ̯d̥ə
spurgte	sb̥uɐ̯d̥ə
spurt	sb̥uɐ̯ˀd̥
spurte	sb̥uɐ̯d̥e
spurv	sb̥uɐ̯ˀw
spyd	sb̥yð
spyt	sbød
spytte	sb̥ød̥ɘ
spå	sb̥ɔˀ
spådom	sb̥ʌd̥ʌmˀ
spånplade	sb̥ʌnpʰlæːðə
spædbarn	sb̥ɛðb̥ɑːˀn
spæk	sb̥ɛɡ̊
spækhugger	sb̥ɛɡ̊hɔɡ̊ɐ
spækhøker	sb̥ɛɡ̊høˀɡ̊ɐ
spække	sb̥ɛɡ̊ə
spænde	sb̥ɛnə
spændende	sb̥ɛnn̩nə
spænder	sb̥ɛnɐ
spænderne	sb̥ɛnɐnə
spændernes	sb̥ɛnɐnəs
spænders	sb̥ɛnɐs
spændes	sb̥ɛnəs
spændet	sb̥ɛnð̩
spændets	sb̥ɛnð̩s
spænding	sb̥ɛneŋ
spændt	sb̥ɛnˀd̥
spændte	sb̥ɛnd̥ə
spændte	sb̥ɛnˀd̥ə
spændtes	sb̥ɛnd̥əs
spæne	sb̥ɛːnə
spærre	sb̥æɐ
spærre	sb̥æʁə
spøg	sb̥øˀ
spøg	sb̥øˀj
spøg	sb̥ʌjˀ
spøge	sb̥øːø
spøge	sb̥øːɪ
spøgelse	sb̥øːjɭ̩sə
spøgelse	sb̥øːl̩sə
spøgt	sb̥øɡ̊d̥
spøgte	sb̥øɡ̊d̥ə
spørge	sb̥ɶɐ̯wə
spørge	sb̥ɶɐ̯ʊ
spørge	sb̥ɶːɐ
spørger	sb̥ɶɐ̯wɐ
spørger	sb̥ɶɐ̯ˀ
spørgsel	sb̥ɶɐ̯səl
spørgsel	sb̥ɶɐ̯ˀsəl
spørgsmål	sb̥ɶɐ̯smɔˀl
stabil	sd̥ab̥iːˀl
stad	sd̥að
staden	sd̥aðˀən
stadig	sd̥æːði
stakket	sd̥ɑɡ̊əð
stakåndet	sd̥ɑɡ̊ʌnˀəð
stalinisme	sd̥alinismə
stand	sd̥anˀ
standard	sd̥and̥ɑːˀd̥
standart	sd̥and̥ɑːˀd̥
stande	sd̥anə
standpunkt	sd̥anpʰɔŋˀd̥
standse	sd̥ansə
stank	sd̥ɑŋˀɡ̊
starte	sd̥ɑːd̥ə
starut	sd̥aʁud̥
starut	sd̥ɑʁud̥
statelig	sd̥æːd̥əli
statelig	sd̥æːˀd̥əli
station	sd̥aɕoˀn
stationsby	sd̥aɕoˀnsb̥yˀ
stativ	sd̥atˢiwˀ
stativ	sd̥æːtˢiwˀ
sted	sd̥ɛð
sted	sd̥ɛðˀ
sted	sd̥ɛˀð
stedbarn	sd̥eb̥ɑˀn
stedbarn	sd̥ɛb̥ɑˀn
stedbarn	sd̥ɛðb̥ɑˀn
steder	sd̥ɛːðɐ
stedfar	sd̥efɑː
stedfar	sd̥ɛfɑː
stedfar	sd̥ɛðfɑː
stedmor	sd̥emoɐ̯
stedmor	sd̥ɛmoɐ̯
stedmor	sd̥ɛðmoɐ̯
stedt	sd̥eˀd̥
stedt	sd̥ɛˀd̥
stedte	sd̥eːd̥ə
stedte	sd̥ɛːd̥ə
steg	sd̥eˀ
steg	sd̥eˀj
steg	sd̥ɑjˀ
stege	sd̥ɑjə
stege	sd̥ɑːɪ
stegepande	sd̥ɑːɪpʰanə
stegt	sd̥ɛɡ̊d̥ə
stegte	sd̥ɛɡ̊d̥ə
stemme	sd̥ɛmə
stemt	sd̥ɛmˀd̥
stemte	sd̥ɛmˀd̥ə
stendød	sd̥eːnd̥øðˀ
stift	sd̥efd̥
stift	sd̥ifd̥
stige	sd̥iːə
stigma	sd̥iɡ̊ma
stigma	sd̥iːma
stikke	sd̥eɡ̊ə
stikkelsbær	sd̥eɡ̊əlsb̥æɐ̯
stikprøve	sd̥eɡ̊pʰʁ̥œ̞ːwə
stil	sd̥elˀ
stil	stˢiːˀl
stilig	stˢiːli
stille	sd̥elə
stinkdyr	sd̥eŋɡ̊d̥yɐ̯ˀ
stirre	sd̥iːɐ
stiv	sd̥iwˀ
stjal	sd̥jæˀl
stjerne	sd̥jæɐ̯nə
stjernekaster	sd̥jæɐ̯nəkʰasd̥ɐ
stjålen	sd̥jɔːln̩
stjålen	sd̥jʌln̩
stjålent	sd̥jɔːlənd̥
stjålet	sd̥jɔːlð̩
stjålet	sd̥jʌlð̩
stjålne	sd̥jɔːlnə
stjålne	sd̥jʌlnə
stjæle	sd̥jɛːlə
stjæler	sd̥jɛˀlɐ
stjæler	sd̥jɛːlɐ
stjæleren	sd̥jɛːlɐɐn
stockholm	sd̥ʌkʰʌlˀm
stod	sd̥oðˀ
stod	sd̥oˀ
stol	sd̥oːˀl
stole	sd̥oːlə
stoppe	sd̥ʌb̥ə
stor	sd̥oɐ̯ˀ
stor	sd̥oˀɐ̯
storbritannien	sd̥oɐ̯b̥ʁitˢanˀjən
stork	sd̥ɒːɡ̊
stort	sd̥oɐ̯ˀd̥
stort	sd̥oˀɐ̯d̥
straf	sd̥ʁɑf
straks	sd̥ʁɑɡ̊s
strakt	sd̥ʁɑɡ̊d̥
strakte	sd̥ʁɑɡ̊d̥ə
stram	sd̥ʁɑmˀ
strand	sd̥ʁɑnˀ
strande	sd̥ʁɑnə
strategi	stˢʁad̥ɛɡ̊iː
stratosfære	sd̥ʁɑd̥osfɛːɐ
stratosfære	sd̥ʁɑd̥ʌsfɛːɐ
streg	sd̥ʁɑjˀ
strejf	sd̥ʁɑjˀf
strejke	sdʁaɡə
strejke	sdʁɑjɡə
streng	sd̥ʁaŋˀ
stress	sd̥ʁas
stress	sd̥ʁɑs
stress	sd̥ʁɛs
stresse	sd̥ʁasə
stresse	sd̥ʁɑsə
stresse	sd̥ʁɛsə
stresset	sd̥ʁasəð
stresset	sd̥ʁɑsəð
stresset	sd̥ʁɛsəð
strid	sd̥ʁiðˀ
stridbar	sd̥ʁiðb̥ɑːˀ
stride	sd̥ʁiːðəs
stridt	sd̥ʁid̥
strube	sd̥ʁuːb̥ə
strukket	sd̥ʁɔɡ̊əð
stryge	sd̥ʁyːy
stryge	sd̥ʁyːə
strå	sd̥ʁɔːˀ
stræbe	sd̥ʁæːb̥ə
stræben	sd̥ʁæːb̥m̩
stræber	sd̥ʁæˀb̥ɐ
stræber	sd̥ʁæːb̥ɐ
stræbt	sd̥ʁab̥d̥
stræbt	sd̥ʁɑb̥d̥
stræbte	sd̥ʁab̥d̥ə
stræbte	sd̥ʁɑb̥d̥ə
stræde	sd̥ʁɛːðə
strække	sd̥ʁaɡ̊ə
strø	sd̥ʁœːˀ
strøg	stʁʌjˀ
strøm	stχœmˀ
strømpe	sd̥ʁɶmb̥ə
stud	sd̥uðˀ
stud	sd̥uˀð
student	sd̥ud̥enˀd̥
studentereksamen	sd̥ud̥enˀd̥ɐeɡ̊sæːmm̩
studentereksamen	sd̥ud̥enˀd̥ɐɛɡ̊sæːmm̩
studere	sd̥ud̥eˀɐ
studerende	sd̥ud̥eˀɐ
stue	sd̥uːu
stuearrest	sd̥uːaʁasd̥
stuearrest	sd̥uːaʁɑsd̥
stuepige	sd̥uːupʰiːi
stund	sdɔnˀ
stupid	sd̥upʰiðˀ
stuve	sd̥uːu
stuve	sd̥uːʋə
styg	sd̥yɡ̊
stygge	sd̥yɡ̊ə
stygt	sd̥yɡ̊d̥
stykke	sd̥øɡ̊ə
styr	sd̥yɐ̯ˀ
styr	sd̥yˀɐ̯
styrbord	sd̥yɐ̯b̥oːˀɐ̯
styre	sd̥yːɐ
styrende	sd̥yːɐnə
styrerne	sd̥yːɐnə
styret	sd̥yˀɐð
styret	sd̥yːɐð
styrte	sd̥yɐ̯d̥ə
stå	sd̥ɔˀ
ståen	sd̥ɔːən
stående	sd̥ɔːənə
stået	sd̥ɔːəð
stål	sd̥ɔːˀl
ståltråd	sd̥ʌltˢʁ̥ɔðˀ
ståltråd	sd̥ʌltˢʁ̥ɔːˀð
står	sd̥ɒˀ
stås	sd̥ɔˀs
ståsted	sd̥ɔːˀsd̥ɛð
stæder	sd̥ɛːðɐ
stække	sd̥ɛɡ̊ə
stækkede	sd̥ɛɡ̊əðə
stækker	sd̥ɛɡ̊ɐ
stækket	sd̥ɛɡ̊əð
stængel	sd̥ɛŋˀl̩
støb	sd̥øˀb̥
støbe	sd̥øːb̥ə
støber	sd̥øˀb̥ɐ
støber	sd̥øːb̥ɐ
støbt	sd̥øb̥d̥
støbte	sd̥øb̥d̥ə
stød	sd̥øð̞
stød	sd̥øð̞ˀ
stød	sd̥øˀð̞
støde	sd̥øðð̩
stødt	sd̥ød̥
stødt	sd̥øˀd̥
stødte	sd̥ød̥ə
stødte	sd̥øˀd̥ə
stødte	sd̥øːd̥ə
støj	sd̥ʌjˀ
støje	sd̥ʌjə
støje	sd̥ʌːɪ
stønne	sd̥œnə
stør	sd̥øɐ̯ˀ
større	sd̥ɶɐ̯ɐ
større	sd̥ɶːɐ
størrelse	sd̥ɶɐ̯ɐlsə
størrelse	sd̥ɶːɐlsə
størst	sd̥ɶsd̥
størst	sd̥ɶɐ̯sd̥
største	sd̥ɶɐ̯sd̥ə
støt	sd̥ød̥
støtte	sd̥ød̥ə
støv	sd̥øwˀ
støv	sd̥øˀw
støve	sd̥øːʊ
støve	sd̥øːʋə
støvle	sd̥œwlə
støvsuger	sd̥øwsuːɐ
støvsuger	sd̥øwsuːˀɐ
sublim	sub̥liːˀm
substans	sub̥sd̥anˀs
substantiv	sub̥sd̥antˢiʊ̯ˀ
subtil	sub̥tˢiːˀl
subversiv	sub̥ʋæɐ̯siwˀ
succes	syɡ̊se
sudanesisk	sud̥aneːˀsisɡ̊
sudanesiske	sud̥aneːˀsisɡ̊ə
sukker	sɔɡ̊ɐ
sukkervand	sɔɡ̊ɐvanˀ
sule	suːlə
sulten	suld̥n̩
sulten	suld̥ən
sulten	sulˀd̥n̩
sulten	sulˀd̥ən
sund	sɔnˀ
sunde	sɔnə
super	suˀb̥ɐ
superhelt	suˀb̥ɐhɛlˀd̥
supermarked	suˀb̥ɐmɑːɡ̊əð
supert	suˀb̥ɐd̥
suppe	sɔb̥ə
supre	suˀb̥ʁɐ
sur	suɐ̯ˀ
surmule	suɐ̯muːlə
surmule	suɐ̯muːˀlə
surströmming	suɐ̯sd̥ʁɶmeŋ
sus	suːˀs
suspensorium	susb̥ænsoːˀɐ̯iɔm
sutte	sud̥ɘ
svag	svæˀj
svage	svæːjə
svagt	svæˀjd̥
sval	svæːˀl
svamp	sʋɑmˀb̥
svans	svanˀs
svar	sʋ̥ɑˀ
svare	sʋ̥ɑːɑ
sved	sʋeðˀ
sved	sʋeˀð
sveder	sveːðɐ
svedig	sveːði
svensk	sʋ̥ɛnˀsɡ̊
svensker	sʋɛnsɡ̊ɐ
sverige	sʋ̥aɐ̯ˀi
sverige	sʋ̥aɐ̯ˀjə
svide	sʋiˀ
svide	sʋiːðə
svide	sʋiːə
svie	sʋiˀ
svie	sʋiːə
svigerdatter	sʋ̥iˀɐd̥ad̥ɐ
svigerfar	sʋ̥iˀɐfɑː
svigerinde	sʋ̥iɐenə
svigermor	sʋ̥iˀɐmoɐ̯
svigersøn	sʋ̥iˀɐsœn
svigte	sʋeɡ̊d̥ə
svin	sʋiˀn
svinde	svenə
svindle	svenlə
svire	sviːɐ
svirre	sviːɐ
svoger	sʋ̥ɒwˀɐ
svoger	sʋ̥ɔwˀɐ
svor	sʋ̥oɐ̯ˀ
svor	sʋ̥oˀɐ̯
svoren	sʋ̥oːɐn
svorent	sʋoːɐnd̥
svoret	sʋoːɐð
svorne	sʋ̥oɐ̯nə
svække	sʋɛɡ̊ə
svækling	svɛɡ̊leŋ
svælg	svɛlˀj
svær	sʋ̥æɐ̯ˀ
svær	sʋ̥ɛɐ̯ˀ
svær	sʋ̥ɛˀɐ̯
sværd	sʋɛɐ̯ˀ
sværd	sʋɛˀɐ̯
sværddrager	svæɐ̯d̥ʁɑːwɐ
sværdfisk	svæɐ̯fesɡ̊
sværge	sʋ̥aɐ̯ʊ
sværm	svæɐ̯ˀm
svøb	sʋøˀb̥ən
svøbe	sʋøːb̥ə
svøben	sʋøːb̥m̩
svøben	sʋøːb̥ən
svøber	sʋøˀb̥ɐ
svøber	sʋøːb̥ɐ
svøbt	sʋøb̥d̥
svøbte	sʋøb̥d̥ə
svøbtes	sʋøb̥d̥əs
svømme	svœmə
sy	syːˀ
syd	syð
syd	syðˀ
syde	syːðə
sydkyst	syðˠkʰøsd̥
sydvest	syðvɛsd̥
syer	syɐ̯ˀ
syer	syˀɐ
syer	syˀɐ̯
syerske	syːˀɐsɡ̊ə
syg	syˀ
sygdom	syːd̥ʌmˀ
syge	syːy
syge	syːə
sygehus	syːyhuˀs
sygeplejerske	syːypʰl̥ɑjˀɐsɡ̊ə
sygeplejerske	syːypʰl̥ɑjˀɪsɡ̊ə
sygt	syɡ̊d̥
sygt	syˀd̥
syl	syːˀl
syle	syːlə
sylte	syld̥ə
syltetøj	syld̥ətˢʌj
symbol	symb̥oːˀl
symfoni	søɱfoniːˀ
synd	sønˀ
synden	sønˀən
synder	sønɐ
syndflod	sønfloðˀ
syndflod	sønfloˀð
syndig	sønd̥i
syndrom	synd̥ʁoːˀm
syne	syːnə
synes	syns
synes	synəs
synes	sys
synes	syːnəs
synge	søŋə
synke	søŋɡ̊ə
synlig	syːnli
synlighed	syːnliheðˀ
synonymordbog	synonyːˀmoɐ̯b̥ɔːˀw
syntaks	syntˢɑɡ̊s
syntes	synd̥əs
syntes	syns
syntes	synəs
syntes	sys
syrer	syˀɐ
syrer	syːɐ
syreregn	syːɐʁɑjˀn
system	sysd̥eːˀm
sytten	sød̥n̩
syv	sywˀ
syvende	sywˀənə
syvti	sywtˢi
så	sɔˀ
så	sʌ
sådan	sɔˀd̥an
sådan	sʌd̥an
sådan	sʌd̥ən
sådan	sʌnoːn
sådan	sʌnˀ
sådan	sʌnˀəd
sådan	sʌnˀən
sål	sɔːˀl
sålbænk	sɔːlb̥ɛŋˀɡ̊
sålbænk	sʌlb̥ɛŋˀɡ̊
sår	sɒˀ
såre	sɒːɒ
såret	sɒˀɒð
såret	sɒːɒð
sås	sɔˀs
sæd	sɛːˀð
sæde	sɛð̞ð̩
sæl	sɛːˀl
sælge	sɛljə
sælge	sɛlə
sælger	sɛlˀjɐ
sælger	sɛlˀɐ
sænke	sɛŋɡ̊ə
sær	sæɐ̯ˀ
sæt	sɛd̥
sætning	sɛd̥neŋ
sætte	sɛd̥ə
sø	søˀ
sød	søðˀ
sød	søˀð
søde	søːðə
sødmælk	søðˀmɛlˀɡ̊
sødt	sød̥
sødygtig	sød̥øɡ̊d̥i
søg	søjˀ
søge	søːø
søge	søːɪ
søger	søːjɐ
søgt	søɡ̊d̥
søgte	søɡ̊d̥ə
søhelt	søhɛlˀd̥
søjle	sʌjlə
søle	søːlə
sølv	søl
sølvbryllup	sølb̥ʁœ̞lɔb̥
sølvbryllup	sølb̥ʁœ̞lʌb̥
sølvet	sølˀvəð
sølvet	sølˀəð
sølvgrå	sølɡ̊ʁɔːˀ
sømme	sœmm̩
sømme	sœmə
søn	sœn
søndag	sœnˀd̥a
søndre	sønʁɐ
sønnen	sœnˀən
sønner	sœnɐ
sørg	sɶwˀ
sørg	sɶɐ̯ˀ
sørg	sɶɐ̯ˀwə
sørge	sɶɐ̯wə
sørge	sɶɐ̯ɐ
sørge	sɶɐ̯ʊ
sørge	sɶːɐ
sørgede	sɶɐ̯wəðə
sørgede	sɶɐ̯ʊðð̩
sørgede	sɶːɐðð̩
sørgede	sɶːɐðə
sørger	sɶɐ̯wɐ
sørger	sɶːɐ
sørget	sɶɐ̯wəð
sørget	sɶɐ̯ʊð
sørget	sɶːɐð
sørøver	søʁœ̞ːwɐ
søskende	søsɡ̊ənə
søster	søsd̥ɐ
søsteren	søsd̥ɐɐn
søsterens	søsd̥ɐɐns
søsters	søsd̥ɐs
søstre	søsd̥ʁɐ
søstrene	søsd̥ʁɐnə
søstrenes	søsd̥ʁɐnəs
søstres	søsd̥ʁɐs
søvn	sœwˀn
søvngænger	sœwnɡ̊ɛŋɐ
søvnig	sœwni
søvnløs	sœwnløˀs
tab	tˢæwˀ
tab	tˢæˀb̥
tabe	tˢæːb̥ə
tabe	tˢæːʊ
taber	tˢawˀɐ
taber	tˢæˀb̥ɐ
taber	tˢæːb̥ɐ
tabt	tˢɑb̥d̥
tabte	tˢɑb̥d̥ə
tag	tˢæɡ̊
tag	tˢæˀ
tag	tˢæˀj
tag	tˢɑw
tage	tˢa
tage	tˢæˀ
tage	tˢæːjə
tage	tˢæːæ
tager	tˢæːjɐ
tager	tˢæːɐ
tager	tˢɑˀ
taget	tˢæðð̩
taget	tˢæðˀð̩
taget	tˢæˀjð̩
taget	tˢæːjð̩
taget	tˢɑwˀð̩
tagetage	tˢɑwetˢæːˀɕə
tak	tˢɑɡ̊
takke	tˢɑɡ̊ə
takker	tˢɑɡ̊ɐ
taks	tˢɑɡ̊s
tal	tˢal
tal	tˢæˀl
tale	tˢæːlə
talemåde	tˢæːləmɔːðə
talent	talɛnˀd̥
taler	tˢæːlɐ
taler	tˢæːˀlɐ
talg	tˢalˀj
talje	tˢaljə
talk	tˢalˀɡ̊
talkum	tˢalkʰɔm
tallerken	tˢalæɐ̯ɡ̊ŋ̩
talord	tˢaloɐ̯ˀ
talsperson	tˢæːˀlspʰæɐ̯soːˀn
talt	tˢalˀd̥
talt	tˢæˀld̥
talte	tˢald̥ə
talte	tˢalˀd̥ə
talte	tˢæˀld̥ə
talte	tˢæːld̥ə
taltes	tˢald̥əs
taltes	tˢæːld̥əs
tand	tˢanˀ
tandbørste	tˢanb̥ɶɐ̯sd̥ə
tandpasta	tˢanpʰasd̥a
tang	tˢɑŋˀ
tango	tˢɑŋɡ̊o
tank	tˢæːŋɡ̊
tank	tˢɑŋˀɡ̊
tanke	tˢɑnɡ̊ə
tankegods	tˢɑŋɡ̊əɡ̊ɔs
tanken	tˢæːŋˀɡ̊ŋ̩
tanken	tˢɑŋɡ̊ŋ̩
tanken	tˢɑŋˀɡ̊ŋ̩
tankens	tˢæːŋˀɡ̊ŋ̩s
tankens	tˢɑŋɡ̊ŋ̩s
tankens	tˢɑŋˀɡ̊ŋ̩s
tanker	tˢɑnɡ̊ɐ̯
tankevækkende	tˢɑŋɡ̊əʋɛɡ̊ənə
tante	tˢand̥ə
tap	tˢɑb̥
tape	tˢɛjb̥
tape	tˢɛjb̥ə
tape	tˢɛjb̥ˀ
tapet	tˢapʰeːˀd̥
tappe	tˢɑb̥ə
tarm	tˢɑːˀm
tarme	tˢɑːmə
tartan	tˢɑːtˢan
tarv	tˢɑwˀ
tarv	tˢɑˀw
tatovere	tatoveˀʌ
tatovering	tatoveˀɐ̯eŋ
tatovør	tatovøˀɐ̯
tav	tavˀ
tav	tˢɑwˀ
tavle	tˢɑwlə
tavs	tˢɑwˀs
taxa	tˢɑɡ̊sa
te	tˢeːˀ
teater	tˢeaˀd̥ɐ
tebrev	tˢeˀb̥ʁæwˀ
tegn	tɑjˀn
tegne	tˢɑjnə
tegnefilm	tˢɑjnəfilˀm
teint	tˢɛŋ
teknik	tˢɛɡ̊niɡ̊
tekniker	tˢɛɡ̊niɡ̊ɐ
telefon	tˢeləfoːˀn
telefonboks	tˢeləfoːˀnb̥ʌɡ̊s
telegraf	tˢeleɡ̊ʁɑːˀf
telegrafist	tˢeleɡ̊ʁɑfisd̥
telt	tˢɛlˀd̥
tempo	tˢɛmb̥o
tempo	tˢɛmpʰo
tendens	tˢend̥ɛnˀs
tendens	tˢɛnd̥ɛnˀs
teoretiker	tˢeoʁɛːˀtˢiɡ̊ɐ
teori	tˢeoʁiˀː
terapi	teɑpiˀ
termin	tˢæɐ̯miːˀn
terminologi	tˢæɐ̯minoloɡ̊iːˀ
terrasse	tˢaʁɑsə
terræn	tˢaʁaŋ
testikel	tˢesd̥iɡ̊əl
testikel	tˢɛsd̥iɡ̊əl
theben	tˢeˀb̥m̩
themsen	tˢɛmˀsn̩
thi	tˢi
thi	tˢiˀ
thor	tˢoɐ̯ˀ
thukydid	tˢuɡ̊yd̥iðˀ
thukydid	tˢuɡ̊əd̥iðˀ
ti	tˢiˀ
tibetaner	tˢib̥ətˢæːˀnɐ
tibetansk	tˢib̥ətˢæːˀnsɡ̊
tid	tˢiðˀ
tid	tˢiˀð
tidlig	tˢiðli
tidlige	tˢiðlii
tidligere	tˢiðliɐɐ
tidligst	tˢiðlisd̥
tidligste	tˢiðlisd̥ə
tidligt	tˢiðlid̥
tidslig	tˢiðsli
tidsmaskine	tˢiðsmasɡ̊iːnə
tidspunkt	tˢiðspʰɔŋˀd̥
tidsskrift	tˢiðsɡ̊ʁɛfd̥
tidszone	tˢiðssoːnə
tie	tˢiːi
tiende	tˢiˀinə
tiende	tˢiːinə
tiende	tˢiːənə
tiendedel	tˢiːˀənəd̥eːˀl
tier	tˢiˀɐ
tier	tˢiːɐ
tiere	tˢiˀɐɐ
tiere	tˢiːɐɐ
tiest	tˢiːəsd̥
tiger	tˢiːɐ
tigere	tˢiːɐɐ
tigger	tˢeɡ̊ɐ
tight	tˢɑjd̥
til	tˢe
til	tˢel
tilbage	tˢeb̥æːjə
tilbage	tˢeb̥æːæ
tilbagestående	tˢeb̥æːjəsd̥ɔˀənə
tilbagestående	tˢeb̥æːæsd̥ɔˀnə
tilbringe	tˢelb̥ʁɛŋˀə
tilfreds	tˢefʁɛs
tilfredsstille	tˢefʁɛssd̥elˀə
tilfredsstillende	tˢefʁɛssd̥elˀənə
tilføje	tˢelfʌjˀə
tilhøre	tˢelhøˀɐ
tilhørende	tˢelhøˀɐnə
tilhører	tˢelhøˀɐ
tilhørerne	tˢelhøˀɐnə
tillade	tˢelæːˀð̠ˠə
tillid	tˢeliðˀ
tillykke	tˢeløɡ̊ə
tillægsord	tˢelɛɡ̊soɐ̯ˀ
tilpas	tˢelpʰas
tilpas	tˢepʰas
tilstand	tˢelsd̥anˀ
tilværelse	tˢelʋaɐ̯ˀlsə
tilværelse	tˢelʋaɐ̯ˀɐlsə
time	tˢiːmə
time	tˢɑjmə
time	tˢɑjˀm
timer	tˢiːmɐ
timer	tˢɑjmɐ
ting	tˢeŋˀ
tirsdag	tˢiɐ̯ˀsd̥a
tisse	tˢisə
tissekone	tˢisəkʰoːnə
tissemand	tˢisəmanˀ
tit	tˢid̥
tivoli	tˢiʋoli
tjald	tɕalˀ
tjek	tçɛɡ̊
tjekke	tçɛɡ̊ə
tjekkede	tçɛɡ̊əðə
tjekket	tçɛɡ̊əð
tjekkiet	tɕɛkʰiˀəð
tjene	tɕɛːnə
tjener	tɕɛˀnɐ
tjener	tɕɛːnɐ
tjeneste	tɕɛːnsd̥ə
tjeneste	tɕɛːnəsd̥ə
tjenlig	tɕɛːnli
tjenstlig	tɕɛːnsd̥li
tjod	tɕʌð
tjæld	tɕɛlˀ
tjære	tɕɛːɐ
tjørn	tɕɶɐ̯ˀn
to	tˢoˀ
tobak	tˢob̥ɑɡ̊
tog	tˢoˀ
tog	tˢɔw
tog	tˢɔˀw
toge	tˢɔːʊ
togstation	tˢɔwsd̥aɕoˀn
togt	tˢʌɡ̊d̥
toilet	tˢoalɛd̥
toilet	tˢʌilɛd̥
toiletpapir	tˢoalɛd̥pʰapʰiɐ̯ˀ
toiletpapir	tˢoalɛd̥pʰɑpʰiɐ̯ˀ
toksikolog	tˢʌɡ̊sikʰoloːˀ
toksisk	tˢʌɡ̊sisɡ̊
told	tˢʌlˀ
tolk	tˢʌlˀɡ̊
tolke	tˢʌlɡ̊ə
tolken	tˢʌlˀɡ̊ŋ̩
tolken	tˢʌlˀɡ̊ən
tolkning	tˢʌlɡ̊neŋ
tolv	tˢʌlˀ
tolvte	tˢʌlˀd̥ə
tom	tˢʌmˀ
tomat	tˢomæːˀd̥
tombak	tˢɔmb̥ɑɡ̊
tomle	tˢʌmlə
tomme	tˢʌmə
tommel	tˢʌml̩
tommel	tˢʌməl
tommelfinger	tˢʌml̩feŋˀɐ
tommelfinger	tˢʌməlfeŋˀɐ
tone	tˢoːnə
topologi	tˢob̥oloɡ̊iːˀ
tor	tˢoːˀɐ̯
torden	tˢoɐ̯d̥n̩
torsdag	tˢɒˀsd̥a
torsk	tˢɒːsɡ̊
tortere	tˢɒtˢeːˀɐ
torv	tˢɒːˀw
torve	tˢɒːʊ
total	tˢotˢal
total	tˢotˢæːˀl
totale	tˢotˢæːˀlə
tov	tˢɒw
tove	tˢoːwə
tove	tˢɒːʊ
tovet	tˢɒwˀð̩
tradition	tˢʁɑd̥iɕonˀ
traditionel	tˢʁ̥ɑd̥iɕonɛlˀ
traf	tˢʁ̥ɑf
traffes	tˢʁ̥ɑfəs
trafikprop	tˢʁ̥ɑfiɡ̊pʰʁ̥ʌb̥
tragedie	tˢʁ̥ɑɡ̊eðˀjə
tragisk	tˢʁ̥ɑˀɡ̊isɡ̊
traktor	tˢʁ̥ɑɡ̊tˢɐ
traktoren	tˢʁ̥ɑɡ̊tˢɐɐn
traktorer	tˢʁ̥ɑɡ̊tˢoːɐ
trampfart	tˢʁ̥ɑmb̥fɑːˀd̥
tranebær	tˢʁ̥ɑːnəb̥æɐ̯
transformer	tʁ̥ɑnsfɒmeɐ̯ˀ
transformer	tʁ̥ɑnsfɒːmɐ
transparens	tˢʁ̥ɑnsb̥ɑʁans
trapez	tˢʁ̥ɑpɛd̥s
trappe	tˢʁɑb̥ə
traske	tˢʁ̥ɑsɡ̊ə
travl	tˢʁ̥ɑwˀl
tre	tˢʁ̥ɛˀ
tredive	tˢʁ̥aðʋə
tredive	tˢʁ̥ɑðʋə
tredivte	tˢʁ̥aðfd̥ə
tredivte	tˢʁ̥ɑðfd̥ə
tredje	tˢʁ̥ɛðjə
treer	tˢʁ̥æːˀɐ
trekant	tˢʁ̥ɛkʰanˀd̥
trekke	tˢɹɛɡ̊ə
trekke	tˢʁ̥aɡ̊ə
tres	tˢʁ̥æs
tresindstyve	tˢʁ̥ɛsn̩stˢyːʋə
tresindstyvende	tˢʁ̥ɛsn̩stˢyːʊnə
tresindstyvende	tˢʁ̥ɛsənstˢyːʋənə
tressende	tˢʁ̥ɛsənə
treti	tˢʁ̥ɛtˢi
tretten	tˢʁ̥ad̥n̩
tretten	tˢʁ̥ɑd̥n̩
trick	tˢʁɛɡ̊
trin	tˢʁ̥in
trit	tˢʁ̥id̥
triumf	tʁiɔmˀf
tro	tˢʁ̥oˀ
trods	tˢʁ̥ʌs
trodse	tˢʁ̥ʌsə
trodsig	tˢʁ̥ʌsi
troede	tˢʁ̥oːð̩
troede	tˢʁ̥oːð̩ð̩
troende	tˢʁ̥oːonə
troet	tˢʁ̥oˀð̩
trojansk	tˢʁojæˀnsɡ̊
trold	tˢʁ̥ʌlˀ
trolig	tˢʁ̥oːli
trompeter	tˢʁ̥ɔmpʰed̥ɐ
trompeter	tˢʁ̥ɔmpʰeːˀd̥ɐ
trompeter	tˢʁ̥ɔmpʰətˢeːˀɐ̯
tronarving	tˢʁ̥oːnɑːveŋ
trone	tˢʁ̥oːnə
troposfære	tˢʁ̥ob̥osfɛːɐ
troposfære	tˢʁ̥ob̥ʌsfɛːɐ
trosbekendelse	tˢʁ̥oˀsb̥ekʰɛnˀl̩sə
trossamfund	tˢʁ̥oˀsɑmfɔnˀ
troværdig	tˢʁ̥oʋaɐ̯ˀd̥i
tru	tˢʁ̥oˀ
tru	tˢʁ̥uˀ
true	tˢʁ̥oːo
true	tˢʁ̥uːu
truende	tˢʁ̥oːonə
truende	tˢʁ̥uːunə
truffen	tˢʁ̥ɔfən
truffet	tˢʁ̥ɔfəð
trufne	tˢʁ̥ɔfnə
trussel	tˢʁosl̩
trussel	tˢʁosəl
trussel	tˢʁusl̩
trussel	tˢʁusəl
tryg	tˢʁ̥œ̞ɡ̊
trygge	tˢʁ̥œɡ̊ə
tryk	tˢʁ̥œɡ̊
trykke	tˢʁ̥œɡ̊ə
tryne	tˢʁyːnə
tryner	tˢʁyːnɐ
trå	tˢʁɔˀ
tråd	tˢʁʌð
tråd	tˢʁ̥ɔðˀ
tråd	tˢʁ̥ɔːˀð
tråde	tˢʁɔːðə
trådløs	tˢʁ̥ɔðløːˀs
trådt	tˢʁ̥ʌd̥
trådte	tˢʁ̥ʌd̥ə
træ	tˢʁ̥aˀ
træ	tˢʁ̥æˀ
træde	tˢʁ̥aðð̩
træde	tˢʁ̥æðð̩
træder	tˢʁ̥aðˀə
træder	tˢʁ̥ɑðˀə
træder	tˢʁ̥ɛðˀə
træf	tˢʁ̥af
træf	tˢʁ̥ɑf
træffe	tˢʁ̥afə
træffe	tˢʁ̥ɑfə
træffedes	tˢʁ̥afəðəs
træffedes	tˢʁ̥ɑfəðəs
træffende	tˢʁ̥afənə
træffende	tˢʁ̥ɑfənə
træffer	tˢʁ̥afɐ
træffer	tˢʁ̥ɑfɐ
træffes	tˢʁ̥afəs
træffes	tˢʁ̥ɑfəs
træg	tˢʁæjˀ
træge	tˢʁ̥æːjə
træk	tˢʁ̥aɡ̊
trække	tˢʁ̥aɡ̊ə
trækkerdreng	tˢʁ̥aɡ̊ɐd̥ʁaŋˀ
træl	tˢʁ̥alˀ
træl	tˢʁ̥ɑlˀ
trældom	tˢʁ̥ald̥ʌmˀ
trældom	tˢʁ̥ɑld̥ʌmˀ
trælle	tˢʁ̥alə
trælle	tˢʁ̥ɑlə
træls	tˢʁ̥als
træls	tˢʁ̥alˀs
træls	tˢʁ̥ɑls
træls	tˢʁ̥ɑlˀs
træn	tˢʁ̥aŋ
træn	tˢʁ̥æŋ
træn	tˢʁ̥æˀn
træne	tˢʁ̥æːnə
træner	tˢʁ̥æˀnɐ
træner	tˢʁ̥æːnɐ
trænet	tˢʁ̥aŋˀð̩
trænet	tˢʁ̥æŋˀð̩
trænet	tˢʁ̥æˀnð̩
trænet	tˢʁ̥æːnð̩
trænge	tˢʁ̥aŋŋ̩
trænge	tˢʁ̥aŋə
træskonæb	tʁasɡoˀnɛ̝b̥ˀ
træt	tˢʁ̥ad̥
træt	tˢʁ̥ɑd̥
trætte	tˢʁ̥ad̥ə
trætte	tˢʁ̥ɑd̥ə
trættekær	tˢʁ̥ad̥əkʰɛːˀɐ̯
trættekær	tˢʁ̥ɑd̥əkʰæɐ̯ˀ
trævl	tˢʁ̥awˀl
trøffel	tˢʁ̥œfəl
trøflen	tˢʁ̥œflən
trøfler	tˢʁ̥œflɐ
trøje	tˢʁ̥ʌjə
tud	tˢuðˀ
tud	tˢuˀð
tude	tˢuːðə
tudse	tusə
tugt	tˢɔɡ̊d̥
tumult	tˢumulˀd̥
tun	tˢuːˀn
tung	tˢɔŋˀ
tunge	tˢɔŋə
tunika	tˢuːˀnikʰa
tupilak	tˢub̥ilɑɡ̊
tupilak	tˢupʰilɑɡ̊
tur	tˢuɐ̯ˀ
turbine	tˢuɐ̯b̥iːnə
turde	tˢoɐ̯d̥ə
turde	tˢoːɐ
turdet	tˢoːɐð
turkis	tˢuɐ̯kʰiːˀs
turkis	tˢyɐ̯kʰiːˀs
tusind	tˢuˀsn̩
tusind	tˢuˀsənə
tut	tˢud̥
tutte	tˢud̥ə
tvang	tˢʋ̥ɑŋˀ
tvedragt	tˢʋ̥ed̥ʁɒɡ̊d̥
tvetydig	tˢvetyːˀði
tveægget	tˢveɛɡ̊əð
tveægget	tˢveɛːˀɡ̊əð
tvinge	tˢʋ̥eŋə
tvivl	tˢviwˀl
tvær	tˢʋ̥ɛˀɐ̯
tvære	tˢʋ̥ɛːɐ
tværs	tˢʋ̥aɐ̯s
tvært	tˢʋ̥aɐ̯d̥
tvært	tˢʋ̥ɛɐ̯ˀd̥
tvætte	tˢvɛd̥ə
ty	tˢyˀ
tyd	tˢyðˀ
tyd	tˢyːˀð
tyde	tˢyːðə
tyfon	tˢyfoˀn
tyfus	tˢyfus
tyfus	tˢyːfus
tyfussen	tˢyfusn̩
tyfussen	tˢyːfusn̩
tyg	tˢyɡ̊
tygge	tˢyɡ̊ə
tyggede	tˢyɡ̊əðə
tygger	tˢyɡ̊ɐ
tygget	tˢyɡ̊əð
tyk	tˢyɡ̊
tykkes	tˢyɡ̊əs
tykkes	tˢœwˀs
tykmælk	tˢyɡ̊mɛlˀɡ̊
tyktarm	tyɡtɑˀm
tynd	tˢønˀ
tyndtarm	tøntɑˀm
tyngde	tˢøŋd̥ə
tyngdekraft	tˢøŋd̥əkʰʁɑfd̥
tyr	tˢyɐ̯ˀ
tyr	tˢyˀɐ̯
tyran	tˢyʁɑn
tyran	tˢyʁɑnˀ
tyran	tˢyʁɑˀn
tyre	tˢyːɐ
tyrker	tˢyɐ̯ɡ̊ɐ
tyrkiet	tˢyɐ̯kʰiˀəð
tyrkisk	tˢyɐ̯kʰisɡ̊
tyrkisk	tˢyɐ̯ɡ̊isɡ̊
tysk	tˢysɡ̊
tysker	tˢysɡ̊ɐ
tyskertøs	tˢysɡ̊ɐtˢøːˀs
tyskland	tˢysɡ̊lanˀ
tyst	tˢysd̥
tyv	tˢywˀ
tyve	tˢyːʊ
tyve	tˢyːʋə
tyvende	tˢywnə
tyvende	tˢyːvənə
tyver	tˢyːvɐ
tå	tˢɔːˀ
tåge	tˢɔːʊ
tåle	tˢɔːlə
tålmod	tˢʌlmoðˀ
tålmod	tˢʌlmoˀð
tålmodig	tˢʌlmoˀði
tår	tˢɒˀ
tåre	tˢɔːɐ
tårn	tˢɒːˀn
tårne	tˢɒːnə
tæft	tˢɛfd̥
tæmme	tˢɛmə
tænde	tˢɛnə
tænder	tˢɛnɐ
tænder	tˢɛnˀɐ
tændt	tˢɛnˀd̥
tænke	tˢɛŋɡ̊ə
tænkt	tˢɛŋˀd̥
tænkte	tˢɛŋd̥ə
tænkte	tˢɛŋˀd̥ə
tæppe	tˢɛb̥ə
tærske	tˢæɐ̯sɡ̊ə
tærskel	tˢæʁsɡ̊əl
tæske	tˢɛsɡ̊ə
tæt	tˢɛd̥
tøffelhelt	tˢøfl̩hɛlˀd̥
tøj	tˢʌj
tøjet	tˢʌjˀəð
tøjet	tˢʌðˀð̩
tøjhus	tˢʌjhuˀs
tøjle	tˢʌɪ̯lə
tøjte	tˢʌjd̥ə
tølt	tˢœlˀd̥
tømme	tˢœmə
tømmermænd	tˢœmɐmɛnˀ
tømrer	tˢœmʁɐ
tønde	tˢønə
tør	tˢøɐ̯ˀ
tør	tˢøˀɐ̯
tør	tˢɶɐ̯
tør	tˢɶɐ̯ˀ
tør	tˢɶˀɐ̯
tørklæde	tˢɶɐ̯kʰl̥ɛːðə
tørst	tˢɶsd̥
tørst	tˢɶɐ̯sd̥
tørstig	tˢɶsd̥i
tørstig	tˢɶɐ̯sd̥i
tøs	tˢøːˀs
tøve	tˢøːʊ
tøve	tˢøːʋə
tøven	tˢøːʊn
tøven	tˢøːʋn̩
uagtet	uɑɡ̊d̥əð
uartig	uɑːˀd̥i
ubestemmelig	ub̥esd̥ɛmˀəli
ubestemt	ub̥esd̥ɛmˀd̥
ubrugelig	ub̥ʁoːˀli
ubrugelig	ub̥ʁuːˀəli
ubønhørlig	ubœnhøɐ̯ˀli
udadvendt	uðˀaðvɛnˀd̥
uddateret	uðd̥atˢeːˀɐð
ude	uːðə
udeblev	uːðəb̥lewˀ
udebleven	uːðəb̥lewˀən
udeblevet	uːðəb̥lewˀəð
udeblevet	uːð̩b̥leðˀð̩
udeblevne	uːðəb̥lewˀnə
udeblive	uːðəb̥liwˀə
udeblive	uːðəb̥liˀ
udebliven	uːðəb̥liwˀən
udebliver	uːðəb̥liwˀɐ
udebliver	uːðəb̥liɐ̯ˀ
udelukke	uːðəlɔɡ̊ə
udelukkende	uːðəlɔɡ̊ənə
udenlands	uðn̩lanˀs
udenlandsk	uðð̩nlanˀsɡ̊
udgift	uðɡ̊ifd̥
udklædning	uðkʰl̥ɛðˀneŋ
udklædt	uðkʰl̥ɛˀd̥
udland	uðlanˀ
udlede	uðleðˀð̩
udlejer	uðlɑjˀɐ
udlændig	uðlɛnˀd̥i
udlænding	uðlɛnˀeŋ
udrede	uðʁæðˀð̩
udrensning	uðʁanˀsneŋ
udrydde	uðʁyðˀə
udsagn	uðsɑwˀn
udsagnsord	uðsɑwnsoɐ̯ˀ
udseende	uðseːˀənə
udsigt	uðseɡ̊d̥
udskud	uðsɡ̊uð
udstykke	uðsd̥øɡ̊ə
udtryk	uðtˢʁ̥œ̞ɡ̊
udtrykke	uðtˢʁ̥œ̞ɡ̊ə
udvikling	uðveɡ̊leŋ
udvortes	uðvɒːd̥əs
udvortes	uðvɒːˀd̥əs
udyr	udyɐ̯ˀ
uforanderlig	ufʌɑnˀɐli
uforlignelig	ufɒliːˀnəli
ufrivillig	ufʁ̥iʋilˀi
ufødt	uføˀd̥
uge	uːə
ugedag	uːd̥æːˀ
ugentlig	uːnli
ugentlig	uːənd̥li
ugift	uɡ̊ifd̥
ugle	uːlə
uglen	uːln̩
ugler	uːlɐ
uglerne	uːlɐnə
uheld	uhɛlˀ
uheldig	uhɛlˀd̥i
uhyre	uhyˀɐ
uhyre	uhyːɐ
uhyrlig	uhyɐ̯ˀli
uhørt	uhøɐ̯ˀd̥
ukendt	ukʰɛnˀd̥
ukrudt	ukʰʁ̥od̥
ukrudt	ukʰʁ̥ud̥
uld	ulˀ
ulden	uln̩
ulden	ulən
ulden	ulˀn̩
ulden	ulˀən
ulig	uliˀ
ulige	uliːi
ulige	uliːə
uligt	uliɡ̊d̥
uligt	uliˀd̥
ulk	ulˀɡ̊
ulovlig	ulɒwˀli
ulovlige	ulɒwˀlii
ulovligt	ulɒwˀlid̥
ultimatum	ultˢimæːtˢɔm
ultralyd	ultˢʁ̥ɑlyðˀ
ulv	ulˀʋ
ulykke	uløɡ̊ə
ulykkelig	uløɡ̊əli
ulykkesbil	uløɡ̊əsb̥iːˀl
ulyst	uløsd̥
umbra	ɔmb̥ʁɑ
unde	ɔnə
under	ɔnɐ
under	ɔnˀɐ
underlag	ɔnɐlæːˀɪ̯
underlig	ɔnʌli
underskrive	ɔnɐsɡ̊ʁiwˀʊ
underskrive	ɔnɐsɡ̊ʁiˀʋə
undertiden	ɔnɐtˢiðˀən
undertøj	ɔnɐtˢʌj
undfange	ɔnfɑŋˀə
undgå	ɔnɡ̊ɔˀ
undgælde	ɔnɡ̊ɛlˀə
undr	ɔnˀd̥ɐ
undre	ɔnd̥ʁɐ
undrede	ɔnd̥ʁɐðə
undredes	ɔnd̥ʁɐðəs
undren	ɔnd̥ʁɐ
undrende	ɔnd̥ʁɐnə
undrer	ɔnd̥ʁɐ
undres	ɔnd̥ʁɐs
undret	ɔnd̥ʁɐð
undtag	ɔntˢæˀ
undtage	ɔntˢæˀ
undtagen	ɔntˢæjˀən
undtagen	ɔntˢæˀn
undtager	ɔntˢɑˀ
undtaget	ɔntˢæˀəð
undtagne	ɔntˢæˀjnə
undtagne	ɔntˢæˀnə
undtog	ɔntˢoˀ
undulat	ɔnd̥ulæːˀd̥
undulat	ʌnd̥ulæːˀd̥
undvige	ɔnʋiˀi
undvære	ɔnʋɛˀɐ
ung	ɔŋˀ
ungarer	ɔŋɡ̊ɑːˀɑ
ungarsk	ɔŋɡ̊ɑːˀsɡ̊
ungdom	ɔŋd̥ʌm
unge	ɔŋə
ungkarl	ɔŋkʰæːˀl
ungt	ɔŋˀd̥
unik	juniɡ̊
unik	uniɡ̊
univers	univæɐ̯s
universitet	uniʋaɐ̯sitˢeˀd̥
unyttig	unød̥i
unødvendig	unøðʋɛnˀd̥i
unødvendige	unøðʋɛnˀd̥ii
unødvendigt	unøðʋɛnˀd̥id̥
uomgængelig	ʌmɡ̊ɛŋˀli
uomgængelig	ʌmɡ̊ɛŋˀəli
uoverlagt	uɒwɐlɑɡ̊d̥
ur	uɐ̯ˀ
uret	uʁad̥
uret	uʁɑd̥
uret	uˀɐð
urgermansk	uɐ̯ɡ̊æɐ̯mæːˀnsɡ̊
urin	uʁiːˀn
urinal	uɐ̯inæːˀl
urinale	uɐ̯inæːlə
urindoeuropæisk	uɐ̯end̥oœwʁopʰɛˀisɡ̊
urinsekt	uɐ̯ensɛɡ̊d̥
ursuppe	uɐ̯sɔb̥ə
urt	uɐ̯d̥
urtid	uɐ̯tˢiðˀ
urtid	uɐ̯tˢiˀð
uræmi	uʁɛmiːˀ
usagt	usɑɡ̊d̥
usikker	useɡ̊ɐ
uskreven	usɡ̊ʁæwˀn̩
uskreven	usɡ̊ʁæˀʋn̩
uskyldig	usɡ̊ylˀd̥i
ussel	usəl
usynlig	usyˀnli
usynlighed	usyːnliheðˀ
utallig	utˢalˀi
utilfreds	utˢefʁɛs
utilfredsstillende	utˢefʁɛssd̥elˀənə
utilgivelig	utˢelɡ̊iːˀvəli
utrolig	utˢʁ̥oˀli
utryg	utˢʁ̥œ̞ɡ̊
utvivlsom	utˢviwˀlsʌmˀ
utøj	utˢʌj
uundgåelig	uɔnɡ̊ɔˀli
uundgåelig	uɔnɡ̊ɔˀəli
uvejr	uʋɛɐ̯ˀ
uvejr	uʋɛˀɐ̯
uvis	uve̝s
uvis	uviˀːs
uvægerlig	uʋɛjˀɐli
uvægerlig	uʋɛɐ̯ˀli
uvægerlig	uʋɛˀɐli
uværdig	uʋaɐ̯d̥i
vabel	vɑːb̥l̩
vad	vað
vad	væːˀð
vag	væjˀ
vag	væːˀj
vage	væːjə
vagt	væˀjd̥
vagt	vɑɡ̊d̥
vagtelkonge	vɑɡ̊d̥əlɡ̊ʰʌŋə
vakt	ʋɑɡ̊d̥
vakte	ʋɑɡ̊d̥ə
vaktes	ʋɑɡ̊d̥əs
vakuum	væːˀkʰuɔm
vakuum	vɑkʰuɔm
vakuum	vɑkʰɔm
val	ʋalˀ
val	ʋæˀl
valg	ʋɑlˀ
valg	ʋɑlˀʝ
valgt	ʋalˀd̥
valgte	ʋald̥ə
valgte	ʋalˀd̥ə
valke	valɡ̊ə
valkyrie	valkʰyɐ̯ˀiə
vallak	valɑk
vals	valˀs
valsen	valsn̩
valsen	valˀsn̩
valte	ʋald̥ə
vammel	vɑmˀl̩
vampyr	ʋɑmpʰyɐ̯ˀ
vams	vɑmˀs
van	van
van	væːn
van	væːˀn
vand	ʋa̝nˀ
vandbakkelse	ʋanb̥ɑɡ̊əlsə
vande	vann̩
vande	vanə
vandet	ʋa̝nˀð̩
vandfarve	vanfɑːvə
vandmelon	ʋanmeloːˀn
vandr	ʋɑnˀd̥ɐ
vandrefalk	vɑnd̥ʁɐfalˀɡ̊
vandrestjerne	ʋɑnd̥ʁɐsd̥jaɐ̯nə
vane	væːnə
vanedyr	væːnədyɐ̯ˀ
vant	ʋanˀd̥
vantro	vantˢʁ̥oːˀ
vanvid	ʋanʋiðˀ
vanvittig	ʋanʋid̥i
vanvittige	ʋanʋid̥ii
vanvittigt	ʋanʋid̥id̥
var	ʋɑ
var	ʋɑˀ
vare	ʋɑːɑ
varetage	ʋɑːɑtˢæˀ
varetægt	ʋɑːɑtˢɛɡ̊d̥
varmeovn	ʋɑːməɒwˀn
varsel	ʋɑːsl̩
varsel	ʋɑːˀsl̩
varsle	ʋɑːslə
varsom	vɑːsɒmˀ
varulv	ʋɑːulˀʋ
vasal	vasalˀ
vase	væːsə
vaskebjørn	vasɡəbjɶɐ̯ˀn
vaskeklud	vasɡ̊əkʰluðˀ
vaskemaskine	vasɡ̊əmasɡ̊iːnə
vaskemiddel	vasɡ̊əmiðˀəl
ve	ʋeːˀ
ved	ʋe
ved	ʋeð
ved	ʋeðˀ
ved	ʋeˀ
vederkvæge	ʋeðɐkʰʋ̥ɛˀjə
vederkvæge	ʋeðɐkʰʋ̥ɛˀɛ
vedrøre	ʋeðʁɶˀɐ
vedrørende	ʋeðʁɶɐ̯ˀnə
vedrørende	ʋeðʁɶˀɐnə
vedtage	ʋeðtˢæˀ
vedtægt	ʋeðtˢɛɡ̊d̥
veer	ʋeːˀɐ
vege	veːjə
vegne	ʋɑjnə
vej	ʋɑjˀ
veje	ʋɑjə
veje	ʋɑːɪ
vejlede	ʋɑjleðˀð̩
vejledning	ʋɑjleðˀneŋ
vejr	ʋɑjˀɐ
vejr	ʋɛɐ̯ˀ
vejr	ʋɛˀɐ̯
vejre	ʋɑjʁɐ
vejret	ʋɑjɐð
vejret	ʋɑjʁɐð
vejret	ʋɛˀɐð
vejrgud	vɛɐ̯kuð
vejrhane	vɛɐ̯hæːnə
vejrudsigt	ʋɛɐ̯uðseɡ̊d̥
velberåd	vɛlb̥eʁɔˀð
velfærd	ʋɛlfɛɐ̯ˀ
velfærd	ʋɛlfɛˀɐ̯
velfærdssamfund	ʋɛlfɛɐ̯ssɑmfɔnˀ
velfærdssamfund	ʋɛlfɛɐ̯sɑmfɔnˀ
velfærdsstat	ʋɛlfɛɐ̯sd̥æˀd̥
velfærdsstat	ʋɛlfɛɐ̯ssd̥æˀd̥
velkendt	vɛlkʰɛnˀd̥
vellevned	ʋɛllɛwnð̩
velocipede	ʋelosipʰeðð̩
velsmagende	ʋelsmɛˀɪnə
ven	ʋɛn
vend	vɛnˀ
vende	ʋɛnə
veninde	vɛnenə
vennen	ʋɛnˀn̩
venskab	vɛnsɡ̊æˀb̥
venskabsby	vɛnsɡ̊ab̥sb̥yːˀ
vent	vɛnˀd̥
vente	ʋɛnd̥ə
verbum	ʋaɐ̯b̥ɔm
verden	ʋaɐ̯d̥n̩
verdenskrig	væɐ̯d̥ənskʰʁiːˀ
verdensmester	væɐ̯d̥ənsmɛsd̥ɐ
verdslig	ʋaɐ̯d̥sli
verfe	ʋaɐ̯rfə
vest	ʋɛsd̥
vestkyst	ʋɛsd̥kʰøsd̥
vesttysk	ʋɛsd̥tˢysɡ̊
veteran	vetˢəʁɑːˀn
viborg	vib̥ɒˀ
vid	ʋið
vid	ʋiðˀ
vid	ʋiˀð
vide	ʋiðð̩
viden	ʋiðð̩n
videnskab	ʋiðˠn̩sɡ̊æːˀb̥
videre	viðɐɐ
vidne	ʋiðnə
vidst	ʋesd̥
vidste	ʋesd̥ə
vidt	vid̥
vidunder	ʋiðɔnˀɐ
vidunderlig	ʋiðɔnˀɐli
vig	ʋiˀ
vige	ʋiːi
viking	vikeŋ
vil	vel
vild	ʋilˀ
vilde	ʋilə
vildsvin	ʋilsʋiˀn
vildt	ʋilˀd̥
vilje	ʋiljə
viljestyrke	viljəsd̥yɐ̯ɡ̊ə
ville	ʋelə
ville	ʋilə
villig	ʋili
vin	ʋiˀn
vind	ʋenˀ
vindbøjtel	ʋenb̥ʌjˀd̥əl
vinde	venə
vinder	venɐ
vinder	venˀɐ
vindruekerneolie	ʋind̥ʁuːəkʰæɐ̯nəoljə
vindue	vend̥u
vinke	viŋɡ̊ə
vinter	venˀd̥ɐ
violin	violiːˀn
violinist	violinisd̥
vippe	veb̥ə
virak	viːʁɑɡ̊
viril	viʁiːˀl
virolog	viʁoloːˀ
vis	ʋes
vis	ʋiˀs
vis	ʋiːˀs
visa	viːsa
visdom	viːsd̥ʌmˀ
vise	ʋiːsə
visk	ʋesɡ̊
viske	ʋesɡ̊ə
visken	ʋesɡ̊ŋ̩
visken	ʋesɡ̊ən
viskestykke	vesɡ̊əsd̥øɡ̊ə
vist	ʋesd̥
vist	ʋiˀsd̥
visum	viːsɔm
vitamin	vitˢamiːˀn
vitaminpille	vitˢamiːˀnpʰelə
vits	ʋid̥s
vittighed	vid̥iheðˀ
vogn	ʋɒwˀn
vogte	ʋʌɡ̊d̥ə
vogter	ʋʌɡ̊d̥ɐ
vokse	ʋʌɡ̊sə
voksen	ʋʌɡ̊sn̩
volapyk	volapʰyɡ̊
vold	ʋʌlˀ
volde	ʋʌlə
voldtægt	ʋʌltˢɛɡ̊d̥
vom	vʌmˀ
vor	ʋɒ
vorde	ʋɒːd̥ə
vordede	ʋɒːd̥ð̩ð̩
vorden	ʋɒːd̥n̩
vordende	ʋɒːd̥n̩nə
vorder	ʋɒːd̥ɐ
vordet	ʋɒːd̥ð̩
vort	vɒd̥
vorte	vɒːd̥ɘ
vov	ʋɒw
vov	ʋɔˀw
vove	ʋɔːʊ
vove	ʋɔːʋə
vovede	ʋɔwð̩ð̩
vovede	ʋɔːʋð̩ð̩
vovedes	ʋɔwð̩ð̩s
vovedes	ʋɔːʋð̩ð̩s
voven	ʋɔwn̩
voven	ʋɔːʋn̩
vover	ʋɔwɐ
vover	ʋɔːʋɐ
voves	ʋɔːʊs
voves	ʋɔːʋəs
vovet	ʋɔwð̩
vovet	ʋɔːʋð̩
vrag	vʁɑːˀw
vrage	vʁɑːwə
vrang	vʁɑŋˀ
vred	ʋʁæðˀ
vred	ʋʁæˀð
vrede	ʋʁɛːðˠə
vrid	vʁið
vrid	vʁiðˀ
vride	ʋʁiðð̩
vrik	vʁæɡ̊
vrikke	vʁæɡ̊ə
vrå	ʋʁɔˀ
vrøvl	ʋʁɶwˀl
vrøvle	ʋʁɶwlə
vrøvlede	ʋʁɶwlð̩ð̩
vrøvlen	ʋʁɶwln̩
vrøvlende	ʋʁɶwl̩nə
vrøvler	ʋʁɶwlɐ
vrøvlet	ʋʁɶwlð̩
vrøvlet	ʋʁɶwˀlð̩
vuf	ʋuf
vugge	ʋɔɡ̊ə
vuggestue	ʋɔɡ̊əsd̥uːu
vulgær	vulɡ̊ɛːˀɐ̯
vunden	vɔnən
vundne	vɔnnə
vurdere	ʋoɐ̯d̥eˀɐ
vurdere	ʋuɐ̯d̥eˀɐ
våben	vɔːˀb̥m̩
våd	ʋɔðˀ
våd	ʋɔˀð
våde	ʋɔðð̩
vådt	ʋʌd̥
våge	ʋɔːʊ
vågede	ʋɔwð̩ð̩
vågen	ʋɔːwən
vågen	ʋɔːʊn
våger	ʋɔwɐ
våges	ʋɔːʊs
våget	ʋɔwð̩
vågn	ʋɔwˀn
vågne	ʋɔwnə
vågnede	ʋɔwnəðə
vågner	ʋɔwnɐ
vågnet	ʋɔwnəð
vår	ʋɒˀ
væd	vɛðˀ
vædde	ʋɛðð̩
vædder	ʋɛðɐ
vædder	ʋɛðˀɐ
væde	ʋɛðð̩
væg	ʋɛːˀɡ̊
væge	vɛːjə
vægre	ʋɛːjʁɐ
vægre	ʋɛːɐ
vægre	ʋɛːʁɐ
vægt	ʋɛɡ̊d̥
vægte	ʋɛɡ̊d̥ə
vægter	ʋɛɡ̊d̥ɐ
vægtning	ʋɛɡ̊d̥neŋ
vægtning	ʋɛɡ̊neŋ
væk	vɛɡ̊
vække	ʋɛɡ̊ə
vækkede	ʋɛɡ̊əðə
vækkedes	ʋɛɡ̊əðəs
vækkelse	vɛɡ̊əlsə
vækken	ʋɛɡ̊ən
vækkende	ʋɛɡ̊ənə
vækker	ʋɛɡ̊ɐ
vækkes	ʋɛɡ̊əs
vækket	ʋɛɡ̊əð
vækning	ʋɛɡ̊neŋ
vækst	ʋɛɡ̊sd̥
vældig	velti
vælge	ʋɛljə
vælger	vɛljɐ
vælte	ʋɛld̥ə
væltepeter	ʋɛld̥əpʰeˀd̥ɐ
vænne	vɛnə
vær	væɐ̯ˀ
vær	væˀɐ̯
værd	ʋɛɐ̯ˀ
værd	ʋɛˀɐ̯
værdi	ʋaɐ̯d̥iˀ
værdifuld	ʋaɐ̯d̥ifulˀ
værdig	ʋaɐ̯d̥i
værdighed	væɐ̯d̥iheðˀ
værdiløs	ʋaɐ̯d̥iløˀs
være	ʋɛːɐ
værelse	ʋaɐ̯lsə
værelse	ʋaːɐlsə
væren	ʋɛːɐn
værg	ʋaɐ̯ˀw
værge	ʋaɐ̯wə
værge	ʋaɐ̯ʊ
værgede	ʋaɐ̯wəðə
værgede	ʋaɐ̯ʊðə
værgedes	ʋaɐ̯wəðəs
værgedes	ʋaɐ̯ʊðəs
værgen	ʋaɐ̯wɐn
værgen	ʋaɐ̯ʊn
værgende	ʋaɐ̯wənə
værgende	ʋaɐ̯ʊnə
værgens	ʋaɐ̯wəns
værgens	ʋaɐ̯ʊns
værger	ʋaɐ̯wɐ
værgerne	ʋaɐ̯wɐnə
værgernes	ʋaɐ̯wɐnəs
værgers	ʋaɐ̯wɐs
værges	ʋaɐ̯wəs
værges	ʋaɐ̯ʊs
værget	ʋaɐ̯wəð
værget	ʋaɐ̯ʊð
værgets	ʋaɐ̯wəðs
værgets	ʋaɐ̯ʊðs
værk	ʋaɐ̯ɡ̊
værktøj	vaɐ̯ɡ̊tˢʌj
værktøjet	vaɐ̯ɡ̊tˢʌjˀəð
værktøjet	vaɐ̯ɡ̊tˢʌðˀð̩
værn	ʋaɐ̯ˀn
værne	ʋaɐ̯nə
værnemager	ʋaɐ̯nəmæˀjɐ
værnemager	ʋaɐ̯nəmæˀɐ
værnemagt	ʋaɐ̯nəmɑɡ̊d̥
værpe	ʋaɐ̯rb̥ə
værre	ʋaɐ̯ɐ
værst	ʋaɐ̯sd̥
værste	ʋaɐ̯sd̥ə
værsågod	væɐ̯sɡoˀ
vært	ʋaɐ̯d̥
værten	ʋaɐ̯d̥n̩
værterne	væɐ̯d̥ɐnə
værtinde	væɐ̯d̥enə
væsen	vɛˀsən
væsentlig	vɛˀsn̩li
væsentlig	vɛˀsənd̥li
vætte	ʋɛd̥ə
væv	ʋɛwˀ
væv	ʋɛˀw
vølve	vølvə
vølve	vœlvə
w	d̥ʌb̥əlveːˀ
walisisk	valiːˀsisɡ̊
wc	veːˀseːˀ
website	wɛb̥sɑjd̥
weekend	wiːɡ̊ɛnd̥
weekend	ʋiːɡ̊ɛnˀd̥
whiskysovs	wisɡ̊isɒʊ̯ˀs
whiskysovs	ʋisɡ̊isɒʊ̯ˀs
whist	ʋesd̥
yde	yːð̠ˠə
ydelse	yːð̠ˠəlsə
ydmyg	yðmyˀ
ydre	yðʁɐ
ynde	ønə
yndling	øŋliŋ
yngre	øŋʁɐ
yngst	øŋˀsd̥
yngste	øŋˀsd̥ə
yoga	joːɡ̊a
ypsilon	yb̥silʌn
yt	yd̥
ytre	yd̥ʁɐ
ytring	yd̥ʁɛŋ
ytringsfrihed	yd̥ʁeŋsfʁiheðˀ
yver	ywˀɐ
yver	yːˀvɐ
yver	yːˀwɐ
zar	sɑːˀ
zarina	zɑʁiːna
zeus	sœwˀs
zink	seŋˀɡ̊
zone	soːnɘ
zucchini	sukʰini
zucchini	sukʰiːni
å	ɔ
å	ɔˀ
å	ɔː
åben	ɔːb̥m̩
åbenbar	ɔːb̥m̩b̥ɑˀ
åbenbar	ɔːb̥ənb̥ɑˀ
åbenbare	ɔːb̥m̩b̥ɑˀɑ
åbenbare	ɔːb̥ənb̥ɑˀɑ
åbn	ɔˀb̥m̩
åbne	ɔːb̥nə
åd	ʌˀð̞
ådsel	ʌðˀsl̩
ådsel	ʌðˀsəl
åg	ɔːˀw
åger	ɔwˀɐ
åger	ɔˀwɐ
ågerkarl	ɔwˀɐkʰæˀl
ålborg	ʌlb̥ɒːˀ
ånd	ʌnˀ
ånde	ʌnə
ånden	ʌnn̩
ånden	ʌnˀn̩
åndet	ʌnəð
ångstrøm	ɔŋsd̥ʁœmˀ
ångstrøm	ʌŋsd̥ʁœmˀ
åre	ɒːɒ
århus	ɒːhus
århus	ɒːhuˀs
århusianer	ɒhuɕæːˀnɐ
århusiansk	ɒhuɕæːˀnsɡ̊
årle	ɒːlə
årlig	ɒːli
årsag	ɒːsæˀj
årsdag	ɒːˀsd̥æːˀ
årstid	ɒːstˢiðˀ
årti	ɒtˢiːˀ
ås	ɔːˀs
æ	ɛːˀ
æble	ɛːb̥lə
æbleskive	eːb̥ləsɡ̊iːw
æbletræ	ɛːb̥lətˢʁɛːˀ
æde	ɛðð̩
ædru	ɛːd̥ʁoˀ
ædru	ɛːd̥ʁuˀ
æg	ɛɡ̊
æg	ɛˀj
æg	ɛˀɡ̊
ægge	ɛɡ̊ə
ægge	ɛːɡ̊ə
æggende	ɛɡ̊ənə
æggene	ɛˀɡ̊n̩nə
æggene	ɛːɡ̊n̩nə
æggestok	ɛɡ̊əsd̥ʌɡ̊
ægget	ɛɡ̊əð
ægget	ɛˀɡ̊əð
ægte	ɛɡ̊d̥ə
ægtefælle	ɛɡ̊d̥əfɛlə
ægtemand	ɛɡ̊d̥əmanˀ
ækel	ɛːˀɡ̊əl
ækvator	ekʰvæːtˢɐ
ækvator	ɛkʰvæːtˢɐ
ælde	ɛlə
ældre	ɛld̥ʁɐ
ældst	ɛlˀsd̥
ældste	ɛlˀsd̥ə
ælling	ɛleŋ
ændre	ɛnd̥ʁɐ
ændring	ɛnd̥ʁeŋ
ændringsforslag	ɛnd̥ʁeŋsfɒːsl̥æˀ
ændringsforslag	ɛnd̥ʁeŋsfɒːsl̥æˀj
ærgerlig	aɐ̯wli
ærgerlig	aɐ̯wɐli
ærgre	aːʊ̯ɐ
ærinde	æɐ̯ɐnə
ærkeengel	æɐ̯ɡ̊əɛŋəl
ærlig	æɐ̯li
ærme	æɐ̯mə
ært	æɐ̯ˀd̥
æsel	ɛˀsəl
æske	ɛsɡ̊ə
æt	ɛˀd̥
æter	ɛˀd̥ɐ
æts	ɛd̥s
æts	ɛˀd̥s
ætse	ɛˀd̥sə
ætten	ɛˀd̥ən
ætter	ɛˀd̥ɐ
ø	øˀ
ø	øːˀ
øde	øðð̩
ødegård	øðð̩ɡ̊ɒˀ
ødelægge	øðð̩lɛɡ̊ə
ødipal	ød̥ipʰæˀl
ødipus	øˀd̥ipʰus
ødipuskompleks	øˀd̥ipʰuskʰʌmpʰl̥ɛɡ̊s
øg	øˀj
øg	ʌjˀ
øge	øːø
øge	øːɪ
øgenavn	øːjənɑwˀn
øgle	ʌjlə
øh	əː
øje	ʌjə
øje	ʌːɪ
øjeblik	ʌjəb̥leɡ̊
øjebæ	ʌːɪpeˀ
øjendråber	ʌjənd̥ʁɔːb̥ɐ
øjet	ʌjð̩
øjet	ʌðð̩
øjne	ʌjnə
øjnene	ʌɪ̯n̩nə
øjnes	ʌjnəs
økonomi	økʰonomiːˀ
økse	øɡ̊sə
økumenisk	økʰumeːˀnisɡ̊
øl	øl
øldåse	øld̥ɔːsə
øllen	ølˀn̩
ølmave	ølmæːvə
øm	œmˀ
ømfindtlig	œmfenˀd̥li
ønske	ønsɡə
ønskedrøm	ønsɡ̊əd̥ʁɶmˀ
ønsketænkning	ønsɡ̊ətˢɛŋɡ̊neŋ
ør	øɐ̯ˀ
ør	øˀɐ̯
øre	øːɐ
øreflip	øːɐfleb̥
ørering	øːɐʁeŋ
ørering	øːɐʁɛŋ
øresund	øːɐsɔnˀ
øresundsbroen	øɐsɔnsb̥ʁoˀːn̩
ørken	ɶɐ̯ɡ̊ŋ̩
ørkesløs	œ̞ɐ̯ɡ̊əsløːˀs
ørn	œ̞ɐ̯ˀn
ørred	ɶɐ̯ʌð̠ˠ
øst	øsd̥
øst	øˀsd̥
østersøen	øsd̥ɐsøːˀən
østkyst	øsd̥kʰøsd̥
østrig	øsd̥ʁi
østtysk	øsd̥tˢysɡ̊
øv	œw
øv	œːw
øve	øːʊ
øve	øːʋə
øverst	øwˀɐsd̥
øverst	øˀʋɐsd̥
øvre	øwɐ
øvre	øwʁɐ
øvrig	øwʁi
