le	lˈe
de	dˈe
e	ˈe
un	ˈun
del	dˈel
in	ˈin
es	ˈes
que	kˈe
Le	lˈe
su	sˈu
a	ˈa
pro	prˈo
per	pˈer
esseva	esˈeva
al	ˈal
ha	hˈa
con	kˈon
se	sˈe
como	kˈomo
plus	plˈus
non	nˈon
o	ˈo
In	ˈin
ille	ˈile
iste	ˈiste
pote	pˈote
altere	ˈaltere
illo	ˈilo
esser	esˈer
Ille	ˈile
era	ˈera
isotopo	isˈotopo
Illo	ˈilo
annos	ˈanos
habeva	habˈeva
Un	ˈun
prime	prˈime
ma	mˈa
inter	ˈinter
lo	lˈo
grande	ɡrˈande
lor	lˈor
super	sˈuper
duo	dˈuo
qui	kˈi
il	ˈil
Iste	ˈiste
Su	sˈu
multe	mˈulte
lingua	lˈiŋɡwa
on	ˈon
durante	durˈante
parte	pˈarte
tote	tˈote
multo	mˈulto
son	sˈon
illos	ˈilos
Il	ˈil
anque	ˈanke
essite	esˈite
nove	nˈove
quando	kwˈando
mesme	mˈesme
nomine	nˈomine
etiam	ˈetjam
qual	kwˈal
usque	ˈuske
forma	fˈorma
citate	t͡sitˈate
post	pˈost
solmente	solmˈente
tempore	tˈempore
isto	ˈisto
mundo	mˈundo
usate	usˈate
vita	vˈita
sur	sˈur
ab	ˈab
linguas	lˈiŋɡwas
circa	t͡sˈirka
deveniva	dˌevenˈiva
illes	ˈiles
population	pˌopulatjˈon
si	sˈi
sin	sˈin
alcun	ˈalkun
et	ˈet
parolas	parˈolas
anno	ˈano
ubi	ˈubi
debe	dˈebe
importante	ˌimportˈante
tres	trˈes
causa	kˈa͡ʊsa
omne	ˈomne
esse	ˈese
seculo	sˈekulo
cata	kˈata
plure	plˈure
personas	persˈonas
pais	pˈa͡ɪs
cognoscite	kˌoɡnost͡sˈite
anglese	aŋɡlˈese
ante	ˈante
exemplo	eksˈemplo
stato	stˈato
appellate	ˌapelˈate
ben	bˈen
Post	pˈost
alicun	ˈalikun
contra	kˈontra
illa	ˈila
numero	nˈumero
parola	parˈola
ex	ˈeks
differente	dˌiferˈente
systema	sistˈema
Pro	prˈo
rege	rˈeɡe
persona	persˈona
morte	mˈorte
fin	fˈin
assi	asˈi
gruppo	ɡrˈupo
nos	nˈos
historia	histˈorja
vices	vˈit͡ses
Isto	ˈisto
la	lˈa
minus	mˈinus
major	maʒˈor
principal	prˌint͡sipˈal
sub	sˈub
parve	pˈarve
sed	sˈed
commun	komˈun
proque	prokˈe
haber	habˈer
paises	pˈa͡ɪses
secunde	sekˈunde
Durante	durˈante
considerate	kˌonsiderˈate
A	ˈa
On	ˈon
obras	ˈobras
sovente	sovˈente
obra	ˈobra
human	humˈan
habitantes	hˌabitˈantes
politic	polˈitik
sol	sˈol
alte	ˈalte
loco	lˈoko
secundo	sekˈundo
facer	fat͡sˈer
proprie	prˈoprje
majoritate	mˌaʒoritˈate
Illa	ˈila
international	ˌinternˌatjonˈal
termino	tˈermino
Deo	ðˈeo
tal	tˈal
uso	ˈuso
moderne	modˈerne
membros	mˈembros
longe	lˈoŋɡe
ultime	ˈultime
include	inklˈude
faceva	fat͡sˈeva
familia	famˈilja
libro	lˈibro
nominate	nˌominˈate
Francia	frˈant͡sja
The	tˈe
existe	eksˈiste
guerra	ɡwˈera
hodie	hˈodje
face	fˈat͡se
alteres	ˈalteres
comenciava	kˌoment͡sjˈava
musica	mˈusika
periodo	perˈiodo
tamben	tambˈen
Al	ˈal
usa	ˈusa
significa	siɡnˈifika
maniera	manjˈera
popular	pˌopulˈar
general	ɡˌenerˈal
varie	vˈarje
vice	vˈit͡se
etate	etˈate
typo	tˈipo
interlingua	ˌinterlˈiŋɡwa
poteva	potˈeva
publicate	pˌublikˈate
los	lˈos
quasi	kwˈasi
De	dˈe
Illos	ˈilos
facite	fat͡sˈite
patre	pˈatre
quatro	kwˈatro
movimento	mˌovimˈento
Per	pˈer
francese	frant͡sˈese
Quando	kwˈando
ancora	ankˈora
re	rˈe
capital	kˌapitˈal
Unite	unˈite
desde	dˈesde
governamento	ɡˌovernamˈento
centro	t͡sˈentro
formas	fˈormas
social	sot͡sjˈal
Como	kˈomo
facto	fˈakto
area	arˈea
poter	potˈer
serie	sˈerje
Europa	e͡ʊrˈopa
mesmo	mˈesmo
puncto	pˈunkto
gruppos	ɡrˈupos
certe	t͡sˈerte
generalmente	ɡˌeneralmˈente
of	ˈof
region	reɡjˈon
grec	ɡrˈek
libros	lˈibros
solo	sˈolo
studio	stˈudjo
filio	fˈiljo
quales	kwˈales
Si	sˈi
roman	romˈan
Union	unjˈon
pauc	pˈawk
scribeva	skribˈeva
corpore	kˈorpore
famose	famˈose
homines	hˈomines
tanto	tˈanto
moriva	morˈiva
aqua	ˈakwa
infantes	infˈantes
trova	trˈova
original	ˌoriɡinˈal
tarde	tˈarde
diverse	divˈerse
milliones	miljˈones
possibile	posˈibile
terra	tˈera
Ecclesia	eklˈesja
toto	tˈoto
base	bˈase
europee	ˌeuropˈee
medio	mˈedjo
animales	ˌanimˈales
verso	vˈerso
antique	antˈikwe
insula	ˈinsula
religiose	rˌeliɡjˈose
scientific	st͡sjentˈifik
sexual	sekswˈal
Jesus	ʒesˈus
basate	basˈate
Secundo	sekˈundo
bon	bˈon
caso	kˈaso
nord	nˈord
partes	pˈartes
statos	stˈatos
Ben	bˈen
Europee	ˌeuropˈee
frequentemente	frˌekwentemˈente
natural	nˌaturˈal
sequente	sekwˈente
create	kreˈate
espaniol	ˌespanjˈol
Christo	krˈisto
official	ˌofit͡sjˈal
Statos	stˈatos
autor	a͡ʊtˈor
aEC	aˈek
dice	dˈit͡se
ecclesia	eklˈesja
origine	orˈiɡine
banda	bˈanda
contine	kontˈine
cuje	kˈuʒe
habe	hˈabe
Nonobstante	nˌonobstˈante
postea	postˈea
version	versjˈon
economic	ˌekonˈomik
public	pˈublik
sud	sˈud
Illes	ˈiles
cultura	kultˈura
die	dˈie
por	pˈor
Ma	mˈa
cinque	t͡sˈiŋkwe
elementos	ˌelemˈentos
disveloppamento	dˌisvelˌopamˈento
film	fˈilm
situate	sitwˈate
classic	klˈasik
objecto	obʒˈekto
scribite	skribˈite
sia	sˈia
basse	bˈase
forte	fˈorte
homine	hˈomine
national	nˌatjonˈal
simple	sˈimple
specialmente	spˌet͡sjalmˈente
alora	alˈora
joco	ʒˈoko
position	pˌositjˈon
dies	dˈies
relationes	rˌelatjˈones
les	lˈes
Con	kˈon
io	ˈio
juvene	ʒˈuvene
genere	ɡˈenere
ancian	ant͡sjˈan
tertie	tˈertje
theoria	tˌeorˈia
Interlingua	ˌinterlˈiŋɡwa
nulle	nˈule
texto	tˈeksto
Assi	asˈi
Nove	nˈove
depost	depˈost
ni	nˈi
rolo	rˈolo
usar	usˈar
natura	natˈura
permitte	permˈite
german	ɡermˈan
mais	mˈais
typos	tˈipos
actual	aktwˈal
considera	kˌonsidˈera
casos	kˈasos
jam	ʒˈam
nigre	nˈiɡre
publicava	pˌublikˈava
historic	histˈorik
latin	latˈin
titulo	tˈitulo
campo	kˈampo
codice	kˈodit͡se
etc	ˈetk
membro	mˈembro
nostre	nˈostre
urbe	ˈurbe
Altere	ˈaltere
christian	kristjˈan
linguage	linɡwˈaʒe
organisation	ˌorɡanˌisatjˈon
regno	rˈeɡno
systemas	sistˈemas
unic	ˈunik
esserea	ˌeserˈea
final	finˈal
gente	ɡˈente
processo	prot͡sˈeso
derecto	derˈekto
initio	inˈitjo
labor	labˈor
personal	pˌersonˈal
relation	rˌelatjˈon
sempre	sˈempre
ambe	ˈambe
cultural	kˌulturˈal
datos	dˈatos
da	dˈa
intra	ˈintra
politica	polˈitika
presente	presˈente
successo	sut͡sˈeso
usualmente	ˌuswalmˈente
occidental	ˌot͡sidentˈal
parla	pˈarla
proxime	prˈoksime
traditional	trˌaditjonˈal
alsi	alsˈi
derectos	derˈektos
programma	proɡrˈama
religion	rˌeliɡjˈon
Multe	mˈulte
refere	refˈere
senso	sˈenso
influentia	inflwˈentja
ipse	ˈipse
modo	mˈodo
species	spˈet͡sjes
Imperio	impˈerjo
album	ˈalbum
practica	prˈaktika
tosto	tˈosto
consiste	konsˈiste
fundate	fundˈate
structura	struktˈura
vive	vˈive
II	duˈo
Roma	rˈoma
education	ˌedukatjˈon
ganiava	ɡanjˈava
ideas	idˈeas
matre	mˈatre
musical	mˌusikˈal
schola	st͡ʃˈola
radio	rˈadjo
Sancte	sˈankte
curte	kˈurte
nivello	nivˈelo
Espania	espˈanja
Germania	ɡermˈanja
litteratura	lˌiteratˈura
medie	mˈedje
problemas	problˈemas
total	totˈal
central	t͡sentrˈal
latino	latˈino
trans	trˈans
casa	kˈasa
fortia	fˈortja
idea	idˈea
linea	linˈea
linguistic	linɡwˈistik
traduction	trˌaduktjˈon
ver	vˈer
creava	kreˈava
departimento	dˌepartimˈento
mundial	mundjˈal
uno	ˈuno
Guerra	ɡwˈera
Svedia	svˈedja
Universitate	ˌunivˌersitˈate
cantos	kˈantos
lege	lˈeɡe
scientia	st͡sjˈentja
scriber	skribˈer
Regno	rˈeɡno
creation	krˌeatjˈon
nasceva	nast͡sˈeva
nunc	nˈunk
nunquam	nˈunkwam
recipeva	rˌet͡sipˈeva
territorio	tˌeritˈorjo
adjuta	adʒˈuta
cosas	kˈosas
crear	kreˈar
epocha	ˈepoka
nomines	nˈomines
ordine	ˈordine
resultato	rˌesultˈato
Grande	ɡrˈande
Hodie	hˈodje
feminas	fˈeminas
scripte	skrˈipte
similar	sˌimilˈar
communitate	kˌomunitˈate
en	ˈan
formate	formˈate
insimul	insˈimul
metros	mˈetros
societate	sˌot͡sjetˈate
via	vˈia
articulo	artˈikulo
includente	ˌinkludˈente
monstra	mˈonstra
particular	pˌartikulˈar
presidente	prˌesidˈente
Totevia	tˌotevˈia
and	ˈand
objectos	obʒˈektos
principalmente	prˌint͡sipalmˈente
the	tˈe
essera	esˈera
lista	lˈista
melior	meljˈor
qualcunque	kwalkˈuŋkwe
material	mˌaterjˈal
arte	ˈarte
definition	dˌefinitjˈon
libere	lˈibere
litteras	lˈiteras
methodo	mˈetodo
numeros	nˈumeros
opera	ˈopera
poterea	pˌoterˈea
production	prˌoduktjˈon
Danmark	danmˈark
Es	ˈes
Plus	plˈus
active	aktˈive
energia	ˌenerɡˈia
est	ˈest
local	lokˈal
recerca	ret͡sˈerka
scopo	skˈopo
seculos	sˈekulos
spatio	spˈatjo
specific	spet͡sˈifik
ultra	ˈultra
Inter	ˈinter
International	ˌinternˌatjonˈal
appella	apˈela
debeva	debˈeva
electric	elˈektrik
equalmente	ˌekwalmˈente
femina	fˈemina
fide	fˈide
latere	lˈatere
menses	mˈenses
phrase	frˈase
succedite	sˌut͡sedˈite
canto	kˈanto
continuava	kˌontinwˈava
fonte	fˈonte
leges	lˈeɡes
physic	fˈisik
recente	ret͡sˈente
stilo	stˈilo
Alcun	ˈalkun
Departimento	dˌepartimˈento
militar	mˌilitˈar
necessari	nˌet͡sesˈari
Cata	kˈata
associate	ˌasot͡sjˈate
blanc	blˈank
carriera	karjˈera
existentia	ˌeksistˈentja
independente	ˌindependˈente
principio	print͡sˈipjo
valor	valˈor
Biblia	bˈiblja
Lor	lˈor
Non	nˈon
Wikipedia	wˌikipˈedja
characteristicas	kˌarakterˈistikas
diceva	dit͡sˈeva
fluvio	flˈuvjo
mal	mˈal
numerose	nˌumerˈose
occurre	okˈure
totevia	tˌotevˈia
vide	vˈide
vista	vˈista
I	ˈi
Tote	tˈote
action	aktjˈon
armea	armˈea
color	kolˈor
concepto	kont͡sˈepto
km	kˌaˈem
statounitese	stˌatoˌunitˈese
tradition	trˌaditjˈon
trovate	trovˈate
dava	dˈava
difficile	difˈit͡sile
svedese	svedˈese
Esperanto	ˌesperˈanto
Terra	tˈera
commercial	kˌomert͡sjˈal
complete	komplˈete
crede	krˈede
maladia	mˌaladˈia
regiones	reɡjˈones
semper	sˈemper
textos	tˈekstos
Postea	postˈea
Republica	repˈublika
ad	ˈad
articulos	artˈikulos
character	karˈakter
citates	t͡sitˈates
comencia	komˈent͡sja
dividite	dˌividˈite
libertate	lˌibertˈate
philosophia	phˌilosofˈia
simplemente	sˌimplemˈente
special	spet͡sjˈal
studios	stˈudjos
terminos	tˈerminos
capacitate	kˌapat͡sitˈate
construite	konstrwˈite
definite	dˌefinˈite
ergo	ˈerɡo
filia	fˈilja
no	nˈo
sono	sˈono
specie	spˈet͡sje
America	amˈerika
britannic	britˈannik
deveni	devˈeni
filios	fˈiljos
programmas	proɡrˈamas
representa	rˌepresˈenta
controlo	kontrˈolo
distincte	distˈinkte
disveloppate	dˌisvelopˈate
interesse	ˌinterˈese
mar	mˈar
ration	ratjˈon
tracta	trˈakta
tunc	tˈunk
John	ʒˈohn
ambiente	ambjˈente
capite	kˈapite
devenite	dˌevenˈite
lineas	linˈeas
litterari	lˌiterˈari
viage	vjˈaʒe
E	ˈe
amor	amˈor
appare	apˈare
autores	a͡ʊtˈores
defensa	defˈensa
includeva	ˌinkludˈeva
information	ˌinformatjˈon
jocator	ʒˌokatˈor
julio	ʒˈuljo
partir	partˈir
projecto	proʒˈekto
rete	rˈete
ser	sˈer
sito	sˈito
va	vˈa
animal	ˌanimˈal
contos	kˈontos
date	dˈate
differentia	dˌiferˈentja
fontes	fˈontes
ibi	ˈibi
importantia	ˌimportˈantja
momento	momˈento
probabilemente	prˌobabˌilemˈente
problema	problˈema
punctos	pˈunktos
rock	rˈokk
usava	usˈava
cavallo	kavˈalo
classe	klˈase
data	dˈata
devenir	dˌevenˈir
function	funktjˈon
indica	ˈindika
insulas	ˈinsulas
lumine	lˈumine
populo	pˈopulo
superior	sˌuperjˈor
trovar	trovˈar
conditiones	kˌonditjˈones
deos	ðˈeos
essente	esˈente
haberea	hˌaberˈea
normalmente	nˌormalmˈente
singule	sˈinɡule
verbos	vˈerbos
Italia	itˈalja
accordo	akˈordo
activitate	ˌaktivitˈate
battalia	batˈalja
casas	kˈasas
interne	intˈerne
mesura	mesˈura
rapidemente	rˌapidemˈente
regulas	rˈeɡulas
unitate	ˌunitˈate
urban	urbˈan
vider	vidˈer
vole	vˈole
Alicun	ˈalikun
Anglaterra	ˌaŋɡlatˈera
Desde	dˈesde
Se	sˈe
american	ˌamerikˈan
catholic	katˈolik
cognoscentia	kˌoɡnost͡sˈentja
construction	kˌonstruktjˈon
originalmente	ˌoriɡˌinalmˈente
provincia	provˈint͡sja
retornava	rˌetornˈava
veni	vˈeni
La	lˈa
arrivava	ˌarivˈava
basso	bˈaso
collection	kˌolektjˈon
cosa	kˈosa
elemento	ˌelemˈento
finalmente	fˌinalmˈente
recognoscite	rˌekoɡnost͡sˈite
voleva	volˈeva
west	wˈest
appareva	ˌaparˈeva
areas	arˈeas
clar	klˈar
dece	dˈet͡se
foras	fˈoras
proprietates	prˌoprjetˈates
resto	rˈesto
septe	sˈepte
situation	sˌitwatjˈon
subsequente	sˌubsekwˈente
television	tˌelevisjˈon
themas	tˈemas
Mundial	mundjˈal
Paris	parˈis
currente	kurˈente
dunque	dˈuŋkwe
fortias	fˈortjas
grado	ɡrˈado
universal	ˌuniversˈal
utilisate	ˌutilisˈate
albumes	albˈumes
april	aprˈil
association	ˌasot͡sjatjˈon
autoritate	ˌa͡ʊtoritˈate
civil	t͡sivˈil
doctrina	doktrˈina
ecclesias	eklˈesjas
economia	ˌekonomˈia
gratias	ɡrˈatjas
limitate	lˌimitˈate
operation	ˌoperatjˈon
pagina	pˈaɡina
separate	sˌeparˈate
sex	sˈeks
supra	sˈupra
symbolo	sˈimbolo
tu	tˈu
veniva	venˈiva
Anque	ˈanke
Consilio	konsˈiljo
National	nˌatjonˈal
Nord	nˈord
cerca	t͡sˈerka
designate	dˌesiɡnˈate
disco	dˈisko
effecto	efˈekto
medios	mˈedjos
modello	modˈelo
remane	remˈane
scholas	st͡ʃˈolas
simile	sˈimile
sposa	spˈosa
travalio	travˈaljo
viveva	vivˈeva
New	nˈiw
Spirito	spˈirito
anterior	ˌanterjˈor
basic	bˈasik
castello	kastˈelo
chimic	kˈimik
existente	ˌeksistˈente
januario	ʒanwˈarjo
large	lˈarɡe
minor	minˈor
novembre	novˈembre
pedophilia	pˌedofilˈia
presso	prˈeso
producite	prˌodut͡sˈite
vidite	vidˈite
Ante	ˈante
Basse	bˈase
Sud	sˈud
York	jˈork
direction	dˌirektjˈon
equipa	ekwˈipa
institutiones	ˌinstitutjˈones
romance	romˈant͡se
vos	vˈos
aperte	apˈerte
bandas	bˈandas
chef	ʃˈef
cognite	kˈoɡnite
decembre	det͡sˈembre
edition	ˌeditjˈon
expression	ˌekspresjˈon
formation	fˌormatjˈon
fundamental	fˌundamentˈal
rubie	rˈubje
significato	sˌiɡnifikˈato
versiones	versjˈones
vocabulario	vˌokabulˈarjo
Io	ˈio
Senior	senjˈor
Stato	stˈato
campos	kˈampos
continua	kontˈinwa
continue	kontˈinwe
danese	danˈese
dar	dˈar
dicer	dit͡sˈer
extension	ˌekstensjˈon
memoria	memˈorja
mense	mˈense
methodos	mˈetodos
paginas	pˈaɡinas
parlate	parlˈate
plantas	plˈantas
possede	posˈede
posterior	pˌosterjˈor
private	privˈate
question	kwestjˈon
sape	sˈape
servicio	servˈit͡sjo
ulle	ˈule
varia	vˈarja
Malgrado	malɡrˈado
cellulas	t͡sˈelulas
chinese	ʃinˈese
complexe	komplˈekse
directe	dirˈekte
distantia	distˈantja
littera	lˈitera
mano	mˈano
nascentia	nast͡sˈentja
porta	pˈorta
standard	stˈandard
trovava	trovˈava
universo	ˌunivˈerso
Africa	ˈafrika
can	kˈan
continente	kˌontinˈente
deberea	dˌeberˈea
derivate	dˌerivˈate
dominio	domˈinjo
guitarra	ɡhitˈara
istos	ˈistos
mi	mˈi
passate	pasˈate
referentia	rˌeferˈentja
undas	ˈundas
verbo	vˈerbo
videva	vidˈeva
augusto	a͡ʊɡˈusto
causava	ka͡ʊsˈava
circum	t͡sˈirkum
computator	kˌomputatˈor
describe	deskrˈibe
dirigite	dˌiriɡˈite
independentia	ˌindependˈentja
km²	kˌaˈemdˈuo
monarchia	mˌonarkˈia
moral	morˈal
movimentos	mˌovimˈentos
pare	pˈare
representate	rˌepresentˈate
stellas	stˈelas
cambiava	kambjˈava
cognosce	koɡnˈost͡se
commercio	komˈert͡sjo
communication	kˌomunˌikatjˈon
completemente	kˌompletemˈente
differentias	dˌiferˈentjas
fundava	fundˈava
interior	ˌinterjˈor
lucta	lˈukta
me	mˈe
million	miljˈon
nascite	nast͡sˈite
nonobstante	nˌonobstˈante
petra	pˈetra
pois	pˈois
potente	potˈente
qualitate	kwˌalitˈate
require	rekwˈire
sede	sˈede
superficie	sˌuperfˈit͡sje
Maria	marˈia
attinger	ˌatiŋɡˈer
feminin	fˌeminˈin
greco	ɡrˈeko
instrumento	ˌinstrumˈento
martio	mˈartjo
materia	matˈerja
nation	natjˈon
normal	normˈal
oriental	ˌorjentˈal
particularmente	pˌartikˌularmˈente
quantitate	kwˌantitˈate
Depost	depˈost
Tractato	traktˈato
contento	kontˈento
evolution	ˌevolutjˈon
formava	formˈava
fratre	frˈatre
functiones	funktjˈones
grecos	ɡrˈekos
imperio	impˈerjo
junio	ʒˈunjo
massa	mˈasa
mental	mentˈal
octobre	oktˈobre
parlar	parlˈar
passava	pasˈava
popularitate	pˌopulˌaritˈate
projectos	proʒˈektos
servicios	servˈit͡sjos
sole	sˈole
stella	stˈela
subjecto	subʒˈekto
utilisa	ˌutilˈisa
vetule	vˈetule
SUA	swˈa
UE	wˈe
actiones	aktjˈones
activitates	ˌaktivitˈates
addition	ˌaditjˈon
comportamento	kˌomportamˈento
disponibile	dˌisponˈibile
facile	fˈat͡sile
imperator	ˌimperatˈor
includite	ˌinkludˈite
jocos	ʒˈokos
legal	leɡˈal
notabile	notˈabile
potentia	potˈentja
proprietate	prˌoprjetˈate
publication	pˌublikatjˈon
qualque	kwˈalke
real	reˈal
structuras	struktˈuras
victoria	viktˈorja
Asia	ˈasja
Mar	mˈar
Russia	rˈusja
actualmente	ˌaktwalmˈente
adultos	adˈultos
attacco	atˈako
causate	ka͡ʊsˈate
costa	kˈosta
eventos	evˈentos
instrumentos	ˌinstrumˈentos
italian	ˌitaljˈan
professional	prˌofesjonˈal
station	statjˈon
union	unjˈon
Academia	ˌakademˈia
Brasil	brasˈil
Grecia	ɡrˈet͡sja
cambio	kˈambjo
climate	klimˈate
compania	kˌompanˈia
composite	kompˈosite
dur	dˈur
figura	fiɡˈura
formar	formˈar
infante	infˈante
ja	ʒˈa
longitude	lˌoŋɡitˈude
maio	mˈajo
nederlandese	nˌederlandˈese
octo	ˈokto
produce	prodˈut͡se
scriptor	skriptˈor
tempores	tˈempores
varietate	vˌarjetˈate
web	wˈeb
Duo	dˈuo
Henrico	henrˈiko
Nos	nˈos
Solmente	solmˈente
Tamen	tˈamen
cambios	kˈambjos
cm	sˌeˈem
consilio	konsˈiljo
debite	dˈebite
deriva	derˈiva
election	ˌelektjˈon
establiva	ˌestablˈiva
evitar	ˌevitˈar
imagine	imˈaɡine
organisationes	ˌorɡanˌisatjˈones
passato	pasˈato
pecia	pˈet͡sja
perdeva	perdˈeva
plural	plurˈal
sanitate	sˌanitˈate
velocitate	vˌelot͡sitˈate
village	vilˈaʒe
zona	zˈona
Parlamento	pˌarlamˈento
alto	ˈalto
artistas	artˈistas
chassa	ʃˈasa
denominate	dˌenominˈate
eligite	ˌeliɡˈite
grandor	ɡrandˈor
hic	hˈik
obscur	obskˈur
opposition	ˌopositjˈon
pecias	pˈet͡sjas
perdite	perdˈite
populos	pˈopulos
presentia	presˈentja
principios	print͡sˈipjos
quotidian	kwˌotidjˈan
vivente	vivˈente
Catholic	katˈolik
Partito	partˈito
adversario	ˌadversˈarjo
applicationes	ˌaplikatjˈones
colores	kolˈores
combatto	kombˈato
consequentia	kˌonsekwˈentja
contrario	kontrˈarjo
credentia	kredˈentja
edificio	ˌedifˈit͡sjo
electronic	ˌelektrˈonik
filmes	fˈilmes
grammatica	ɡramˈatika
integre	ˈinteɡre
locos	lˈokos
maestro	maˈestro
magnetic	maɡnˈetik
medietate	mˌedjetˈate
objectivo	ˌobʒektˈivo
plen	plˈen
presenta	presˈenta
primari	primˈari
respecto	respˈekto
romanos	romˈanos
securitate	sˌekuritˈate
signos	sˈiɡnos
software	sˈoftware
thema	tˈema
usator	ˌusatˈor
Charles	t͡ʃˈarles
David	davˈid
Internet	ˌinternˈet
Odysseo	ˌodisˈeo
Omne	ˈomne
absolute	ˌabsolˈute
arabe	ˈarabe
attention	ˌatentjˈon
attingeva	ˌatiŋɡˈeva
condition	kˌonditjˈon
conto	kˈonto
decideva	dˌet͡sidˈeva
domestic	domˈestik
domo	dˈomo
equal	ekwˈal
exacte	eksˈakte
experientia	ˌeksperjˈentja
inclusive	ˌinklusˈive
individual	ˌindividwˈal
istes	ˈistes
m	ˈem
moneta	monˈeta
pedon	pedˈon
practic	prˈaktik
previe	prˈevje
programmation	prˌoɡramatjˈon
questiones	kwestjˈones
relativemente	rˌelatˌivemˈente
remaneva	rˌemanˈeva
seque	sˈekwe
totalmente	tˌotalmˈente
China	ʃˈina
Etiam	ˈetjam
Pais	pˈa͡ɪs
adjectivos	ˌadʒektˈivos
classification	klˌasifˌikatjˈon
depende	depˈende
discos	dˈiskos
extende	ekstˈende
externe	ekstˈerne
generes	ɡˈeneres
guerras	ɡwˈeras
habite	habˈite
kilometros	kilˈometros
machina	mˈakina
mercato	merkˈato
mover	movˈer
pertine	pertˈine
poco	pˈoko
recipe	ret͡sˈipe
section	sektjˈon
traductiones	trˌaduktjˈones
troppo	trˈopo
unda	ˈunda
usatores	ˌusatˈores
Britannia	britˈanja
Newton	ŋˈewton
additional	ˌaditjonˈal
aspectos	aspˈektos
calendario	kˌalendˈarjo
carga	kˈarɡa
cartas	kˈartas
christianismo	krˌistjanˈismo
contexto	kontˈeksto
corte	kˈorte
critica	krˈitika
cum	kˈum
dicite	dit͡sˈite
esperanto	ˌesperˈanto
existeva	ˌeksistˈeva
februario	febrwˈarjo
finiva	finˈiva
forsan	fˈorsan
geographic	ɡˌeoɡrˈafik
initial	ˌinitjˈal
judee	ʒudˈee
justitia	ʒustˈitja
organisate	ˌorɡanisˈate
pace	pˈat͡se
partito	partˈito
phase	fˈase
portugese	pˌortuɡˈese
publico	pˈubliko
radioamatori	rˌadjoˌamatˈori
realitate	rˌealitˈate
revista	revˈista
septembre	septˈembre
symbolos	sˈimbolos
temperatura	tˌemperatˈura
Finalmente	fˌinalmˈente
Sol	sˈol
Testamento	tˌestamˈento
University	ˌuniversˈiti
artista	artˈista
combination	kˌombinatjˈon
correcte	korˈekte
curso	kˈurso
dedicate	dˌedikˈate
deo	ðˈeo
describite	dˌeskribˈite
formal	formˈal
habitation	hˌabitatjˈon
imagines	imˈaɡines
naturalmente	nˌaturalmˈente
peso	pˈeso
premio	prˈemjo
primo	prˈimo
racia	rˈat͡sja
rapide	rˈapide
resulta	resˈulta
resultatos	rˌesultˈatos
signo	sˈiɡno
usage	usˈaʒe
voce	vˈot͡se
Carolo	kˈarolo
Del	dˈel
Duvert	duvˈert
acceptate	ˌat͡septˈate
administrative	ˌadminˌistratˈive
blanco	blˈanko
communmente	kˌomunmˈente
considerava	kˌonsiderˈava
correspondente	kˌorespondˈente
designo	desˈiɡno
directemente	dˌirektemˈente
discoperite	dˌiskoperˈite
excepte	ekst͡sˈepte
facilemente	fˌat͡silemˈente
futuro	futˈuro
germano	ɡermˈano
historias	histˈorjas
immediatemente	ˌimedjˌatemˈente
infantil	ˌinfantˈil
linguages	linɡwˈaʒes
maritava	mˌaritˈava
necessitate	nˌet͡sesitˈate
nocte	nˈokte
nomina	nomˈina
notation	nˌotatjˈon
ora	ˈora
passa	pˈasa
postal	postˈal
pression	presjˈon
professor	prˌofesˈor
protection	prˌotektjˈon
regula	rˈeɡula
russe	rˈuse
scriptores	skriptˈores
studiava	studjˈava
substantivo	sˌubstantˈivo
telephonic	tˌelefˈonik
universitate	ˌunivˌersitˈate
usante	usˈante
American	ˌamerikˈan
Dunque	dˈuŋkwe
amicos	amˈikos
appoio	apˈojo
apprender	ˌaprendˈer
categoria	kˌateɡorˈia
characterisate	t͡ʃˌaraktˌerisˈate
conflicto	konflˈikto
conta	kˈonta
contato	kontˈato
critic	krˈitik
declarava	dˌeklarˈava
describer	dˌeskribˈer
director	dˌirektˈor
distante	distˈante
divide	divˈide
dum	dˈum
industrial	ˌindustrjˈal
masculin	mˌaskulˈin
municipalitates	mˌunit͡sˌipalitˈates
nave	nˈave
nucleo	nuklˈeo
omnes	ˈomnes
parlatores	pˌarlatˈores
planeta	planˈeta
prende	prˈende
radices	radˈit͡ses
responsa	respˈonsa
scientistas	st͡sjentˈistas
scopos	skˈopos
soldatos	soldˈatos
traducite	trˌadut͡sˈite
typicamente	tˌipikamˈente
vadeva	vadˈeva
veritate	vˌeritˈate
Roman	romˈan
Troia	θrˈoja
actor	aktˈor
breve	brˈeve
categorias	kˌateɡorˈias
celo	t͡sˈelo
colpo	kˈolpo
contemporanee	kˌontempˌoranˈee
discurso	diskˈurso
divin	divˈin
favor	favˈor
foco	fˈoko
fundator	fˌundatˈor
habente	habˈente
humanitate	hˌumanitˈate
includer	ˌinkludˈer
inferior	ˌinferjˈor
malgrado	malɡrˈado
organismos	ˌorɡanˈismos
parentes	parˈentes
prendite	prendˈite
quarte	kwˈarte
rationes	ratjˈones
regnos	rˈeɡnos
vendite	vendˈite
viver	vivˈer
Ab	ˈab
Dublin	dublˈin
Irlanda	irlˈanda
Johannes	ʒohˈannes
London	ɫˈondon
Occidental	ˌot͡sidentˈal
Rege	rˈeɡe
Robert	robˈert
adjectivo	ˌadʒektˈivo
adoptate	ˌadoptˈate
antea	antˈea
arriva	arˈiva
cambiar	kambjˈar
characteristic	kˌarakterˈistik
classes	klˈases
compone	kompˈone
corresponde	kˌorespˈonde
dialectos	djalˈektos
electiones	ˌelektjˈones
films	fˈilms
fratres	frˈatres
habita	habˈita
horas	hˈoras
humanos	humˈanos
individuos	ˌindivˈidwos
jornal	ʒornˈal
oculos	ˈokulos
offere	ofˈere
physica	fˈisika
poteres	potˈeres
prendeva	prendˈeva
profunde	profˈunde
referer	rˌeferˈer
salvage	salvˈaʒe
secur	sekˈur
stricte	strˈikte
theorias	tˌeorˈias
vocales	vokˈales
Gustav	ɡustˈav
Plure	plˈure
Raphael	rˌafaˈel
Sed	sˈed
Societate	sˌot͡sjetˈate
accesso	at͡sˈeso
amico	amˈiko
analyse	anˈalise
aspecto	aspˈekto
assatis	asˈatis
benque	bˈeŋkwe
colonia	kˌolonˈia
constitue	konstˈitwe
crea	krˈea
cresce	krˈest͡se
dea	dˈea
elevate	ˌelevˈate
inseniamento	ˌinsenjamˈento
interpretation	ˌinterprˌetatjˈon
japonese	ʒˌaponˈese
juvenes	ʒˈuvenes
maxime	mˈaksime
operas	ˈoperas
orthographia	ˌortoɡrafˈia
personage	pˌersonˈaʒe
poema	poˈema
prender	prendˈer
recipite	rˌet͡sipˈite
regional	rˌeɡjonˈal
regular	rˌeɡulˈar
sanguine	sˈanɡwine
scriptura	skriptˈura
secundari	sˌekundˈari
spirito	spˈirito
succedeva	sˌut͡sedˈeva
territorios	tˌeritˈorjos
to	tˈo
tractamento	trˌaktamˈento
voluntate	vˌoluntˈate
Cook	koˈok
Dr	dˌeˈer
James	ʒˈames
Prime	prˈime
Usque	ˈuske
altitude	ˌaltitˈude
artistic	artˈistik
belle	bˈele
calide	kˈalide
cambia	kˈambja
camera	kˈamera
cento	t͡sˈento
comprender	kˌomprendˈer
concernente	kˌont͡sernˈente
decennio	det͡sˈenjo
defini	defˈini
dialecto	djalˈekto
disveloppava	dˌisvelopˈava
episcopo	epˈiskopo
essential	ˌesentjˈal
experimentos	ˌeksperimˈentos
fini	fˈini
functiona	funktjˈona
identic	idˈentik
illac	ˈilak
kg	kˌaɡˈe
ligate	liɡˈate
location	lˌokatjˈon
materiales	mˌaterjˈales
novas	nˈovas
par	pˈar
permittite	pˌermitˈite
petras	pˈetras
poemas	poˈemas
policia	pˌolit͡sˈia
politicas	polˈitikas
ponte	pˈonte
praseodymium	prˌaseodˈimjum
prision	prisjˈon
proveni	provˈeni
regal	reɡˈal
regina	reɡˈina
saper	sapˈer
spiritual	spˌiritwˈal
tellurium	telˈurjum
terras	tˈeras
Fox	fˈoks
George	ɡeˈorɡe
III	trˈes
India	ˈindja
Paulo	pˈa͡ʊlo
San	sˈan
Star	stˈar
administration	ˌadminˌistratjˈon
alphabeto	ˌalfabˈeto
approximativemente	ˌaproksˌimatˌivemˈente
attinge	atˈiŋɡe
avante	avˈante
basa	bˈasa
bastante	bastˈante
contacto	kontˈakto
credeva	kredˈeva
cresceva	krest͡sˈeva
crescimento	krˌest͡simˈento
culturas	kultˈuras
demanda	demˈanda
editiones	ˌeditjˈones
fusion	fusjˈon
futur	futˈur
ganiar	ɡanjˈar
honor	honˈor
hypothese	hipˈotese
infantia	infˈantja
laborava	lˌaborˈava
lanthano	lantˈano
medieval	mˌedjevˈal
nam	nˈam
obstante	obstˈante
occurreva	ˌokurˈeva
pedemontese	pˌedemontˈese
pictura	piktˈura
poc	pˈok
populationes	pˌopulatjˈones
pronomines	pronˈomines
salvation	sˌalvatjˈon
scena	st͡sˈena
servi	sˈervi
substantivos	sˌubstantˈivos
technic	tˈeknik
tribos	trˈibos
unitates	ˌunitˈates
verde	vˈerde
Erasmo	erˈasmo
Kristian	kristjˈan
Mexico	mˈeksiko
NAMBLA	nˈambla
Patre	pˈatre
Premio	prˈemjo
accepta	at͡sˈepta
applicate	ˌaplikˈate
application	ˌaplikatjˈon
armas	ˈarmas
aves	ˈaves
biblic	bˈiblik
composition	kˌompositjˈon
copias	kˈopjas
distinction	dˌistinktjˈon
documento	dˌokumˈento
effectos	efˈektos
establite	ˌestablˈite
frequentia	frekwˈentja
industria	indˈustrja
investigation	ˌinvestˌiɡatjˈon
jammais	ʒamˈais
jocatores	ʒˌokatˈores
medicina	mˌedit͡sˈina
message	mesˈaʒe
ministro	minˈistro
monarcha	monˈart͡ʃa
monstrar	monstrˈar
parlantes	parlˈantes
partita	partˈita
pede	pˈede
positive	pˌositˈive
realisar	rˌealisˈar
registrate	rˌeɡistrˈate
resultava	rˌesultˈava
romances	romˈant͡ses
romanic	romˈanik
significante	sˌiɡnifikˈante
signification	sˌiɡnifˌikatjˈon
singular	sˌiŋɡulˈar
tamen	tˈamen
termination	tˌerminatjˈon
Committee	komˈiti
Eduardo	edwˈardo
General	ɡˌenerˈal
Generalmente	ɡˌeneralmˈente
IV	kwˈatro
MSX	ˌemˌesˈiks
Thomas	tˈomas
alimento	ˌalimˈento
apparatos	ˌaparˈatos
architectura	ˌart͡ʃitektˈura
auxiliar	ˌa͡ʊksiljˈar
capabile	kapˈabile
cauda	kˈa͡ʊda
christianos	kristjˈanos
culto	kˈulto
distingue	distˈiŋɡwe
division	dˌivisjˈon
eveni	evˈeni
executate	ˌeksekutˈate
exterior	ˌeksterjˈor
familias	famˈiljas
incontrava	ˌinkontrˈava
iodo	jˈodo
juridic	ʒurˈidik
mantener	mˌantenˈer
modellos	modˈelos
multes	mˈultes
neodymium	nˌeodˈimjum
nihil	nˈihil
obtener	ˌobtenˈer
parlamento	pˌarlamˈento
particulas	partˈikulas
plano	plˈano
produceva	prˌodut͡sˈeva
pur	pˈur
recognosce	rˌekoɡnˈost͡se
reges	rˈeɡes
representation	rˌepresˌentatjˈon
revolution	rˌevolutjˈon
ric	rˈik
septimanas	sˌeptimˈanas
slave	slˈave
successor	sˌut͡sesˈor
turre	tˈure
Documento	dˌokumˈento
Eneas	enˈeas
Japon	ʒapˈon
Kalmar	kalmˈar
William	wiljˈam
acto	ˈakto
adherentes	ˌadherˈentes
anima	ˈanima
appellava	ˌapelˈava
armate	armˈate
cathedral	kˌatedrˈal
centos	t͡sˈentos
citatanos	t͡sˌitatˈanos
classificate	klˌasifikˈate
colonias	kˌolonˈias
constante	konstˈante
conversion	kˌonversjˈon
corona	korˈona
cupro	kˈupro
dependente	dˌependˈente
determinate	dˌeterminˈate
dominante	dˌominˈante
figuras	fiɡˈuras
finite	finˈite
frequente	frekwˈente
fundation	fˌundatjˈon
ganiate	ɡanjˈate
generation	ɡˌeneratjˈon
grados	ɡrˈados
indium	ˈindjum
lassava	lasˈava
ligno	lˈiɡno
metropolitan	mˌetropˌolitˈan
move	mˈove
passo	pˈaso
patrono	patrˈono
pensa	pˈensa
permitteva	pˌermitˈeva
perque	perkˈe
positiones	pˌositjˈones
protestante	prˌotestˈante
provide	provˈide
quadrato	kwadrˈato
quanto	kwˈanto
representar	rˌepresentˈar
samarium	samˈarjum
scientias	st͡sjˈentjas
scribe	skrˈibe
sexualitate	sˌekswalitˈate
sinistre	sinˈistre
technica	tˈeknika
tentava	tentˈava
travaliava	trˌavaljˈava
typic	tˈipik
variante	varjˈante
vermente	vermˈente
visibile	visˈibile
vulpes	vˈulpes
zinc	zˈink
Association	ˌasot͡sjatjˈon
Erik	erˈik
Filio	fˈiljo
Secunde	sekˈunde
Smith	smˈit
West	wˈest
aere	ˈaere
affaires	afˈers
campania	kampˈanja
canes	kˈanes
clave	klˈave
communitates	kˌomunitˈates
continental	kˌontinentˈal
dama	dˈama
debile	dˈebile
defender	dˌefendˈer
dictionario	dˌiktjonˈarjo
documentos	dˌokumˈentos
entrata	entrˈata
exactemente	ˌeksaktemˈente
false	fˈalse
gay	ɡˈaj
genetic	ɡenˈetik
implica	ˈimplika
informationes	ˌinformatjˈones
krypton	krˈipton
maritage	mˌaritˈaʒe
mathematica	mˌatemˈatika
minores	minˈores
nordic	nˈordik
opinion	ˌopinjˈon
peninsula	penˈinsula
possibilitate	pˌosibˌilitˈate
presentava	prˌesentˈava
previemente	prˌevjemˈente
promethium	promˈetjum
rarmente	rarmˈente
realisate	rˌealisˈate
reciper	rˌet͡sipˈer
reputation	rˌeputatjˈon
retro	rˈetro
rubidium	rubˈidjum
sablo	sˈablo
sequite	sekwˈite
tante	tˈante
tractato	traktˈato
transverso	transvˈerso
valores	valˈores
yttrium	ˈitrjum
Oriental	ˌorjentˈal
affirma	afˈirma
alternative	ˌalternatˈive
ample	ˈample
arbore	ˈarbore
cambiate	kambjˈate
cercar	t͡serkˈar
characteristica	kˌarakterˈistika
concertos	kont͡sˈertos
constitution	kˌonstitutjˈon
decision	dˌet͡sisjˈon
determinar	dˌeterminˈar
developpamento	dˌevelˌopamˈento
differe	difˈere
equivalente	ˌekwivalˈente
estimate	ˌestimˈate
evento	evˈento
exemplos	eksˈemplos
haveva	havˈeva
homosexual	hˌomosekswˈal
impossibile	ˌimposˈibile
initiava	ˌinitjˈava
intendite	ˌintendˈite
interpretate	ˌinterpretˈate
introduceva	ˌintrodut͡sˈeva
isolate	ˌisolˈate
italiano	ˌitaljˈano
jocar	ʒokˈar
leger	leɡˈer
manos	mˈanos
media	mˈedja
mente	mˈente
mythologia	mˌitoloɡˈia
nivellos	nivˈelos
occidite	ˌot͡sidˈite
officialmente	ˌofit͡sjalmˈente
palladium	palˈadjum
passar	pasˈar
pedophilos	pedˈofilos
poner	ponˈer
prefixos	prefˈiksos
processos	prot͡sˈesos
regime	reʒˈim
relative	rˌelatˈive
republica	repˈublika
responsabile	rˌesponsˈabile
rolos	rˈolos
scala	skˈala
soror	sorˈor
studentes	studˈentes
tabula	tˈabula
talia	tˈalja
terrestre	terˈestre
theatro	teˈatro
tractos	trˈaktos
utile	ˈutile
vetere	vˈetere
Bernard	bernˈard
Copenhagen	kˌopenhˈaɡen
Edward	edwˈard
Israel	ˌisraˈel
Joseph	ʒˈosef
Licentia	lit͡sˈentja
Mais	mˈais
Ricardo	rikˈardo
abstracte	abstrˈakte
addite	adˈite
adjutar	ˌadʒutˈar
capace	kapˈat͡se
consentimento	kˌonsentimˈento
corde	kˈorde
crescente	krest͡sˈente
despecto	despˈekto
destruite	destrwˈite
districto	distrˈikto
duple	dˈuple
el	ˈel
enorme	enˈorme
entrava	entrˈava
essayava	ˌesajˈava
essayos	esˈajos
estate	estˈate
exprimer	ˌeksprimˈer
factos	fˈaktos
folios	fˈoljos
for	fˈor
fortemente	fˌortemˈente
gadolinimum	ɡˌadolˌinimˈum
heroe	herˈoe
identitate	ˌidentitˈate
incontra	inkˈontra
individuo	ˌindivˈidwo
ligamines	lˈiɡamˌines
logica	lˈoɡika
marca	mˈarka
melio	mˈeljo
novo	nˈovo
occupa	okˈupa
organo	ˈorɡano
participava	pˌartit͡sipˈava
pauco	pˈawko
pensamento	pˌensamˈento
phenomeno	fenˈomeno
poeta	poˈeta
ponite	ponˈite
portava	portˈava
primarimente	prˌimarimˈente
producer	prˌodut͡sˈer
religiones	rˌeliɡjˈones
rhodium	rhˈodjum
scriptos	skrˈiptos
sequeva	sekwˈeva
solution	sˌolutjˈon
strontium	strˈontjum
technetium	teknˈetjum
technicas	tˈeknikas
templo	tˈemplo
temporal	tˌemporˈal
vicin	vit͡sˈin
von	vˈon
vulpe	vˈulpe
Carl	kˈarl
Dynastia	dˌinastˈia
Ergo	ˈerɡo
Hall	hˈol
Marx	mˈarks
OmegaT	ˈomeɡatˈe
Proque	prokˈe
Stockholm	stokkhˈolm
Studios	stˈudjos
academic	ˌakadˈemik
apud	ˈapud
aures	ˈawres
cavallos	kavˈalos
commando	komˈando
componentes	kˌomponˈentes
conception	kˌont͡septjˈon
conceptos	kont͡sˈeptos
consequentias	kˌonsekwˈentjas
conservate	kˌonservˈate
credentias	kredˈentjas
designos	desˈiɡnos
editor	ˌeditˈor
evidentia	ˌevidˈentja
expansion	ˌekspansjˈon
foreste	forˈeste
fructo	frˈukto
fundo	fˈundo
germanium	ɡermˈanjum
gratia	ɡrˈatja
guida	ɡwˈida
influentiate	ˌinflwentjˈate
inspirate	ˌinspirˈate
judeos	ʒudˈeos
manco	mˈanko
manieras	manjˈeras
mentionate	mˌentjonˈate
milles	mˈiles
native	natˈive
nigro	nˈiɡro
obteneva	ˌobtenˈeva
periodos	perˈiodos
philosophic	phˌilosˈofik
poesia	pˌoesˈia
populate	pˌopulˈate
publicar	pˌublikˈar
pueros	pˈueros
reformas	refˈormas
sequer	sekwˈer
sitos	sˈitos
sta	stˈa
theologic	tˌeolˈoɡik
traditiones	trˌaditjˈones
unite	unˈite
viste	vˈiste
zonas	zˈonas
Apollon	apˈolon
Provincia	provˈint͡sja
Royal	rojˈal
Senato	senˈato
Switza	swˈitza
acheos	at͡ʃˈeos
actrice	aktrˈit͡se
assemblea	ˌasemblˈea
atomos	ˈatomos
attitude	ˌatitˈude
auro	ˈa͡ʊro
automatic	ˌa͡ʊtomˈatik
autonome	a͡ʊtˈonome
autoritates	ˌa͡ʊtoritˈates
candidato	kˌandidˈato
carne	kˈarne
cobalt	kˈobalt
communista	kˌomunˈista
comparation	kˌomparatjˈon
componite	kˌomponˈite
considerar	kˌonsiderˈar
doctrinas	doktrˈinas
durava	durˈava
errores	erˈores
ethnic	ˈetnik
fama	fˈama
familiar	fˌamiljˈar
federal	fˌederˈal
fixate	fiksˈate
formato	formˈato
governamentos	ɡˌovernamˈentos
guarda	ɡwˈarda
habitava	hˌabitˈava
historicos	histˈorikos
initialmente	ˌinitjalmˈente
ista	ˈista
jazz	d͡ʒˈez
juventute	ʒˌuventˈute
mathematic	mˌatemˈatik
modificationes	mˌodifˌikatjˈones
multiple	mˈultiple
nationes	natjˈones
negative	nˌeɡatˈive
niobium	niˈobjum
nota	nˈota
occupava	ˌokupˈava
pelle	pˈele
personages	pˌersonˈaʒes
piano	pjˈano
placia	plˈat͡sja
precise	pret͡sˈise
proponite	prˌoponˈite
proposition	prˌopositjˈon
proteger	prˌoteɡˈer
puero	pˈuero
rebellion	rˌebeljˈon
referite	rˌeferˈite
resistentia	rˌesistˈentja
series	sˈerjes
sorta	sˈorta
specialisate	spˌet͡sjalisˈate
sufficiente	sˌufit͡sjˈente
troianos	tro͡ɪˈanos
univa	unˈiva
vertical	vˌertikˈal
Achilles	akˈiles
Balki	bˈalki
Cesare	t͡sesˈare
IALA	jˈala
Instituto	ˌinstitˈuto
Larry	lˈari
Madrid	madrˈid
Marco	mˈarko
Museo	musˈeo
Nobel	nobˈel
Nota	nˈota
World	wˈorld
adulte	adˈulte
african	ˌafrikˈan
annual	anwˈal
blau	blˈa͡ʊ
brasilian	brˌasiljˈan
carbon	karbˈon
comprendite	kˌomprendˈite
conjuncto	konʒˈunkto
corpores	kˈorpores
description	dˌeskriptjˈon
disciplina	dˌist͡siplˈina
duceva	dut͡sˈeva
ecclesiastic	ˌeklesjˈastik
edificios	ˌedifˈit͡sjos
entitate	ˌentitˈate
exclusivemente	ˌeksklusˌivemˈente
explica	ˈeksplika
facie	fˈat͡sje
governate	ɡˌovernˈate
illas	ˈilas
jocava	ʒokˈava
labores	labˈores
minerales	mˌinerˈales
molybdenum	mˌolibdenˈum
monstrate	monstrˈate
naves	nˈaves
necun	nekˈun
notas	nˈotas
pan	pˈan
parlava	parlˈava
partitos	partˈitos
pornographia	pˌornoɡrafˈia
presentate	prˌesentˈate
primitive	prˌimitˈive
radice	radˈit͡se
retorno	retˈorno
ruthenium	rutˈenjum
selenium	selˈenjum
senior	senjˈor
studia	stˈudja
supreme	suprˈeme
tempo	tˈempo
tractate	traktˈate
transition	trˌansitjˈon
vento	vˈento
violentia	vjolˈentja
wiki	wˈiki
Alora	alˈora
Cambridge	kambrˈidɡe
Circa	t͡sˈirka
City	t͡sˈiti
Egypto	eɡˈipto
Ibi	ˈibi
VI	sˈeks
adjutava	ˌadʒutˈava
adresse	adrˈese
antiquitate	ˌantikwitˈate
apparato	ˌaparˈato
assere	asˈere
bandiera	bandjˈera
bibliotheca	bˌibljotˈeka
characteres	t͡ʃˌaraktˈeres
cognoscer	kˌoɡnost͡sˈer
cognosceva	kˌoɡnost͡sˈeva
considerabile	kˌonsiderˈabile
copyright	kˈopirˌait
definir	dˌefinˈir
demandava	dˌemandˈava
depois	depˈois
deserto	desˈerto
detalios	detˈaljos
di	dˈi
difficultates	dˌifikultˈates
diffusion	dˌifusjˈon
dura	dˈura
duration	dˌuratjˈon
effortios	efˈortjos
espanioles	ˌespanjˈoles
esseres	esˈeres
estranie	estrˈanje
experientias	ˌeksperjˈentjas
global	ɡlobˈal
habilitate	hˌabilitˈate
historico	histˈoriko
introducite	ˌintrodut͡sˈite
invention	ˌinventjˈon
lente	lˈente
marin	marˈin
menacia	menˈat͡sja
musicos	mˈusikos
nuclear	nˌukleˈar
organic	orɡˈanik
paradoxo	pˌaradˈokso
passage	pasˈaʒe
pena	pˈena
periculo	perˈikulo
permanente	pˌermanˈente
picturas	piktˈuras
portate	portˈate
prefere	prefˈere
prefixo	prefˈikso
presidentia	prˌesidˈentja
provincias	provˈint͡sjas
publica	pˈublika
quantic	kwˈantik
representantes	rˌepresentˈantes
retornar	rˌetornˈar
selection	sˌelektjˈon
silicium	silˈit͡sjum
societates	sˌot͡sjetˈates
solide	sˈolide
stationes	statjˈones
throno	trˈono
totes	tˈotes
variantes	varjˈantes
vision	visjˈon
Antonio	antˈonjo
Augusto	a͡ʊɡˈusto
Brown	brˈown
Central	t͡sentrˈal
Gratias	ɡrˈatjas
Oriente	orjˈente
Ultra	ˈultra
alcunos	alkˈunos
assassinate	ˌasasinˈate
assecurar	ˌasekurˈar
calor	kalˈor
cameras	kˈameras
catena	katˈena
catholicos	katˈolikos
circulo	t͡sˈirkulo
civilisation	t͡sˌivilˌisatjˈon
computatores	kˌomputatˈores
connectite	kˌonektˈite
cursos	kˈursos
dansa	dˈansa
decide	det͡sˈide
determina	dˌetermˈina
distribuite	dˌistribwˈite
episcopos	epˈiskopos
error	erˈor
execution	ˌeksekutjˈon
extra	ˈekstra
frigide	frˈiɡide
fronte	frˈonte
gallium	ɡˈaljum
habitate	hˌabitˈate
hiberno	hibˈerno
i	ˈi
impostos	impˈostos
incontro	inkˈontro
infra	ˈinfra
instruction	ˌinstruktjˈon
irregular	ˌireɡulˈar
jocate	ʒokˈate
judicio	ʒudˈit͡sjo
limite	lˈimite
logic	lˈoɡik
manuscriptos	mˌanuskrˈiptos
minutas	minˈutas
normas	nˈormas
participar	pˌartit͡sipˈar
peccato	pekˈato
permitter	pˌermitˈer
planetas	planˈetas
planos	plˈanos
productos	prodˈuktos
rar	rˈar
realisava	rˌealisˈava
secun	sekˈun
sembla	sˈembla
sinistra	sinˈistra
slovene	slovˈene
substantias	substˈantjas
technologia	tˌeknoloɡˈia
terreno	terˈeno
transmission	trˌansmisjˈon
tropic	trˈopik
vitas	vˈitas
Athena	atˈena
Benque	bˈeŋkwe
Bolívar	bˌolivˈar
Corte	kˈorte
El	ˈel
Gulielmo	ɡuljˈelmo
Linné	lˈine
Portugal	pˌortuɡˈal
Toki	tˈoki
Vasa	vˈasa
XX	vˈinti
adolescentes	ˌadolest͡sˈentes
agricultura	ˌaɡrikultˈura
ambes	ˈambes
ancestre	ant͡sˈestre
artificial	ˌartifit͡sjˈal
catto	kˈato
causar	ka͡ʊsˈar
cinema	t͡sˈinema
comenciamento	kˌoment͡sjamˈento
compositos	kompˈositos
comprende	komprˈende
contribueva	kˌontribwˈeva
coperi	kopˈeri
debatto	debˈato
decisiones	dˌet͡sisjˈones
desiro	desˈiro
distribution	dˌistributjˈon
dynamic	dinˈamik
effective	ˌefektˈive
establir	ˌestablˈir
eveniva	ˌevenˈiva
executive	ˌeksekutˈive
experimental	ˌeksperˌimentˈal
extreme	ekstrˈeme
governator	ɡˌovernatˈor
gris	ɡrˈis
ido	ˈido
influentias	inflwˈentjas
institution	ˌinstitutjˈon
internet	ˌinternˈet
introduction	ˌintroduktjˈon
iva	ˈiva
kitsune	kitsˈune
licentia	lit͡sˈentja
marcate	markˈate
mechanica	mekˈanika
metallos	metˈalos
mille	mˈile
monstrava	monstrˈava
nickel	nˈikel
nobile	nˈobile
novem	nˈovem
nube	nˈube
oceano	ot͡sˈeano
oculo	ˈokulo
pedophile	pedˈofile
placiate	plat͡sjˈate
polonese	pˌolonˈese
posto	pˈosto
proposito	propˈosito
reguardate	rˌeɡwardˈate
resta	rˈesta
saison	sezˈon
sclavos	sklˈavos
serviva	servˈiva
significantia	sˌiɡnifikˈantja
significar	sˌiɡnifikˈar
simultaneemente	sˌimultˌaneemˈente
studiar	studjˈar
ulterior	ˌulterjˈor
universitates	ˌunivˌersitˈates
vocal	vokˈal
Citate	t͡sitˈate
Democratic	dˌemokrˈatik
Fluvio	flˈuvjo
Islam	islˈam
Language	laŋɡwˈaɡe
Lingua	lˈiŋɡwa
Louis	ɫwˈi
Mundo	mˈundo
Norvegia	norvˈeɡja
Polonia	polˈonja
Pona	pˈona
Scotia	skˈotja
Shakespeare	ʃˌakespeˈare
Tony	tˈoni
XIX	dˈet͡senˈovem
Zeus	ʒˈeus
activismo	ˌaktivˈismo
actualitate	ˌaktwalitˈate
alliantia	aljˈantja
amonta	amˈonta
appoiava	ˌapo͡ɪˈava
arrivar	ˌarivˈar
arrivata	ˌarivˈata
artes	ˈartes
atomic	atˈomik
beltate	beltˈate
calculo	kˈalkulo
causas	kˈa͡ʊsas
clarmente	klarmˈente
conscientia	konst͡sjˈentja
continuar	kˌontinwˈar
contributiones	kˌontributjˈones
controlar	kˌontrolˈar
decennios	det͡sˈenjos
dimension	dˌimensjˈon
discoperiva	dˌiskoperˈiva
disveloppar	dˌisvelopˈar
diversitate	dˌiversitˈate
editate	ˌeditˈate
entrar	entrˈar
eterne	etˈerne
expertos	ekspˈertos
fixe	fˈikse
fluxo	flˈukso
fortalessa	fˌortalˈesa
fungos	fˈuŋɡos
habera	habˈera
hora	hˈora
identificate	ˌidentˌifikˈate
incognite	inkˈoɡnite
initia	inˈitja
intellectual	ˌintelektwˈal
intelligente	ˌinteliɡˈente
jornales	ʒornˈales
laborar	lˌaborˈar
lectores	lektˈores
liberal	lˌiberˈal
magazin	mˌaɡazˈin
maladias	mˌaladˈias
manganese	mˌaŋɡanˈese
massive	masˈive
minoritate	mˌinoritˈate
motor	motˈor
nominava	nˌominˈava
obtenite	ˌobtenˈite
oleo	olˈeo
oral	orˈal
phosphoro	phˈosforo
pone	pˈone
porto	pˈorto
povre	pˈovre
practicas	prˈaktikas
precedente	prˌet͡sedˈente
presidential	prˌesidentjˈal
prominente	prˌominˈente
promotion	prˌomotjˈon
reforma	refˈorma
regularmente	rˌeɡularmˈente
requirite	rˌekwirˈite
schema	st͡ʃˈema
sexo	sˈekso
solar	solˈar
suffreva	sufrˈeva
superfacie	sˌuperfˈat͡sje
surgeva	surɡˈeva
syllaba	sˈilaba
theologia	tˌeoloɡˈia
titulos	tˈitulos
torno	tˈorno
transformation	trˌansformatjˈon
transporto	transpˈorto
truppas	trˈupas
usos	ˈusos
variationes	vˌarjatjˈones
vaste	vˈaste
zirconium	zirkˈonjum
Bibliotheca	bˌibljotˈeka
Carinthia	karˈintja
Centro	t͡sˈentro
Constitution	kˌonstitutjˈon
Evangelio	ˌevaŋɡˈeljo
Istes	ˈistes
Istos	ˈistos
Jerusalem	ʒˌerusalˈem
Latin	latˈin
Libro	lˈibro
Lo	lˈo
Originalmente	ˌoriɡˌinalmˈente
Que	kˈe
Rock	rˈokk
Sparta	spˈarta
Tiberio	tibˈerjo
V	vˈe
Vide	vˈide
accompaniate	ˌakompanjˈate
apparentia	ˌaparˈentja
attaccos	atˈakos
avantiate	ˌavantjˈate
axe	ˈakse
benes	bˈenes
binari	binˈari
c	sˈe
chimia	kimˈia
chromium	kromjˈum
circulation	t͡sˌirkulatjˈon
contrasto	kontrˈasto
coperite	kˌoperˈite
copia	kˈopja
criticos	krˈitikos
decade	dˈekade
denomina	dˌenomˈina
describeva	dˌeskribˈeva
dirigeva	dˌiriɡˈeva
distinctive	dˌistinktˈive
dramas	drˈamas
duce	dˈut͡se
efficace	ˌefikˈat͡se
exister	ˌeksistˈer
fluvios	flˈuvjos
indian	indjˈan
infection	ˌinfektjˈon
inseniava	ˌinsenjˈava
labora	labˈora
largemente	lˌarɡemˈente
litteralmente	lˌiteralmˈente
locate	lokˈate
manual	manwˈal
masculo	mˈaskulo
mineral	mˌinerˈal
mm	ˌemˈem
modificate	mˌodifikˈate
montanias	montˈanjas
notate	notˈate
observate	ˌobservˈate
occupate	ˌokupˈate
patronos	patrˈonos
pedes	pˈedes
pensar	pensˈar
perdita	pˈerdita
proteina	protˈe͡ɪna
pseudonymo	psˌeudˈonimo
publicationes	pˌublikatjˈones
quadratos	kwadrˈatos
racias	rˈat͡sjas
radical	rˌadikˈal
risco	rˈisko
s	ˈes
scandium	skˈandjum
scripto	skrˈipto
seligite	sˌeliɡˈite
sensibile	sensˈibile
serea	serˈea
servitor	sˌervitˈor
sic	sˈik
sulfure	sˈulfure
symbolic	simbˈolik
te	tˈe
tendentia	tendˈentja
teneva	tenˈeva
tenite	tenˈite
titanium	titˈanjum
transmittite	trˌansmitˈite
travalios	travˈaljos
vias	vˈias
visual	viswˈal
Ambe	ˈambe
Amsterdam	ˌamsterdˈam
Battalia	batˈalja
Brian	brjˈan
Colombia	kolˈombja
Couturat	kˌouturˈat
Era	ˈera
Luna	lˈuna
Nederland	ŋˈederland
Paises	pˈa͡ɪses
Peter	petˈer
Press	prˈess
accento	at͡sˈento
adder	adˈer
adoptava	ˌadoptˈava
age	ˈaɡe
augmenta	a͡ʊɡmˈenta
autonomia	ˌa͡ʊtonomˈia
censo	t͡sˈenso
chacos	ʃˈakos
chloro	klˈoro
clause	klˈa͡ʊse
collectiones	kˌolektjˈones
commenciava	kˌoment͡sjˈava
compositor	kˌompositˈor
condemnate	kˌondemnˈate
construer	konstrwˈer
costo	kˈosto
criticas	krˈitikas
denomination	dˌenomˌinatjˈon
discipulos	dist͡sˈipulos
discussion	dˌiskusjˈon
disputa	dispˈuta
dolor	dolˈor
electromagnetic	ˌelektrˌomaɡnˈetik
episodio	ˌepisˈodjo
equilibrio	ˌekwilˈibrjo
expedition	ˌekspeditjˈon
files	faˈils
financiari	fˌinant͡sjˈari
football	futbˈol
frontiera	frontjˈera
fructos	frˈuktos
generic	ɡenˈerik
germanic	ɡermˈanik
grave	ɡrˈave
horologio	hˌorolˈoɡjo
humide	hˈumide
immediate	ˌimedjˈate
indianos	indjˈanos
indicate	ˌindikˈate
inseniar	ˌinsenjˈar
intense	intˈense
interessante	ˌinteresˈante
interessate	ˌinteresˈate
inventate	ˌinventˈate
inviate	invjˈate
lassa	lˈasa
lector	lektˈor
limites	lˈimites
magic	mˈaɡik
manteneva	mˌantenˈeva
masculos	mˈaskulos
mechanismo	mˌet͡ʃanˈismo
mixtura	mikstˈura
mobile	mˈobile
municipal	mˌunit͡sipˈal
muro	mˈuro
necessita	nˌet͡sesˈita
notion	notjˈon
nubes	nˈubes
objectivos	ˌobʒektˈivos
observationes	ˌobservatjˈones
offereva	ˌoferˈeva
officio	ofˈit͡sjo
opposite	opˈosite
orientate	ˌorjentˈate
origines	orˈiɡines
papiro	papˈiro
plan	plˈan
proba	prˈoba
probabile	probˈabile
producto	prodˈukto
promover	prˌomovˈer
pronunciation	prˌonunt͡sjatjˈon
quand	kwˈand
radiation	rˌadjatjˈon
radioamatores	rˌadjoˌamatˈores
recognosceva	rˌekoɡnost͡sˈeva
referentias	rˌeferˈentjas
reimplaciate	rˌe͡ɪmplat͡sjˈate
rende	rˈende
representationes	rˌepresˌentatjˈones
ressources	ressˈurses
sapeva	sapˈeva
secrete	sekrˈete
sectiones	sektjˈones
sector	sektˈor
separation	sˌeparatjˈon
sera	serˈa
sona	sˈona
sonos	sˈonos
spatial	spatjˈal
strictemente	strˌiktemˈente
studiate	studjˈate
substantia	substˈantja
suggere	suɡˈere
supporto	supˈorto
temperaturas	tˌemperatˈuras
tende	tˈende
tornados	tornˈados
tubo	tˈubo
una	ˈuna
unes	ˈunes
utilisar	ˌutilisˈar
virus	vˈirus
vitro	vˈitro
volumine	volˈumine
votos	vˈotos
Anne	ˈane
Assemblea	ˌasemblˈea
Cage	kˈaɡe
Cid	t͡sˈid
Communitate	kˌomunitˈate
Existe	eksˈiste
Historia	histˈorja
Hollywood	hˌoliwoˈod
ISO	ˈiso
Kansas	kˈansas
Latino	latˈino
Martin	martˈin
Minor	minˈor
PIE	pjˈe
Revolution	rˌevolutjˈon
Sicilia	sit͡sˈilja
Sur	sˈur
Tamben	tambˈen
Tres	trˈes
Turre	tˈure
VIH	vˈih
Vetule	vˈetule
acceptava	ˌat͡septˈava
acido	ˈat͡sido
animate	ˌanimˈate
annunciava	ˌanunt͡sjˈava
approximatemente	ˌaproksˌimatemˈente
arbores	ˈarbores
armeas	armˈeas
arrestate	ˌarestˈate
cade	kˈade
capitulos	kapˈitulos
cercava	t͡serkˈava
collo	kˈolo
combina	kombˈina
comenciate	kˌoment͡sjˈate
comprehende	kˌomprehˈende
consistente	kˌonsistˈente
contactos	kontˈaktos
cosmic	kˈosmik
creator	krˌeatˈor
cura	kˈura
democratic	dˌemokrˈatik
diametro	djˈametro
digital	dˌiɡitˈal
dispareva	dˌisparˈeva
distinguer	dˌistiŋɡwˈer
donava	donˈava
essentialmente	ˌesentjalmˈente
exprime	eksprˈime
frontieras	frontjˈeras
fundatores	fˌundatˈores
illegal	ˌileɡˈal
impedir	ˌimpedˈir
influentiava	ˌinflwentjˈava
legenda	leɡˈenda
liberation	lˌiberatjˈon
ligamine	lˈiɡamˌine
meliorar	mˌeljorˈar
mixte	mˈikste
montaniose	mˌontanjˈose
morite	morˈite
nasce	nˈast͡se
operationes	ˌoperatjˈones
opiniones	ˌopinjˈones
ordinari	ˌordinˈari
orthodoxe	ˌortodˈokse
palatio	palˈatjo
partiva	partˈiva
pensava	pensˈava
periculose	pˌerikulˈose
periodic	perjˈodik
possedeva	pˌosedˈeva
posteriormente	pˌosterjormˈente
progressive	prˌoɡresˈive
propone	propˈone
propositiones	prˌopositjˈones
puncta	pˈunkta
quitava	kwitˈava
realmente	rˌealmˈente
representante	rˌepresentˈante
resultante	rˌesultˈante
reuniones	re͡ʊnjˈones
rito	rˈito
saepe	saˈepe
secretario	sˌekretˈarjo
septimana	sˌeptimˈana
servite	servˈite
situationes	sˌitwatjˈones
soldato	soldˈato
sposo	spˈoso
successos	sut͡sˈesos
supernomine	sˌupernomˈine
tentativa	tˌentatˈiva
theoric	teˈorik
traditionalmente	trˌaditjˌonalmˈente
unitari	ˌunitˈari
urbes	ˈurbes
vader	vadˈer
visitava	vˌisitˈava
ADN	ˈadn
Bon	bˈon
Britannic	britˈannik
Canada	kˌanadˈa
Esseva	esˈeva
Fame	fˈame
Francisco	frant͡sˈisko
Hic	hˈik
Insulas	ˈinsulas
Justitia	ʒustˈitja
Luther	lutˈer
Miguel	miɡwˈel
Paul	pˈa͡ʊl
Platon	plˈaton
Posteriormente	pˌosterjormˈente
Region	reɡjˈon
Tal	tˈal
Texto	tˈeksto
acute	akˈute
angulo	ˈanɡulo
apertura	ˌapertˈura
architecto	ˌart͡ʃitˈekto
assertion	ˌasertjˈon
augmentar	ˌa͡ʊɡmentˈar
conjunctemente	kˌonʒunktemˈente
constitutional	kˌonstitˌutjonˈal
cooperation	kˌoopˌeratjˈon
costumes	kostˈumes
credite	kredˈite
criticate	krˌitikˈate
designa	desˈiɡna
detra	dˈetra
dictionarios	dˌiktjonˈarjos
discoperta	dˌiskopˈerta
editorial	ˌeditorjˈal
effortio	efˈortjo
emphase	ˈemfase
estima	estˈima
extendite	ˌekstendˈite
forestes	forˈestes
functionamento	fˌunktjonamˈento
ideal	ˌideˈal
identificar	ˌidentˌifikˈar
imperial	ˌimperjˈal
imprimite	ˌimprimˈite
influente	inflwˈente
instructiones	ˌinstruktjˈones
intention	ˌintentjˈon
interrate	ˌinterˈate
ir	ˈir
jalne	ʒˈalne
magnesium	maɡnˈesjum
manca	mˈanka
mangiar	manʒˈar
mantene	mantˈene
memorias	memˈorjas
modificar	mˌodifikˈar
nobilitate	nˌobilitˈate
note	nˈote
occupation	ˌokupatjˈon
opponente	ˌoponˈente
orbita	ˈorbita
organos	ˈorɡanos
pagar	paɡˈar
passos	pˈasos
perfecte	perfˈekte
phenomenos	fenˈomenos
placer	plat͡sˈer
planta	plˈanta
possibilemente	pˌosibˌilemˈente
presentar	prˌesentˈar
pressa	prˈesa
probas	prˈobas
prova	prˈova
psychologic	psˌikolˈoɡik
quadrate	kwadrˈate
quantitates	kwˌantitˈates
rango	rˈaŋɡo
recentemente	rˌet͡sentemˈente
recercas	ret͡sˈerkas
refusava	rˌefusˈava
regulate	rˌeɡulˈate
respectivemente	rˌespektˌivemˈente
responsabilitate	rˌesponsˌabilitˈate
retes	rˈetes
revela	revˈela
seriose	serjˈose
sport	spˈort
stabilitate	stˌabilitˈate
stratas	strˈatas
stylo	stˈilo
succession	sˌut͡sesjˈon
superviveva	sˌupervivˈeva
territorial	tˌeritorjˈal
totalitate	tˌotalitˈate
turres	tˈures
ut	ˈut
valle	vˈale
van	vˈan
vector	vektˈor
verbal	verbˈal
video	vidˈeo
y	ˌipsilˈon
Achille	at͡ʃˈile
Actualmente	ˌaktwalmˈente
Athenas	atˈenas
Berlin	berlˈin
California	kˌalifˈornja
Die	dˈie
Etate	etˈate
Frits	frˈits
Fundation	fˌundatjˈon
Guerras	ɡwˈeras
Harry	hˈari
Hectore	hektˈore
Insula	ˈinsula
Libere	lˈibere
Luca	lˈuka
OMS	ˈoms
Renascentia	rˌenast͡sˈentja
Scripturas	skriptˈuras
Super	sˈuper
Tjörn	tʒˈorn
acclamate	ˌaklamˈate
accusate	ˌakusˈate
actos	ˈaktos
adaptate	ˌadaptˈate
agricole	ˌaɡrikˈole
alco	ˈalko
algorithmos	ˌalɡorˈitmos
alliatos	aljˈatos
ancestres	ant͡sˈestres
applica	ˈaplika
apprendeva	ˌaprendˈeva
arco	ˈarko
arrangiamento	ˌaranʒamˈento
attingite	ˌatiŋɡˈite
augmentava	ˌa͡ʊɡmentˈava
brevemente	brˌevemˈente
celle	t͡sˈele
cellula	t͡sˈelula
cellular	t͡sˌelulˈar
characterisa	t͡ʃˌarakterˈisa
circular	t͡sˌirkulˈar
coincide	ko͡ɪnt͡sˈide
comenciar	kˌoment͡sjˈar
conducta	kondˈukta
conserva	konsˈerva
consonante	kˌonsonˈante
consonantes	kˌonsonˈantes
cornamusa	kˌornamˈusa
creante	kreˈante
credente	kredˈente
deber	debˈer
decisive	dˌet͡sisˈive
dedicava	dˌedikˈava
defende	defˈende
destruction	dˌestruktjˈon
discoperi	dˌiskopˈeri
discoperir	dˌiskoperˈir
distinguite	dˌistiŋɡwˈite
emergentia	ˌemerɡˈentja
emplea	emplˈea
ensemble	ansˈamble
eruditos	ˌerudˈitos
eventualmente	ˌeventwalmˈente
examine	eksˈamine
exilio	eksˈiljo
exposition	ˌekspositjˈon
expressiones	ˌekspresjˈones
ferro	fˈero
filias	fˈiljas
functional	fˌunktjonˈal
gas	ɡˈas
gases	ɡˈases
idiomas	idjˈomas
indicar	ˌindikˈar
insenia	insˈenja
interslavo	ˌinterslˈavo
intervention	ˌinterventjˈon
jornalista	ʒˌornalˈista
kalium	kˈaljum
laboratorio	lˌaboratˈorjo
linguistica	linɡwˈistika
listas	lˈistas
luctava	luktˈava
machinas	mˈakinas
magazines	mˌaɡazˈins
materne	matˈerne
medic	mˈedik
melodic	melˈodik
meridional	mˌeridjonˈal
metallic	metˈalik
minime	mˈinime
mission	misjˈon
municipalitate	mˌunit͡sˌipalitˈate
muros	mˈuros
museo	musˈeo
narra	nˈara
narration	nˌaratjˈon
natrium	nˈatrjum
nominar	nˌominˈar
novemente	nˌovemˈente
obtene	obtˈene
parco	pˈarko
partialmente	pˌartjalmˈente
participantes	pˌartit͡sipˈantes
patiente	patjˈente
pederastia	pˌederastˈia
personalitate	pˌersonˌalitˈate
pictor	piktˈor
planification	plˌanifˌikatjˈon
poneva	ponˈeva
portas	pˈortas
portion	portjˈon
precoce	prekˈot͡se
preter	prˈeter
productor	prˌoduktˈor
progresso	proɡrˈeso
prohibite	prˌohibˈite
pronomine	pronˈomine
pulvere	pˈulvere
reducite	rˌedut͡sˈite
renominate	rˌenominˈate
restava	restˈava
sancte	sˈankte
sapite	sapˈite
signava	siɡnˈava
sphera	sfˈera
stilos	stˈilos
suffre	sˈufre
summa	sˈuma
supernatural	sˌupernˌaturˈal
tenta	tˈenta
tono	tˈono
totos	tˈotos
toures	toˈures
tractatos	traktˈatos
ventos	vˈentos
viages	vjˈaʒes
Annos	ˈanos
C	sˈe
Castello	kastˈelo
Commission	kˌomisjˈon
Congresso	koŋɡrˈeso
Derectos	derˈektos
Duce	dˈut͡se
Est	ˈest
Exemplos	eksˈemplos
Juan	ʒwˈan
King	kˈiŋɡ
Liga	lˈiɡa
Ludovico	ludˈoviko
Manifesto	mˌanifˈesto
Ordine	ˈordine
Prince	prˈint͡se
Richard	rit͡ʃˈard
Sovente	sovˈente
Trump	trˈump
Zamenhof	zˌamenhˈof
abuso	abˈuso
adjacente	ˌadʒat͡sˈente
adjutate	ˌadʒutˈate
ager	aɡˈer
alimentos	ˌalimˈentos
altemente	ˌaltemˈente
antenna	antˈena
aperite	ˌaperˈite
appropriate	ˌaproprjˈate
aquas	ˈakwas
assignate	ˌasiɡnˈate
atmosphera	ˌatmosfˈera
authentic	a͡ʊtˈentik
avantiamento	ˌavantjamˈento
battalias	batˈaljas
batteria	bˌaterˈia
bloco	blˈoko
blues	blwˈes
bordo	bˈordo
brancas	brˈankas
canal	kanˈal
celate	t͡selˈate
celebre	t͡sˈelebre
centros	t͡sˈentros
cerebro	t͡serˈebro
cessava	t͡sesˈava
chordas	t͡ʃˈordas
claudite	kla͡ʊdˈite
cogniscite	kˌoɡnist͡sˈite
colonos	kolˈonos
committee	komˈiti
complexo	komplˈekso
conferentias	kˌonferˈentjas
congresso	koŋɡrˈeso
consisteva	kˌonsistˈeva
continuitate	kˌontinwitˈate
corruption	kˌoruptjˈon
credentes	kredˈentes
crise	krˈise
criterios	kritˈerjos
declaration	dˌeklaratjˈon
declinava	dˌeklinˈava
democratia	dˌemokratˈia
densitate	dˌensitˈate
des	dˈes
descriptiones	dˌeskriptjˈones
desira	desˈira
digitos	dˈiɡitos
divisiones	dˌivisjˈones
donate	donˈate
drogas	drˈoɡas
eminente	ˌeminˈente
entitates	ˌentitˈates
essaya	esˈaja
exceptiones	ˌekst͡septjˈones
exemplares	ˌeksemplˈares
facente	fat͡sˈente
fragmentos	fraɡmˈentos
gradualmente	ɡrˌadwalmˈente
imposto	impˈosto
indigena	indˈiɡena
invasion	ˌinvasjˈon
legendas	leɡˈendas
legislative	lˌeɡislatˈive
legite	leɡˈite
liberate	lˌiberˈate
longor	loŋɡˈor
luna	lˈuna
maritate	mˌaritˈate
mediante	medjˈante
mus	mˈus
musico	mˈusiko
neon	nˈeon
objective	ˌobʒektˈive
opponentes	ˌoponˈentes
originava	ˌoriɡinˈava
papa	pˈapa
parlante	parlˈante
participation	pˌartit͡sˌipatjˈon
patientes	patjˈentes
permission	pˌermisjˈon
perspectiva	pˌerspektˈiva
petroleo	pˌetrolˈeo
photographia	phˌotoɡrafˈia
phrases	frˈases
pop	pˈop
pronunciate	prˌonunt͡sjˈate
pugno	pˈuɡno
reducer	rˌedut͡sˈer
resolution	rˌesolutjˈon
restos	rˈestos
revistas	revˈistas
rural	rurˈal
saliva	salˈiva
san	sˈan
scenas	st͡sˈenas
sedes	sˈedes
studente	studˈente
symptomas	simptˈomas
tabella	tabˈela
telescopio	tˌeleskˈopjo
tendentias	tendˈentjas
universitari	ˌunivˌersitˈari
variabile	varjˈabile
vicinitate	vˌit͡sinitˈate
visita	visˈita
Addams	adˈams
Age	ˈaɡe
Anna	ˈana
Argentina	ˌarɡentˈina
Florentia	florˈentja
German	ɡermˈan
Helena	hˈelena
Jean	ʒeˈan
Lege	lˈeɡe
Mae	mˈae
Medievo	medjˈevo
Mesmo	mˈesmo
Papa	pˈapa
Pedro	pˈedro
Petro	pˈetro
Schola	st͡ʃˈola
Scriptura	skriptˈura
Singapur	sˌiŋɡapˈur
Sovietic	sovjˈetik
Sub	sˈub
Tom	tˈom
Vasari	vasˈari
acceptation	ˌat͡septatjˈon
adde	ˈade
aer	aˈer
aeree	aˈeree
agente	aɡˈente
agitation	ˌaɡitatjˈon
alcunes	alkˈunes
appello	apˈelo
appreciate	ˌapret͡sjˈate
assistentia	ˌasistˈentja
associationes	ˌasot͡sjatjˈones
avantage	ˌavantˈaʒe
avantiar	ˌavantjˈar
bilingue	bilˈiŋɡwe
brillante	brilˈante
castellos	kastˈelos
celebrate	t͡sˌelebrˈate
circulos	t͡sˈirkulos
colpos	kˈolpos
communicar	kˌomunikˈar
communitari	kˌomunitˈari
concerne	kont͡sˈerne
conclusion	kˌonklusjˈon
conduceva	kˌondut͡sˈeva
conferentia	kˌonferˈentja
consenso	konsˈenso
constituyentes	kˌonstitujˈentes
contava	kontˈava
convention	kˌonventjˈon
defensive	dˌefensˈive
descendentes	dˌest͡sendˈentes
descendentia	dˌest͡sendˈentja
designar	dˌesiɡnˈar
diabete	djabˈete
dirige	dirˈiɡe
disposition	dˌispositjˈon
dissolution	dˌisolutjˈon
disveloppa	dˌisvelˈopa
dominava	dˌominˈava
drama	drˈama
dubita	dˈubita
dulce	dˈult͡se
edificate	ˌedifikˈate
educative	ˌedukatˈive
elemental	ˌelementˈal
evidente	ˌevidˈente
explicar	ˌeksplikˈar
exprimite	ˌeksprimˈite
factor	faktˈor
fiction	fiktjˈon
flotta	flˈota
fortiate	fortjˈate
generationes	ɡˌeneratjˈones
hospite	hˈospite
incorporate	ˌinkorporˈate
independentemente	ˌindepˌendentemˈente
inseniate	ˌinsenjˈate
integrate	ˌinteɡrˈate
integration	ˌinteɡratjˈon
interesses	ˌinterˈeses
intime	ˈintime
isse	ˈise
joca	ʒˈoka
juxta	ʒˈuksta
lanceate	lˌant͡seˈate
leader	lˌeadˈer
lentemente	lˌentemˈente
li	lˈi
licentias	lit͡sˈentjas
medical	mˌedikˈal
micre	mˈikre
millennio	milˈenjo
milliardos	miljˈardos
molle	mˈole
moveva	movˈeva
mythos	mˈitos
nemo	nˈemo
novella	novˈela
obligatori	ˌobliɡatˈori
observar	ˌobservˈar
occasiones	ˌokasjˈones
operator	ˌoperatˈor
or	ˈor
ordinate	ˌordinˈate
ordinava	ˌordinˈava
ordines	ˈordines
organismo	ˌorɡanˈismo
parlamentari	pˌarlamentˈari
passive	pasˈive
patas	pˈatas
pertineva	pˌertinˈeva
phases	fˈases
photographias	phˌotoɡrafˈias
photos	fˈotos
platteforma	plˌatefˈorma
portar	portˈar
possibilitates	pˌosibˌilitˈates
pp	pˌepˈe
precios	prˈet͡sjos
preparation	prˌeparatjˈon
pretendentes	prˌetendˈentes
prince	prˈint͡se
propagation	prˌopaɡatjˈon
protegite	prˌoteɡˈite
registrava	rˌeɡistrˈava
resurrection	rˌesurektjˈon
retirava	rˌetirˈava
revolta	revˈolta
ritos	rˈitos
riviera	rivjˈera
rugby	rˈuɡbi
sacre	sˈakre
sagessa	saʒˈesa
sentimentos	sˌentimˈentos
serpente	serpˈente
seta	sˈeta
sonate	sonˈate
specificamente	spˌet͡sifˌikamˈente
statal	statˈal
suffice	sufˈit͡se
tabuliero	tˌabuljˈero
termina	termˈina
tornava	tornˈava
trenta	trˈenta
usual	uswˈal
vacuo	vˈakwo
vale	vˈale
venir	venˈir
vulgar	vulɡˈar
Abu	ˈabu
Australia	a͡ʊstrˈalja
B	bˈe
Christian	kristjˈan
Derecto	derˈekto
Don	dˈon
Frequentemente	frˌekwentemˈente
Gruppo	ɡrˈupo
Hans	hˈans
Jehovah	ʒehˈovah
Jonathan	ʒˌonatˈan
Karl	kˈarl
Lord	lˈord
Los	lˈos
Mary	mˈari
Multo	mˈulto
Quasi	kwˈasi
Regal	reɡˈal
SIDA	sˈida
Santa	sˈanta
Sin	sˈin
St	ˌestˈe
Tacito	tat͡sˈito
Vos	vˈos
X	ˈiks
XML	ˌiksˌemˈel
abandonava	ˌabandonˈava
absentia	absˈentja
acceptar	ˌat͡septˈar
alique	ˈalike
alter	altˈer
amicitate	ˌamit͡sitˈate
aperiva	ˌaperˈiva
apparente	ˌaparˈente
applicabile	ˌaplikˈabile
attribuite	ˌatribwˈite
bases	bˈases
besonia	besˈonja
biologic	bjolˈoɡik
bits	bˈits
brun	brˈun
ca	kˈa
cadita	kadˈita
cammino	kamˈino
captura	kaptˈura
cavallero	kˌavalˈero
combatter	kˌombatˈer
commandante	kˌomandˈante
complexitate	kˌompleksitˈate
componente	kˌomponˈente
componeva	kˌomponˈeva
comprendeva	kˌomprendˈeva
connexe	konˈekse
connexiones	kˌoneksjˈones
contar	kontˈar
controlate	kˌontrolˈate
convertite	kˌonvertˈite
cosino	kosˈino
costose	kostˈose
creaturas	krˌeatˈuras
creder	kredˈer
cursa	kˈursa
descendente	dˌest͡sendˈente
detaliate	dˌetaljˈate
discopertas	dˌiskopˈertas
discussiones	dˌiskusjˈones
domination	dˌominatjˈon
dominios	domˈinjos
dynastia	dˌinastˈia
elaborate	ˌelaborˈate
emergeva	ˌemerɡˈeva
emphysema	ˌemfisˈema
entra	ˈentra
episodios	ˌepisˈodjos
establimento	ˌestablimˈento
executar	ˌeksekutˈar
experimento	ˌeksperimˈento
extendeva	ˌekstendˈeva
extense	ekstˈense
factores	faktˈores
ferroviari	fˌerovjˈari
franc	frˈank
gamma	ɡˈama
gania	ɡˈanja
gigante	ɡiɡˈante
grammatic	ɡramˈatik
hereditate	hˌereditˈate
ideologia	ˌideˌoloɡˈia
incorpora	ˌinkorpˈora
inimicos	ˌinimˈikos
intermediari	ˌintermedjˈari
introducer	ˌintrodut͡sˈer
irlandese	ˌirlandˈese
laco	lˈako
legier	leʒˈer
leon	leˈon
liquido	lˈikwido
longemente	lˌoŋɡemˈente
luctar	luktˈar
malade	malˈade
mammales	mamˈales
manifesta	mˌanifˈesta
mappa	mˈapa
matrimonio	mˌatrimˈonjo
mentiona	mentjˈona
metallo	metˈalo
modos	mˈodos
mortal	mortˈal
mortes	mˈortes
motivo	motˈivo
motores	motˈores
musulmanes	mˌusulmˈanes
necessarimente	nˌet͡sesˌarimˈente
nobiles	nˈobiles
obligate	ˌobliɡˈate
occasion	ˌokasjˈon
occide	ot͡sˈide
paisage	pa͡ɪsˈaʒe
partitas	partˈitas
partition	pˌartitjˈon
pedones	pedˈones
penal	penˈal
perception	pˌert͡septjˈon
philosophos	philˈosofos
poetas	poˈetas
precio	prˈet͡sjo
preparate	prˌeparˈate
primavera	prˌimavˈera
promove	promˈove
proponeva	prˌoponˈeva
provar	provˈar
providite	prˌovidˈite
qualitates	kwˌalitˈates
quinte	kwˈinte
radios	rˈadjos
reactiones	rˌeaktjˈones
realisa	rˌealˈisa
reception	rˌet͡septjˈon
redaction	rˌedaktjˈon
reflecte	reflˈekte
representava	rˌepresentˈava
reproduction	rˌeproduktjˈon
respondeva	rˌespondˈeva
rhythmo	rˈitmo
satis	sˈatis
senti	sˈenti
spiral	spirˈal
statua	stˈatwa
suffixos	sufˈiksos
superava	sˌuperˈava
superficial	sˌuperfit͡sjˈal
supponite	sˌuponˈite
supportar	sˌuportˈar
switze	swˈitze
tertio	tˈertjo
theatral	tˌeatrˈal
tra	trˈa
tractava	traktˈava
tropical	trˌopikˈal
utensiles	utˈensiles
vehiculo	vehˈikulo
versos	vˈersos
viagiar	vjaʒˈar
vostre	vˈostre
Anglese	aŋɡlˈese
Basel	basˈel
Bison	bisˈon
Camera	kˈamera
Castilia	kastˈilja
Claudio	klˈa͡ʊdjo
Comocunque	kˌomokˈuŋkwe
Confederation	kˌonfedˌeratjˈon
Contato	kontˈato
Copertura	kˌopertˈura
Dorking	dorkˈiŋɡ
Dum	dˈum
Evangelios	ˌevaŋɡˈeljos
Giovanni	ɡjovˈani
Joh	ʒˈoh
Julio	ʒˈuljo
Leonardo	lˌeonˈardo
Les	lˈes
Marilyn	mˌarilˈin
Michael	mˌit͡ʃaˈel
Monte	mˈonte
Palatio	palˈatjo
Ponte	pˈonte
Presidente	prˌesidˈente
Van	vˈan
XIV	dˈet͡sekwˈatro
alcuno	alkˈuno
alimentation	ˌalimˌentatjˈon
ama	ˈama
apparer	ˌaparˈer
armenie	armˈenje
arrangiate	ˌaraŋɡjˈate
attacca	atˈaka
ave	ˈave
bisonte	bisˈonte
branca	brˈanka
cambiamento	kˌambjamˈento
capitulo	kapˈitulo
capturate	kˌapturˈate
cavitate	kˌavitˈate
circumstantias	t͡sˌirkumstˈantjas
citatano	t͡sˌitatˈano
cognoscimento	kˌoɡnost͡simˈento
comprar	komprˈar
comprension	kˌomprensjˈon
concrete	konkrˈete
configuration	kˌonfiɡˌuratjˈon
connexion	kˌoneksjˈon
consequente	kˌonsekwˈente
conservative	kˌonservatˈive
constantemente	kˌonstantemˈente
contineva	kˌontinˈeva
controverse	kˌontrovˈerse
converteva	kˌonvertˈeva
copertura	kˌopertˈura
cornos	kˈornos
correspondentia	kˌorespondˈentja
crescer	krest͡sˈer
cultivate	kˌultivˈate
decime	dˈet͡sime
demonstrate	dˌemonstrˈate
dense	dˈense
desinentia	dˌesinˈentja
developpate	dˌevelopˈate
disciplinas	dˌist͡siplˈinas
discrimination	dˌiskrimˌinatjˈon
discursos	diskˈursos
dona	dˈona
elevation	ˌelevatjˈon
emission	ˌemisjˈon
estranier	ˌestranjˈer
evita	evˈita
excambio	ekskˈambjo
expandite	ˌekspandˈite
explicate	ˌeksplikˈate
explication	ˌeksplikatjˈon
explicitemente	ˌeksplit͡sˌitemˈente
explosion	ˌeksplosjˈon
fabrica	fˈabrika
filos	fˈilos
formante	formˈante
functionalitate	fˌunktjonˌalitˈate
genes	ɡˈenes
geometria	ɡˌeometrˈia
governar	ɡˌovernˈar
governava	ɡˌovernˈava
gran	ɡrˈan
granos	ɡrˈanos
gusto	ɡˈusto
historicamente	hˌistorˌikamˈente
horizontal	hˌorizontˈal
humor	humˈor
hydrogeno	hidrˈoɡeno
impression	ˌimpresjˈon
ingeniero	ˌiŋɡenjˈero
inseniamentos	ˌinsenjamˈentos
intende	intˈende
involvite	ˌinvolvˈite
justo	ʒˈusto
lacte	lˈakte
liquide	lˈikwide
lontan	lontˈan
magazine	mˌaɡazˈin
maximo	mˈaksimo
medico	mˈediko
mesuras	mesˈuras
migration	mˌiɡratjˈon
multitude	mˌultitˈude
occider	ˌot͡sidˈer
occurrer	ˌokurˈer
offensiva	ˌofensˈiva
opponeva	ˌoponˈeva
optic	ˈoptik
orientation	ˌorjentatjˈon
parallel	pˌaralˈel
parente	parˈente
pareva	parˈeva
participa	pˌartit͡sˈipa
participio	pˌartit͡sˈipjo
perse	pˈerse
precision	prˌet͡sisjˈon
preste	prˈeste
pretende	pretˈende
proclamava	prˌoklamˈava
promovite	prˌomovˈite
proteinas	protˈe͡ɪnas
puera	pˈuera
punk	pˈuŋk
quartiero	kwartjˈero
rational	rˌatjonˈal
recensiones	rˌet͡sensjˈones
reduction	rˌeduktjˈon
referendum	rˌeferˈendum
registration	rˌeɡistratjˈon
reguarda	reɡwˈarda
removite	rˌemovˈite
reservate	rˌeservˈate
respective	rˌespektˈive
responde	respˈonde
reticulo	retˈikulo
scandalo	skˈandalo
scripturas	skriptˈuras
secular	sˌekulˈar
secundas	sekˈundas
sensos	sˈensos
sequentia	sekwˈentja
signate	siɡnˈate
significatos	sˌiɡnifikˈatos
spisse	spˈise
sportive	sportˈive
stabile	stˈabile
static	stˈatik
strata	strˈata
strategia	strˌateɡˈia
suffixo	sufˈikso
supervive	sˌupervˈive
supporta	supˈorta
talento	talˈento
terminate	tˌerminˈate
testa	tˈesta
timor	timˈor
traducer	trˌadut͡sˈer
traduceva	trˌadut͡sˈeva
transferite	trˌansferˈite
utilisation	ˌutilˌisatjˈon
victima	vˈiktima
vigor	viɡˈor
virtute	virtˈute
zero	zˈero
Alexander	ˌaleksandˈer
Alfred	alfrˈed
Ancora	ankˈora
Atlantic	atlˈantik
Bakonyi	bakˈonji
Brongersma	broŋɡˈersma
Cascadas	kaskˈadas
Concilio	kont͡sˈiljo
Corea	korˈea
Daejeon	dˌaeʒeˈon
Disney	disnˈej
Districto	distrˈikto
EC	ˈek
Francese	frant͡sˈese
Georgio	ɡeˈorɡjo
Herodoto	hˌerodˈoto
Hertz	hˈertz
Historicamente	hˌistorˌikamˈente
Intertanto	ˌintertˈanto
Jacobo	ʒˈakobo
Jam	ʒˈam
Jedi	ʒˈedi
Margareta	mˌarɡarˈeta
Nationes	natjˈones
Nulle	nˈule
Ora	ˈora
Pace	pˈat͡se
Parola	parˈola
Priamo	prjˈamo
Records	rˈekords
Secun	sekˈun
Tu	tˈu
Universal	ˌuniversˈal
VII	sˈepte
Victoria	viktˈorja
Wilson	wilsˈon
XVI	dˈet͡seseks
Zelanda	zelˈanda
abbreviate	ˌabrevjˈate
abbreviation	ˌabrevjatjˈon
abundante	ˌabundˈante
accusationes	ˌakusatjˈones
activista	ˌaktivˈista
actores	aktˈores
adequate	ˌadekwˈate
administrator	ˌadminˌistratˈor
adoptar	ˌadoptˈar
advocato	ˌadvokˈato
affirmava	ˌafirmˈava
alternativa	ˌalternatˈiva
anatomia	ˌanatomˈia
appoia	apˈo͡ɪa
approbation	ˌaprobatjˈon
astronomic	ˌastronˈomik
attaccate	ˌatakˈate
attrahite	ˌatrahˈite
auree	a͡ʊrˈee
automaticamente	ˌa͡ʊtomˌatikamˈente
balla	bˈala
bestial	bestjˈal
campion	kampjˈon
carta	kˈarta
centimetros	t͡sentˈimetros
codification	kˌodifˌikatjˈon
cognate	koɡnˈate
collaboration	kˌolabˌoratjˈon
comocunque	kˌomokˈuŋkwe
companias	kˌompanˈias
companion	kˌompanjˈon
complicate	kˌomplikˈate
compositores	kˌompositˈores
conflictos	konflˈiktos
conforme	konfˈorme
conjugation	kˌonʒuɡatjˈon
consideration	kˌonsidˌeratjˈon
constitueva	kˌonstitwˈeva
costas	kˈostas
costume	kostˈume
declino	deklˈino
demandar	dˌemandˈar
derivation	dˌerivatjˈon
descende	dest͡sˈende
desirava	dˌesirˈava
dieta	djˈeta
difficultate	dˌifikultˈate
dimensiones	dˌimensjˈones
discutite	dˌiskutˈite
distantias	distˈantjas
domesticate	dˌomestikˈate
du	dˈu
equipas	ekwˈipas
esperantistas	ˌesperantˈistas
essayo	esˈajo
europeos	ˌeuropˈeos
evangelio	ˌevaŋɡˈeljo
evolveva	ˌevolvˈeva
excellente	ˌekst͡selˈente
explicite	eksplˈit͡site
exploration	ˌeksploratjˈon
extinction	ˌekstinktjˈon
extrememente	ˌekstrememˈente
faciente	fat͡sjˈente
favorabile	fˌavorˈabile
ferite	ferˈite
file	faˈil
filo	fˈilo
gothic	ɡˈotik
idioma	idjˈoma
immigration	ˌimiɡratjˈon
impedi	impˈedi
indefinite	ˌindefinˈite
indice	ˈindit͡se
infinite	ˌinfinˈite
influential	ˌinflwentjˈal
initiate	ˌinitjˈate
inscription	ˌinskriptjˈon
inspiration	ˌinspiratjˈon
installation	ˌinstalatjˈon
internationalmente	ˌinternˌatjonalmˈente
islamic	islˈamik
judicial	ʒˌudit͡sjˈal
juncte	ʒˈunkte
lancea	lant͡sˈea
las	lˈas
lectiones	lektjˈones
lectura	lektˈura
leve	lˈeve
luce	lˈut͡se
luctas	lˈuktas
manifestation	mˌanifˌestatjˈon
marita	marˈita
mechanic	mekˈanik
mechanismos	mˌet͡ʃanˈismos
ministerio	mˌinistˈerjo
monasterio	mˌonastˈerjo
monumentos	mˌonumˈentos
negotios	neɡˈotjos
neutral	ne͡ʊtrˈal
nodo	nˈodo
nomen	nomˈen
novellas	novˈelas
observation	ˌobservatjˈon
organisa	ˌorɡanˈisa
partial	partjˈal
peccatos	pekˈatos
pertinente	pˌertinˈente
pesante	pesˈante
phonetic	fonˈetik
pipiones	pipjˈones
politico	polˈitiko
possession	pˌosesjˈon
potentias	potˈentjas
preciose	pret͡sjˈose
predominante	prˌedominˈante
primemente	prˌimemˈente
principe	print͡sˈipe
protagonista	prˌotaɡonˈista
qualcosa	kwalkˈosa
rapiditate	rˌapiditˈate
realisation	rˌealˌisatjˈon
registrar	rˌeɡistrˈar
rejectate	rˌeʒektˈate
render	rendˈer
reunion	re͡ʊnjˈon
romantic	romˈantik
salvate	salvˈate
scientista	st͡sjentˈista
signal	siɡnˈal
significative	sˌiɡnifˌikatˈive
sino	sˈino
spectaculo	spektˈakulo
stoppar	stopˈar
subito	sˈubito
substantial	sˌubstantjˈal
sue	sˈue
superviver	sˌupervivˈer
supportate	sˌuportˈate
surge	sˈurɡe
temperate	tˌemperˈate
tene	tˈene
terminologia	tˌerminˌoloɡˈia
unicamente	ˌunikamˈente
utilisante	ˌutilisˈante
vacca	vˈaka
vade	vˈade
variate	varjˈate
veces	vˈet͡ses
venite	venˈite
verificar	vˌerifikˈar
vinti	vˈinti
wikis	wˈikis
Alexandria	ˌaleksˈandrja
Ambes	ˈambes
Angeles	aŋɡˈeles
Antique	antˈikwe
Aphrodite	ˌafrodˈite
Aragon	ˌaraɡˈon
Brahe	brˈahe
Casa	kˈasa
Cor	kˈor
Costa	kˈosta
Elizabeth	ˌelizabˈet
Espaniol	ˌespanjˈol
Gabriel	ɡabrjˈel
Galles	ɡˈales
Gay	ɡˈaj
Granada	ɡranˈada
Groenlandia	ɡrˌoenlˈandja
Intra	ˈintra
Joco	ʒˈoko
José	ʒˈose
Leonidas	ɫeˈonidas
Lisbona	lisbˈona
Love	lˈove
Mat	mˈat
Mattheo	matˈeo
Normalmente	nˌormalmˈente
Occidente	ˌot͡sidˈente
Oceano	ot͡sˈeano
Odense	odˈense
PIB	pˈib
Pacific	pat͡sˈifik
Personas	persˈonas
RFC	ˌeɹˌefsˈe
Re	rˈe
Representantes	rˌepresentˈantes
Roll	rˈol
Romulo	rˈomulo
Septe	sˈepte
Society	sot͡sjˈeti
Supreme	suprˈeme
Toto	tˈoto
Tribunal	trˌibunˈal
UMI	ˈumi
Urano	urˈano
Version	versjˈon
Washington	wˌaʃiŋɡtˈon
Windows	windˈows
XVII	dˈet͡sesˈepte
accidente	ˌat͡sidˈente
acquirite	ˌakkwirˈite
alas	ˈalas
alicunes	ˌalikˈunes
ambito	ˈambito
apogeo	ˌapoɡˈeo
appoiar	ˌapo͡ɪˈar
apprentissage	ˌaprentisˈaʒe
arbitrari	ˌarbitrˈari
arrivate	ˌarivˈate
asino	ˈasino
assume	asˈume
astronomia	ˌastronomˈia
attaccar	ˌatakˈar
attraction	ˌatraktjˈon
attributos	ˌatribˈutos
bolla	bˈola
bracio	brˈat͡sjo
cadeva	kadˈeva
canales	kanˈales
capites	kˈapites
cargate	karɡˈate
cassa	kˈasa
catalan	kˌatalˈan
chaco	ʃˈako
chimpanzes	ʃˌimpanzˈes
cifra	t͡sˈifra
colon	kˈolon
columna	kolˈumna
combinate	kˌombinˈate
comic	kˈomik
competition	kˌompetitjˈon
compilation	kˌompilatjˈon
completar	kˌompletˈar
compositiones	kˌompositjˈones
concentration	kˌont͡sentratjˈon
concerto	kont͡sˈerto
confirmate	kˌonfirmˈate
confrontava	kˌonfrontˈava
conquesta	koŋkwˈesta
conquireva	kˌoŋkwirˈeva
conspiration	kˌonspiratjˈon
continueva	kˌontinwˈeva
contractiones	kˌontraktjˈones
contribue	kontrˈibwe
controversia	kˌontrovˈersja
crimine	krˈimine
curiositate	kˌurjositˈate
denominava	dˌenominˈava
dextre	dˈekstre
directiones	dˌirektjˈones
doctor	doktˈor
domos	dˈomos
dramatic	dramˈatik
electricitate	ˌelektrˌit͡sitˈate
electrones	ˌelektrˈones
elegite	ˌeleɡˈite
elementari	ˌelementˈari
empleate	ˌempleˈate
empleo	emplˈeo
epochas	ˈepokas
ethica	ˈetika
exception	ˌekst͡septjˈon
expandeva	ˌekspandˈeva
extensive	ˌekstensˈive
extincte	ekstˈinkte
faction	faktjˈon
febre	fˈebre
felicitate	fˌelit͡sitˈate
fidel	fidˈel
fideles	fidˈeles
filas	fˈilas
fossile	fˈosile
galaxias	ɡalˈaksjas
gentes	ɡˈentes
geographia	ɡˌeoɡrafˈia
guitarras	ɡhitˈaras
habitual	hˌabitwˈal
hebreo	hebrˈeo
immigrantes	ˌimiɡrˈantes
impacto	impˈakto
incendio	int͡sˈendjo
indicante	ˌindikˈante
infundibulo	ˌinfundˈibulo
initiativa	ˌinitjatˈiva
instantia	instˈantja
interaction	ˌinteraktjˈon
interpretationes	ˌinterprˌetatjˈones
interprisa	ˌinterprˈisa
investigationes	ˌinvestˌiɡatjˈones
invisibile	ˌinvisˈibile
is	ˈis
judicamento	ʒˌudikamˈento
judice	ʒˈudit͡se
lassar	lasˈar
lassate	lasˈate
liberar	lˌiberˈar
libertates	lˌibertˈates
linguistas	linɡwˈistas
magne	mˈaɡne
magnitude	mˌaɡnitˈude
mantenite	mˌantenˈite
massas	mˈasas
matur	matˈur
mexican	mˌeksikˈan
minimo	mˈinimo
ministros	minˈistros
moderate	mˌoderˈate
montania	montˈanja
monte	mˈonte
mytho	mˈito
natal	natˈal
nive	nˈive
notar	notˈar
nova	nˈova
observava	ˌobservˈava
optime	ˈoptime
p	pˈe
pacchetto	pat͡ʃˈeto
pacchettos	pat͡ʃˈetos
pensata	pensˈata
peste	pˈeste
phasic	fˈasik
photo	fˈoto
photographic	phˌotoɡrˈafik
pluvial	pluvjˈal
poetic	poˈetik
portrait	portrˈe
practicate	prˌaktikˈate
preparar	prˌeparˈar
principato	prˌint͡sipˈato
prisioneros	prˌisjonˈeros
pronunciar	prˌonunt͡sjˈar
proprietario	prˌoprjetˈarjo
provider	prˌovidˈer
pueras	pˈueras
quadro	kwˈadro
quam	kwˈam
radioamator	rˌadjoˌamatˈor
rattos	rˈatos
reaction	rˌeaktjˈon
recercatores	rˌet͡serkatˈores
recognoscer	rˌekoɡnost͡sˈer
registro	reɡˈistro
reimplaciar	rˌe͡ɪmplat͡sjˈar
reimplaciava	rˌe͡ɪmplat͡sjˈava
remaner	rˌemanˈer
renascentia	rˌenast͡sˈentja
residentia	rˌesidˈentja
resolver	rˌesolvˈer
responder	rˌespondˈer
ritual	ritwˈal
satellite	satˈelite
sentimento	sˌentimˈento
servir	servˈir
significava	sˌiɡnifikˈava
slovenos	slovˈenos
socialismo	sˌot͡sjalˈismo
socialista	sˌot͡sjalˈista
solutiones	sˌolutjˈones
sonar	sonˈar
specificate	spˌet͡sifikˈate
spectro	spˈektro
subite	sˈubite
successive	sˌut͡sesˈive
sucro	sˈukro
superviventia	sˌupervivˈentja
tener	tenˈer
tentativas	tˌentatˈivas
terminava	tˌerminˈava
these	tˈese
titulate	tˌitulˈate
tolerantia	tˌolerˈantja
tourismo	turˈismo
transformate	trˌansformˈate
travaliar	trˌavaljˈar
travaliatores	trˌavaljatˈores
troian	tro͡ɪˈan
tue	tˈue
vectores	vektˈores
vender	vendˈer
vino	vˈino
vocabulos	vokˈabulos
voces	vˈot͡ses
volumines	volˈumines
ASCII	ˈast͡sji
Additionalmente	ˌaditjˌonalmˈente
Adjectivos	ˌadʒektˈivos
Buddha	bˈudha
Chinese	ʃinˈese
Convention	kˌonventjˈon
Daniel	danjˈel
Dobkin	dobkˈin
English	eŋɡlˈiʃ
Federal	fˌederˈal
Federation	fˌederatjˈon
Festival	fˌestivˈal
Frank	frˈaŋk
Gallia	ɡˈalja
Hannover	hˌanovˈer
Henry	hˈenri
Hitler	hitlˈer
House	hoˈuse
Ido	ˈido
Initialmente	ˌinitjalmˈente
Invariabile	ˌinvarjˈabile
Jamblicho	ʒamblˈit͡ʃo
Java	ʒˈava
Jupiter	ʒˈupiter
Jutlandia	ʒutlˈandja
Largo	lˈarɡo
Leon	leˈon
León	leˈon
Liberation	lˌiberatjˈon
Lublin	lublˈin
Magne	mˈaɡne
Marte	mˈarte
Martijn	martˈiʒn
Medie	mˈedje
Mi	mˈi
Neptuno	neptˈuno
Niagara	ŋjˈaɡara
Nostre	nˈostre
Nuwas	nˈuwas
ONU	ˈonu
Orthodoxe	ˌortodˈokse
Peano	peˈano
Poseidon	pˌose͡ɪdˈon
Pote	pˈote
Professor	prˌofesˈor
Quatro	kwˈatro
Regina	reɡˈina
School	st͡ʃoˈol
Sectiones	sektjˈones
Similarmente	sˌimilarmˈente
Superman	sˌupermˈan
São	sˈao
Traditionalmente	trˌaditjˌonalmˈente
Turner	turnˈer
Uppsala	upsˈala
Varie	vˈarje
abandonar	ˌabandonˈar
abolition	ˌabolitjˈon
academia	ˌakademˈia
adresses	adrˈeses
affaire	afˈer
affectate	ˌafektˈate
affligite	ˌafliɡˈite
algorithmo	ˌalɡorˈitmo
alicunos	ˌalikˈunos
alteremente	ˌalteremˈente
amplemente	ˌamplemˈente
analytic	ˌanalˈitik
anonyme	anˈonime
apparition	ˌaparitjˈon
appellar	ˌapelˈar
applicar	ˌaplikˈar
apprende	aprˈende
aragonese	ˌaraɡonˈese
archivos	art͡ʃˈivos
asiatic	asjˈatik
assumeva	ˌasumˈeva
attitudes	ˌatitˈudes
audir	a͡ʊdˈir
aut	ˈa͡ʊt
baptisate	bˌaptisˈate
baptismo	baptˈismo
biographias	bjˌoɡrafˈias
bisontes	bisˈontes
bucca	bˈuka
byzantin	bˌizantˈin
calcular	kˌalkulˈar
calculate	kˌalkulˈate
cardiac	kardˈiak
cargo	kˈarɡo
celebration	t͡sˌelebratjˈon
celtic	t͡sˈeltik
chefes	t͡ʃˈefes
cocina	kot͡sˈina
commentarios	kˌomentˈarjos
communion	kˌomunjˈon
competentia	kˌompetˈentja
complite	komplˈite
concipite	kˌont͡sipˈite
concorda	konkˈorda
conducto	kondˈukto
conservation	kˌonservatjˈon
constituente	kˌonstitwˈente
constituite	kˌonstitwˈite
conte	kˈonte
contes	kˈontes
continuate	kˌontinwˈate
converte	konvˈerte
creative	krˌeatˈive
criterio	kritˈerjo
crystallin	krˌistalˈin
currer	kurˈer
cyclo	t͡sˈiklo
damnos	dˈamnos
dante	dˈante
debilitate	dˌebilitˈate
decades	dˈekades
declara	deklˈara
declarate	dˌeklarˈate
demonstra	demˈonstra
der	dˈer
destinate	dˌestinˈate
destination	dˌestinatjˈon
destrueva	destrwˈeva
detalio	detˈaljo
dialogo	djˈaloɡo
diario	djˈarjo
dirigente	dˌiriɡˈente
disordine	disˈordine
dispare	dispˈare
dissolveva	dˌisolvˈeva
dominate	dˌominˈate
dorso	dˈorso
eligeva	ˌeliɡˈeva
emissiones	ˌemisjˈones
emittite	ˌemitˈite
energetic	ˌenerɡˈetik
energic	enˈerɡik
epistolas	epˈistolas
equipamento	ˌekwipamˈento
essentia	esˈentja
excessive	ˌekst͡sesˈive
executa	ˌeksekˈuta
exige	eksˈiɡe
explicava	ˌeksplikˈava
fabula	fˈabula
facilita	fˌat͡silˈita
ferma	fˈerma
festas	fˈestas
fila	fˈila
finir	finˈir
foramine	forˈamine
formalmente	fˌormalmˈente
fraude	frˈa͡ʊde
frequentias	frekwˈentjas
genera	ɡenˈera
gestion	ɡestjˈon
glacie	ɡlˈat͡sje
gloria	ɡlˈorja
granpatre	ɡranpˈatre
greges	ɡrˈeɡes
guidate	ɡwidˈate
habitat	hˌabitˈat
hardware	hˈardware
hereditario	hˌereditˈarjo
homosexuales	hˌomosekswˈales
hospites	hˈospites
humano	humˈano
identifica	ˌidentˈifika
importa	impˈorta
imprisionate	ˌimprisjonˈate
ingenieria	ˌinɡenjerˈia
innovationes	ˌinovatjˈones
inspirava	ˌinspirˈava
integral	ˌinteɡrˈal
interprisas	ˌinterprˈisas
intersection	ˌintersektjˈon
interslave	ˌinterslˈave
invariabile	ˌinvarjˈabile
inviava	invjˈava
laboratores	lˌaboratˈores
lanceava	lˌant͡seˈava
lassante	lasˈante
legislation	lˌeɡislatjˈon
liberemente	lˌiberemˈente
lithium	lˈitjum
litros	lˈitros
lupo	lˈupo
mandava	mandˈava
match	mˈat͡ʃ
menaciate	mˌenat͡sjˈate
minuta	minˈuta
modifica	modˈifika
moleculas	molˈekulas
momentos	momˈentos
monarchias	mˌonarkˈias
motion	motjˈon
motivos	motˈivos
movite	movˈite
n	ˈen
navigation	nˌaviɡatjˈon
norma	nˈorma
nude	nˈude
occideva	ˌot͡sidˈeva
occurrite	ˌokurˈite
orbital	ˌorbitˈal
ossos	ˈosos
ove	ˈove
pagan	paɡˈan
paisanos	pa͡ɪsˈanos
parasito	pˌarasˈito
pares	pˈares
patria	pˈatrja
perder	perdˈer
permittente	pˌermitˈente
physico	fˈisiko
plagias	plˈaʒas
plu	plˈu
pluvia	plˈuvja
politicos	polˈitikos
possessive	pˌosesˈive
posta	pˈosta
practicamente	prˌaktikamˈente
precipitation	prˌet͡sipˌitatjˈon
preda	prˈeda
preferentia	prˌeferˈentja
premios	prˈemjos
prepositiones	prˌepositjˈones
presentation	prˌesentatjˈon
preservation	prˌeservatjˈon
primates	primˈates
psychologia	psˌikoloɡˈia
publicitate	pˌublit͡sitˈate
qua	kwˈa
quaranta	kwarˈanta
racemo	rat͡sˈemo
rebelliones	rˌebeljˈones
recognition	rˌekoɡnitjˈon
redactor	rˌedaktˈor
representative	rˌepresˌentatˈive
republican	rˌepublikˈan
requireva	rˌekwirˈeva
resimila	rˌesimˈila
retorna	retˈorna
sacco	sˈako
sacrificio	sˌakrifˈit͡sjo
sclavitude	sklˌavitˈude
secta	sˈekta
sectores	sektˈores
secunda	sekˈunda
seliger	sˌeliɡˈer
semantic	semˈantik
senatores	sˌenatˈores
sentiva	sentˈiva
septime	sˈeptime
sever	sevˈer
show	ʃˈow
sine	sˈine
sovietic	sovjˈetik
spatios	spˈatjos
sperantia	sperˈantja
stellar	stelˈar
strato	strˈato
subgeneres	subɡˈeneres
substituite	sˌubstitwˈite
sulco	sˈulko
supervivente	sˌupervivˈente
tabulas	tˈabulas
taxa	tˈaksa
technologias	tˌeknoloɡˈias
tornado	tornˈado
touristas	turˈistas
traduce	tradˈut͡se
traffico	trˈafiko
traverso	travˈerso
u	ˈu
uncias	ˈunt͡sjas
valide	vˈalide
vegetation	vˌeɡetatjˈon
vel	vˈel
vestimentos	vˌestimˈentos
visitar	vˌisitˈar
visitate	vˌisitˈate
vocabulo	vokˈabulo
voto	vˈoto
Albert	albˈert
Arthur	artˈur
Austria	ˈawstrja
Aves	ˈaves
Bakunin	bˌakunˈin
Beatles	beˈatles
Belgica	βˈelɡika
Blue	blwˈe
Book	boˈok
Celsius	t͡sˈelsjus
Certe	t͡sˈerte
Ciceron	t͡sˌit͡serˈon
Congo	kˈoŋɡo
Consequentemente	kˌonsekwˌentemˈente
Constantino	kˌonstantˈino
Conte	kˈonte
Corona	korˈona
Cure	kˈure
Ecce	ˈet͡se
Ensemble	ansˈamble
Fide	fˈide
Foucault	fˌoukˈa͡ʊlt
Grammy	ɡrˈami
Institute	ˌinstitˈute
JSP	ʒˌotaˌespˈe
Jane	ʒˈane
Kinsey	kinsˈej
LHC	ˌelhˌasˈe
Lupin	lupˈin
Manuel	manwˈel
Mark	mˈark
Michel	mit͡ʃˈel
Microsoft	mˌikrosˈoft
Multes	mˈultes
Nascite	nast͡sˈite
Neubronner	nˌe͡ʊbronˈer
Nigre	nˈiɡre
Organisation	ˌorɡanˌisatjˈon
Pakistan	pˌakistˈan
Philippinas	fˌilipˈinas
Philippo	filˈipo
Pois	pˈois
Polo	pˈolo
Praga	prˈaɡa
Quanto	kwˈanto
Research	rˌeseˈart͡ʃ
Sede	sˈede
Street	streˈet
Systema	sistˈema
Textos	tˈekstos
Theatre	teˈatre
Traduction	trˌaduktjˈon
Vaticano	vˌatikˈano
Venetia	venˈetja
Vietnam	vjetnˈam
Vita	vˈita
Wilhelm	wilhˈelm
XVIII	dˈet͡seˈocto
Zag	zˈaɡ
Zig	zˈiɡ
absolutemente	ˌabsolˌutemˈente
accordos	akˈordos
addeva	adˈeva
adopta	adˈopta
adverbios	advˈerbjos
affecta	afˈekta
aggressive	ˌaɡresˈive
ambiental	ˌambjentˈal
amplitude	ˌamplitˈude
apparentemente	ˌaparˌentemˈente
apparite	ˌaparˈite
appartamento	ˌapartamˈento
apportava	ˌaportˈava
approbate	ˌaprobˈate
arabic	arˈabik
archeologic	ˌarkeolˈoɡik
argumentos	ˌarɡumˈentos
armenio	armˈenjo
assecurava	ˌasekurˈava
assisteva	ˌasistˈeva
audientia	a͡ʊdjˈentja
ballon	balˈon
bonasus	bonˈasus
canna	kˈana
cantator	kˌantatˈor
cantava	kantˈava
capturar	kˌapturˈar
cargas	kˈarɡas
celebrava	t͡sˌelebrˈava
centrate	t͡sentrˈate
ceremonia	t͡sˌeremonˈia
cholera	kˈolera
cinctura	t͡sinktˈura
circumferite	t͡sˌirkumferˈite
cives	t͡sˈives
clinic	klˈinik
codices	kˈodit͡ses
combinationes	kˌombinatjˈones
comedias	komˈedjas
comenciante	kˌoment͡sjˈante
commercialmente	kˌomert͡sjalmˈente
communismo	kˌomunˈismo
companiones	kˌompanjˈones
comparate	kˌomparˈate
computation	kˌomputatjˈon
concentrate	kˌont͡sentrˈate
conduce	kondˈut͡se
conducer	kˌondut͡sˈer
confession	kˌonfesjˈon
confrontar	kˌonfrontˈar
confusion	kˌonfusjˈon
conquirite	kˌoŋkwirˈite
conventiones	kˌonventjˈones
converter	kˌonvertˈer
corage	korˈaʒe
coronate	kˌoronˈate
cortes	kˈortes
cumulo	kˈumulo
cyclos	t͡sˈiklos
damno	dˈamno
decidite	dˌet͡sidˈite
defia	defˈia
definitiones	dˌefinitjˈones
definitive	dˌefinitˈive
definiva	dˌefinˈiva
dentes	dˈentes
deputatos	dˌeputˈatos
destino	destˈino
destruer	destrwˈer
dextera	dˈekstera
dialogos	djˈaloɡos
digito	dˈiɡito
discographic	dˌiskoɡrˈafik
discuter	dˌiskutˈer
divider	dˌividˈer
divideva	dˌividˈeva
durar	durˈar
educate	ˌedukˈate
egyptian	ˌeɡiptjˈan
emotional	ˌemotjonˈal
epic	ˈepik
equationes	ˌekwatjˈones
erronee	ˌeronˈee
escappar	ˌeskapˈar
estraniero	ˌestranjˈero
evolvite	ˌevolvˈite
exigeva	ˌeksiɡˈeva
expectate	ˌekspektˈate
experte	ekspˈerte
expone	ekspˈone
fabrication	fˌabrikatjˈon
facilitar	fˌat͡silitˈar
facultate	fˌakultˈate
felice	felˈit͡se
finales	finˈales
flores	flˈores
fluido	flˈuido
folklore	folklˈor
formulas	fˈormulas
forni	fˈorni
fossiles	fˈosiles
fresc	frˈesk
fugir	fuɡˈir
fundos	fˈundos
generar	ɡˌenerˈar
geometric	ɡˌeomˈetrik
goal	ɡˈol
habilitates	hˌabilitˈates
harmonia	hˌarmonˈia
hasardo	hasˈardo
hebree	hebrˈee
hereditava	hˌereditˈava
heterosexual	hˌeterˌosekswˈal
historiographia	hˌistorjˌoɡrafˈia
hollandese	hˌolandˈese
iconic	ikˈonik
immagazinage	ˌimaɡˌazinˈaʒe
immagazinate	ˌimaɡˌazinˈate
immense	imˈense
imposition	ˌimpositjˈon
incarcerate	ˌinkart͡serˈate
incorporava	ˌinkorporˈava
indicava	ˌindikˈava
indigenas	indˈiɡenas
industrias	indˈustrjas
intensitate	ˌintensitˈate
interactiones	ˌinteraktjˈones
involve	invˈolve
julian	ʒuljˈan
late	lˈate
liga	lˈiɡa
limita	limˈita
linear	lˌineˈar
listate	listˈate
literalmente	lˌiteralmˈente
litoral	lˌitorˈal
longeve	loŋɡˈeve
mandato	mandˈato
marcas	mˈarkas
membrana	membrˈana
messages	mesˈaʒes
mesurate	mˌesurˈate
millias	mˈiljas
miraculos	mirˈakulos
monachos	mˈonakos
mori	mˈori
motto	mˈoto
multos	mˈultos
museos	musˈeos
music	mˈusik
musulman	mˌusulmˈan
mythic	mˈitik
narrationes	nˌaratjˈones
naval	navˈal
necesse	net͡sˈese
neutre	nˈe͡ʊtre
nomination	nˌominatjˈon
notava	notˈava
occasionalmente	ˌokasjˌonalmˈente
officiero	ˌofit͡sjˈero
pacific	pat͡sˈifik
parentheses	parˈenteses
passages	pasˈaʒes
pectore	pˈektore
pedophilic	pˌedofˈilik
pellicula	pelˈikula
pensatores	pˌensatˈores
perditas	pˈerditas
persecution	pˌersekutjˈon
philosopho	philˈosofo
pilo	pˈilo
pionero	pjonˈero
pisces	pˈist͡ses
populose	pˌopulˈose
potential	pˌotentjˈal
potite	potˈite
predas	prˈedas
prediction	prˌediktjˈon
prefixate	prˌefiksˈate
preservar	prˌeservˈar
profunditate	prˌofunditˈate
programmatura	prˌoɡramatˈura
promitteva	prˌomitˈeva
promoveva	prˌomovˈeva
propaganda	prˌopaɡˈanda
proprietarios	prˌoprjetˈarjos
protocollo	prˌotokˈolo
protocollos	prˌotokˈolos
proximitate	prˌoksimitˈate
pullos	pˈulos
quartieros	kwartjˈeros
quicunque	kikˈunkwe
r	ˈer
radioamatorismo	rˌadjoˌamatorˈismo
rationamento	rˌatjonamˈento
recte	rˈekte
reduce	redˈut͡se
relationate	rˌelatjonˈate
remover	rˌemovˈer
rendite	rendˈite
reporto	repˈorto
resultar	rˌesultˈar
reteneva	rˌetenˈeva
reuniva	re͡ʊnˈiva
revelate	rˌevelˈate
revolutiones	rˌevolutjˈones
rhythmos	rˈitmos
rocca	rˈoka
rotation	rˌotatjˈon
rumine	rˈumine
salas	sˈalas
sanitari	sˌanitˈari
scuto	skˈuto
segmento	seɡmˈento
seligeva	sˌeliɡˈeva
sententia	sentˈentja
separatemente	sˌeparˌatemˈente
star	stˈar
stratos	strˈatos
subjecte	subʒˈekte
supernominate	sˌupernˌominˈate
sustene	sustˈene
syntactic	sintˈaktik
syntaxe	sintˈakse
tecto	tˈekto
telephono	telˈefono
traductor	trˌaduktˈor
transgenere	trˌansɡenˈere
ubicate	ˌubikˈate
ubique	ubˈikwe
umbra	ˈumbra
unification	ˌunifˌikatjˈon
unquam	ˈunkwam
utilisava	ˌutilisˈava
variabiles	varjˈabiles
variar	varjˈar
variation	vˌarjatjˈon
vendeva	vendˈeva
viagia	vjˈaɡja
victimas	vˈiktimas
vinceva	vint͡sˈeva
violente	vjolˈente
vital	vitˈal
voluntari	vˌoluntˈari
Agamemnon	ˌaɡamemnˈon
Alcunes	alkˈunes
Alcunos	alkˈunos
Alte	ˈalte
Andross	andrˈoss
Aristotele	ˌaristˈotele
Barcelona	bˌart͡selˈona
Blanc	blˈank
Bornholm	bornhˈolm
Canto	kˈanto
Cathedral	kˌatedrˈal
Collegio	kolˈeɡjo
Columbia	kolˈumbja
Credo	krˈedo
Debite	dˈebite
Dido	dˈido
Dominica	domˈinika
Donald	donˈald
Donatello	dˌonatˈelo
Ecclesias	eklˈesjas
Engels	eŋɡˈels
Enrique	enrˈikwe
Entertainment	ˌenterta͡ɪnmˈent
Equalmente	ˌekwalmˈente
Fiume	fjˈume
Gaio	ɡˈa͡ɪo
Georgia	ɡeˈorɡja
Gode	ɡˈode
Gregorio	ɡreɡˈorjo
Heleno	helˈeno
Hidalgo	hidˈalɡo
Human	humˈan
Introduction	ˌintroduktjˈon
Johan	ʒohˈan
Johann	ʒohˈan
Kazakhstan	kˌazakhstˈan
Kennedy	kenˈedi
Libano	ɫˈibano
Madagascar	mˌadaɡaskˈar
Membros	mˈembros
Menelao	mˌenelˈao
Messia	mesˈia
Ministerio	mˌinistˈerjo
Montreal	mˌontreˈal
Nam	nˈam
Nova	nˈova
O	ˈo
Orleans	ˌorleˈans
Paz	pˈaz
Penelope	pˌenelˈope
Pilato	pilˈato
Qui	kˈi
RFCs	ˌeɹˌefsˌeˈes
Russe	rˈuse
Sapir	sapˈir
Sayyid	sajjˈid
Software	sˈoftware
Tempore	tˈempore
Testes	tˈestes
Texas	tˈeksas
Top	tˈop
Trek	trˈek
Tudor	tudˈor
Tunc	tˈunk
Typicamente	tˌipikamˈente
Valle	vˈale
XI	dˈet͡seun
acceder	ˌat͡sedˈer
accentuate	ˌat͡sentwˈate
accordate	ˌakordˈate
acidos	ˈat͡sidos
acquireva	ˌakkwirˈeva
acquisition	ˌakkwisitjˈon
administrate	ˌadministrˈate
adolescentia	ˌadolest͡sˈentja
alcohol	ˌalkohˈol
algebra	ˈalɡebra
aliquando	ˌalikwˈando
altera	altˈera
anniversario	ˌaniversˈarjo
antennas	antˈenas
anthropologia	ˌantropˌoloɡˈia
aperi	apˈeri
apostolos	apˈostolos
appoiate	ˌapo͡ɪˈate
aquelle	akwˈele
as	ˈas
assalto	asˈalto
astronomos	astrˈonomos
attachate	ˌatat͡ʃˈate
aun	ˈa͡ʊn
autumno	a͡ʊtˈumno
avantages	ˌavantˈaʒes
avantia	avˈantja
banca	bˈanka
becco	bˈeko
bibliothecas	bˌibljotˈekas
bosco	bˈosko
cambiamentos	kˌambjamˈentos
canta	kˈanta
capitano	kˌapitˈano
captivitate	kˌaptivitˈate
catholicismo	kˌatolit͡sˈismo
caudas	kˈa͡ʊdas
causante	ka͡ʊsˈante
christiano	kristjˈano
chronic	krˈonik
classificar	klˌasifikˈar
clientes	kljˈentes
colonisation	kˌolonˌisatjˈon
compacte	kompˈakte
complimento	kˌomplimˈento
conditional	kˌonditjonˈal
confundite	kˌonfundˈite
connecte	konˈekte
conquirer	kˌoŋkwirˈer
conservar	kˌonservˈar
contextos	kontˈekstos
contrari	kontrˈari
conventional	kˌonventjonˈal
conversation	kˌonversatjˈon
coperir	kˌoperˈir
cordes	kˈordes
coronas	korˈonas
corporal	kˌorporˈal
correctemente	kˌorektemˈente
cortice	kˈortit͡se
crescentia	krest͡sˈentja
crescite	krest͡sˈite
criminal	krˌiminˈal
cruce	krˈut͡se
crusta	krˈusta
cyclones	t͡siklˈones
debattos	debˈatos
declarationes	dˌeklaratjˈones
defendeva	dˌefendˈeva
depingite	dˌepiŋɡˈite
derivar	dˌerivˈar
designator	dˌesiɡnatˈor
destructive	dˌestruktˈive
dextra	dˈekstra
diabolo	djˈabolo
diagramma	djaɡrˈama
dicte	dˈikte
differentemente	dˌiferˌentemˈente
diffundite	dˌifundˈite
discute	diskˈute
disparition	dˌisparitjˈon
dispositiones	dˌispositjˈones
disputas	dispˈutas
distacca	distˈaka
districtos	distrˈiktos
dominica	domˈinika
dos	dˈos
editores	ˌeditˈores
eliger	ˌeliɡˈer
equation	ˌekwatjˈon
esque	ˈeske
eucaryotes	ˌe͡ʊkarjˈotes
expeditiones	ˌekspeditjˈones
fabricate	fˌabrikˈate
facte	fˈakte
fiasco	fjˈasko
fictional	fˌiktjonˈal
fixar	fiksˈar
flechas	flˈeʃas
fora	fˈora
formula	fˈormula
fornite	fornˈite
forrage	forˈaʒe
fortuna	fortˈuna
fugiva	fuɡˈiva
fundamento	fˌundamˈento
galleco	ɡalˈeko
ganiator	ɡˌanjatˈor
generate	ɡˌenerˈate
germanos	ɡermˈanos
gigantes	ɡiɡˈantes
governamental	ɡˌovernˌamentˈal
grammatical	ɡrˌamatikˈal
haver	havˈer
hemispherio	hˌemisfˈerjo
hereditage	hˌereditˈaʒe
hierarchia	hjˌerarkˈia
homosexualitate	hˌomosˌekswalitˈate
horologios	hˌorolˈoɡjos
identification	ˌidentˌifikatjˈon
implementation	ˌimplemˌentatjˈon
imponeva	ˌimponˈeva
imponite	ˌimponˈite
incerte	int͡sˈerte
incomplete	ˌinkomplˈete
incontrar	ˌinkontrˈar
incontrate	ˌinkontrˈate
incorrecte	ˌinkorˈekte
inducite	ˌindut͡sˈite
induction	ˌinduktjˈon
inflation	ˌinflatjˈon
informal	ˌinformˈal
insular	ˌinsulˈar
integremente	ˌinteɡremˈente
intendeva	ˌintendˈeva
interviews	ˈinterviws
introduce	ˌintrodˈut͡se
inventor	ˌinventˈor
istas	ˈistas
judices	ʒˈudit͡ses
juncto	ʒˈunkto
lacos	lˈakos
lateres	lˈateres
lexical	lˌeksikˈal
limitationes	lˌimitatjˈones
localisate	lˌokalisˈate
localitate	lˌokalitˈate
magia	maɡˈia
mangia	mˈaŋɡja
mappas	mˈapas
martial	martjˈal
mediterranee	mˌeditˌeranˈee
meliorava	mˌeljorˈava
metro	mˈetro
modification	mˌodifˌikatjˈon
molecular	mˌolekulˈar
monetari	mˌonetˈari
montante	montˈante
mortos	mˈortos
mostra	mˈostra
mythologic	mˌitolˈoɡik
naturalistic	nˌaturalˈistik
necessitates	nˌet͡sesitˈates
necuno	nekˈuno
nervose	nervˈose
norvegian	nˌorveɡjˈan
notitias	notˈitjas
obscuritate	ˌobskuritˈate
octave	oktˈave
offensive	ˌofensˈive
offerer	ˌoferˈer
orchestra	ort͡ʃˈestra
origina	ˌoriɡˈina
pariete	parjˈete
participante	pˌartit͡sipˈante
particula	partˈikula
passageros	pˌasaʒˈeros
patres	pˈatres
patrimonio	pˌatrimˈonjo
perde	pˈerde
phantastic	fantˈastik
placiava	plat͡sjˈava
plagia	plˈaʒa
plures	plˈures
pms	pˌeˌemˈes
potera	potˈera
predecessor	prˌedet͡sesˈor
preservate	prˌeservˈate
prestigio	prestˈiɡjo
primes	prˈimes
privilegios	prˌivilˈeɡjos
procede	prot͡sˈede
productive	prˌoduktˈive
professores	prˌofesˈores
programmatores	prˌoɡramatˈores
prole	prˈole
prophetia	prˌofetˈia
prototypo	protˈotipo
provate	provˈate
proveniente	prˌovenjˈente
purmente	purmˈente
rata	rˈata
reguardo	reɡwˈardo
remarcabile	rˌemarkˈabile
requesta	rekwˈesta
requestas	rekwˈestas
resolvite	rˌesolvˈite
respectar	rˌespektˈar
reuni	rˈe͡ʊni
revolutionari	rˌevolˌutjonˈari
rival	rivˈal
rosate	rosˈate
russo	rˈuso
sacerdote	sˌat͡serdˈote
sacramentos	sˌakramˈentos
sal	sˈal
salute	salˈute
sanctos	sˈanktos
satellites	satˈelites
scepticismo	st͡sˌeptit͡sˈismo
sculptura	skulptˈura
selectionate	sˌelektjonˈate
semines	sˈemines
separa	sepˈara
separava	sˌeparˈava
septentrional	sˌeptentrjonˈal
sexanta	seksˈanta
sexte	sˈekste
sicut	sˈikut
single	sˈiŋɡle
solitari	sˌolitˈari
sonava	sonˈava
specialistas	spˌet͡sjalˈistas
stabilite	stˌabilˈite
stadios	stˈadjos
statistica	statˈistika
structural	strˌukturˈal
suggerite	sˌuɡerˈite
superar	sˌuperˈar
superate	sˌuperˈate
synonymo	sinˈonimo
tan	tˈan
tango	tˈaŋɡo
technologic	tˌeknolˈoɡik
tensiones	tensjˈones
tenue	tˈenwe
terminar	tˌerminˈar
testimonio	tˌestimˈonjo
touristic	turˈistik
traciar	trat͡sjˈar
tractamentos	trˌaktamˈentos
traductores	trˌaduktˈores
transformava	trˌansformˈava
tumba	tˈumba
uni	ˈuni
unificate	ˌunifikˈate
uniforme	ˌunifˈorme
unir	unˈir
vapor	vapˈor
vehiculos	vehˈikulos
velocitates	vˌelot͡sitˈates
vendita	vˈendita
vengiantia	venʒˈantja
verme	vˈerme
viagiava	vjaɡjˈava
viro	vˈiro
visitas	visˈitas
voluntarios	vˌoluntˈarjos
ya	jˈa
Aeroporto	ˌaeropˈorto
Aires	ˈa͡ɪres
Alba	ˈalba
Alteremente	ˌalteremˈente
Alteres	ˈalteres
Andersen	ˌandersˈen
Apollo	apˈolo
Armstrong	armstrˈoŋɡ
Arte	ˈarte
Atlantico	atlˈantiko
Auro	ˈa͡ʊro
Bismarck	bismˈarkk
Boston	bostˈon
Buddhismo	budhˈismo
Buenos	bwˈenos
Bulgaria	bulɡˈarja
Carlos	kˈarlos
Chicago	t͡ʃikˈaɡo
Ci	t͡sˈi
Civil	t͡sivˈil
Compania	kˌompanˈia
Corporation	kˌorporatjˈon
Creta	krˈeta
Cromwell	kromwˈel
Day	dˈaj
Declaration	dˌeklaratjˈon
Der	dˈer
Dewey	dewˈej
Dictionary	dˌiktjonˈari
Equus	ˈekwus
Esque	ˈeske
Football	futbˈol
Gallecia	ɡalˈet͡sja
Gilbert	ɡilbˈert
Google	ɡoˈoɡle
Grec	ɡrˈek
Groningen	ɡrˌoniŋɡˈen
Ha	hˈa
Hector	hektˈor
Historias	histˈorjas
Hogwarts	hoɡwˈarts
Hollanda	holˈanda
Huygens	hujɡˈens
ILGA	ˈilɡa
IP	ˈip
Indonesia	ˌindonˈesja
Jan	ʒˈan
Jocos	ʒˈokos
Jones	ʒˈones
Julia	ʒˈulja
Julietta	ʒuljˈeta
Laco	lˈako
Lancaster	lˌankastˈer
Las	lˈas
Latio	lˈatjo
Linnaeus	linˈae͡ʊs
Lu	lˈu
Macedonia	mˌat͡sedˈonja
Magazine	mˌaɡazˈin
Magnus	mˈaɡnus
Manila	manˈila
Mappa	mˈapa
Maurice	ma͡ʊrˈit͡se
Media	mˈedja
Minnesota	mˌinesˈota
Naruto	narˈuto
Ni	nˈi
Nicolas	nikˈolas
Normandia	ŋˌormandˈia
North	nˈort
Olympic	olˈimpik
PM	pˌeˈem
Pablo	pˈablo
Pacioli	pat͡sjˈoli
Parolas	parˈolas
Patroclo	patrˈoklo
Pauc	pˈawk
Peru	perˈu
Piaget	pjaɡˈet
Piro	pˈiro
Pythagoras	pitˈaɡoras
Recerca	ret͡sˈerka
Republican	rˌepublikˈan
Roger	roɡˈer
Saturno	satˈurno
Science	st͡sjˈent͡se
Solo	sˈolo
Sture	stˈure
Taiwan	ta͡ɪwˈan
Tractatos	traktˈatos
Turchia	θurkˈia
Uno	ˈuno
Usualmente	ˌuswalmˈente
Utah	utˈah
Verso	vˈerso
White	whˈite
Wikidata	wˌikidˈata
Wujek	wuʒˈek
XIII	dˈet͡setres
XV	dˈet͡set͡sˈinkwe
Xenophon	ksˌenofˈon
You	jˈou
abandonate	ˌabandonˈate
abundantia	ˌabundˈantja
abusos	abˈusos
accentos	at͡sˈentos
accentua	at͡sˈentwa
accessibile	ˌakt͡sesˈibile
adverbio	advˈerbjo
affin	afˈin
alicuno	ˌalikˈuno
alie	ˈalje
alimenta	ˌalimˈenta
alimentar	ˌalimentˈar
alterate	ˌalterˈate
amante	amˈante
amica	amˈika
anatomic	ˌanatˈomik
angelo	ˈanɡelo
annuncia	anˈunt͡sja
anteriormente	ˌanterjormˈente
apportar	ˌaportˈar
apportate	ˌaportˈate
appunctate	ˌapunktˈate
apte	ˈapte
aquatic	akwˈatik
archaic	arkˈaik
argumento	ˌarɡumˈento
articulation	ˌartikˌulatjˈon
assassinato	ˌasasinˈato
assereva	ˌaserˈeva
assimilation	ˌasimˌilatjˈon
assumer	ˌasumˈer
atheismo	atˈe͡ɪsmo
audite	a͡ʊdˈite
augmentate	ˌa͡ʊɡmentˈate
aventuras	ˌaventˈuras
biographia	bjˌoɡrafˈia
biologia	bjˌoloɡˈia
bobina	bobˈina
boxa	bˈoksa
boxer	bˈokser
brasilianos	brˌasiljˈanos
cader	kadˈer
calefaction	kˌalefaktjˈon
cantatores	kˌantatˈores
cantatrice	kˌantatrˈit͡se
car	kˈar
catalogo	katˈaloɡo
celebra	t͡selˈebra
centra	t͡sˈentra
certemente	t͡sˌertemˈente
certo	t͡sˈerto
cessa	t͡sˈesa
chassatores	t͡ʃˌasatˈores
cinquanta	t͡siŋkwˈanta
civilisationes	t͡sˌivilˌisatjˈones
classifica	klasˈifika
cliente	kljˈente
climatic	klimˈatik
cognoscentias	kˌoɡnost͡sˈentjas
collaborava	kˌolaborˈava
columnas	kolˈumnas
comedia	komˈedja
compara	kompˈara
competentias	kˌompetˈentjas
compilate	kˌompilˈate
completate	kˌompletˈate
complir	komplˈir
compliva	komplˈiva
concedite	kˌont͡sedˈite
condemnation	kˌondemnatjˈon
consentite	kˌonsentˈite
constructiones	kˌonstruktjˈones
construe	kˈonstrwe
contatos	kontˈatos
continentes	kˌontinˈentes
continer	kˌontinˈer
continuemente	kˌontinwemˈente
contribution	kˌontributjˈon
control	kontrˈol
controlava	kˌontrolˈava
copula	kˈopula
corda	kˈorda
coxa	kˈoksa
criticava	krˌitikˈava
cruciate	krut͡sjˈate
culpa	kˈulpa
declination	dˌeklinatjˈon
defensores	dˌefensˈores
demonstrava	dˌemonstrˈava
dependentia	dˌependˈentja
designava	dˌesiɡnˈava
desirate	dˌesirˈate
dextere	dˈekstere
dialectal	djˌalektˈal
diaphragma	djafrˈaɡma
digne	dˈiɡne
dignitate	dˌiɡnitˈate
diminue	dimˈinwe
diminuer	dˌiminwˈer
diplomatic	dˌiplomˈatik
disparite	dˌisparˈite
distaccate	dˌistakˈate
distribuer	dˌistribwˈer
disveloppamentos	dˌisvelˌopamˈentos
divinitate	dˌivinitˈate
documentari	dˌokumentˈari
dollares	dolˈares
dono	dˈono
donos	dˈonos
ducite	dut͡sˈite
durabile	durˈabile
educational	ˌedukˌatjonˈal
elastic	elˈastik
electe	elˈekte
electron	ˌelektrˈon
emotiones	ˌemotjˈones
encyclopedia	ˌent͡siklˌopedˈia
equalitate	ˌekwalitˈate
equipage	ˌekwipˈaʒe
erigite	ˌeriɡˈite
erosion	ˌerosjˈon
essayate	ˌesajˈate
ethic	ˈetik
etiquetta	ˌetikˈeta
etymologic	ˌetimolˈoɡik
excludite	ˌekskludˈite
existite	ˌeksistˈite
experimentation	ˌeksperˌimentatjˈon
experimentava	ˌeksperˌimentˈava
explora	eksplˈora
extremitate	ˌekstremitˈate
facilitates	fˌat͡silitˈates
falcon	falkˈon
falleva	falˈeva
fame	fˈame
favorite	fˌavorˈite
flexibile	fleksˈibile
focar	fokˈar
folk	fˈolk
fornir	fornˈir
fortalessas	fˌortalˈesas
frigido	frˈiɡido
fundamentos	fˌundamˈentos
galaxia	ɡalˈaksja
gamba	ɡˈamba
glacial	ɡlat͡sjˈal
glandulas	ɡlˈandulas
governa	ɡovˈerna
grandemente	ɡrˌandemˈente
grano	ɡrˈano
graphic	ɡrˈafik
gravitate	ɡrˌavitˈate
gravitational	ɡrˌavitˌatjonˈal
grosse	ɡrˈose
hellenistic	hˌelenˈistik
hereditari	hˌereditˈari
hindu	hindˈu
historietta	hˌistorjˈeta
honorari	hˌonorˈari
honores	honˈores
hypothetic	hˌipotˈetik
illustrate	ˌilustrˈate
imperatores	ˌimperatˈores
implicate	ˌimplikˈate
incarnation	ˌinkarnatjˈon
infectate	ˌinfektˈate
infectiones	ˌinfektjˈones
infinitivo	ˌinfinitˈivo
influentiar	ˌinflwentjˈar
inimico	ˌinimˈiko
insectos	insˈektos
instabilitate	ˌinstabˌilitˈate
instantanee	ˌinstantanˈee
insulina	ˌinsulˈina
intentiones	ˌintentjˈones
interpreta	ˌinterprˈeta
interpretar	ˌinterpretˈar
intervallo	ˌintervˈalo
inundation	ˌinundatjˈon
inventava	ˌinventˈava
jardin	ʒardˈin
judicate	ʒˌudikˈate
largor	larɡˈor
lequales	lekwˈales
lettera	letˈera
liturgic	litˈurɡik
locationes	lˌokatjˈones
loyal	lojˈal
mandate	mandˈate
mangiate	maŋɡjˈate
manifestava	mˌanifestˈava
manipulation	mˌanipˌulatjˈon
manuscripto	mˌanuskrˈipto
mares	mˈares
margine	mˈarɡine
marineros	mˌarinˈeros
marito	marˈito
mata	mˈata
materias	matˈerjas
medalia	medˈalja
medievo	medjˈevo
meliorate	mˌeljorˈate
mer	mˈer
mesurar	mˌesurˈar
mina	mˈina
minas	mˈinas
monastic	monˈastik
morphologia	mˌorfoloɡˈia
municipios	mˌunit͡sˈipjos
mutual	mutwˈal
mystic	mˈistik
ne	nˈe
nervos	nˈervos
nodos	nˈodos
nominal	nˌominˈal
normanne	normˈane
normative	nˌormatˈive
notabilemente	nˌotabˌilemˈente
obedientia	ˌobedjˈentja
obvie	ˈobvje
oceanic	ˌot͡seˈanik
offerite	ˌoferˈite
omaso	omˈaso
opportunitate	ˌoportˌunitˈate
orange	orˈanʒe
oration	ˌoratjˈon
organisava	ˌorɡanisˈava
originari	ˌoriɡinˈari
originate	ˌoriɡinˈate
oves	ˈoves
pagate	paɡˈate
pannello	panˈelo
parietes	parjˈetes
participate	pˌartit͡sipˈate
partisanos	pˌartisˈanos
patente	patˈente
paupere	pˈawpere
periodico	perjˈodiko
personalitates	pˌersonˌalitˈates
pesa	pˈesa
pete	pˈete
petroglyphos	petrˈoɡlifos
physicamente	fˌisikamˈente
pisca	pˈiska
plana	plˈana
politicamente	pˌolitˌikamˈente
portraits	portrˈes
posseder	pˌosedˈer
prece	prˈet͡se
precisemente	prˌet͡sisemˈente
predecessores	prˌedet͡sesˈores
predication	prˌedikatjˈon
prestigiose	prˌestiɡjˈose
prevention	prˌeventjˈon
priones	prjˈones
productivitate	prˌoduktˌivitˈate
prohibition	prˌohibitjˈon
promissa	promˈisa
pronuncia	pronˈunt͡sja
proportion	prˌoportjˈon
proportiones	prˌoportjˈones
propriemente	prˌoprjemˈente
psychiatria	psˌikjatrˈia
pulmonar	pˌulmonˈar
qualificate	kwˌalifikˈate
quante	kwˈante
quarto	kwˈarto
rangos	rˈaŋɡos
ratto	rˈato
receptas	ret͡sˈeptas
recognoscibile	rˌekoɡnost͡sˈibile
recommenda	rˌekomˈenda
recursos	rekˈursos
reflexion	rˌefleksjˈon
reger	reɡˈer
registros	reɡˈistros
regite	reɡˈite
rejection	rˌeʒektjˈon
relievo	reljˈevo
repasto	repˈasto
republicas	repˈublikas
reside	resˈide
restante	restˈante
retirar	rˌetirˈar
retirate	rˌetirˈate
rigide	rˈiɡide
roccas	rˈokas
ronde	rˈonde
rota	rˈota
rotante	rotˈante
ruptura	ruptˈura
sacrificios	sˌakrifˈit͡sjos
scenario	st͡senˈarjo
schemas	st͡ʃˈemas
segmentos	seɡmˈentos
sentir	sentˈir
separar	sˌeparˈar
servitores	sˌervitˈores
sexos	sˈeksos
sexualmente	sˌekswalmˈente
signala	siɡnˈala
silva	sˈilva
similaritates	sˌimilˌaritˈates
simultanee	sˌimultanˈee
situa	sˈitwa
slavos	slˈavos
soveranitate	sˌoverˌanitˈate
stadio	stˈadjo
standardisate	stˌandardisˈate
statistic	statˈistik
statuas	stˈatwas
subinde	subˈinde
subjectos	subʒˈektos
supertoto	sˌupertˈoto
supervivite	sˌupervivˈite
supportava	sˌuportˈava
suppression	sˌupresjˈon
surprisa	surprˈisa
synthetic	sintˈetik
tagalog	tˌaɡalˈoɡ
tales	tˈales
tardive	tardˈive
tempos	tˈempos
terminationes	tˌerminatjˈones
testamento	tˌestamˈento
textual	tekstwˈal
titular	tˌitulˈar
trainamento	trˌa͡ɪnamˈento
transmitter	trˌansmitˈer
triangulo	trjˈanɡulo
tribo	trˈibo
tubos	tˈubos
und	ˈund
usabile	usˈabile
validitate	vˌaliditˈate
veniente	venjˈente
venita	venˈita
vicinos	vit͡sˈinos
vincite	vint͡sˈite
viros	vˈiros
