di	dˈi
e	ˈe
cu	kˈu
ta	tˈa
a	ˈa
pa	pˈa
y	iɡrˈɛk
un	ˈuŋ
na	nˈa
den	dˈeŋ
nan	nˈaŋ
tin	tˈiŋ
no	nˈo
Aruba	arˈuba
por	pˈor
lo	lˈo
aki	ˈaki
nos	nˈos
E	ˈe
riba	rˈiba
su	sˈu
mas	mˈas
tabata	tabˈata
tur	tˈur
mester	mestˈer
bay	bˈaj
wordo	wˈordo
tambe	tˈambe
haci	hˈasi
esaki	esˈaki
haya	hˈaja
hopi	hˈopi
pero	pˈero
otro	ˈotro
keda	kˈeda
hende	hˈende
bo	bˈo
of	ˈof
asina	asˈina
aña	ˈaɲa
persona	persˈona
mes	mˈes
duna	dˈuna
si	sˈi
tuma	tˈuma
sigui	sˈiɡj
como	kˈomo
bisa	bˈisa
ora	ˈora
pasa	pˈasa
Minister	ministˈer
bin	bˈiŋ
for	fˈor
ORANJESTAD	oranjestˈad
AAN	ˈaːŋ
dia	djˈa
nobo	nˈobo
Na	nˈa
yega	jˈeɡa
caso	kˈaso
manera	manˈera
Hulanda	hulˈanda
kier	kjˈer
Gobierno	ɡobjˈerno
prome	prˈome
loke	lˈoke
unda	ˈunda
cas	kˈas
el	ˈel
Pa	pˈa
pais	pˈa͡ɪs
grandi	ɡrˈandi
situacion	sitwasjˈoŋ
drenta	drˈenta
caminda	kamˈinda
momento	momˈento
Esaki	esˈaki
Den	dˈeŋ
bon	bˈoŋ
cual	kwˈal
forma	fˈorma
traha	trˈaha
bira	bˈira
te	tˈe
parti	pˈarti
Ta	tˈa
gobierno	ɡobjˈerno
dos	dˈos
mira	mˈira
Nos	nˈos
Un	ˈuŋ
durante	durˈante
despues	despwˈes
pone	pˈone
con	kˈoŋ
diferente	diferˈente
pasobra	pasˈobra
siman	simˈaŋ
pueblo	pwˈeblo
sin	sˈiŋ
caba	kˈaba
entre	ˈentre
polis	polˈis
awor	awˈor
anochi	anˈot͡ʃi
yuda	jˈuda
biaha	bjˈaha
cuminsa	kumˈinsa
sa	sˈa
importante	importˈante
Polis	polˈis
tempo	tˈempo
El	ˈel
informacion	informasjˈoŋ
trata	trˈata
presenta	presˈenta
habri	hˈabri
Parlamento	parlamˈento
mundo	mˈundo
comunidad	komunidˈad
auto	aˈuto
sitio	sˈitjo
pidi	pˈidi
luna	lˈuna
esnan	ˈesnan
algun	alɡˈuŋ
placa	plˈaka
segun	seɡˈuŋ
ainda	ˈa͡ɪnda
esey	esˈej
mustra	mˈustra
dilanti	dilˈanti
mi	mˈi
problema	problˈema
ricibi	risˈibi
tene	tˈene
crisis	krisˈis
Croes	krˈus
DIARIO	djˈarjo
splica	splˈika
paga	pˈaɡa
A	ˈa
indica	indˈika
ya	jˈa
Pero	pˈero
logra	lˈoɡra
mainta	mˈa͡ɪnta
hunto	hˈunto
mucha	mˈut͡ʃa
door	dˈoːr
sali	sˈali
kico	kˈiko
ley	lˈej
atende	atˈende
contra	kˈontra
trece	trˈese
total	totˈal
papia	pˈapja
cada	kˈada
Prome	prˈome
ultimo	ultˈimo
lugar	luɡˈar
cantidad	kantidˈad
motibo	motˈibo
Si	sˈi
mesora	mesˈora
financiero	finansjˈero
yama	jˈama
grupo	ɡrˈupo
informa	infˈorma
conoce	konˈose
ningun	ninɡˈuŋ
ey	ˈej
entrega	entrˈeɡa
banda	bˈanda
publico	publˈiko
algo	ˈalɡo
patruya	patrˈuja
bek	bˈek
sigur	siɡˈur
famia	fˈamja
para	pˈara
homber	hombˈer
scol	skˈol
laga	lˈaɡa
awe	ˈawe
casonan	kasˈonan
varios	varjˈos
dirigi	dirˈixi
trabao	trabˈao
via	vjˈa
trabou	trabˈow
busca	bˈuska
tanto	tˈanto
cumpli	kˈumpli
solamente	solamˈente
test	tˈest
personanan	personˈanan
de	dˈe
cuenta	kwˈenta
economia	ekonˈomja
cera	sˈera
Nan	nˈaŋ
baha	bˈaha
cos	kˈos
Segun	seɡˈuŋ
Departamento	departamˈento
base	bˈase
Tambe	tˈambe
compania	kompˈanja
virus	virˈus
muchanan	mut͡ʃˈanan
dicidi	disˈidi
No	nˈo
ser	sˈer
informe	infˈorme
bida	bˈida
positivo	positˈivo
Tur	tˈur
wak	wˈak
man	mˈaŋ
Hues	hwˈes
entrada	entrˈada
miyon	mijˈoŋ
social	sosjˈal
Ministro	minˈistro
nota	nˈota
Hulandes	hulandˈes
posibel	posibˈel
manda	mˈanda
salud	salˈud
Tin	tˈiŋ
proyecto	projˈekto
Maduro	madˈuro
hasta	hˈasta
maneho	manˈeho
menos	menˈos
ni	nˈi
Merca	mˈerka
necesario	nesesˈarjo
cuido	kˈujdo
mesun	mesˈuŋ
en	ˈeŋ
Reino	rˈe͡ɪno
acuerdo	akwˈerdo
bishita	biʃˈita
crea	krˈea
servicio	servˈisjo
personal	personˈal
dje	d͡ʒˈe
prensa	prˈensa
conoci	konˈosi
mantene	mantˈene
reunion	rewnjˈoŋ
minister	ministˈer
Y	iɡrˈɛk
futuro	futˈuro
menciona	mensjˈona
local	lokˈal
luga	lˈuɡa
rond	rˈond
basta	bˈasta
Mike	mˈike
AZV	ˈazv
proceso	prosˈeso
hendenan	hendˈenan
Cu	kˈu
caya	kˈaja
registra	rexˈistra
evita	evˈita
spera	spˈera
coronavirus	koronavirˈus
cay	kˈaj
bou	bˈow
accidente	aksidˈente
Evelyn	evelˈiŋ
economico	ekonomˈiko
florin	florˈiŋ
dal	dˈal
mandatario	mandatˈarjo
yegada	jeɡˈada
isla	ˈisla
debi	dˈebi
henter	hentˈer
cambia	kˈambja
prepara	prepˈara
medidanan	medidˈanan
nada	nˈada
AVP	ˈavp
Durante	durˈante
investigacion	investiɡasjˈoŋ
pandemia	pandˈemja
medico	medˈiko
semper	sempˈer
tabatin	tabatˈiŋ
Despues	despwˈes
politico	politˈiko
chauffeur	t͡ʃauffˈewr
uza	ˈuza
Oduber	odubˈer
dificil	difisˈil
sistema	sistˈema
cuminza	kumˈinza
Diabierna	djabjˈerna
cla	klˈa
brinda	brˈinda
subi	sˈubi
tereno	terˈeno
Nicolas	nikolˈas
poco	pˈoko
mientras	mjentrˈas
tres	trˈes
Pues	pwˈes
compronde	komprˈonde
halto	hˈalto
awa	ˈawa
Dialuna	djalˈuna
conta	kˈonta
cambio	kˈambjo
cerca	sˈerka
causa	kaˈusa
Publico	publˈiko
fin	fˈiŋ
dama	dˈama
hospital	hospitˈal
locual	lokwˈal
contacto	kontˈakto
sector	sektˈor
uno	ˈuno
Esey	esˈej
Ora	ˈora
decision	desisjˈoŋ
biba	bˈiba
atardi	atˈardi
Por	pˈor
turismo	turˈismo
perde	pˈerde
relaciona	relasjˈona
herida	herˈida
core	kˈore
expresa	eksprˈesa
negoshi	neɡˈoʃi
warda	wˈarda
Hospital	hospitˈal
Parlamentario	parlamentˈarjo
control	kontrˈol
medio	mˈedjo
Di	dˈi
detene	detˈene
Eman	emˈaŋ
topa	tˈopa
area	arˈea
Fiscal	fiskˈal
anuncia	anˈunsja
resultado	resultˈado
saca	sˈaka
afecta	afˈekta
mundial	mundjˈal
San	sˈaŋ
candela	kandˈela
percura	perkˈura
desaroyo	desarˈojo
Venezuela	venezwˈela
hiba	hˈiba
serio	sˈerjo
sosten	sostˈeŋ
ehempel	ehempˈel
ayudo	ajˈudo
DVG	dˌevˌeɡˈe
cliente	kljˈente
Diahuebs	djahwˈebs
paisnan	pˈa͡ɪsnan
exigi	eksˈixi
momentonan	momentˈonan
edad	edˈad
pregunta	preɡˈunta
final	finˈal
peticion	petisjˈoŋ
van	vˈaŋ
Diasabra	djasˈabra
sosode	sosˈode
nifica	nifˈika
reglanan	reɡlˈanan
pago	pˈaɡo
atencion	atensjˈoŋ
actual	aktwˈal
ariba	arˈiba
partido	partˈido
Mi	mˈi
bini	bˈini
chikito	t͡ʃikˈito
internacional	internasjonˈal
desde	dˈesde
oportunidad	oportunidˈad
pues	pwˈes
conferencia	konferˈensja
punto	pˈunto
bolbe	bˈolbe
introduci	introdˈusi
bao	bˈao
plan	plˈaŋ
permiti	permˈiti
aworaki	aworˈaki
esta	ˈesta
remarca	remˈarka
cierto	sjˈerto
programa	proɡrˈama
controla	kontrˈola
Awe	ˈawe
Ministerio	ministˈerjo
purba	pˈurba
pashent	paʃˈent
salario	salˈarjo
fuerte	fwˈerte
meta	mˈeta
sumamente	sumamˈente
berdad	berdˈad
kende	kˈende
medida	medˈida
Diamars	djamˈars
companianan	kompanjˈanan
nomber	nombˈer
gastonan	ɡastˈonan
dianan	djˈanan
Coronavirus	koronavirˈus
so	sˈo
trahando	trahˈando
cune	kˈune
pensa	pˈensa
Presidente	presidˈente
hecho	hˈet͡ʃo
hoben	hobˈeŋ
Riba	rˈiba
Diadomingo	djadomˈinɡo
Salud	salˈud
firma	fˈirma
sinti	sˈinti
nunca	nˈunka
turista	turˈista
nivel	nivˈel
cualkier	kwalkjˈer
sr	ˌɛsˈɛr
number	numbˈer
tocante	tokˈante
Awor	awˈor
yiu	jjˈu
Caribe	karˈibe
esun	esˈuŋ
periodo	perjˈodo
kere	kˈere
sinta	sˈinta
miembronan	mjembrˈonan
tipo	tˈipo
atrobe	atrˈobe
realidad	realidˈad
resulta	resˈulta
cumpra	kˈumpra
prueba	prwˈeba
general	xenerˈal
activo	aktˈivo
cuminda	kumˈinda
interes	interˈes
mirando	mirˈando
Manera	manˈera
departamento	departamˈento
temporada	temporˈada
Citgo	sˈitɡo
impacto	impˈakto
tawata	tawˈata
team	teˈam
ofrece	ofrˈese
participa	partisˈipa
regla	rˈeɡla
Asina	asˈina
largo	lˈarɡo
porta	pˈorta
kibra	kˈibra
pasando	pasˈando
palabra	palˈabra
duro	dˈuro
presente	presˈente
Mester	mestˈer
yena	jˈena
desea	desˈea
Pesey	pesˈej
tras	trˈas
contesta	kontˈesta
bienestar	bjenestˈar
propio	prˈopjo
malesa	malˈesa
miembro	mjˈembro
carta	kˈarta
online	onlˈine
Florin	florˈiŋ
ciudadano	sjudadˈano
gradici	ɡradˈisi
guia	ɡjˈa
hobennan	hobˈennan
victima	viktˈima
asistencia	asistˈensja
special	spesjˈal
siguiente	siɡjˈente
clientenan	kljentˈenan
mihor	mihˈor
derecho	derˈet͡ʃo
suma	sˈuma
ku	kˈu
malo	mˈalo
worde	wˈorde
cana	kˈana
Bo	bˈo
arma	ˈarma
boto	bˈoto
Fundacion	fundasjˈoŋ
lama	lˈama
necesidad	nesesidˈad
kita	kˈita
gobernacion	ɡobernasjˈoŋ
usa	ˈusa
bista	bˈista
eleccion	eleksjˈoŋ
Dia	djˈa
falta	fˈalta
anterior	anterjˈor
recupera	rekupˈera
Cuerpo	kwˈerpo
trafico	trafˈiko
uzo	ˈuzo
atras	atrˈas
proyectonan	projektˈonan
puntra	pˈuntra
lanta	lˈanta
mucho	mˈut͡ʃo
mayoria	majˈorja
normal	normˈal
añanan	aɲˈanan
miho	mˈiho
frontera	frontˈera
oficial	ofisjˈal
contento	kontˈento
tampoco	tampˈoko
debe	dˈebe
Pais	pˈa͡ɪs
lista	lˈista
pronto	prˈonto
sostene	sostˈene
compara	kompˈara
demostra	demˈostra
esakinan	esakˈinan
vacuna	vakˈuna
Toque	tˈokwe
rapport	rappˈort
Aki	ˈaki
dialuna	djalˈuna
cubri	kˈubri
mil	mˈil
droga	drˈoɡa
pashentnan	paʃˈentnan
seguridad	seɡuridˈad
agrega	aɡrˈeɡa
condicionnan	kondisjˈonnan
Betico	betˈiko
Como	kˈomo
mescos	meskˈos
tema	tˈema
abuso	abˈuso
For	fˈor
morto	mˈorto
awo	ˈawo
hasi	hˈasi
trahadornan	trahadˈornan
cuadro	kwˈadro
scolnan	skˈolnan
problemanan	problemˈanan
solucion	solusjˈoŋ
declara	deklˈara
Marisol	marisˈol
opinion	opinjˈoŋ
vehiculo	vehikˈulo
lucha	lˈut͡ʃa
proximo	proksˈimo
cifranan	sifrˈanan
distancia	distˈansja
Sinembargo	sinembˈarɡo
bunita	bunˈita
ki	kˈi
Ademas	ademˈas
eynan	ˈejnan
Policial	polisjˈal
actua	ˈaktwa
masha	mˈaʃa
maximo	maksˈimo
acepta	asˈepta
mayornan	majˈornan
aden	adˈeŋ
gana	ɡˈana
basa	bˈasa
fecha	fˈet͡ʃa
Diaranson	djaransˈoŋ
Corte	kˈorte
responsabilidad	responsabilidˈad
riesgo	rjˈesɡo
stop	stˈop
gran	ɡrˈaŋ
oficina	ofisˈina
Arubiano	arubjˈano
unico	unˈiko
cuarentena	kwarentˈena
merdia	mˈerdja
casi	kˈasi
completo	komplˈeto
facil	fasˈil
poni	pˈoni
Kico	kˈiko
aplica	aplˈika
peliger	pelixˈer
Arubano	arubˈano
Covid	kovˈid
autoridad	autoridˈad
diabierna	djabjˈerna
scucha	skˈut͡ʃa
confirma	konfˈirma
constata	konstˈata
encarga	enkˈarɡa
haciendo	hasjˈendo
presupuesto	presupwˈesto
principal	prinsipˈal
aumenta	aumˈenta
Hopi	hˈopi
Colegio	kolˈexjo
bandona	bandˈona
hunga	hˈunɡa
rato	rˈato
Bikker	bikkˈer
cuida	kˈujda
mayor	majˈor
permiso	permˈiso
proteha	protˈeha
mercado	merkˈado
edificio	edifˈisjo
completamente	kompletamˈente
corda	kˈorda
empleadonan	empleadˈonan
fase	fˈase
mama	mˈama
Maart	mˈaːrt
pm	pˌeˈɛm
Knops	knˈops
curpa	kˈurpa
Husticia	hustˈisja
bai	bˈa͡ɪ
posibilidad	posibilidˈad
cambionan	kambjˈonan
extra	ˈekstra
protocol	protokˈol
realisa	realˈisa
asunto	asˈunto
cosnan	kˈosnan
sea	sˈea
MEP	mˈep
depende	depˈende
acaso	akˈaso
Dangui	dˈanɡj
Santa	sˈanta
cooperacion	koːperasjˈoŋ
oranan	orˈanan
refineria	refinˈerja
ambulans	ambulˈans
hinca	hˈinka
mata	mˈata
pesey	pesˈej
actividad	aktividˈad
accion	aksjˈoŋ
publica	publˈika
sra	srˈa
direccion	direksjˈoŋ
sera	sˈera
señala	seɲˈala
trahador	trahadˈor
uso	ˈuso
Club	klˈub
Crisis	krisˈis
Premier	premjˈer
over	ovˈer
studiantenan	studjantˈenan
suficiente	sufisjˈente
estado	estˈado
FASE	fˈase
campaña	kampˈaɲa
djis	d͡ʒˈis
dor	dˈor
maart	mˈaːrt
nacional	nasjonˈal
website	websˈite
Team	teˈam
polisnan	polˈisnan
tira	tˈira
Pueblo	pwˈeblo
historia	histˈorja
tratamento	tratamˈento
danki	dˈanki
lunanan	lunˈanan
sospechoso	sospet͡ʃˈoso
Lo	lˈo
benta	bˈenta
conseho	konsˈeho
preocupacion	preokupasjˈoŋ
director	direktˈor
islanan	islˈanan
Gabinete	ɡabinˈete
calidad	kalidˈad
leynan	lˈejnan
pafo	pˈafo
Bank	bˈank
Cruz	krˈuz
disponibel	disponibˈel
full	fˈull
or	ˈor
señora	seɲˈora
Sr	ˌɛsˈɛr
bati	bˈati
considera	konsidˈera
digital	dixitˈal
mesa	mˈesa
net	nˈet
toch	tˈot͡ʃ
comparti	kompˈarti
fondo	fˈondo
gasto	ɡˈasto
paso	pˈaso
estudio	estˈudjo
vuelo	vwˈelo
December	desembˈer
cura	kˈura
doño	dˈoɲo
sino	sˈino
desaroya	desarˈoja
acudi	akˈudi
contribui	kontribˈuj
lubida	lubˈida
priva	prˈiva
bayendo	bajˈendo
carga	kˈarɡa
comercio	komˈersjo
Juli	jˈuli
November	novembˈer
Social	sosjˈal
destrui	destrˈuj
humano	humˈano
juli	jˈuli
importancia	importˈansja
Tromp	trˈomp
actualmente	aktwalmˈente
fundacion	fundasjˈoŋ
Nacional	nasjonˈal
Wever	wevˈer
articulo	artikˈulo
aproba	aprˈoba
condicion	kondisjˈoŋ
instancia	instˈansja
liber	libˈer
muher	muhˈer
responsabel	responsabˈel
rotonde	rotˈonde
Beach	beˈat͡ʃ
September	septembˈer
continua	kontˈinwa
testnan	tˈestnan
pisa	pˈisa
uni	ˈuni
hala	hˈala
termina	termˈina
stipula	stipˈula
boso	bˈoso
celebra	selˈebra
comision	komisjˈoŋ
bende	bˈende
i	ˈi
leu	lˈew
madruga	madrˈuɡa
maneha	manˈeha
reuni	rˈewni
studiante	studjˈante
trahado	trahˈado
turistanan	turistˈanan
plama	plˈama
produci	prodˈusi
puntonan	puntˈonan
Te	tˈe
keto	kˈeto
experiencia	eksperjˈensja
paden	padˈeŋ
subraya	subrˈaja
inclui	inklˈuj
October	oktobˈer
cita	sˈita
Queda	kwˈeda
Juni	jˈuni
Partido	partˈido
ambiente	ambjˈente
Ley	lˈej
Tabata	tabˈata
capacidad	kapasidˈad
cuanto	kwˈanto
espacio	espˈasjo
bario	bˈarjo
empleado	empleˈado
garantisa	ɡarantˈisa
Central	sentrˈal
abogado	aboɡˈado
ambulance	ambulˈanse
organisacion	orɡanisasjˈoŋ
reduci	redˈusi
castigo	kastˈiɡo
chens	t͡ʃˈens
fiesta	fjˈesta
parlamentario	parlamentˈarjo
pega	pˈeɡa
seguro	seɡˈuro
deteni	detˈeni
sintoma	sintˈoma
Pasobra	pasˈobra
organisa	orɡanˈisa
pasado	pasˈado
sigura	siɡˈura
tiki	tˈiki
Banco	bˈanko
Mientras	mjentrˈas
afo	ˈafo
autonomia	autonˈomja
confronta	konfrˈonta
recuperacion	rekuperasjˈoŋ
Mas	mˈas
bisti	bˈisti
donacion	donasjˈoŋ
Mei	mˈe͡ɪ
abou	abˈow
dolor	dolˈor
Aparte	apˈarte
enfatisa	enfatˈisa
pia	pjˈa
Polisnan	polˈisnan
Serlimar	serlimˈar
adapta	adˈapta
prijs	prˈe͡ɪs
China	t͡ʃˈina
POR	pˈor
SVb	ˌɛsvˌebˈe
check	t͡ʃˈekk
ne	nˈe
Desde	dˈesde
aumento	aumˈento
entrante	entrˈante
pakico	pakˈiko
subsidio	subsˈidjo
luz	lˈuz
video	vidˈeo
Loke	lˈoke
Status	statˈus
comercial	komersjˈal
ciudadanonan	sjudadanˈonan
mal	mˈal
aspecto	aspˈekto
transporta	transpˈorta
fondonan	fondˈonan
mei	mˈe͡ɪ
proteccion	proteksjˈoŋ
boet	bˈut
evalua	evˈalwa
Gobernador	ɡobernadˈor
corta	kˈorta
marduga	mardˈuɡa
negativo	neɡatˈivo
presencia	presˈensja
banco	bˈanko
material	materjˈal
diasabra	djasˈabra
enfrenta	enfrˈenta
menasa	menˈasa
enseñansa	enseɲˈansa
noticia	notˈisja
Curacao	kurakˈao
declaracion	deklarasjˈoŋ
etc	ˈetk
hotel	hotˈel
siña	sˈiɲa
caida	kˈa͡ɪda
famianan	famjˈanan
Sra	srˈa
invita	invˈita
potret	potrˈet
Endy	ˈendi
impuesto	impwˈesto
lider	lidˈer
pakete	pakˈete
sala	sˈala
Centro	sˈentro
Impuesto	impwˈesto
region	rexjˈoŋ
relacion	relasjˈoŋ
tata	tˈata
cacho	kˈat͡ʃo
contagio	kontˈaxjo
documento	dokumˈento
ilegal	ileɡˈal
poder	podˈer
yiunan	jjˈunan
Banda	bˈanda
horta	hˈorta
pasahero	pasahˈero
ripara	ripˈara
barco	bˈarko
directiva	direktˈiva
combati	kombˈati
Colombia	kolˈombja
politica	politˈika
presidente	presidˈente
produccion	produksjˈoŋ
solo	sˈolo
exterior	eksterjˈor
ken	kˈeŋ
buki	bˈuki
centro	sˈentro
conclui	konklˈuj
dokter	doktˈer
lihe	lˈihe
resultadonan	resultadˈonan
yudansa	judˈansa
Facebook	fasebˈoːk
ayera	ajˈera
consecuencia	konsekwˈensja
ehecuta	ehekˈuta
juni	jˈuni
otronan	otrˈonan
legal	leɡˈal
balor	balˈor
detencion	detensjˈoŋ
mara	mˈara
tumando	tumˈando
fisico	fisˈiko
Censo	sˈenso
Con	kˈoŋ
efecto	efˈekto
higiena	hixjˈena
in	ˈiŋ
pareha	parˈeha
producto	prodˈukto
productonan	produktˈonan
bes	bˈes
desaroyonan	desarojˈonan
limita	limˈita
basico	basˈiko
diahuebs	djahwˈebs
negoshinan	neɡoʃˈinan
reto	rˈeto
unidad	unidˈad
yamada	jamˈada
pendiente	pendjˈente
Augustus	auɡustˈus
acerca	asˈerka
directamente	direktamˈente
Dr	dˌeˈɛr
altura	altˈura
ambos	ambˈos
diamars	djamˈars
laboral	laborˈal
tey	tˈej
fraccion	fraksjˈoŋ
kiermen	kjermˈeŋ
Lampe	lˈampe
coriente	korjˈente
diaranson	djaransˈoŋ
prison	prisˈoŋ
sufri	sˈufri
Carnaval	karnavˈal
Januari	janwˈari
Noord	nˈoːrd
contagia	kontˈaxja
costa	kˈosta
Cada	kˈada
Conseho	konsˈeho
bishitante	biʃitˈante
directo	dirˈekto
documentonan	dokumentˈonan
envolvi	envˈolvi
forsa	fˈorsa
and	ˈand
bishitantenan	biʃitantˈenan
evento	evˈento
mental	mentˈal
topico	topˈiko
trahadonan	trahadˈonan
november	novembˈer
augustus	auɡustˈus
december	desembˈer
vota	vˈota
Turismo	turˈismo
instancianan	instansjˈanan
interna	intˈerna
parce	pˈarse
tarea	tarˈea
St	ˌɛstˈe
pisca	pˈiska
raporta	rapˈorta
telefon	telefˈoŋ
Costa	kˈosta
diadomingo	djadomˈinɡo
inicia	inˈisja
Director	direktˈor
Xiomara	zjomˈara
actividadnan	aktividˈadnan
adicional	adisjonˈal
sirbi	sˈirbi
corecto	korˈekto
crece	krˈese
deporte	depˈorte
lamenta	lamˈenta
retonan	retˈonan
cobra	kˈobra
come	kˈome
influencia	inflwˈensja
keho	kˈeho
pagina	paxˈina
siguridad	siɡuridˈad
Oranjestad	oranjestˈad
Uni	ˈuni
emergencia	emerxˈensja
enorme	enˈorme
ex	ˈeks
incluyendo	inklujˈendo
prevencion	prevensjˈoŋ
profesional	profesjonˈal
daño	dˈaɲo
ela	ˈela
ocasion	okasjˈoŋ
reconoce	rekonˈose
tera	tˈera
Mericano	merikˈano
avion	avjˈoŋ
comunicacion	komunikasjˈoŋ
confiansa	konfjˈansa
dato	dˈato
Caya	kˈaja
Europa	ewrˈopa
alarma	alˈarma
fayece	fajˈese
abao	abˈao
educacion	edukasjˈoŋ
presentacion	presentasjˈoŋ
residente	residˈente
Trump	trˈump
notifica	notifˈika
protocolnan	protokˈolnan
recorda	rekˈorda
start	stˈart
Benny	bˈenni
Maarten	maːrtˈeŋ
corupcion	korupsjˈoŋ
expertonan	ekspertˈonan
fabor	fabˈor
lesa	lˈesa
posicion	posisjˈoŋ
Algemene	alxemˈene
cara	kˈara
representa	represˈenta
careda	karˈeda
demanda	demˈanda
encera	ensˈera
existi	eksˈisti
April	aprˈil
NV	ˌɛnvˈe
isola	isˈola
les	lˈes
meter	metˈer
promer	promˈer
specialmente	spesjalmˈente
tende	tˈende
DIMP	dˈimp
Stichting	stit͡ʃtˈinɡ
enfoca	enfˈoka
september	septembˈer
central	sentrˈal
decisionnan	desisjˈonnan
indicacion	indikasjˈoŋ
industria	indˈustrja
remedi	remˈedi
surgi	sˈurxi
color	kolˈor
mensahe	mensˈahe
Parke	pˈarke
anto	ˈanto
deshaci	deʃˈasi
parlamento	parlamˈento
sushi	sˈuʃi
Diaranzon	djaranzˈoŋ
politiconan	politikˈonan
rekeri	rekˈeri
rol	rˈol
De	dˈe
Rekenkamer	rekenkamˈer
preguntanan	preɡuntˈanan
atraco	atrˈako
email	emˈa͡ɪl
sindicato	sindikˈato
Algun	alɡˈuŋ
Arends	arˈends
isolacion	isolasjˈoŋ
papel	papˈel
studia	stˈudja
DIMAS	dimˈas
camber	kambˈer
minimo	minˈimo
transporte	transpˈorte
TdQ	tˌedˈekˈy
duda	dˈuda
intencion	intensjˈoŋ
investiga	investˈiɡa
cifra	sˈifra
mehora	mehˈora
NO	nˈo
am	ˈam
simannan	simˈannan
Corona	korˈona
DIP	dˈip
alumnonan	alumnˈonan
ladronicia	ladronˈisja
peligroso	peliɡrˈoso
preocupa	preokˈupa
wega	wˈeɡa
Europeo	ewropˈeo
formulario	formulˈarjo
idea	idˈea
Lopez	lopˈez
distanciamento	distansjamˈento
Cas	kˈas
Raad	rˈaːd
drecha	drˈet͡ʃa
funciona	funsjˈona
musica	musˈika
practica	praktˈika
servicionan	servisjˈonan
Esnan	ˈesnan
opcion	opsjˈoŋ
ordo	ˈordo
turistico	turistˈiko
Plan	plˈaŋ
inverti	invˈerti
rijbewijs	re͡ɪbewˈe͡ɪs
yen	jˈeŋ
Cultura	kultˈura
amplio	ˈampljo
aunke	aˈunke
queda	kwˈeda
DOW	dˈow
lansa	lˈansa
muri	mˈuri
o	ˈo
premio	prˈemjo
premira	premˈira
blanco	blˈanko
cabes	kabˈes
consisti	konsˈisti
dedica	dedˈika
entrevista	entrevˈista
operacion	operasjˈoŋ
Ban	bˈaŋ
Mirando	mirˈando
KIA	kjˈa
Su	sˈu
abo	ˈabo
canando	kanˈando
consideracion	konsiderasjˈoŋ
limpi	lˈimpi
pensamento	pensamˈento
Enseñansa	enseɲˈansa
Lotto	lˈotto
contenido	kontenˈido
drumi	drˈumi
grandinan	ɡrandˈinan
adres	adrˈes
construccion	konstruksjˈoŋ
splicacion	splikasjˈoŋ
Debi	dˈebi
alumno	alˈumno
habitantenan	habitantˈenan
januari	janwˈari
mr	ˌɛmˈɛr
pasonan	pasˈonan
Tanki	tˈanki
antes	antˈes
pariba	parˈiba
toque	tˈokwe
training	tra͡ɪnˈinɡ
Corsow	korsˈow
WEB	wˈeb
atento	atˈento
muhe	mˈuhe
representante	representˈante
urgencia	urxˈensja
Dios	djˈos
Tjon	tjˈoŋ
empresa	emprˈesa
esfuerso	esfwˈerso
acusa	akˈusa
gruponan	ɡrupˈonan
mocion	mosjˈoŋ
prestamo	prestˈamo
stroba	strˈoba
coleganan	koleɡˈanan
implementa	implemˈenta
preveni	prevˈeni
sentencia	sentˈensja
concerni	konsˈerni
enfermedad	enfermedˈad
aglomeracion	aɡlomerasjˈoŋ
naturalesa	naturalˈesa
cua	kwˈa
piso	pˈiso
reacciona	reaksjˈona
regresa	reɡrˈesa
prioridad	prjoridˈad
trabounan	trabˈownan
Afl	ˈafl
Koolman	koːlmˈaŋ
Otro	ˈotro
miedo	mjˈedo
real	reˈal
AHATA	ahˈata
exitoso	eksitˈoso
funcion	funsjˈoŋ
gara	ɡˈara
inicio	inˈisjo
sindicatonan	sindikatˈonan
voto	vˈoto
Pasco	pˈasko
Savaneta	savanˈeta
comete	komˈete
docentenan	dosentˈenan
elabora	elabˈora
palo	pˈalo
reaccion	reaksjˈoŋ
sexual	sekswˈal
amplia	ˈamplja
bezig	bezˈiɡ
determina	determˈina
encontra	enkˈontra
supervision	supervisjˈoŋ
tal	tˈal
vision	visjˈoŋ
Aeropuerto	aeropwˈerto
Mesora	mesˈora
akinan	akˈinan
alcohol	alkohˈol
andando	andˈando
apertura	apertˈura
exito	eksˈito
stimula	stimˈula
yegando	jeɡˈando
palabranan	palabrˈanan
termino	termˈino
vigor	viɡˈor
Arubianonan	arubjanˈonan
La	lˈa
conhuntamente	konhuntamˈente
cuadra	kwˈadra
denuncia	denˈunsja
entidad	entidˈad
integridad	inteɡridˈad
marca	mˈarka
planea	planˈea
ATA	ˈata
candidato	kandidˈato
comerciante	komersjˈante
diferencia	diferˈensja
kizas	kizˈas
respeta	respˈeta
valido	valˈido
abusa	abˈusa
bisando	bisˈando
boca	bˈoka
dentro	dˈentro
elimina	elimˈina
scoge	skˈoxe
vuelonan	vwelˈonan
caha	kˈaha
coriendo	korjˈendo
cultura	kultˈura
escolar	eskolˈar
huur	hˈyr
klas	klˈas
prohibi	prohˈibi
referi	refˈeri
Kiwanis	kiwanˈis
peso	pˈeso
poblacion	poblasjˈoŋ
procedura	prosedˈura
temponan	tempˈonan
Andin	andˈiŋ
amigo	amˈiɡo
beach	beˈat͡ʃ
bebe	bˈebe
cinco	sˈinko
discusion	diskusjˈoŋ
februari	febrwˈari
informacionnan	informasjˈonnan
moderno	modˈerno
nenga	nˈenɡa
policial	polisjˈal
profesionalnan	profesjonˈalnan
relato	relˈato
acceso	aksˈeso
encuesta	enkwˈesta
excepcion	ekssepsjˈoŋ
mag	mˈaɡ
reduccion	reduksjˈoŋ
respet	respˈet
safe	sˈafe
viola	vjˈola
Seroe	sˈeru
alcansa	alkˈansa
aporte	apˈorte
condena	kondˈena
contene	kontˈene
esencial	esensjˈal
preparacion	preparasjˈoŋ
rumbo	rˈumbo
Asuntonan	asuntˈonan
areanan	areˈanan
defende	defˈende
laboratorio	laboratˈorjo
orario	orˈarjo
participacion	partisipasjˈoŋ
planta	plˈanta
Cuido	kˈujdo
Playa	plˈaja
confisca	konfˈiska
docter	doktˈer
interesa	interˈesa
orguyoso	orɡjˈoso
patras	patrˈas
sintomanan	sintomˈanan
the	thˈe
Recientemente	resjentemˈente
Venezolano	venezolˈano
buscando	buskˈando
comienso	komjˈenso
obligatorio	obliɡatˈorjo
Februari	febrwˈari
Hunto	hˈunto
comprende	komprˈende
disfruta	disfrˈuta
fronteranan	fronterˈanan
gasta	ɡˈasta
mishi	mˈiʃi
porciento	porsjˈento
Cuba	kˈuba
Howell	howˈell
anual	anwˈal
docente	dosˈente
examen	eksamˈeŋ
familiar	familjˈar
Tourism	towrˈism
asuntonan	asuntˈonan
minuut	minˈyt
Bonaire	bonˈa͡ɪre
Internacional	internasjonˈal
Siman	simˈaŋ
demas	demˈas
exigencia	eksixˈensja
nace	nˈase
recientemente	resjentemˈente
sconde	skˈonde
sostenibel	sostenibˈel
Actualmente	aktwalmˈente
Aworaki	aworˈaki
Salubridad	salubridˈad
The	thˈe
ademas	ademˈas
comportacion	komportasjˈoŋ
plataforma	platafˈorma
presion	presjˈoŋ
analisa	analˈisa
asisti	asˈisti
autoridadnan	autoridˈadnan
conocemento	konosemˈento
consulta	konsˈulta
husticia	hustˈisja
posible	posˈible
presta	prˈesta
retiro	retˈiro
Comision	komisjˈoŋ
Curaçao	kurasˈao
aporta	apˈorta
comunica	komunˈika
establecimento	establesimˈento
importa	impˈorta
iniciativa	inisjatˈiva
recomenda	rekomˈenda
retira	retˈira
Rutte	rˈutte
fiscal	fiskˈal
hayando	hajˈando
het	hˈet
suplica	suplˈika
Authority	authorˈiti
inscribi	inskrˈibi
Danki	dˈanki
Sindicato	sindikˈato
Ya	jˈa
acto	ˈakto
admiti	admˈiti
haber	habˈer
patruyanan	patrujˈanan
pe	pˈe
Mundial	mundjˈal
aeropuerto	aeropwˈerto
inversion	inversjˈoŋ
maestro	maˈestro
organiza	orɡanˈiza
toca	tˈoka
En	ˈeŋ
categoria	kateɡˈorja
conseha	konsˈeha
departamentonan	departamentˈonan
dunando	dunˈando
orden	ordˈeŋ
petroleo	petrolˈeo
ruman	rumˈaŋ
señal	seɲˈal
socede	sosˈede
Bureau	bureˈau
Oficina	ofisˈina
brote	brˈote
casa	kˈasa
ekipo	ekˈipo
experto	ekspˈerto
idioma	idjˈoma
organizacion	orɡanizasjˈoŋ
pickup	pikkˈup
salida	salˈida
situacionnan	sitwasjˈonnan
tremendo	tremˈendo
Sint	sˈint
Virus	virˈus
adulto	adˈulto
hotelnan	hotˈelnan
realmente	realmˈente
rosea	rosˈea
satisfecho	satisfˈet͡ʃo
strategia	stratˈexja
ticket	tikkˈet
trankilidad	trankilidˈad
Directiva	direktˈiva
President	presidˈent
aire	ˈa͡ɪre
apelacion	apelasjˈoŋ
apesar	apesˈar
aprobacion	aprobasjˈoŋ
media	mˈedja
principalmente	prinsipalmˈente
skirbi	skˈirbi
Cora	kˈora
SKOA	skˈoa
alrededor	alrededˈor
bringa	brˈinɡa
debidamente	debidamˈente
habitante	habitˈante
impone	impˈone
intensivo	intensˈivo
lugarnan	luɡˈarnan
maestronan	maestrˈonan
structura	struktˈura
Desaroyo	desarˈojo
SIMAR	simˈar
competencia	kompetˈensja
computer	komputˈer
disciplina	dissiplˈina
haña	hˈaɲa
menor	menˈor
sectornan	sektˈornan
violando	vjolˈando
Palm	pˈalm
Sin	sˈiŋ
Universidad	universidˈad
asumi	asˈumi
ban	bˈaŋ
detecta	detˈekta
hacie	hˈasje
oficialmente	ofisjalmˈente
reapertura	reapertˈura
surpasa	surpˈasa
vigila	vixˈila
Hotel	hotˈel
concepto	konsˈepto
destinacion	destinasjˈoŋ
la	lˈa
otorga	otˈorɡa
trempan	trempˈaŋ
Center	sentˈer
Personal	personˈal
coalicion	koalisjˈoŋ
colega	kolˈeɡa
conexion	koneksjˈoŋ
dollar	dollˈar
laba	lˈaba
lomba	lˈomba
sinembargo	sinembˈarɡo
teniendo	tenjˈendo
urgi	ˈurxi
wowo	wˈowo
Romero	romˈero
biahe	bjˈahe
celebracion	selebrasjˈoŋ
conduci	kondˈusi
curso	kˈurso
descubri	deskˈubri
eherce	ehˈerse
falso	fˈalso
finalisa	finalˈisa
Aunke	aˈunke
Door	dˈoːr
cuestiona	kwestjˈona
dialogo	djalˈoɡo
domina	domˈina
exigencianan	eksixensjˈanan
felicita	felisˈita
gubernamental	ɡubernamentˈal
promove	promˈove
risico	risˈiko
scapa	skˈapa
curason	kurasˈoŋ
perhudica	perhudˈika
siendo	sjˈendo
sobrevivi	sobrevˈivi
vigente	vixˈente
Nacionnan	nasjˈonnan
claridad	klaridˈad
consecuencianan	konsekwensjˈanan
democratico	demokratˈiko
par	pˈar
trabaonan	trabaˈonan
weekend	weːkˈend
Locual	lokwˈal
abordo	abˈordo
areglo	arˈeɡlo
averahe	averˈahe
deficit	defisˈit
deseo	desˈeo
independiente	independjˈente
mey	mˈej
midi	mˈidi
nombra	nˈombra
resto	rˈesto
Health	heˈalth
Rosa	rˈosa
Warda	wˈarda
adverti	advˈerti
bar	bˈar
consciente	konssjˈente
cortico	kortˈiko
emiti	emˈiti
incertidumbre	insertidˈumbre
october	oktobˈer
scondi	skˈondi
solicita	solisˈita
Airport	a͡ɪrpˈort
Scol	skˈol
amor	amˈor
energia	enˈerxja
gratis	ɡratˈis
ocupacion	okupasjˈoŋ
perdida	perdˈida
proba	prˈoba
restaurant	restaurˈant
sentido	sentˈido
America	amerˈika
bula	bˈula
colaboracion	kolaborasjˈoŋ
ganador	ɡanadˈor
medionan	medjˈonan
residentenan	residentˈenan
truck	trˈukk
cabez	kabˈez
laat	lˈaːt
plachi	plˈat͡ʃi
preferencia	preferˈensja
sorpresa	sorprˈesa
Economico	ekonomˈiko
Leendert	leːndˈert
alivio	alˈivjo
ataca	atˈaka
experencia	eksperˈensja
protesta	protˈesta
tapa	tˈapa
tecnologia	teknolˈoxja
update	updˈate
Advies	advjˈes
Pos	pˈos
Respaldo	respˈaldo
Union	unjˈoŋ
aviso	avˈiso
belasting	belastˈinɡ
construi	konstrˈuj
menaza	menˈaza
seyo	sˈejo
stima	stˈima
storia	stˈorja
victimanan	viktimˈanan
Van	vˈaŋ
ami	ˈami
brandweer	brandwˈeːr
comerciantenan	komersjantˈenan
dura	dˈura
estatal	estatˈal
hudicial	hudisjˈal
mondi	mˈondi
motor	motˈor
partidonan	partidˈonan
tempran	temprˈaŋ
vulnerabel	vulnerabˈel
Sevinger	sevinxˈer
Varios	varjˈos
beneficio	benefˈisjo
concreto	konkrˈeto
crecemento	kresemˈento
derechonan	deret͡ʃˈonan
dunador	dunadˈor
libertad	libertˈad
ola	ˈola
Deporte	depˈorte
casnan	kˈasnan
club	klˈub
conforme	konfˈorme
custumber	kustumbˈer
datonan	datˈonan
existente	eksistˈente
negocia	neɡˈosja
preto	prˈeto
registracion	rexistrasjˈoŋ
Miyon	mijˈoŋ
Online	onlˈine
apenas	apenˈas
confianza	konfjˈanza
detaye	detˈaje
resumen	resumˈeŋ
reunionnan	rewnjˈonnan
screening	skreːnˈinɡ
venidero	venidˈero
Guardacosta	ɡwardakˈosta
Thijsen	the͡ɪsˈeŋ
alerta	alˈerta
colmo	kˈolmo
coopera	koːpˈera
dushi	dˈuʃi
gusta	ɡˈusta
obliga	oblˈiɡa
popular	populˈar
reforma	refˈorma
specifico	spesifˈiko
subida	subˈida
Aña	ˈaɲa
Papiamento	papjamˈento
espera	espˈera
grave	ɡrˈave
identifica	identifˈika
metanan	metˈanan
obstante	obstˈante
tapaboca	tapabˈoka
Dakota	dakˈota
Hende	hˈende
SETAR	setˈar
amigonan	amiɡˈonan
april	aprˈil
huridico	huridˈiko
instala	instˈala
move	mˈove
ocupa	okˈupa
principio	prinsˈipjo
severo	sevˈero
trayecto	trajˈekto
velocidad	velosidˈad
New	nˈew
Paradera	paradˈera
bolter	boltˈer
brug	brˈuɡ
cancer	kansˈer
controlnan	kontrˈolnan
cuestionario	kwestjonˈarjo
saludabel	saludabˈel
virtual	virtwˈal
BBO	bbˈo
Corsou	korsˈow
aspectonan	aspektˈonan
autonan	autˈonan
dispuesto	dispwˈesto
dunado	dunˈado
efectonan	efektˈonan
generacion	xenerasjˈoŋ
hogar	hoɡˈar
instruccion	instruksjˈoŋ
interno	intˈerno
motibonan	motibˈonan
op	ˈop
priminti	primˈinti
urgente	urxˈente
Dos	dˈos
Fraccion	fraksjˈoŋ
Glenbert	ɡlenbˈert
Kock	kˈokk
actonan	aktˈonan
critica	kritˈika
desconoci	deskonˈosi
diripiente	diripjˈente
organo	orɡˈano
relata	relˈata
revela	revˈela
Candelaria	kandelˈarja
Mescos	meskˈos
cancela	kansˈela
corto	kˈorto
crusada	krusˈada
encuanto	enkwˈanto
enfasis	enfasˈis
fayecimento	fajesimˈento
forza	fˈorza
genera	xenˈera
haltura	haltˈura
transmision	transmisjˈoŋ
transparencia	transparˈensja
Comercio	komˈersjo
Directie	dirˈektje
Señora	seɲˈora
brommer	brommˈer
contract	kontrˈakt
esunnan	esˈunnan
lamentablemente	lamentablemˈente
serca	sˈerka
tarifa	tarˈifa
vakantie	vakˈantje
yudanza	judˈanza
Alto	ˈalto
Robert	robˈert
SMOA	smˈoa
acusacion	akusasjˈoŋ
avisa	avˈisa
back	bˈakk
bieu	bjˈew
boluntario	boluntˈarjo
deber	debˈer
discuti	diskˈuti
esfuerzo	esfwˈerzo
exactamente	eksaktamˈente
panico	panˈiko
rekisitonan	rekisitˈonan
reserva	resˈerva
CAft	sˈeˈaft
airport	a͡ɪrpˈort
contribucion	kontribusjˈoŋ
costo	kˈosto
cuatro	kwˈatro
existencia	eksistˈensja
maltrato	maltrˈato
mundialmente	mundjalmˈente
pasaheronan	pasaherˈonan
pensioen	pensjˈuŋ
precaucion	prekausjˈoŋ
treci	trˈesi
Dominicana	dominikˈana
Elmar	elmˈar
Famia	fˈamja
Labor	labˈor
Macuarima	makwarˈima
claro	klˈaro
infecta	infˈekta
ranca	rˈanka
representantenan	representantˈenan
seccion	seksjˈoŋ
wanta	wˈanta
Casino	kasˈino
Entre	ˈentre
KPA	kpˈa
analisis	analisˈis
aparato	aparˈato
basha	bˈaʃa
clave	klˈave
empresanan	empresˈanan
facilita	fasilˈita
guera	ɡˈera
pabao	pabˈao
pagonan	paɡˈonan
proposicion	proposisjˈoŋ
articulonan	artikulˈonan
demasiado	demasjˈado
gremionan	ɡremjˈonan
historico	historˈiko
invitacion	invitasjˈoŋ
partner	partnˈer
plannan	plˈannan
profundo	profˈundo
ruta	rˈuta
union	unjˈoŋ
violencia	vjolˈensja
AAA	ˈaːa
Corda	kˈorda
Entrante	entrˈante
Rocco	rˈokko
SVB	ˌɛsvˌebˈe
aplicacion	aplikasjˈoŋ
dado	dˈado
estricto	estrˈikto
fiansa	fjˈansa
manifesta	manifˈesta
multa	mˈulta
practicamente	praktikamˈente
reparti	repˈarti
sospechosonan	sospet͡ʃosˈonan
EPI	ˈepi
General	xenerˈal
School	st͡ʃˈoːl
Vos	vˈos
Watty	wˈatti
bastante	bastˈante
comenta	komˈenta
creativo	kreatˈivo
robes	robˈes
tristo	trˈisto
Republica	republˈika
completa	komplˈeta
crucero	krusˈero
electoral	elektorˈal
honra	hˈonra
mediano	medjˈano
mondkapje	mondkˈapje
nacionalidad	nasjonalidˈad
natural	naturˈal
penal	penˈal
rapido	rapˈido
rapportnan	rappˈortnan
recien	resjˈeŋ
COVID	kovˈid
Comisario	komisˈarjo
Comunidad	komunidˈad
Guarda	ɡwˈarda
Meza	mˈeza
Statuut	statˈyt
democracia	demokrˈasja
evaluacion	evalwasjˈoŋ
factor	faktˈor
infeccion	infeksjˈoŋ
infrastructura	infrastruktˈura
kiko	kˈiko
logro	lˈoɡro
ocasiona	okasjˈona
portanan	portˈanan
scenario	ssenˈarjo
veld	vˈeld
Donald	donˈald
Eagle	eˈaɡle
contrario	kontrˈarjo
drastico	drastˈiko
ministerio	ministˈerjo
soluciona	solusjˈona
supermercado	supermerkˈado
Bubali	bubˈali
Pakico	pakˈiko
Tanto	tˈanto
afspraak	afsprˈaːk
bien	bjˈeŋ
condolencia	kondolˈensja
cuater	kwatˈer
entradanan	entradˈanan
tog	tˈoɡ
Ayera	ajˈera
CAFT	kˈaft
Foundation	fowndatjˈoŋ
Sabana	sabˈana
apoyo	apˈojo
bisiña	bisˈiɲa
burachi	burˈat͡ʃi
decada	dekˈada
destruccion	destruksjˈoŋ
efectivo	efektˈivo
haye	hˈaje
introduccion	introduksjˈoŋ
niun	njˈuŋ
trankil	trankˈil
Besaril	besarˈil
CITGO	sˈitɡo
Grandi	ɡrˈandi
Tjin	tjˈiŋ
arte	ˈarte
desaster	desastˈer
edicion	edisjˈoŋ
ehemplo	ehˈemplo
enfoke	enfˈoke
etapa	etˈapa
grado	ɡrˈado
hamas	hamˈas
helicopter	helikoptˈer
mita	mˈita
opta	ˈopta
realiza	realˈiza
simplemente	simplemˈente
CEO	sˈeo
Juan	jwˈaŋ
alabes	alabˈes
bibando	bibˈando
buskeda	buskˈeda
combersacion	kombersasjˈoŋ
dedicacion	dedikasjˈoŋ
diario	djˈarjo
discurso	diskˈurso
gasolin	ɡasolˈiŋ
intento	intˈento
legalmente	leɡalmˈente
localidad	lokalidˈad
reitera	re͡ɪtˈera
salubridad	salubridˈad
sano	sˈano
situa	sˈitwa
speransa	sperˈansa
Reina	rˈe͡ɪna
Richard	rit͡ʃˈard
automaticamente	automatikamˈente
calamidad	kalamidˈad
cuestion	kwestjˈoŋ
deal	deˈal
enseñanza	enseɲˈanza
fastioso	fastjˈoso
modelo	modˈelo
participante	partisipˈante
preparando	preparˈando
procesa	prosˈesa
publicacion	publikasjˈoŋ
refleha	reflˈeha
Infrastructura	infrastruktˈura
Setar	setˈar
cocaina	kokˈa͡ɪna
extende	ekstˈende
hefe	hˈefe
horcan	horkˈaŋ
opera	opˈera
pilar	pilˈar
school	st͡ʃˈoːl
Subsidio	subsˈidjo
Wardacosta	wardakˈosta
corona	korˈona
cumpliendo	kumpljˈendo
ilustra	ilˈustra
internet	internˈet
los	lˈos
perspectiva	perspektˈiva
surplus	surplˈus
Rey	rˈej
bashi	bˈaʃi
comprension	komprensjˈoŋ
constantemente	konstantemˈente
cultural	kulturˈal
facebook	fasebˈoːk
kendenan	kendˈenan
to	tˈo
transmiti	transmˈiti
viahe	vjˈahe
Association	assosjatjˈoŋ
International	internatjonˈal
Sneek	snˈeːk
al	ˈal
aparentemente	aparentemˈente
comienzo	komjˈenzo
container	konta͡ɪnˈer
cora	kˈora
honor	honˈor
husto	hˈusto
levemente	levemˈente
segundo	seɡˈundo
seis	sˈe͡ɪs
turno	tˈurno
Alan	alˈaŋ
Boulevard	bowlevˈard
Caribbean	karibbeˈaŋ
Mientrastanto	mjentrastˈanto
Recherche	ret͡ʃˈert͡ʃe
actitud	aktitˈud
ahusta	ahˈusta
atendi	atˈendi
calcula	kalkˈula
carchi	kˈart͡ʃi
compromiso	kompromˈiso
dak	dˈak
destina	destˈina
detenido	detenˈido
finalmente	finalmˈente
gerencia	xerˈensja
huy	hˈuj
mantencion	mantensjˈoŋ
reclama	reklˈama
webinar	webinˈar
Ambulance	ambulˈanse
Ningun	ninɡˈuŋ
Raymond	rajmˈond
Resort	resˈort
fe	fˈe
importacion	importasjˈoŋ
nissan	nissˈaŋ
pabien	pabjˈeŋ
participantenan	partisipantˈenan
perdi	pˈerdi
remarke	remˈarke
Ainda	ˈa͡ɪnda
Chauffeur	t͡ʃauffˈewr
ICU	ˈiku
aprecia	aprˈesja
bahando	bahˈando
critico	kritˈiko
hustamente	hustamˈente
innovacion	innovasjˈoŋ
negociacion	neɡosjasjˈoŋ
obligacion	obliɡasjˈoŋ
observa	obsˈerva
oro	ˈoro
rabia	rˈabja
ripiti	ripˈiti
Apesar	apesˈar
Code	kˈode
Codigo	kodˈiɡo
Economia	ekonˈomja
Otmar	otmˈar
Plaza	plˈaza
Sigur	siɡˈur
York	jˈork
balansa	balˈansa
kiebro	kjˈebro
porfin	porfˈiŋ
recauda	rekaˈuda
weganan	weɡˈanan
Brazil	brazˈil
DPL	dˌepˌeˈɛl
ImSan	ˈimsˈaŋ
Salario	salˈarjo
atene	atˈene
femenino	femenˈino
financiamento	finansjamˈento
gabinete	ɡabinˈete
huma	hˈuma
misa	mˈisa
paña	pˈaɲa
pida	pˈida
preventivo	preventˈivo
regular	reɡulˈar
sistemanan	sistemˈanan
Marlon	marlˈoŋ
Mundo	mˈundo
TDQ	tˌedˌekˈy
bestia	bˈestja
comun	komˈuŋ
conclusion	konklusjˈoŋ
covid	kovˈid
debenan	debˈenan
igual	iɡwˈal
serie	sˈerje
straño	strˈaɲo
wardando	wardˈando
Chikito	t͡ʃikˈito
comunicado	komunikˈado
dus	dˈus
empleo	emplˈeo
establecimentonan	establesimentˈonan
imagen	imaxˈeŋ
lidernan	lidˈernan
merece	merˈese
pecho	pˈet͡ʃo
pio	pjˈo
prefera	prefˈera
preocupante	preokupˈante
señor	seɲˈor
specialista	spesjalˈista
Ambiente	ambjˈente
Lamentablemente	lamentablemˈente
advertencia	advertˈensja
conocido	konosˈido
crimen	krimˈeŋ
divulga	divˈulɡa
educa	edˈuka
encuentro	enkwˈentro
especialmente	espesjalmˈente
garantia	ɡarˈantja
interesante	interesˈante
malesanan	malesˈanan
panort	panˈort
parada	parˈada
sorto	sˈorto
tarda	tˈarda
up	ˈup
Blanco	blˈanko
Boekhoudt	bukhˈowdt
Camacuri	kamakˈuri
Chris	t͡ʃrˈis
Huez	hwˈez
Sero	sˈero
avansa	avˈansa
biento	bjˈento
compra	kˈompra
describi	deskrˈibi
drechi	drˈet͡ʃi
movecion	movesjˈoŋ
negociacionnan	neɡosjasjˈonnan
probecha	probˈet͡ʃa
pusha	pˈuʃa
sigi	sˈixi
totalmente	totalmˈente
Alabes	alabˈes
Kelly	kˈelli
KvK	kˌavˈekˈa
Mucha	mˈut͡ʃa
Vrolijk	vrolˈe͡ɪk
awendia	awˈendja
conciente	konsjˈente
consumidor	konsumidˈor
criminalidad	kriminalidˈad
desinfecta	desinfˈekta
ehecucion	ehekusjˈoŋ
expande	ekspˈande
fuente	fwˈente
hisa	hˈisa
individual	individwˈal
ladron	ladrˈoŋ
laman	lamˈaŋ
mehoracion	mehorasjˈoŋ
recherche	ret͡ʃˈert͡ʃe
revisa	revˈisa
sanger	sanxˈer
sociedad	sosjedˈad
Intensivo	intensˈivo
Patrishi	patrˈiʃi
Sharline	ʃarlˈine
artista	artˈista
aun	aˈuŋ
bombero	bombˈero
estilo	estˈilo
molester	molestˈer
normalmente	normalmˈente
pan	pˈaŋ
pelea	pelˈea
stress	strˈess
tarheta	tarhˈeta
yobida	jobˈida
Ambos	ambˈos
Happy	hˈappi
IPA	ˈipa
Parlamentarionan	parlamentarjˈonan
acusacionnan	akusasjˈonnan
agenda	axˈenda
dignatario	diɡnatˈarjo
draai	drˈaːj
edificionan	edifisjˈonan
musical	musikˈal
normanan	normˈanan
oido	ˈojdo
pasenshi	pasˈenʃi
procedente	prosedˈente
roadservice	roadservˈise
College	kollˈexe
Estado	estˈado
Finalmente	finalmˈente
Geerman	xeːrmˈaŋ
UPP	ˈupp
afor	afˈor
anuncio	anˈunsjo
baranca	barˈanka
cartera	kartˈera
drs	dˌeˌɛrˈɛs
duradero	duradˈero
hyundai	hjˈunda͡ɪ
informantenan	informantˈenan
keri	kˈeri
materia	matˈerja
origen	orixˈeŋ
regula	reɡˈula
Algo	ˈalɡo
Defensa	defˈensa
Esakinan	esakˈinan
Hasta	hˈasta
Homber	hombˈer
Mark	mˈark
Mayoria	majˈorja
Relaciona	relasjˈona
bijstand	be͡ɪstˈand
biyon	bijˈoŋ
conecta	konˈekta
defensa	defˈensa
dune	dˈune
humanitario	humanitˈarjo
kima	kˈima
maltrata	maltrˈata
ministernan	ministˈernan
peligro	pelˈiɡro
titulo	titˈulo
transparente	transparˈente
Airlines	a͡ɪrlinˈes
Arikok	arikˈok
Asunto	asˈunto
Rijkswet	re͡ɪkswˈet
Secretario	sekretˈarjo
Semper	sempˈer
Servicio	servˈisjo
US	ˈus
agente	axˈente
berde	bˈerde
condicional	kondisjonˈal
institui	institˈuj
mustrando	mustrˈando
reactiva	reaktˈiva
reconoci	rekonˈosi
regalo	reɡˈalo
scohe	skˈohe
tanten	tantˈeŋ
viaha	vjˈaha
violacion	vjolasjˈoŋ
vocero	vosˈero
zona	zˈona
Brandweer	brandwˈeːr
Camara	kamˈara
Group	ɡrˈowp
Medio	mˈedjo
Sociaal	sosjˈaːl
adicto	adˈikto
aparece	aparˈese
apartamento	apartamˈento
ceremonia	seremˈonja
cupo	kˈupo
epoca	epˈoka
finaliza	finalˈiza
garantiza	ɡarantˈiza
vivienda	vivjˈenda
App	ˈapp
Awo	ˈawo
Jamaica	jamˈa͡ɪka
celular	selulˈar
contact	kontˈakt
criminal	kriminˈal
cuminsando	kuminsˈando
dicho	dˈit͡ʃo
doñonan	doɲˈonan
formal	formˈal
hand	hˈand
herencia	herˈensja
normalidad	normalidˈad
oportunidadnan	oportunidˈadnan
oposicion	oposisjˈoŋ
papiando	papjˈando
place	plˈase
show	ʃˈow
stranhero	stranhˈero
tankinan	tankˈinan
tareanan	tareˈanan
totalidad	totalidˈad
usando	usˈando
Cuanto	kwˈanto
Island	islˈand
Kamer	kamˈer
Maria	mˈarja
activa	aktˈiva
alma	ˈalma
ciudad	sjudˈad
codigo	kodˈiɡo
continuamente	kontinwamˈente
cuerpo	kwˈerpo
decreto	dekrˈeto
destino	destˈino
feliz	felˈiz
lesnan	lˈesnan
liher	lihˈer
lora	lˈora
mascota	maskˈota
pabou	pabˈow
particular	partikulˈar
procesonan	prosesˈonan
rueda	rwˈeda
Dowers	dowˈers
Eddy	ˈeddi
Grupo	ɡrˈupo
MANA	mˈana
aerolinea	aerolinˈea
asiento	asjˈento
ciere	sjˈere
circula	sirkˈula
civil	sivˈil
claramente	klaramˈente
convenci	konvˈensi
establece	establˈese
inmediatamente	inmedjatamˈente
limite	limˈite
mañan	maɲˈaŋ
padilanti	padilˈanti
partinan	partˈinan
primario	primˈarjo
propone	propˈone
resumi	resˈumi
santo	sˈanto
stakeholders	stakeholdˈers
temanan	temˈanan
unicamente	unikamˈente
vehiculonan	vehikulˈonan
Muchanan	mut͡ʃˈanan
PPP	pˌepˌepˈe
Piedra	pjˈedra
Ponton	pontˈoŋ
alegria	alˈeɡrja
cancion	kansjˈoŋ
carnaval	karnavˈal
dificultad	difikultˈad
enfatiza	enfatˈiza
facilidad	fasilidˈad
faya	fˈaja
inscripcion	inskripsjˈoŋ
paz	pˈaz
peticionnan	petisjˈonnan
porcentahe	porsentˈahe
probablemente	probablemˈente
progreso	proɡrˈeso
saco	sˈako
secreto	sekrˈeto
solucionnan	solusjˈonnan
tranche	trˈant͡ʃe
transcurso	transkˈurso
Boneiro	bonˈe͡ɪro
Dienst	djˈenst
Haag	hˈaːɡ
MFA	mfˈa
PCR	pˌesˌeˈɛr
RdA	ˌɛrdˈeˈa
capta	kˈapta
causando	kausˈando
corte	kˈorte
expresion	ekspresjˈoŋ
fia	fjˈa
grita	ɡrˈita
kisas	kisˈas
maske	mˈaske
pafor	pafˈor
parlamentarionan	parlamentarjˈonan
prolonga	prolˈonɡa
similar	similˈar
stuur	stˈyr
testigo	testˈiɡo
Bar	bˈar
Enseñanza	enseɲˈanza
Lacle	lˈakle
Latino	latˈino
Paso	pˈaso
Rijbewijs	re͡ɪbewˈe͡ɪs
apoya	apˈoja
carera	karˈera
constitucion	konstitusjˈoŋ
cruzada	kruzˈada
insisti	insˈisti
kilo	kˈilo
lockdown	lokkdˈowŋ
oficialnan	ofisjˈalnan
organisacionnan	orɡanisasjˈonnan
plachinan	plat͡ʃˈinan
post	pˈost
prohibicion	prohibisjˈoŋ
proyecta	projˈekta
record	rekˈord
strategico	stratexˈiko
tas	tˈas
tienda	tjˈenda
waf	wˈaf
Arubahuis	arubahˈujs
Dollar	dollˈar
Florida	florˈida
Ombudsman	ombudsmˈaŋ
ambulante	ambulˈante
app	ˈapp
atendiendo	atendjˈendo
awanan	awˈanan
baby	bˈabi
combina	kombˈina
culpa	kˈulpa
curashi	kurˈaʃi
es	ˈes
funda	fˈunda
goberna	ɡobˈerna
implementacion	implementasjˈoŋ
indice	indˈise
motiva	motˈiva
oferta	ofˈerta
seno	sˈeno
solido	solˈido
tiro	tˈiro
Plat	plˈat
aplaudi	aplaˈudi
beslag	beslˈaɡ
biniendo	binjˈendo
canta	kˈanta
colecta	kolˈekta
consehonan	konsehˈonan
daña	dˈaɲa
debido	debˈido
defini	defˈini
desastre	desˈastre
diabetes	djabetˈes
disculpa	diskˈulpa
emocional	emosjonˈal
escala	eskˈala
esfuersonan	esfwersˈonan
hamber	hambˈer
loonsubsidie	loːnsubsˈidje
meld	mˈeld
muestra	mwˈestra
norma	nˈorma
on	ˈoŋ
pelicula	pelikˈula
personalmente	personalmˈente
promedio	promˈedjo
sospecha	sospˈet͡ʃa
tropical	tropikˈal
zorg	zˈorɡ
Canada	kanˈada
Eynan	ˈejnan
Horacio	horˈasjo
Rudy	rˈudi
Staten	statˈeŋ
compras	komprˈas
consumo	konsˈumo
contribuyente	kontribujˈente
dunadornan	dunadˈornan
eleccionnan	eleksjˈonnan
estadia	estˈadja
facilidadnan	fasilidˈadnan
formacion	formasjˈoŋ
kwartaal	kwartˈaːl
linea	linˈea
nocturno	noktˈurno
pospone	pospˈone
renoba	renˈoba
salba	sˈalba
saliendo	saljˈendo
sanitizer	sanitizˈer
tercer	tersˈer
Arthur	arthˈur
Hoben	hobˈeŋ
Iran	irˈaŋ
Museo	musˈeo
Ponson	ponsˈoŋ
bancario	bankˈarjo
bomberonan	bomberˈonan
cadena	kadˈena
crucial	krusjˈal
custumbra	kustˈumbra
diariamente	djarjamˈente
enberdad	enberdˈad
exposicion	eksposisjˈoŋ
eyden	ejdˈeŋ
formula	formˈula
gobernantenan	ɡobernantˈenan
graba	ɡrˈaba
horario	horˈarjo
inversionista	inversjonˈista
investigacionnan	investiɡasjˈonnan
march	mˈart͡ʃ
maritimo	maritˈimo
monitor	monitˈor
muraya	murˈaja
planificacion	planifikasjˈoŋ
propiedad	propjedˈad
scur	skˈur
sentimento	sentimˈento
sesion	sesjˈoŋ
soño	sˈoɲo
tecnico	teknˈiko
tendencia	tendˈensja
Biyon	bijˈoŋ
Docter	doktˈer
Hecho	hˈet͡ʃo
Park	pˈark
Parkietenbos	parkjetenbˈos
Ronella	ronˈella
Sector	sektˈor
Sinterklaas	sinterklˈaːs
Transporte	transpˈorte
World	wˈorld
bancarota	bankarˈota
confia	kˈonfja
data	dˈata
encurasha	enkurˈaʃa
informativo	informatˈivo
inicial	inisjˈal
manifestacion	manifestasjˈoŋ
masculino	maskulˈino
mitiga	mitˈiɡa
naturalmente	naturalmˈente
staciona	stasjˈona
temporalmente	temporalmˈente
unidadnan	unidˈadnan
Arubus	arubˈus
Biblioteca	bibljotˈeka
DNM	dˌeˌɛnˈɛm
Finanzas	finanzˈas
Inglatera	inɡlatˈera
Kiermen	kjermˈeŋ
Miami	mjˈami
Ni	nˈi
Promer	promˈer
adelanta	adelˈanta
apunta	apˈunta
atake	atˈake
caro	kˈaro
cende	sˈende
combersa	kombˈersa
conscientisacion	konssjentisasjˈoŋ
contracto	kontrˈakto
culpable	kulpˈable
equipo	ekwˈipo
eventonan	eventˈonan
fayecido	fajesˈido
grandemente	ɡrandemˈente
gremio	ɡrˈemjo
impresion	impresjˈoŋ
incluso	inklˈuso
inversionistanan	inversjonistˈanan
ladronnan	ladrˈonnan
lagando	laɡˈando
miles	milˈes
pazuid	pazˈujd
promesa	promˈesa
radio	rˈadjo
recomendacion	rekomendasjˈoŋ
talento	talˈento
varia	vˈarja
vecindario	vesindˈarjo
voluntario	voluntˈarjo
CBS	sˌebˌeˈɛs
Cacique	kasˈikwe
Caribense	karibˈense
Chines	t͡ʃinˈes
FADA	fˈada
Madiki	madˈiki
One	ˈone
Prensa	prˈensa
Uno	ˈuno
accionnan	aksjˈonnan
alternativa	alternatˈiva
anticipa	antisˈipa
barconan	barkˈonan
bentana	bentˈana
bibo	bˈibo
candidatonan	kandidatˈonan
constitucional	konstitusjonˈal
copia	kˈopja
cushina	kuʃˈina
dr	dˌeˈɛr
fuera	fwˈera
keha	kˈeha
marihuana	marihwˈana
page	pˈaxe
piedra	pjˈedra
pinta	pˈinta
pronostica	pronostˈika
reconocimento	rekonosimˈento
renobacion	renobasjˈoŋ
separa	sepˈara
transferi	transfˈeri
valioso	valjˈoso
voor	vˈoːr
Asociacion	asosjasjˈoŋ
Bombero	bombˈero
Democratico	demokratˈiko
Lago	lˈaɡo
Mansur	mansˈur
agradecido	aɡradesˈido
awacero	awasˈero
banconan	bankˈonan
cachonan	kat͡ʃˈonan
creatividad	kreatividˈad
cuchiu	kˈut͡ʃju
fantasia	fantˈasja
financia	finˈansja
mascara	maskˈara
mente	mˈente
moral	morˈal
obra	ˈobra
positivity	positivˈiti
prijsnan	prˈe͡ɪsnan
prima	prˈima
regimen	reximˈeŋ
restaurantnan	restaurˈantnan
sangura	sanɡˈura
shelter	ʃeltˈer
sikiera	sikjˈera
simpel	simpˈel
sindical	sindikˈal
spaar	spˈaːr
specificamente	spesifikamˈente
sucedido	susedˈido
television	televisjˈoŋ
Ami	ˈami
DAO	dˈao
FPNA	fpnˈa
Guaidó	ɡwa͡ɪdˈo
Ministernan	ministˈernan
Renaissance	rena͡ɪssˈanse
anda	ˈanda
bari	bˈari
caracter	karaktˈer
complica	komplˈika
corant	korˈant
cronico	kronˈiko
escoge	eskˈoxe
ideanan	ideˈanan
indicando	indikˈando
instituto	institˈuto
lanza	lˈanza
piscadornan	piskadˈornan
programanan	proɡramˈanan
raport	rapˈort
resalta	resˈalta
seriedad	serjedˈad
speranza	sperˈanza
temporal	temporˈal
topiconan	topikˈonan
Bushiri	buʃˈiri
Cosecha	kosˈet͡ʃa
Festival	festivˈal
Figaroa	fiɡarˈoa
Hooiberg	hoːjbˈerɡ
Italia	itˈalja
Kruis	krˈujs
Kustwacht	kustwˈat͡ʃt
Lejuez	lejwˈez
Manager	manaxˈer
Medico	medˈiko
Nelson	nelsˈoŋ
Nissan	nissˈaŋ
Real	reˈal
Rusia	rˈusja
Sea	sˈea
Task	tˈask
agentenan	axentˈenan
anteriormente	anterjormˈente
autonomo	autonˈomo
barionan	barjˈonan
comentario	komentˈarjo
educativo	edukatˈivo
fruta	frˈuta
glas	ɡlˈas
gobiernonan	ɡobjernˈonan
goza	ɡˈoza
hereda	herˈeda
hulandes	hulandˈes
limitacion	limitasjˈoŋ
localnan	lokˈalnan
mitar	mitˈar
persigui	persˈiɡj
suministra	suminˈistra
Amsterdam	amsterdˈam
Keda	kˈeda
Personanan	personˈanan
Reclassering	reklasserˈinɡ
Restaurant	restaurˈant
Santo	sˈanto
Tene	tˈene
Tweede	twˈeːde
adecua	adˈekwa
anja	ˈanja
atrae	atrˈae
boter	botˈer
botica	botˈika
cama	kˈama
contribuyentenan	kontribujentˈenan
dump	dˈump
eficiente	efisjˈente
financieramente	finansjeramˈente
fundeshi	fundˈeʃi
mask	mˈask
necesidadnan	nesesidˈadnan
pare	pˈare
piloto	pilˈoto
problematica	problematˈika
recurso	rekˈurso
representacion	representasjˈoŋ
resolve	resˈolve
sacrificio	sakrifˈisjo
secundario	sekundˈarjo
sugeri	suxˈeri
tini	tˈini
yabi	jˈabi
Avenida	avenˈida
Boneiru	bonˈe͡ɪru
Diferente	diferˈente
Euro	ˈewro
HOH	hˈoh
Investigacion	investiɡasjˈoŋ
SMFA	smfˈa
STA	stˈa
Vanessa	vanˈessa
acompaña	akompˈaɲa
acorda	akˈorda
bez	bˈez
bruto	brˈuto
capital	kapitˈal
cauteloso	kautelˈoso
cometi	komˈeti
continuo	kontˈinwo
crusero	krusˈero
cumbre	kˈumbre
delibera	delibˈera
diploma	diplˈoma
drasticamente	drastikamˈente
exacto	eksˈakto
hues	hwˈes
link	lˈink
musico	musˈiko
otorgamento	otorɡamˈento
paketenan	paketˈenan
pesar	pesˈar
petrolero	petrolˈero
posiblemente	posiblemˈente
redaccion	redaksjˈoŋ
reformanan	reformˈanan
registro	rexˈistro
riesgonan	rjesɡˈonan
rij	rˈe͡ɪ
sincero	sinsˈero
solidaridad	solidaridˈad
sorprendi	sorprˈendi
tiramento	tiramˈento
FTA	ftˈa
Lions	ljˈons
Master	mastˈer
SADA	sˈada
WHO	whˈo
aglomera	aɡlomˈera
ancra	ˈankra
bus	bˈus
casino	kasˈino
cientifico	sjentifˈiko
destaho	destˈaho
estableci	establˈesi
factornan	faktˈornan
gaña	ɡˈaɲa
lus	lˈus
mercadonan	merkadˈonan
mortal	mortˈal
naci	nˈasi
plamamento	plamamˈento
potretnan	potrˈetnan
solidario	solidˈarjo
sorteo	sortˈeo
structural	strukturˈal
APA	ˈapa
Akinan	akˈinan
Ambulans	ambulˈans
FPNC	ˌɛfpˌeˌɛnsˈe
Frank	frˈank
Pabien	pabjˈeŋ
Presupuesto	presupwˈesto
RED	rˈed
Ultimo	ultˈimo
accident	aksidˈent
agresivo	aɡresˈivo
bandera	bandˈera
bendi	bˈendi
beneficionan	benefisjˈonan
cash	kˈaʃ
concentra	konsˈentra
contexto	kontˈeksto
desmenti	desmˈenti
domestico	domestˈiko
echo	ˈet͡ʃo
expone	ekspˈone
fiha	fˈiha
instrumento	instrumˈento
likides	likidˈes
pidiendo	pidjˈendo
potencial	potensjˈal
schedule	st͡ʃedˈule
todo	tˈodo
Atraco	atrˈako
Boso	bˈoso
City	sˈiti
Companianan	kompanjˈanan
Dellanire	dellanˈire
Food	fˈoːd
Force	fˈorse
Hof	hˈof
Hubenil	hubenˈil
Importante	importˈante
Primario	primˈarjo
SVOA	svˈoa
Vista	vˈista
bisto	bˈisto
caduca	kadˈuka
canto	kˈanto
comporta	kompˈorta
ehecutivo	ehekutˈivo
enfrente	enfrˈente
fungi	fˈunxi
instante	instˈante
intermedia	intermˈedja
inversionnan	inversjˈonnan
mannan	mˈannan
oktober	oktobˈer
pagando	paɡˈando
partnernan	partnˈernan
preocupacionnan	preokupasjˈonnan
rason	rasˈoŋ
reanuda	reanˈuda
remedinan	remedˈinan
temperatura	temperatˈura
tradicional	tradisjonˈal
vacacion	vakasjˈoŋ
DAS	dˈas
Guera	ɡˈera
Plenipotenciario	plenipotensjˈarjo
Señor	seɲˈor
Solamente	solamˈente
Tres	trˈes
acuerdonan	akwerdˈonan
beneficia	benefˈisja
berguensa	berɡˈensa
bicicleta	bisiklˈeta
boga	bˈoɡa
canal	kanˈal
clima	klˈima
delito	delˈito
dialoga	djalˈoɡa
disponible	disponˈible
eligi	elˈixi
gobernante	ɡobernˈante
hustifica	hustifˈika
inspira	inspˈira
labor	labˈor
palabracion	palabrasjˈoŋ
relacionnan	relasjˈonnan
sernan	sˈernan
traspasa	traspˈasa
AO	ˈao
Finansa	finˈansa
Informacion	informasjˈoŋ
Kibrahacha	kibrahˈat͡ʃa
Linda	lˈinda
Of	ˈof
SABA	sˈaba
Shelter	ʃeltˈer
Toyota	tojˈota
adaptacion	adaptasjˈoŋ
agricultura	aɡrikultˈura
birando	birˈando
borchi	bˈort͡ʃi
calor	kalˈor
capaz	kapˈaz
diseña	disˈeɲa
forensico	forensˈiko
ganashi	ɡanˈaʃi
golpi	ɡˈolpi
imposibel	imposibˈel
inmediato	inmedjˈato
kedando	kedˈando
kehonan	kehˈonan
labora	labˈora
leve	lˈeve
likidez	likidˈez
liña	lˈiɲa
mando	mˈando
operacional	operasjonˈal
plasma	plˈasma
portal	portˈal
pro	prˈo
responsable	responsˈable
security	sekurˈiti
vocifera	vosifˈera
AWG	ˈawɡ
American	amerikˈaŋ
BCA	bkˈa
Berdad	berdˈad
Biden	bidˈeŋ
Green	ɡrˈeːŋ
Lider	lidˈer
Marriott	marrjˈott
OPPA	ˈoppa
Patruya	patrˈuja
Renny	rˈenni
Rooi	rˈoːj
SPA	spˈa
Vocero	vosˈero
Voz	vˈoz
acumula	akumˈula
ambtenaar	ambtenˈaːr
biblioteca	bibljotˈeka
capitan	kapitˈaŋ
clase	klˈase
confirmacion	konfirmasjˈoŋ
cualifica	kwalifˈika
debito	debˈito
despedi	despˈedi
dicta	dˈikta
directora	direktˈora
era	ˈera
fortifica	fortifˈika
getest	xetˈest
is	ˈis
nanishi	nanˈiʃi
notificacion	notifikasjˈoŋ
operacionnan	operasjˈonnan
pertenece	pertenˈese
ppt	pˌepˌetˈe
salvaguardia	salvaɡwˈardja
scan	skˈaŋ
spanta	spˈanta
takelwagen	takelwaxˈeŋ
taxi	tˈaksi
tormenta	tormˈenta
vigilancia	vixilˈansja
Carnival	karnivˈal
Cifranan	sifrˈanan
CoronaVirus	korˈonavirˈus
Democrata	demokrˈata
John	jˈohŋ
Laga	lˈaɡa
Ling	lˈinɡ
Toch	tˈot͡ʃ
Wit	wˈit
acelera	aselˈera
adecuado	adekwˈado
adelante	adelˈante
aniversario	aniversˈarjo
aplicabel	aplikabˈel
aserca	asˈerka
aya	ˈaja
bebida	bebˈida
bisiñanan	bisiɲˈanan
certificado	sertifikˈado
compila	kompˈila
desvia	dˈesvja
eleva	elˈeva
funcionamento	funsjonamˈento
generacionnan	xenerasjˈonnan
global	ɡlobˈal
inespera	inespˈera
intercepta	intersˈepta
internacionalmente	internasjonalmˈente
localidadnan	lokalidˈadnan
memey	memˈej
monitorea	monitorˈea
naturaleza	naturalˈeza
obtenibel	obtenibˈel
ordena	ordˈena
ponencia	ponˈensja
rapidamente	rapidamˈente
sla	slˈa
stap	stˈap
supermarket	supermarkˈet
teni	tˈeni
tension	tensjˈoŋ
toyota	tojˈota
Civil	sivˈil
Clientenan	kljentˈenan
DTI	dtˈi
GKMB	ɡˌekˌaˌɛmbˈe
Helicopter	helikoptˈer
Hunta	hˈunta
KLM	kˌaˌɛlˈɛm
Mexico	meksˈiko
Misa	mˈisa
Organisacion	orɡanisasjˈoŋ
Ras	rˈas
asalto	asˈalto
blauw	blaˈuw
cai	kˈa͡ɪ
ehercicio	ehersˈisjo
keintura	ke͡ɪntˈura
liderazgo	liderˈazɡo
ma	mˈa
militar	militˈar
minimalisa	minimalˈisa
papelnan	papˈelnan
pober	pobˈer
purbando	purbˈando
recomendacionnan	rekomendasjˈonnan
siguiendo	siɡjˈendo
taxista	taksˈista
tayer	tajˈer
terminal	terminˈal
vence	vˈense
ATIA	ˈatja
Albertus	albertˈus
Estadistica	estadistˈika
Happiness	happinˈess
Informantenan	informantˈenan
Ingles	inɡlˈes
Jan	jˈaŋ
Mama	mˈama
OCCA	ˈokka
Proteccion	proteksjˈoŋ
Siglo	sˈiɡlo
Supermarket	supermarkˈet
Total	totˈal
Unda	ˈunda
Wardakosta	wardakˈosta
alivia	alˈivja
amiga	amˈiɡa
bise	bˈise
cansa	kˈansa
captura	kaptˈura
carni	kˈarni
cayente	kajˈente
chauffeurnan	t͡ʃauffˈewrnan
consehero	konsehˈero
der	dˈer
dinamico	dinamˈiko
encargo	enkˈarɡo
escenario	essenˈarjo
famoso	famˈoso
fenomeno	fenomˈeno
fiho	fˈiho
finanzas	finanzˈas
fout	fˈowt
fresco	frˈesko
futbol	futbˈol
geel	xˈeːl
griep	ɡrjˈep
hit	hˈit
inspeccion	inspeksjˈoŋ
luganan	luɡˈanan
matanan	matˈanan
musiconan	musikˈonan
poniendo	ponjˈendo
pronostico	pronostˈiko
proposito	proposˈito
reconstrui	rekonstrˈuj
regularmente	reɡularmˈente
sperando	sperˈando
status	statˈus
suerte	swˈerte
supera	supˈera
terminacion	terminasjˈoŋ
tire	tˈire
yora	jˈora
Balashi	balˈaʃi
Care	kˈare
Flip	flˈip
Ki	kˈi
Maneho	manˈeho
Mayornan	majˈornan
Naturalmente	naturalmˈente
Obispo	obˈispo
Rasmijn	rasmˈe͡ɪŋ
Sindicatonan	sindikatˈonan
Taxi	tˈaksi
Willemstad	willemstˈad
adultonan	adultˈonan
airco	ˈa͡ɪrko
berdura	berdˈura
birada	birˈada
corectamente	korektamˈente
coy	kˈoj
dicon	dikˈoŋ
entiero	entjˈero
exporta	ekspˈorta
festival	festivˈal
gas	ɡˈas
gosa	ɡˈosa
incidente	insidˈente
jong	jˈonɡ
labamento	labamˈento
mericano	merikˈano
nort	nˈort
orguyo	ˈorɡjo
pleno	plˈeno
publicidad	publisidˈad
pulmon	pulmˈoŋ
rementa	remˈenta
specialisa	spesjalˈisa
stricto	strˈikto
tratado	tratˈado
verifica	verifˈika
Dama	dˈama
Douane	dowˈane
Expertonan	ekspertˈonan
Inspector	inspektˈor
Isla	ˈisla
Masha	mˈaʃa
Quota	kwˈota
YMCA	ˈimka
administrativo	administratˈivo
alavez	alavˈez
aprecio	aprˈesjo
atractivo	atraktˈivo
bala	bˈala
cercania	serkˈanja
cobransa	kobrˈansa
compromete	kompromˈete
contratista	kontratˈista
duracion	durasjˈoŋ
empeora	empeˈora
escrito	eskrˈito
firme	fˈirme
gradualmente	ɡradwalmˈente
identidad	identidˈad
ministerial	ministerjˈal
mobilisa	mobilˈisa
obtene	obtˈene
operador	operadˈor
patruyando	patrujˈando
posibilidadnan	posibilidˈadnan
principionan	prinsipjˈonan
promocion	promosjˈoŋ
regional	rexjonˈal
relevante	relevˈante
repasa	repˈasa
restriccion	restriksjˈoŋ
Barcadera	barkadˈera
Bestuurskantoor	bestyrskantˈoːr
Bomberonan	bomberˈonan
Fondo	fˈondo
Instituto	institˈuto
Jossy	jˈossi
Marina	marˈina
Obispado	obispˈado
Place	plˈase
Proyecto	projˈekto
Registro	rexˈistro
Smith	smˈith
Via	vjˈa
Vicente	visˈente
average	averˈaxe
barata	barˈata
concierto	konsjˈerto
conflicto	konflˈikto
conosi	konˈosi
contrato	kontrˈato
creacion	kreasjˈoŋ
credito	kredˈito
culmina	kulmˈina
curazon	kurazˈoŋ
fundamental	fundamentˈal
inconveniencia	inkonvenjˈensja
interino	interˈino
limpiesa	limpjˈesa
moneda	monˈeda
publicamente	publikamˈente
puesto	pwˈesto
sumanan	sumˈanan
trayectoria	trajektˈorja
Ariba	arˈiba
Bario	bˈarjo
Carlos	karlˈos
Casonan	kasˈonan
Claro	klˈaro
Edgard	edɡˈard
Freewinds	freːwˈinds
Futuro	futˈuro
Gele	xˈele
Industria	indˈustrja
Jacobs	jakˈobs
Kizas	kizˈas
Meta	mˈeta
Rancho	rˈant͡ʃo
Wayaca	wajˈaka
abase	abˈase
accidenta	aksidˈenta
animal	animˈal
asesinato	asesinˈato
basicamente	basikamˈente
botonan	botˈonan
creando	kreˈando
delicado	delikˈado
deportivo	deportˈivo
desconfiansa	deskonfjˈansa
docternan	doktˈernan
estrecho	estrˈet͡ʃo
fluho	flˈuho
garganta	ɡarɡˈanta
hipoteca	hipotˈeka
hotelero	hotelˈero
kia	kjˈa
monumento	monumˈento
paramedico	paramedˈiko
parkinglot	parkinɡlˈot
periodista	perjodˈista
posponi	pospˈoni
proceduranan	prosedurˈanan
proyeccion	projeksjˈoŋ
rescata	reskˈata
robez	robˈez
shinishi	ʃinˈiʃi
sink	sˈink
top	tˈop
vergunning	verɡunnˈinɡ
vital	vitˈal
workshop	workʃˈop
zuid	zˈujd
Anto	ˈanto
Control	kontrˈol
Daphne	dˈaphne
Drive	drˈive
FCCA	fkkˈa
Hefe	hˈefe
Himno	hˈimno
Jurette	jurˈette
Pau	pˈau
Paul	paˈul
Pontilius	pontiljˈus
Spaña	spˈaɲa
acentua	asˈentwa
alarmante	alarmˈante
animo	anˈimo
antemano	antemˈano
artistanan	artistˈanan
buraco	burˈako
cercano	serkˈano
colabora	kolabˈora
combinacion	kombinasjˈoŋ
considerando	konsiderˈando
consistiendo	konsistjˈendo
debate	debˈate
deposita	deposˈita
druk	drˈuk
finansas	finansˈas
herment	hermˈent
hombernan	hombˈernan
jega	jˈeɡa
memoria	memˈorja
mentira	mentˈira
museo	musˈeo
ocho	ˈot͡ʃo
oficinanan	ofisinˈanan
paralisa	paralˈisa
parke	pˈarke
pension	pensjˈoŋ
prescribi	preskrˈibi
profesion	profesjˈoŋ
projecto	projˈekto
pruebanan	prwebˈanan
rechasa	ret͡ʃˈasa
reina	rˈe͡ɪna
resorta	resˈorta
stabilidad	stabilidˈad
temblor	temblˈor
Alex	alˈeks
BO	bˈo
Boluntario	boluntˈarjo
Bon	bˈoŋ
Corridor	korridˈor
Decreto	dekrˈeto
Fuera	fwˈera
Groningen	ɡroninxˈeŋ
HH	hˌahˈa
Helder	heldˈer
Informacionnan	informasjˈonnan
Mega	mˈeɡa
National	natjonˈal
Puerto	pwˈerto
UTV	ˈutv
adiccion	adiksjˈoŋ
aereo	aerˈeo
atracadornan	atrakadˈornan
aumentando	aumentˈando
centronan	sentrˈonan
cero	sˈero
ciclista	siklˈista
clubnan	klˈubnan
contagionan	kontaxjˈonan
coregi	korˈexi
cuentanan	kwentˈanan
detayenan	detajˈenan
diseño	disˈeɲo
disparce	dispˈarse
distrito	distrˈito
een	ˈeːŋ
frontal	frontˈal
instalacion	instalasjˈoŋ
matutino	matutˈino
mediante	medjˈante
mensahenan	mensahˈenan
mensual	menswˈal
mln	ˌɛmˌɛlˈɛn
nesesario	nesesˈarjo
palabracionnan	palabrasjˈonnan
pedofil	pedofˈil
pic	pˈik
preparacionnan	preparasjˈonnan
ramo	rˈamo
relativamente	relativamˈente
sanitario	sanitˈarjo
sexo	sˈekso
strea	strˈea
terenonan	terenˈonan
trese	trˈese
trucknan	trˈukknan
votacion	votasjˈoŋ
yudando	judˈando
Ady	ˈadi
Air	ˈa͡ɪr
Beatrix	beatrˈiks
Bida	bˈida
Bucuti	bukˈuti
Cuminda	kumˈinda
Danies	danjˈes
Digicel	dixisˈel
Distanciamento	distansjamˈento
Entertainment	enterta͡ɪnmˈent
Francisco	fransˈisko
Hesus	hesˈus
MAVO	mˈavo
Musica	musˈika
Nobo	nˈobo
RDA	rdˈa
SMAC	smˈak
TV	tˌevˈe
Tampoco	tampˈoko
Teritorial	teritorjˈal
Trahadornan	trahadˈornan
Village	villˈaxe
Waf	wˈaf
Whatsapp	whatsˈapp
actualisacion	aktwalisasjˈoŋ
art	ˈart
bahada	bahˈada
baki	bˈaki
beachnan	beˈat͡ʃnan
brasa	brˈasa
buelo	bwˈelo
cabesante	kabesˈante
cobertura	kobertˈura
conserva	konsˈerva
descarta	deskˈarta
determinacion	determinasjˈoŋ
diaranzon	djaranzˈoŋ
enfrentando	enfrentˈando
estadonan	estadˈonan
extenso	ekstˈenso
fuentenan	fwentˈenan
innovativo	innovatˈivo
institutonan	institutˈonan
investigashon	investiɡaʃˈoŋ
mashin	maʃˈiŋ
negosacion	neɡosasjˈoŋ
oracion	orasjˈoŋ
organonan	orɡanˈonan
piscado	piskˈado
pushi	pˈuʃi
respiratorio	respiratˈorjo
sospecho	sospˈet͡ʃo
supuesto	supwˈesto
tanda	tˈanda
tradicion	tradisjˈoŋ
traficacion	trafikasjˈoŋ
yaris	jarˈis
Accidente	aksidˈente
Bandera	bandˈera
Botica	botˈika
Casi	kˈasi
Emergencia	emerxˈensja
Henriquez	henrikwˈez
Ken	kˈeŋ
March	mˈart͡ʃ
Ministerial	ministerjˈal
PM	pˌeˈɛm
Post	pˈost
Reclasering	reklaserˈinɡ
Rica	rˈika
Romano	romˈano
Saba	sˈaba
Sostenibel	sostenibˈel
Tabatin	tabatˈiŋ
atravez	atravˈez
bendemento	bendemˈento
boletin	boletˈiŋ
cumplimento	kumplimˈento
depresion	depresjˈoŋ
desastroso	desastrˈoso
disponibilidad	disponibilidˈad
experticio	ekspertˈisjo
fianza	fjˈanza
formanan	formˈanan
fundacionnan	fundasjˈonnan
gratitud	ɡratitˈud
habilidad	habilidˈad
honda	hˈonda
ideal	ideˈal
instrui	instrˈuj
intercambio	interkˈambjo
intimo	intˈimo
jama	jˈama
mercadeo	merkadˈeo
mitad	mitˈad
motociclista	motosiklˈista
nacemento	nasemˈento
obvio	ˈobvjo
pier	pjˈer
placer	plasˈer
provee	provˈeː
resta	rˈesta
rico	rˈiko
salarionan	salarjˈonan
saldo	sˈaldo
sosega	sosˈeɡa
suavisa	swavˈisa
suela	swˈela
tolera	tolˈera
train	trˈa͡ɪŋ
tranca	trˈanka
transaccion	transaksjˈoŋ
trato	trˈato
vulnerable	vulnerˈable
yerba	jˈerba
zink	zˈink
Academy	akadˈemi
GDP	ɡˌedˌepˈe
Hyundai	hjˈunda͡ɪ
IDEA	idˈea
Net	nˈet
Nunca	nˈunka
Organization	orɡanizatjˈoŋ
Parce	pˈarse
TUI	tˈuj
administracion	administrasjˈoŋ
agencia	axˈensja
asociacion	asosjasjˈoŋ
avanza	avˈanza
balornan	balˈornan
bebi	bˈebi
berdadero	berdadˈero
competi	kompˈeti
cunukero	kunukˈero
cuponan	kupˈonan
deliberacion	deliberasjˈoŋ
detenidonan	detenidˈonan
districto	distrˈikto
download	downloˈad
enemigo	enemˈiɡo
especial	espesjˈal
habon	habˈoŋ
hogarnan	hoɡˈarnan
incorecto	inkorˈekto
ingreso	inɡrˈeso
inhusto	inhˈusto
magnitud	maɡnitˈud
materialnan	materjˈalnan
matrimonio	matrimˈonjo
original	orixinˈal
paspoort	paspˈoːrt
poderoso	poderˈoso
precedente	presedˈente
provoca	provˈoka
realistico	realistˈiko
satisfaccion	satisfaksjˈoŋ
screen	skrˈeːŋ
sucu	sˈuku
videonan	videˈonan
Blok	blˈok
Blvd	bˌeˌɛlvˌedˈe
Business	businˈess
CEDE	sˈede
CPI	kpˈi
Gran	ɡrˈaŋ
Hato	hˈato
IVA	ˈiva
Shaba	ʃˈaba
Sigui	sˈiɡj
Triple	trˈiple
alimentacion	alimentasjˈoŋ
atraves	atravˈes
boluntarionan	boluntarjˈonan
castigonan	kastiɡˈonan
cellular	sellulˈar
chevrolet	t͡ʃevrolˈet
compleho	komplˈeho
conference	konferˈense
documentacion	dokumentasjˈoŋ
dokternan	doktˈernan
ekipa	ekˈipa
electronicamente	elektronikamˈente
estudionan	estudjˈonan
evaluando	evalwˈando
flexibilisa	fleksibilˈisa
funcionario	funsjonˈarjo
intercambia	interkˈambja
localmente	lokalmˈente
machine	mat͡ʃˈine
manager	manaxˈer
manipula	manipˈula
mentalidad	mentalidˈad
necesariamente	nesesarjamˈente
notario	notˈarjo
numbernan	numbˈernan
plantacion	plantasjˈoŋ
propaganda	propaɡˈanda
red	rˈed
regreso	reɡrˈeso
rescate	reskˈate
run	rˈuŋ
transferencia	transferˈensja
voz	vˈoz
AUA	ˈawa
Aduana	adwˈana
DEZHI	dˈezhi
Es	ˈes
Garage	ɡarˈaxe
Humano	humˈano
Mary	mˈari
Paisnan	pˈa͡ɪsnan
Refineria	refinˈerja
Ruiz	rˈujz
Service	servˈise
TOPA	tˈopa
Taekwondo	taekwˈondo
Trinidad	trinidˈad
Tropical	tropikˈal
University	universˈiti
Washington	waʃinɡtˈoŋ
academico	akademˈiko
ameno	amˈeno
animalnan	animˈalnan
aventura	aventˈura
baila	bˈa͡ɪla
bordo	bˈordo
coleccion	koleksjˈoŋ
cunukeronan	kunukerˈonan
dentista	dentˈista
diversificacion	diversifikasjˈoŋ
encamina	enkamˈina
fatal	fatˈal
fauna	faˈuna
gemeente	xemˈeːnte
grabacion	ɡrabasjˈoŋ
hubenil	hubenˈil
instruccionnan	instruksjˈonnan
kiermeen	kjermˈeːŋ
mientrastanto	mjentrastˈanto
optimal	optimˈal
parcialmente	parsjalmˈente
pensionadonan	pensjonadˈonan
peor	peˈor
plastic	plastˈik
psicologo	psikolˈoɡo
recesion	resesjˈoŋ
restaura	restaˈura
retraso	retrˈaso
seriamente	serjamˈente
shock	ʃˈokk
significante	siɡnifikˈante
smartphone	smartphˈone
sufriendo	sufrjˈendo
telefoon	telefˈoːŋ
uniform	unifˈorm
uzando	uzˈando
ABC	ˈabk
Aparentemente	aparentemˈente
Auto	aˈuto
Autoridad	autoridˈad
Derecho	derˈet͡ʃo
ELMAR	elmˈar
FM	ˌɛfˈɛm
Fase	fˈase
Halto	hˈalto
Hendenan	hendˈenan
Joe	jˈu
Michael	mit͡ʃaˈel
Onderwijs	onderwˈe͡ɪs
Peru	pˈeru
Rico	rˈiko
Roadservice	roadservˈise
Roberto	robˈerto
Shady	ʃˈadi
Taskforce	taskfˈorse
Teniendo	tenjˈendo
apropia	aprˈopja
azeta	azˈeta
boluntad	boluntˈad
brindando	brindˈando
buska	bˈuska
camera	kamˈera
cannabis	kannabˈis
cargamento	karɡamˈento
circumstancianan	sirkumstansjˈanan
communidad	kommunidˈad
conocimento	konosimˈento
conscientisa	konssjentˈisa
contagioso	kontaxjˈoso
continuacion	kontinwasjˈoŋ
convence	konvˈense
creciente	kresjˈente
desempleo	desemplˈeo
desicion	desisjˈoŋ
dignidad	diɡnidˈad
discriminacion	diskriminasjˈoŋ
doloroso	dolorˈoso
drentando	drentˈando
expansion	ekspansjˈoŋ
ganadornan	ɡanadˈornan
graduado	ɡradwˈado
impacta	impˈakta
indocumenta	indokumˈenta
inspiracion	inspirasjˈoŋ
integral	inteɡrˈal
live	lˈive
lock	lˈokk
miyones	mijonˈes
mutuo	mˈutwo
nabega	nabˈeɡa
pata	pˈata
permanente	permanˈente
piscadonan	piskadˈonan
president	presidˈent
primordial	primordjˈal
rebaho	rebˈaho
reconocemento	rekonosemˈento
rekisito	rekisˈito
sorprende	sorprˈende
stock	stˈokk
stoel	stˈul
stof	stˈof
suministro	suminˈistro
teritorial	teritorjˈal
trapa	trˈapa
trimester	trimestˈer
vez	vˈez
wela	wˈela
Activo	aktˈivo
Atrobe	atrˈobe
Consecuentemente	konsekwentemˈente
Fort	fˈort
Huis	hˈujs
Integridad	inteɡridˈad
Jose	jˈose
Kia	kjˈa
Linear	lineˈar
Matutino	matutˈino
Miss	mˈiss
Ricardo	rikˈardo
accesibel	aksesibˈel
admira	admˈira
aerolineanan	aerolineˈanan
angustia	anɡˈustja
bela	bˈela
combersacionnan	kombersasjˈonnan
comosifuera	komosifwˈera
confusion	konfusjˈoŋ
conmemora	konmemˈora
conteo	kontˈeo
costanan	kostˈanan
deduci	dedˈusi
desaparece	desaparˈese
devastador	devastadˈor
electronico	elektronˈiko
enbes	enbˈes
encarcela	enkarsˈela
entretenimento	entretenimˈento
facilmente	fasilmˈente
fix	fˈiks
honesto	honˈesto
hospitaliza	hospitalˈiza
increibel	inkre͡ɪbˈel
militarnan	militˈarnan
molestia	molˈestja
monetario	monetˈarjo
muda	mˈuda
obhetivo	obhetˈivo
pool	pˈoːl
presidencial	presidensjˈal
presupuesta	presupwˈesta
resiliente	resiljˈente
stabil	stabˈil
supletorio	supletˈorjo
tanki	tˈanki
taxistanan	taksistˈanan
unit	unˈit
visibel	visibˈel
Abogado	aboɡˈado
Antes	antˈes
Baby	bˈabi
Baly	bˈali
Digital	dixitˈal
Divi	dˈivi
IT	ˈit
Josephine	josephˈine
Kavel	kavˈel
Liber	libˈer
Metal	metˈal
Metanan	metˈanan
Papa	pˈapa
Seccion	seksjˈoŋ
Spaño	spˈaɲo
Tara	tˈara
Trigt	trˈiɡt
Unidad	unidˈad
Valdes	valdˈes
Vice	vˈise
Werleman	werlemˈaŋ
Zodiac	zodjˈak
aclarea	aklarˈea
adkiri	adkˈiri
aviacion	avjasjˈoŋ
añadi	aɲˈadi
bos	bˈos
calculacion	kalkulasjˈoŋ
cendi	sˈendi
cobranza	kobrˈanza
constelacion	konstelasjˈoŋ
cuero	kwˈero
deposito	deposˈito
desordo	desˈordo
economicamente	ekonomikamˈente
epidemia	epidˈemja
esei	ˈese͡ɪ
esencia	esˈensja
eyfo	ˈejfo
fiestanan	fjestˈanan
ful	fˈul
gesto	xˈesto
hancra	hˈankra
holo	hˈolo
hubentud	hubentˈud
interogacion	interoɡasjˈoŋ
kg	kˌaɡˈe
luznan	lˈuznan
mercancia	merkˈansja
metodo	metˈodo
motorisa	motorˈisa
negligencia	neɡlixˈensja
peaton	peatˈoŋ
percela	persˈela
playa	plˈaja
prestamonan	prestamˈonan
primordialmente	primordjalmˈente
proponi	propˈoni
propuesta	propwˈesta
recursonan	rekursˈonan
reemplasa	reːmplˈasa
repatriacion	repatrjasjˈoŋ
respectivamente	respektivamˈente
seco	sˈeko
significa	siɡnifˈika
silencio	silˈensjo
skerpi	skˈerpi
slachtofferhulp	slat͡ʃtofferhˈulp
splika	splˈika
superior	superjˈor
supervisa	supervˈisa
trauma	traˈuma
urna	ˈurna
visual	viswˈal
vooral	voːrˈal
Asamblea	asamblˈea
Cumana	kumˈana
Cura	kˈura
Dirks	dˈirks
Entrada	entrˈada
Fiesta	fjˈesta
Francia	frˈansja
Fun	fˈuŋ
HAVA	hˈava
Jenny	jˈenni
Kòrsou	kˈɔrsow
Mastercard	masterkˈard
Ministronan	ministrˈonan
Normalmente	normalmˈente
Olimpico	olimpˈiko
PPA	ppˈa
Panama	panˈama
Parada	parˈada
Republicano	republikˈano
Scolnan	skˈolnan
Shark	ʃˈark
Toezicht	tuzˈit͡ʃt
UA	wˈa
actuacion	aktwasjˈoŋ
agradabel	aɡradabˈel
asegurado	aseɡurˈado
baca	bˈaka
bom	bˈom
camara	kamˈara
canalnan	kanˈalnan
castigabel	kastiɡabˈel
comprobante	komprobˈante
conhunto	konhˈunto
conservacion	konservasjˈoŋ
cortamento	kortamˈento
corupto	korˈupto
costumber	kostumbˈer
deadline	deadlˈine
detaya	detˈaja
diversifica	diversifˈika
excepcional	ekssepsjonˈal
exitosamente	eksitosamˈente
explora	eksplˈora
extraordinario	ekstraordinˈarjo
extremo	ekstrˈemo
eybanda	ejbˈanda
felicidad	felisidˈad
gang	ɡˈanɡ
hibe	hˈibe
humanidad	humanidˈad
hunta	hˈunta
instrumentonan	instrumentˈonan
jetBlue	jˈetblwˈe
kavel	kavˈel
lasonan	lasˈonan
logico	loxˈiko
mande	mˈande
mentor	mentˈor
ministro	minˈistro
muhernan	muhˈernan
obhecion	obhesjˈoŋ
plaka	plˈaka
practico	praktˈiko
pretende	pretˈende
privacidad	privasidˈad
recuperando	rekuperˈando
rednan	rˈednan
reflexiona	refleksjˈona
ricibiendo	risibjˈendo
rondona	rondˈona
skina	skˈina
sobrebibi	sobrebˈibi
specialistanan	spesjalistˈanan
tino	tˈino
tour	tˈowr
transforma	transfˈorma
traspaso	traspˈaso
traves	travˈes
Alfonso	alfˈonso
Antia	ˈantja
Articulo	artikˈulo
Basa	bˈasa
Bernadina	bernadˈina
Centraal	sentrˈaːl
Defensor	defensˈor
Edwin	edwˈiŋ
Mahuma	mahˈuma
Media	mˈedja
Miembronan	mjembrˈonan
Plas	plˈas
Prins	prˈins
SCP	ˌɛssˌepˈe
Sali	sˈali
Sons	sˈons
Studiantenan	studjantˈenan
Taxistanan	taksistˈanan
Test	tˈest
VRA	vrˈa
alerto	alˈerto
ansha	ˈanʃa
argumento	arɡumˈento
automobilistanan	automobilistˈanan
autorisacion	autorisasjˈoŋ
baho	bˈaho
card	kˈard
cardinal	kardinˈal
cortesia	kortˈesja
cria	krjˈa
cruel	krwˈel
desconfianza	deskonfjˈanza
desperdicio	desperdˈisjo
disgusto	disɡˈusto
fisicamente	fisikamˈente
grafico	ɡrafˈiko
hero	hˈero
incorpora	inkorpˈora
influenza	inflwˈenza
lamentabel	lamentabˈel
libremente	libremˈente
lidera	lidˈera
mandato	mandˈato
menu	mˈenu
pasashi	pasˈaʃi
pasion	pasjˈoŋ
positivismo	positivˈismo
reemplaza	reːmplˈaza
reglamento	reɡlamˈento
regulacion	reɡulasjˈoŋ
representando	representˈando
rumannan	rumˈannan
spaño	spˈaɲo
super	supˈer
suspende	suspˈende
suspendi	suspˈendi
task	tˈask
teritorio	teritˈorjo
testigonan	testiɡˈonan
texto	tˈeksto
tips	tˈips
trailer	tra͡ɪlˈer
tripulacion	tripulasjˈoŋ
ubica	ubˈika
worry	wˈorri
AM	ˈam
Abo	ˈabo
Abuso	abˈuso
Alemania	alemˈanja
Awendia	awˈendja
Balentina	balentˈina
Bay	bˈaj
Bijstand	be͡ɪstˈand
DRH	dˌeˌɛrhˈa
Dam	dˈam
Departamentonan	departamentˈonan
Educacion	edukasjˈoŋ
Haci	hˈasi
Henk	hˈenk
I	ˈi
Inmediatamente	inmedjatamˈente
Inspectie	inspˈektje
Luna	lˈuna
Miembro	mjˈembro
Organizacion	orɡanizasjˈoŋ
Palabra	palˈabra
Poco	pˈoko
REOI	reˈoj
Ruben	rubˈeŋ
Solutions	solutjˈons
Stef	stˈef
Tchong	tt͡ʃˈonɡ
Teishi	tˈe͡ɪʃi
Velasquez	velaskwˈez
Wilhelmina	wilhelmˈina
alaves	alavˈes
amienda	amjˈenda
aresta	arˈesta
automobilista	automobilˈista
autor	autˈor
avance	avˈanse
baile	bˈa͡ɪle
botter	bottˈer
cautela	kautˈela
charla	t͡ʃˈarla
choller	t͡ʃollˈer
code	kˈode
colga	kˈolɡa
comparacion	komparasjˈoŋ
compaña	kompˈaɲa
complicacion	komplikasjˈoŋ
declaracionnan	deklarasjˈonnan
dividi	divˈidi
drama	drˈama
excelente	eksselˈente
frecuentemente	frekwentemˈente
fuertemente	fwertemˈente
holor	holˈor
huramenta	huramˈenta
infunda	infˈunda
investigando	investiɡˈando
kilometer	kilometˈer
logronan	loɡrˈonan
luchando	lut͡ʃˈando
machete	mat͡ʃˈete
manipulacion	manipulasjˈoŋ
metodonan	metodˈonan
optimista	optimˈista
paki	pˈaki
pas	pˈas
practicanan	praktikˈanan
realisacion	realisasjˈoŋ
renombra	renˈombra
restauracion	restaurasjˈoŋ
sagrado	saɡrˈado
score	skˈore
seminario	seminˈarjo
siglo	sˈiɡlo
sostenibilidad	sostenibilidˈad
standard	standˈard
sumo	sˈumo
supuestamente	supwestamˈente
tan	tˈaŋ
unanimamente	unanimamˈente
wiel	wjˈel
CEA	sˈea
Catiri	katˈiri
Diego	djˈeɡo
Directora	direktˈora
Erasmus	erasmˈus
Eva	ˈeva
Financiero	finansjˈero
Hernandez	hernandˈez
Horcan	horkˈaŋ
ID	ˈid
IMF	ˈimf
Intensive	intensˈive
Los	lˈos
Nisbet	nisbˈet
PG	pˌeɡˈe
Sur	sˈur
Unabes	unabˈes
United	unitˈed
Valero	valˈero
Willem	willˈem
adelanto	adelˈanto
aloca	alˈoka
artificial	artifisjˈal
atletanan	atletˈanan
bais	bˈa͡ɪs
boa	bˈoa
call	kˈall
caos	kaˈos
circunstancia	sirkunstˈansja
circunstancianan	sirkunstansjˈanan
ciudadnan	sjudˈadnan
confrontacion	konfrontasjˈoŋ
consensus	konsensˈus
datos	datˈos
decadanan	dekadˈanan
del	dˈel
delitonan	delitˈonan
eficiencia	efisjˈensja
emocion	emosjˈoŋ
entusiasmo	entusjˈasmo
eror	erˈor
esfuerzonan	esfwerzˈonan
evidencia	evidˈensja
exportacion	eksportasjˈoŋ
fayo	fˈajo
focus	fokˈus
huicio	hˈujsjo
incumplimento	inkumplimˈento
interactivo	interaktˈivo
interesado	interesˈado
interesadonan	interesadˈonan
kwihi	kwˈihi
manteniendo	mantenjˈendo
pensando	pensˈando
per	pˈer
prolongacion	prolonɡasjˈoŋ
reclamo	reklˈamo
redobla	redˈobla
regala	reɡˈala
regarda	reɡˈarda
responde	respˈonde
rifa	rˈifa
scrap	skrˈap
seleccion	seleksjˈoŋ
sponsor	sponsˈor
staf	stˈaf
supermercadonan	supermerkadˈonan
transicion	transisjˈoŋ
vacunacion	vakunasjˈoŋ
version	versjˈoŋ
ATM	ˈatm
Alexander	aleksandˈer
Anne	ˈanne
Anthony	anthˈoni
Caminda	kamˈinda
Card	kˈard
Cratz	krˈatz
Cual	kwˈal
Dirksz	dˈirksz
Eustatius	ewstatjˈus
Evita	evˈita
Gobernacion	ɡobernasjˈoŋ
Henter	hentˈer
Hubentud	hubentˈud
Kudawecha	kudawˈet͡ʃa
Local	lokˈal
Man	mˈaŋ
Masnoticia	masnotˈisja
MetaCorp	mˈetakˈorp
Otronan	otrˈonan
PAHO	pˈaho
Pablo	pˈablo
Pedagogico	pedaɡoxˈiko
Placa	plˈaka
Rotary	rotˈari
Salazar	salazˈar
Tempo	tˈempo
Tratado	tratˈado
Venezolanonan	venezolanˈonan
actualisa	aktwalˈisa
benidero	benidˈero
bestianan	bestjˈanan
brainstorm	bra͡ɪnstˈorm
bukinan	bukˈinan
center	sentˈer
circulacion	sirkulasjˈoŋ
comproba	komprˈoba
consenshi	konsˈenʃi
costoso	kostˈoso
cuminsamento	kuminsamˈento
cursonan	kursˈonan
delivery	delivˈeri
dera	dˈera
desgracia	desɡrˈasja
despedida	despedˈida
distribui	distribˈuj
divisa	divˈisa
drive	drˈive
ehemplar	ehemplˈar
embargo	embˈarɡo
empresario	empresˈarjo
encuentronan	enkwentrˈonan
flexibilisacion	fleksibilisasjˈoŋ
flora	flˈora
fortalece	fortalˈese
gravedad	ɡravedˈad
imagennan	imaxˈennan
inaceptabel	inaseptabˈel
indirecto	indirˈekto
innecesario	innesesˈarjo
inseguridad	inseɡuridˈad
involucra	involˈukra
join	jˈojŋ
landa	lˈanda
meymey	mejmˈej
monton	montˈoŋ
motivacion	motivasjˈoŋ
negosha	neɡˈoʃa
oxigeno	oksixˈeno
pantaya	pantˈaja
pareu	parˈew
plazo	plˈazo
precario	prekˈarjo
radar	radˈar
razzia	rˈazzja
resisti	resˈisti
resort	resˈort
respecto	respˈekto
reta	rˈeta
rio	rjˈo
rudia	rˈudja
semanal	semanˈal
subsidia	subsˈidja
teoria	teˈorja
tiendanan	tjendˈanan
tip	tˈip
tratando	tratˈando
usuarionan	uswarjˈonan
Americano	amerikˈano
B	bˈe
Belgica	belxˈika
Cualkier	kwalkjˈer
Desiree	desirˈeː
Fin	fˈiŋ
Haiti	hˈa͡ɪti
Jennifer	jennifˈer
Kapel	kapˈel
Kende	kˈende
Kleuterschool	klewterst͡ʃˈoːl
Landsbesluit	landsbeslˈujt
Landsrecherche	landsret͡ʃˈert͡ʃe
Lee	lˈeː
Management	manaxemˈent
Meijer	me͡ɪjˈer
Ministerraad	ministerrˈaːd
Rincon	rinkˈoŋ
Rond	rˈond
Services	servisˈes
Supervision	supervisjˈoŋ
Suriname	surinˈame
Una	ˈuna
Veer	vˈeːr
Volksgezondheid	volksxezondhˈe͡ɪd
Youth	jˈowth
anciano	ansjˈano
apela	apˈela
areglonan	areɡlˈonan
bishitando	biʃitˈando
bleki	blˈeki
buelonan	bwelˈonan
circulando	sirkulˈando
circular	sirkulˈar
colectivo	kolektˈivo
consecuentemente	konsekwentemˈente
containernan	konta͡ɪnˈernan
controlando	kontrolˈando
coordina	koːrdˈina
dengue	dˈenɡe
desconocidonan	deskonosidˈonan
descuento	deskwˈento
destinacionnan	destinasjˈonnan
detenshon	detenʃˈoŋ
dirigentenan	dirixentˈenan
disgusta	disɡˈusta
dispone	dispˈone
disposicion	disposisjˈoŋ
donjo	dˈonjo
efectua	efˈektwa
escogencia	eskoxˈensja
factura	faktˈura
fomenta	fomˈenta
gram	ɡrˈam
gym	xˈim
ignora	iɡnˈora
inmenso	inmˈenso
interesnan	interˈesnan
internamente	internamˈente
lamentable	lamentˈable
liter	litˈer
logrando	loɡrˈando
mayan	majˈaŋ
mire	mˈire
obligacionnan	obliɡasjˈonnan
ofreci	ofrˈesi
pesca	pˈeska
planeta	planˈeta
posesion	posesjˈoŋ
proyeccionnan	projeksjˈonnan
residencia	residˈensja
sembra	sˈembra
sentimentonan	sentimentˈonan
substancial	substansjˈal
teatro	teˈatro
tiplijn	tiplˈe͡ɪŋ
traduci	tradˈusi
trankilo	trankˈilo
vloer	vlˈur
voluntarionan	voluntarjˈonan
Adicionalmente	adisjonalmˈente
Afdeling	afdelˈinɡ
Antonio	antˈonjo
Arqueologico	arkweoloxˈiko
Aruparking	aruparkˈinɡ
Brasil	brasˈil
CDC	sˌedˌesˈe
Ciencia	sjˈensja
Constitucion	konstitusjˈoŋ
Dande	dˈande
Daniel	danjˈel
Dokter	doktˈer
Domingo	domˈinɡo
Dus	dˈus
Esun	esˈuŋ
Hapon	hapˈoŋ
Hogeschool	hoxest͡ʃˈoːl
IBISA	ibˈisa
Interino	interˈino
Kier	kjˈer
Luz	lˈuz
MB	ˌɛmbˈe
Maske	mˈaske
Mental	mentˈal
Mervin	mervˈiŋ
Mil	mˈil
Miljard	miljˈard
Muhe	mˈuhe
Nederland	nederlˈand
Obama	obˈama
Orman	ormˈaŋ
Planea	planˈea
Politie	polˈitje
Rotterdam	rotterdˈam
Sallestraat	sallestrˈaːt
Scheepvaart	st͡ʃeːpvˈaːrt
Specialmente	spesjalmˈente
Tanten	tantˈeŋ
Tarabana	tarabˈana
Tormenta	tormˈenta
Tuma	tˈuma
Turistanan	turistˈanan
Weststraat	weststrˈaːt
absoluto	absolˈuto
accent	aksˈent
acomoda	akomˈoda
acomodacion	akomodasjˈoŋ
acompañante	akompaɲˈante
alrespecto	alrespˈekto
ampliacion	ampljasjˈoŋ
apart	apˈart
asilo	asˈilo
ateriza	aterˈiza
autorisa	autorˈisa
bataya	batˈaja
bateria	batˈerja
baño	bˈaɲo
calma	kˈalma
cantante	kantˈante
cartanan	kartˈanan
castiga	kastˈiɡa
chance	t͡ʃˈanse
circulo	sirkˈulo
comestibel	komestibˈel
confiabel	konfjabˈel
cunucu	kunˈuku
dam	dˈam
dat	dˈat
debil	debˈil
descripcion	deskripsjˈoŋ
detencionnan	detensjˈonnan
digitalisa	dixitalˈisa
distribucion	distribusjˈoŋ
down	dˈowŋ
electricidad	elektrisidˈad
eroneo	eronˈeo
fila	fˈila
firmamento	firmamˈento
fraude	fraˈude
frecuente	frekwˈente
gradicimento	ɡradisimˈento
habriendo	habrjˈendo
hari	hˈari
huesped	hwespˈed
huez	hwˈez
humilde	humˈilde
imagina	imaxˈina
inmunologico	inmunoloxˈiko
integro	intˈeɡro
inventa	invˈenta
klasnan	klˈasnan
laso	lˈaso
mapa	mˈapa
medaya	medˈaja
mete	mˈete
motoriza	motorˈiza
obstaculo	obstakˈulo
orarionan	orarjˈonan
organizacionnan	orɡanizasjˈonnan
parehanan	parehˈanan
parkeer	parkˈeːr
permisonan	permisˈonan
pick	pˈikk
piki	pˈiki
planifica	planifˈika
pos	pˈos
protehi	protˈehi
receta	resˈeta
rechaza	ret͡ʃˈaza
reforza	refˈorza
rekesitonan	rekesitˈonan
reservanan	reservˈanan
semi	sˈemi
sucursal	sukursˈal
sugerencia	suxerˈensja
tecnologico	teknoloxˈiko
tristeza	tristˈeza
veredicto	veredˈikto
wayanan	wajˈanan
yame	jˈame
yude	jˈude
ARUBIANO	arubjˈano
Alaves	alavˈes
Alivio	alˈivjo
Aviacion	avjasjˈoŋ
Avianca	avjˈanka
Bernabela	bernabˈela
Catolico	katolˈiko
Colorado	kolorˈado
Dicon	dikˈoŋ
EPB	ˈepb
Empleadonan	empleadˈonan
FDA	fdˈa
GNC	ɡˌeˌɛnsˈe
Haime	hˈa͡ɪme
Hildward	hildwˈard
Joan	joˈaŋ
Militair	militˈa͡ɪr
Nivel	nivˈel
Obra	ˈobra
Parti	pˈarti
Pastoor	pastˈoːr
Quandt	kwˈandt
Rapport	rappˈort
Representantenan	representantˈenan
Resultado	resultˈado
Rodgers	rodxˈers
SDGs	ˌɛsdˌeɡˌeˈɛs
SER	sˈer
Slachtofferhulp	slat͡ʃtofferhˈulp
Sport	spˈort
UPA	ˈupa
West	wˈest
acera	asˈera
activamente	aktivamˈente
agredi	aɡrˈedi
agresion	aɡresjˈoŋ
alegre	alˈeɡre
alimento	alimˈento
anticurpa	antikˈurpa
atraccion	atraksjˈoŋ
bringando	brinɡˈando
bruha	brˈuha
consecutivo	konsekutˈivo
contestanan	kontestˈanan
crusa	krˈusa
culpabel	kulpabˈel
damanan	damˈanan
delinea	delinˈea
diagnostico	djaɡnostˈiko
directornan	direktˈornan
discusionnan	diskusjˈonnan
euro	ˈewro
exclui	eksklˈuj
fada	fˈada
finansa	finˈansa
food	fˈoːd
formularionan	formularjˈonan
hechonan	het͡ʃˈonan
hibando	hibˈando
horizonte	horizˈonte
independencia	independˈensja
indesea	indesˈea
inicialmente	inisjalmˈente
inmunidad	inmunidˈad
inocente	inosˈente
invitado	invitˈado
juda	jˈuda
km	kˌaˈɛm
lancha	lˈant͡ʃa
landamento	landamˈento
lectornan	lektˈornan
limpieza	limpjˈeza
listra	lˈistra
loco	lˈoko
mahos	mahˈos
marino	marˈino
medicinal	medisinˈal
meimei	mˈe͡ɪme͡ɪ
nombernan	nombˈernan
ok	ˈok
opcionnan	opsjˈonnan
panorama	panorˈama
payroll	pajrˈoll
percepcion	persepsjˈoŋ
pista	pˈista
reconstruccion	rekonstruksjˈoŋ
reforsa	refˈorsa
sero	sˈero
socionan	sosjˈonan
staff	stˈaff
stichting	stit͡ʃtˈinɡ
storianan	storjˈanan
titula	titˈula
tosamento	tosamˈento
tristesa	tristˈesa
turbulencia	turbulˈensja
usuario	uswˈarjo
votado	votˈado
waya	wˈaja
yamado	jamˈado
ABV	ˈabv
ADR	ˈadr
ATV	ˈatv
AVB	ˈavb
Alavez	alavˈez
Avestruz	avestrˈuz
Basico	basˈiko
Cacho	kˈat͡ʃo
Conforme	konfˈorme
Contrario	kontrˈarjo
Dilanti	dilˈanti
Dominicano	dominikˈano
Escudero	eskudˈero
Fast	fˈast
Fonds	fˈonds
Give	xˈive
Guillfred	ɡjllfrˈed
Hotelnan	hotˈelnan
Libertador	libertadˈor
Marketing	marketˈinɡ
Medidanan	medidˈanan
OK	ˈok
PDVSA	pˈedvsˈa
PR	pˌeˈɛr
Page	pˈaxe
Persona	persˈona
Ports	pˈorts
Pronto	prˈonto
RIVM	rˈivm
Recien	resjˈeŋ
Rijksministerraad	re͡ɪksministerrˈaːd
Sanicolas	sanikolˈas
Segunda	seɡˈunda
Tobago	tobˈaɡo
Trahadonan	trahadˈonan
Weg	wˈeɡ
WhatsApp	whˈatsˈapp
alternativo	alternatˈivo
balie	bˈalje
bendicion	bendisjˈoŋ
bendiciona	bendisjˈona
bono	bˈono
bringamento	brinɡamˈento
camindanan	kamindˈanan
clausura	klausˈura
click	klˈikk
confrontando	konfrontˈando
continente	kontinˈente
coordinador	koːrdinadˈor
corespondiente	korespondjˈente
credibilidad	kredibilidˈad
debernan	debˈernan
destaca	destˈaka
detayes	detajˈes
digitalisacion	dixitalisasjˈoŋ
divisas	divisˈas
empuhe	empˈuhe
fam	fˈam
fechanan	fet͡ʃˈanan
figura	fiɡˈura
force	fˈorse
funcionarionan	funsjonarjˈonan
genero	xenˈero
habrimento	habrimˈento
heeft	hˈeːft
intentonan	intentˈonan
invalido	invalˈido
keur	kˈewr
marcha	mˈart͡ʃa
mision	misjˈoŋ
muy	mˈuj
negosacionnan	neɡosasjˈonnan
nombracion	nombrasjˈoŋ
ofertanan	ofertˈanan
panel	panˈel
particularmente	partikularmˈente
perfecto	perfˈekto
piscanan	piskˈanan
ponencianan	ponensjˈanan
preserva	presˈerva
prizon	prizˈoŋ
quizas	kwizˈas
referente	referˈente
reporta	repˈorta
resa	rˈesa
saludable	saludˈable
seccionnan	seksjˈonnan
sosodiendo	sosodjˈendo
sub	sˈub
testing	testˈinɡ
treciendo	tresjˈendo
work	wˈork
Arashi	arˈaʃi
Astec	astˈek
Autoridadnan	autoridˈadnan
BAZV	bˈazv
Basora	basˈora
Bestuur	bestˈyr
Buki	bˈuki
California	kalifˈornja
Cft	sˌeˌɛftˈe
Chevrolet	t͡ʃevrolˈet
Child	t͡ʃˈild
Comunicacion	komunikasjˈoŋ
Dentro	dˈentro
Djis	d͡ʒˈis
Electoral	elektorˈal
Esta	ˈesta
Exprodesk	eksprodˈesk
Filomena	filomˈena
George	xeˈorxe
Google	ɡˈoːɡle
Guardian	ɡwardjˈaŋ
LabHOH	lˈabhˈoh
Lenny	lˈenni
Mes	mˈes
Miles	milˈes
Mini	mˈini
Moko	mˈoko
Nada	nˈada
Norte	nˈorte
Plataforma	platafˈorma
Politico	politˈiko
Prof	prˈof
Royal	rojˈal
SEPPA	sˈeppa
Senado	senˈado
Tienda	tjˈenda
Tratamento	tratamˈento
UNESCO	unˈesko
Valdez	valdˈez
Visa	vˈisa
Yaris	jarˈis
aan	ˈaːŋ
adopta	adˈopta
afectando	afektˈando
artistico	artistˈiko
asbest	asbˈest
asta	ˈasta
ata	ˈata
audiencia	audjˈensja
biahamento	bjahamˈento
blokea	blokˈea
boei	bˈuj
campañanan	kampaɲˈanan
capa	kˈapa
capacita	kapasˈita
cayanan	kajˈanan
cien	sjˈeŋ
clinica	klinˈika
complice	komplˈise
constante	konstˈante
contacta	kontˈakta
crudo	krˈudo
desesperacion	desesperasjˈoŋ
desplega	desplˈeɡa
diferencianan	diferensjˈanan
elementonan	elementˈonan
elogio	elˈoxjo
enfermedadnan	enfermedˈadnan
ensera	ensˈera
entidadnan	entidˈadnan
envez	envˈez
felicitacion	felisitasjˈoŋ
frena	frˈena
fuel	fwˈel
gradua	ɡrˈadwa
heroe	hˈeru
inteligencia	intelixˈensja
interveni	intervˈeni
kaso	kˈaso
lage	lˈaxe
lansamento	lansamˈento
luhoso	luhˈoso
moratorio	moratˈorjo
netamente	netamˈente
nivelnan	nivˈelnan
obviamente	obvjamˈente
ocacion	okasjˈoŋ
origina	orixˈina
plastico	plastˈiko
pobresa	pobrˈesa
productivo	produktˈivo
profundamente	profundamˈente
rasa	rˈasa
raspa	rˈaspa
saluda	salˈuda
session	sessjˈoŋ
set	sˈet
sosteni	sostˈeni
studio	stˈudjo
tosa	tˈosa
yamadanan	jamadˈanan
Argentina	arxentˈina
Arubalening	arubalenˈinɡ
Awg	ˈawɡ
Back	bˈakk
Bao	bˈao
Bin	bˈiŋ
Booshi	bˈoːʃi
Cliente	kljˈente
Colombiano	kolombjˈano
Conferencia	konferˈensja
Cumpra	kˈumpra
David	davˈid
Daño	dˈaɲo
Derechonan	deret͡ʃˈonan
Diesel	djesˈel
Docternan	doktˈernan
Edward	edwˈard
Elite	elˈite
End	ˈend
Finansas	finansˈas
Ford	fˈord
Gomez	ɡomˈez
Grandinan	ɡrandˈinan
HTC	hˌatˌesˈe
House	hˈowse
Illes	illˈes
Instancia	instˈansja
Juffrouw	juffrˈoww
King	kˈinɡ
Luis	lˈujs
Mario	mˈarjo
Mediador	medjadˈor
Milieu	miljˈew
Mundialmente	mundjalmˈente
Pandemia	pandˈemja
Pfizer	pfizˈer
Rotaract	rotarˈakt
Siendo	sjˈendo
Sosten	sostˈeŋ
TUR	tˈur
Tata	tˈata
Telearuba	telearˈuba
Telefon	telefˈoŋ
Tevreden	tevredˈeŋ
Town	tˈowŋ
Unit	unˈit
WVB	wˌevˌebˈe
Zaken	zakˈeŋ
Zuid	zˈujd
advies	advjˈes
ambtenaarnan	ambtenˈaːrnan
amistad	amistˈad
ansiedad	ansjedˈad
aparte	apˈarte
asigna	asˈiɡna
atraca	atrˈaka
awasero	awasˈero
balora	balˈora
biahenan	bjahˈenan
biña	bˈiɲa
bofon	bofˈoŋ
by	bˈi
cantica	kantˈika
cena	sˈena
certifica	sertifˈika
confidencial	konfidensjˈal
contamina	kontamˈina
criteria	kritˈerja
debati	debˈati
delegacion	deleɡasjˈoŋ
dependiendo	dependjˈendo
diabetico	djabetˈiko
diagnostica	djaɡnostˈika
djies	d͡ʒjˈes
duidelijk	dujdelˈe͡ɪk
eerste	ˈeːrste
ekiponan	ekipˈonan
exclusivo	eksklusˈivo
externo	ekstˈerno
higiene	hixjˈene
homenahe	homenˈahe
igualdad	iɡwaldˈad
impresiona	impresjˈona
insinua	insˈinwa
institucion	institusjˈoŋ
interpreta	interprˈeta
interpretacion	interpretasjˈoŋ
intervencion	intervensjˈoŋ
kibrando	kibrˈando
kustwacht	kustwˈat͡ʃt
medicina	medisˈina
miseria	misˈerja
modera	modˈera
monumentonan	monumentˈonan
nombramento	nombramˈento
nomina	nomˈina
ohala	ohˈala
operadornan	operadˈornan
originalmente	orixinalmˈente
park	pˈark
parkeerplaats	parkeːrplˈaːts
partners	partnˈers
piscamento	piskamˈento
plaso	plˈaso
productor	produktˈor
prometedor	prometedˈor
reaccionnan	reaksjˈonnan
restriccionnan	restriksjˈonnan
sapato	sapˈato
seconde	sekˈonde
secuestra	sekwˈestra
spearfishing	spearfiʃˈinɡ
stul	stˈul
subiendo	subjˈendo
sushedad	suʃedˈad
tawatin	tawatˈiŋ
temor	temˈor
tine	tˈine
track	trˈakk
unabes	unabˈes
vandalismo	vandalˈismo
verbal	verbˈal
votadonan	votadˈonan
wordu	wˈordu
zonido	zonˈido
Abao	abˈao
Anual	anwˈal
Arutram	arutrˈam
Basta	bˈasta
Bosman	bosmˈaŋ
Bou	bˈow
Cabay	kabˈaj
Cantidad	kantidˈad
Casa	kˈasa
Day	dˈaj
Desk	dˈesk
Development	developmˈent
Diabetes	djabetˈes
Docentenan	dosentˈenan
Duna	dˈuna
Ecuador	ekwadˈor
Eleccion	eleksjˈoŋ
Gonzalez	ɡonzalˈez
Historia	histˈorja
Hitler	hitlˈer
Hulandesnan	hulandˈesnan
Hyatt	hjˈatt
Internet	internˈet
Loonsubsidie	loːnsubsˈidje
Lucia	lˈusja
Malmok	malmˈok
Mangel	manxˈel
Monumentenfonds	monumentenfˈonds
Natuur	natˈyr
Pavia	pˈavja
Pickup	pikkˈup
Prijs	prˈe͡ɪs
Protocol	protokˈol
RST	ˌɛrˌɛstˈe
Region	rexjˈoŋ
Regreso	reɡrˈeso
RevPAR	rˈevpˈar
Sasakiweg	sasakiwˈeɡ
Segundo	seɡˈundo
actuando	aktwˈando
alimenta	alimˈenta
anti	ˈanti
autorizacion	autorizasjˈoŋ
barcode	barkˈode
bebemento	bebemˈento
bonus	bonˈus
cabalmente	kabalmˈente
cambernan	kambˈernan
capitulo	kapitˈulo
cargo	kˈarɡo
categorianan	kateɡorjˈanan
cel	sˈel
clarifica	klarifˈika
concentracion	konsentrasjˈoŋ
condecoracion	kondekorasjˈoŋ
continuidad	kontinujdˈad
cosecha	kosˈet͡ʃa
cubo	kˈubo
danjo	dˈanjo
dependiente	dependjˈente
die	djˈe
diesel	djesˈel
dunabo	dunˈabo
elmar	elmˈar
elogia	elˈoxja
estimulo	estimˈulo
expectativa	ekspektatˈiva
exponi	ekspˈoni
fotografia	fotoɡrˈafja
gradual	ɡradwˈal
herido	herˈido
himno	hˈimno
hobenan	hobˈenan
horeca	horˈeka
hospitalisa	hospitalˈisa
huurdo	hˈyrdo
inciso	insˈiso
industrial	industrjˈal
informando	informˈando
intermediacion	intermedjasjˈoŋ
kaminda	kamˈinda
klapchi	klˈapt͡ʃi
libera	libˈera
liga	lˈiɡa
literatura	literatˈura
masterplan	masterplˈaŋ
migracion	miɡrasjˈoŋ
morde	mˈorde
operando	operˈando
organisando	orɡanisˈando
paro	pˈaro
parokia	parˈokja
participando	partisipˈando
personan	persˈonan
placentero	plasentˈero
pleito	plˈe͡ɪto
premionan	premjˈonan
preparatorio	preparatˈorjo
preso	prˈeso
prioridadnan	prjoridˈadnan
prosperidad	prosperidˈad
rango	rˈanɡo
razon	razˈoŋ
recibo	resˈibo
rehen	rehˈeŋ
religion	relixjˈoŋ
resistencia	resistˈensja
rumor	rumˈor
sacrifica	sakrifˈika
segunda	seɡˈunda
siguransa	siɡurˈansa
slip	slˈip
sobrevivencia	sobrevivˈensja
socio	sˈosjo
sostenible	sostenˈible
spierta	spjˈerta
spirito	spirˈito
stabilisa	stabilˈisa
stapnan	stˈapnan
studiando	studjˈando
substancia	substˈansja
sucesonan	susesˈonan
systema	sistˈema
tardi	tˈardi
transportacion	transportasjˈoŋ
tratadonan	tratadˈonan
webo	wˈebo
wowonan	wowˈonan
ALV	ˈalv
Atlantico	atlantˈiko
BES	bˈes
Bus	bˈus
Cunucu	kunˈuku
Dificultad	difikultˈad
Diripiente	diripjˈente
Ela	ˈela
Emmastraat	emmastrˈaːt
Falcon	falkˈoŋ
Falta	fˈalta
Fe	fˈe
Gamma	ɡˈamma
Gerencia	xerˈensja
Jaburibari	jaburibˈari
Karibe	karˈibe
LNG	ˌɛlˌɛnɡˈe
Lagoen	laɡˈuŋ
Logicamente	loxikamˈente
Marino	marˈino
Masterplan	masterplˈaŋ
Mr	ˌɛmˈɛr
Normal	normˈal
OM	ˈom
OMS	ˈoms
Piet	pjˈet
Prueba	prwˈeba
RCA	rkˈa
Rector	rektˈor
Recurso	rekˈurso
Sanders	sandˈers
Schakel	st͡ʃakˈel
Schiphol	st͡ʃiphˈol
Schwengle	st͡ʃwˈenɡle
Security	sekurˈiti
Specialista	spesjalˈista
Store	stˈore
Suzuki	suzˈuki
Taxista	taksˈista
Trabou	trabˈow
WiFi	wˈifˈi
Zoutman	zowtmˈaŋ
abogadonan	aboɡadˈonan
aclaria	aklˈarja
adictonan	adiktˈonan
afdeling	afdelˈinɡ
alomenos	alomenˈos
armanan	armˈanan
aseguradonan	aseɡuradˈonan
asombra	asˈombra
at	ˈat
atleta	atlˈeta
avionnan	avjˈonnan
añas	aɲˈas
best	bˈest
biaheronan	bjaherˈonan
borchinan	bort͡ʃˈinan
campus	kampˈus
cariño	karˈiɲo
celnan	sˈelnan
componente	komponˈente
comunista	komunˈista
convoca	konvˈoka
criadero	krjadˈero
cruza	krˈuza
cuidadano	kujdadˈano
dañino	daɲˈino
dede	dˈede
diplomatico	diplomatˈiko
documenta	dokumˈenta
dudoso	dudˈoso
dunadonan	dunadˈonan
especie	espˈesje
expresionnan	ekspresjˈonnan
feedback	feːdbˈakk
handsanitizer	handsanitizˈer
hemchi	hˈemt͡ʃi
hoga	hˈoɡa
hospitalidad	hospitalidˈad
ilegalnan	ileɡˈalnan
implica	implˈika
incinerator	insineratˈor
informashon	informaʃˈoŋ
intencionalmente	intensjonalmˈente
iresponsabel	iresponsabˈel
justicia	justˈisja
kleuter	klewtˈer
lastra	lˈastra
lema	lˈema
logicamente	loxikamˈente
mandatarionan	mandatarjˈonan
manual	manwˈal
nochi	nˈot͡ʃi
ofreciendo	ofresjˈendo
opone	opˈone
organizadornan	orɡanizadˈornan
parse	pˈarse
persecucion	persekusjˈoŋ
piek	pjˈek
plamando	plamˈando
pobreza	pobrˈeza
progresa	proɡrˈesa
psychiater	psit͡ʃjatˈer
reglamenta	reɡlamˈenta
reino	rˈe͡ɪno
relaha	relˈaha
restructura	restruktˈura
sacando	sakˈando
sancion	sansjˈoŋ
selecta	selˈekta
sensacion	sensasjˈoŋ
sercania	serkˈanja
sker	skˈer
software	softwˈare
suave	swˈave
superficie	superfˈisje
take	tˈake
tantisimo	tantisˈimo
teme	tˈeme
temporario	temporˈarjo
yamando	jamˈando
APFA	ˈapfa
ARA	ˈara
Al	ˈal
Art	ˈart
Arte	ˈarte
Biento	bjˈento
Boegoeroei	buɡurˈuj
Bond	bˈond
CDA	kdˈa
Caso	kˈaso
Commissie	kommˈissje
Congreso	konɡrˈeso
Cria	krjˈa
Cruise	krˈujse
Curason	kurasˈoŋ
Examen	eksamˈeŋ
Famianan	famjˈanan
Feliz	felˈiz
Flamingo	flamˈinɡo
Frans	frˈans
Gobiernonan	ɡobjernˈonan
Groot	ɡrˈoːt
Habitantenan	habitantˈenan
Hoo	hˈoː
Hose	hˈose
Imelda	imˈelda
Importacion	importasjˈoŋ
Inmigracion	inmiɡrasjˈoŋ
Interact	interˈakt
Kong	kˈonɡ
Laba	lˈaba
Laboral	laborˈal
Leo	lˈeo
Lito	lˈito
Live	lˈive
Lottery	lottˈeri
NOS	nˈos
Nicolaas	nikolˈaːs
Ocean	oseˈaŋ
Ohala	ohˈala
Palo	pˈalo
Pita	pˈita
Pro	prˈo
Qredits	kredˈits
Reunion	rewnjˈoŋ
Ritz	rˈitz
Seguridad	seɡuridˈad
Sta	stˈa
State	stˈate
Super	supˈer
Tumba	tˈumba
Veterinaire	veterinˈa͡ɪre
Well	wˈell
Women	womˈeŋ
Wuhan	wuhˈaŋ
abusonan	abusˈonan
aceptabel	aseptabˈel
acogida	akoxˈida
adhunto	adhˈunto
alternativanan	alternativˈanan
aproximadamente	aproksimadamˈente
aresto	arˈesto
atacha	atˈat͡ʃa
blokia	blˈokja
box	bˈoks
bureau	bureˈau
cancelacion	kanselasjˈoŋ
cancionnan	kansjˈonnan
carbon	karbˈoŋ
castigable	kastiɡˈable
cerebro	serˈebro
cielo	sjˈelo
ciencia	sjˈensja
cientificonan	sjentifikˈonan
coach	koˈat͡ʃ
coba	kˈoba
cognitivo	koɡnitˈivo
combatimento	kombatimˈento
combustibel	kombustibˈel
competente	kompetˈente
concientizacion	konsjentizasjˈoŋ
conocirnan	konosˈirnan
considerabel	konsiderabˈel
considerablemente	konsiderablemˈente
debolbe	debˈolbe
decisionan	desisjˈonan
despacha	despˈat͡ʃa
dirigente	dirixˈente
division	divisjˈoŋ
documentario	dokumentˈarjo
dramatico	dramatˈiko
ehecutivonan	ehekutivˈonan
ei	ˈe͡ɪ
elemento	elemˈento
empodera	empodˈera
enfermeronan	enfermerˈonan
entendi	entˈendi
escohe	eskˈohe
estrictamente	estriktamˈente
fiel	fjˈel
fit	fˈit
fragil	fraxˈil
galiña	ɡalˈiɲa
gritonan	ɡritˈonan
hayanan	hajˈanan
hora	hˈora
inaugura	inauɡˈura
individuo	indivˈidwo
inkomstenbelasting	inkomstenbelastˈinɡ
instalacionnan	instalasjˈonnan
intenso	intˈenso
interior	interjˈor
intrankilidad	intrankilidˈad
investigadornan	investiɡadˈornan
jeep	jˈeːp
ke	kˈe
kerstboom	kerstbˈoːm
kitando	kitˈando
laboratorionan	laboratorjˈonan
locura	lokˈura
lote	lˈote
mamanan	mamˈanan
management	manaxemˈent
met	mˈet
multitud	multitˈud
negociando	neɡosjˈando
netto	nˈetto
niet	njˈet
nificacion	nifikasjˈoŋ
observacion	observasjˈoŋ
ocaciona	okasjˈona
odio	ˈodjo
opleiding	ople͡ɪdˈinɡ
oranje	orˈanje
perseverancia	perseverˈansja
personalnan	personˈalnan
piesa	pjˈesa
pintura	pintˈura
pionero	pjonˈero
placanan	plakˈanan
primi	prˈimi
pronosticonan	pronostikˈonan
propietario	propjetˈarjo
recorido	rekorˈido
refugiado	refuxjˈado
religioso	relixjˈoso
resona	resˈona
rijkswet	re͡ɪkswˈet
sabi	sˈabi
sabiendo	sabjˈendo
segura	seɡˈura
sesionnan	sesjˈonnan
sex	sˈeks
señalnan	seɲˈalnan
silencia	silˈensja
simbolo	simbˈolo
sonido	sonˈido
soporta	sopˈorta
stage	stˈaxe
suzuki	suzˈuki
tennis	tennˈis
tent	tˈent
territorial	territorjˈal
trastorno	trastˈorno
turtuga	turtˈuɡa
unavez	unavˈez
valve	vˈalve
viaheronan	vjaherˈonan
weso	wˈeso
AIDS	ˈa͡ɪds
BOB	bˈob
Britania	britˈanja
Burger	burxˈer
CAO	kˈao
Casnan	kˈasnan
Conchi	kˈont͡ʃi
Condecoracion	kondekorasjˈoŋ
DTP	dˌetˌepˈe
Debit	debˈit
Deportivo	deportˈivo
Dushi	dˈuʃi
ED	ˈed
Edad	edˈad
Eddie	ˈeddje
Entiteit	entitˈe͡ɪt
Ex	ˈeks
Excelencia	eksselˈensja
Exxon	eksksˈoŋ
Formacion	formasjˈoŋ
HAVO	hˈavo
Haciendo	hasjˈendo
Hamas	hamˈas
Henny	hˈenni
Hobennan	hobˈennan
Honda	hˈonda
IBiSA	ibˈisˈa
Koopmans	koːpmˈans
Latin	latˈiŋ
Liliana	liljˈana
Lucky	lˈukki
Ma	mˈa
Maestro	maˈestro
Mitsubishi	mitsubˈiʃi
Negoshinan	neɡoʃˈinan
Ocupacion	okupasjˈoŋ
Officer	offisˈer
Penal	penˈal
Procurador	prokuradˈor
Quanten	kwantˈeŋ
Redaccion	redaksjˈoŋ
Relacionnan	relasjˈonnan
Rode	rˈode
Sousa	sˈowsa
Tours	tˈowrs
Trade	trˈade
Unico	unˈiko
Voogdijraad	voːɡde͡ɪrˈaːd
Wout	wˈowt
Young	jˈownɡ
aborda	abˈorda
accentua	aksˈentwa
accepta	aksˈepta
arubiano	arubjˈano
autobus	autobˈus
auxilio	auksˈiljo
balance	balˈanse
balans	balˈans
barnan	bˈarnan
bestuur	bestˈyr
cabay	kabˈaj
cambiando	kambjˈando
cent	sˈent
chekeo	t͡ʃekˈeo
chiquito	t͡ʃikwˈito
colegio	kolˈexjo
comisario	komisˈarjo
concientisacion	konsjentisasjˈoŋ
contaminacion	kontaminasjˈoŋ
cortina	kortˈina
criterianan	kriterjˈanan
cuarto	kwˈarto
cube	kˈube
damnan	dˈamnan
desafio	desˈafjo
direct	dirˈekt
distincion	distinsjˈoŋ
dobel	dobˈel
doctor	doktˈor
efectividad	efektividˈad
empresarial	empresarjˈal
entretene	entretˈene
eseynan	esˈejnan
excusa	ekskˈusa
ford	fˈord
habilidadnan	habilidˈadnan
hygiena	hixjˈena
illegal	illeɡˈal
imigracion	imiɡrasjˈoŋ
impedi	impˈedi
imponi	impˈoni
innova	innˈova
insulta	insˈulta
kap	kˈap
kleuterschool	klewterst͡ʃˈoːl
lamper	lampˈer
laptop	laptˈop
lokaal	lokˈaːl
medianan	medjˈanan
muhenan	muhˈenan
numa	nˈuma
obheto	obhˈeto
obranan	obrˈanan
ocupante	okupˈante
opina	opˈina
optimismo	optimˈismo
pacientnan	pasjˈentnan
paramediconan	paramedikˈonan
parcial	parsjˈal
pase	pˈase
patient	patjˈent
pensionado	pensjonˈado
plus	plˈus
preferi	prefˈeri
preliminar	preliminˈar
primanan	primˈanan
proceder	prosedˈer
productornan	produktˈornan
protegi	protˈexi
refuerzo	refwˈerzo
reservacion	reservasjˈoŋ
restitucion	restitusjˈoŋ
ritmo	rˈitmo
scooter	skoːtˈer
sede	sˈede
significativo	siɡnifikatˈivo
signo	sˈiɡno
sobresali	sobresˈali
stabiel	stabjˈel
sticker	stikkˈer
sucursalnan	sukursˈalnan
sunchi	sˈunt͡ʃi
technico	tet͡ʃnˈiko
tram	trˈam
trapi	trˈapi
verf	vˈerf
victoria	viktˈorja
òf	ˈɔf
ASTEC	astˈek
Alberto	albˈerto
Amigo	amˈiɡo
Asistencia	asistˈensja
Atardi	atˈardi
Best	bˈest
Boekenfonds	bukenfˈonds
Bogota	boɡˈota
Campaña	kampˈaɲa
Canal	kanˈal
Cancer	kansˈer
Caracas	karakˈas
Carlton	karltˈoŋ
Cerca	sˈerka
Challenge	t͡ʃallˈenxe
Creek	krˈeːk
DCA	dkˈa
DI	dˈi
Delivery	delivˈeri
Democracia	demokrˈasja
Funeral	funerˈal
Genser	xensˈer
Governance	ɡovernˈanse
Grecia	ɡrˈesja
Hospice	hospˈise
Hubert	hubˈert
II	dˈos
IPKO	ˈipko
Imigracion	imiɡrasjˈoŋ
Innovacion	innovasjˈoŋ
Islanan	islˈanan
Italiano	italjˈano
Klabér	klabˈer
Ladronnan	ladrˈonnan
Lancer	lansˈer
Latinoamerica	latinoamerˈika
Leerorkest	leːrorkˈest
Lounge	lˈownxe
Luydens	lujdˈens
Maestronan	maestrˈonan
Marinierskazerne	marinjerskazˈerne
Melvin	melvˈiŋ
Momento	momˈento
Naturalesa	naturalˈesa
News	nˈews
Nicole	nikˈole
Notario	notˈarjo
Orden	ordˈeŋ
Paramediconan	paramedikˈonan
Parokia	parˈokja
Pastor	pastˈor
Pone	pˈone
Problema	problˈema
ROPV	rˈopv
Radio	rˈadjo
Ryan	rjˈaŋ
Sahara	sahˈara
Shiribana	ʃiribˈana
Siguiendo	siɡjˈendo
Sky	skˈi
Step	stˈep
Tecnologia	teknolˈoxja
Theo	thˈeo
WGK	wˌeɡˌekˈa
Wind	wˈind
Yama	jˈama
Yarzagaray	jarzaɡarˈaj
abismo	abˈismo
abusador	abusadˈor
aceptable	aseptˈable
acusado	akusˈado
admision	admisjˈoŋ
ambiental	ambjentˈal
amistadnan	amistˈadnan
anima	anˈima
anualmente	anwalmˈente
anula	anˈula
aplicable	aplikˈable
aplicando	aplikˈando
aplicante	aplikˈante
atakenan	atakˈenan
atrasa	atrˈasa
ausencia	ausˈensja
automatico	automatˈiko
balente	balˈente
bentaha	bentˈaha
bij	bˈe͡ɪ
biodiversidad	bjodiversidˈad
biologico	bjoloxˈiko
bishitanan	biʃitˈanan
boluntariamente	boluntarjamˈente
bonbini	bonbˈini
brigada	briɡˈada
cabey	kabˈej
caidanan	ka͡ɪdˈanan
calculacionnan	kalkulasjˈonnan
campeonato	kampeonˈato
capita	kapˈita
certificacion	sertifikasjˈoŋ
cluster	klustˈer
comentarionan	komentarjˈonan
comite	komˈite
conose	konˈose
conseheronan	konseherˈonan
consumidornan	konsumidˈornan
contrae	kontrˈae
convenio	konvˈenjo
converti	konvˈerti
coordinacion	koːrdinasjˈoŋ
culminacion	kulminasjˈoŋ
custuma	kustˈuma
decente	desˈente
decir	desˈir
demostrando	demostrˈando
desespera	desespˈera
diez	djˈez
digitalmente	dixitalmˈente
drief	drjˈef
entama	entˈama
fabuloso	fabulˈoso
fast	fˈast
fiansanan	fjansˈanan
filma	fˈilma
finalisando	finalisˈando
formalisa	formalˈisa
formando	formˈando
foto	fˈoto
garoshi	ɡarˈoʃi
generalmente	xeneralmˈente
gusto	ɡˈusto
harpun	harpˈuŋ
helpdesk	helpdˈesk
hermentnan	hermˈentnan
iPad	ipˈad
imprimi	imprˈimi
incansabel	inkansabˈel
indigna	indˈiɡna
infantil	infantˈil
inflacion	inflasjˈoŋ
inkietud	inkjetˈud
instructornan	instruktˈornan
intacto	intˈakto
intensifica	intensifˈika
invitadonan	invitadˈonan
kimico	kimˈiko
kontakto	kontˈakto
landsbesluit	landsbeslˈujt
lechi	lˈet͡ʃi
lector	lektˈor
listanan	listˈanan
localiza	lokalˈiza
loonbelasting	loːnbelastˈinɡ
luho	lˈuho
maleta	malˈeta
mandando	mandˈando
mangel	manxˈel
maniobra	manjˈobra
meneer	menˈeːr
mobiliza	mobilˈiza
normalisa	normalˈisa
om	ˈom
oost	ˈoːst
out	ˈowt
paraliza	paralˈiza
plataformanan	plataformˈanan
porfabor	porfabˈor
posecion	posesjˈoŋ
preis	prˈe͡ɪs
presentacionnan	presentasjˈonnan
psikiatra	psikjˈatra
rate	rˈate
recherchenan	ret͡ʃert͡ʃˈenan
reciente	resjˈente
rector	rektˈor
referendum	referendˈum
reflexion	refleksjˈoŋ
respaldo	respˈaldo
respectivo	respektˈivo
restart	restˈart
rooi	rˈoːj
santana	santˈana
scarcedad	skarsedˈad
severamente	severamˈente
simple	sˈimple
solicitud	solisitˈud
specializa	spesjalˈiza
spiel	spjˈel
stranheronan	stranherˈonan
tardansa	tardˈansa
tempu	tˈempu
testimonio	testimˈonjo
time	tˈime
titular	titulˈar
trahe	trˈahe
transport	transpˈort
turbulento	turbulˈento
vuurwerk	vyrwˈerk
zwaai	zwˈaːj
Aldrich	aldrˈit͡ʃ
Anuesca	anwˈeska
BER	bˈer
BFTO	bftˈo
Bahamas	bahamˈas
Bishita	biʃˈita
Cambio	kˈambjo
Coach	koˈat͡ʃ
Considerando	konsiderˈando
Contraloria	kontralˈorja
Coronel	koronˈel
Cuida	kˈujda
Democrats	demokrˈats
Diagnostico	djaɡnostˈiko
Edjean	ed͡ʒeˈaŋ
Eerste	ˈeːrste
Embahador	embahadˈor
Empresanan	empresˈanan
Hendrikstraat	hendrikstrˈaːt
IPTV	ˈiptv
Influenza	inflwˈenza
Islands	islˈands
Ivo	ˈivo
Jairo	jˈa͡ɪro
Juliana	juljˈana
Kibaima	kibˈa͡ɪma
Korea	korˈea
Laura	laˈura
Leadership	leaderʃˈip
Market	markˈet
Martijn	martˈe͡ɪŋ
Mericanonan	merikanˈonan
Meverly	mevˈerli
Oceano	oseˈano
PNA	pnˈa
PPS	pˌepˌeˈɛs
Porfin	porfˈiŋ
Productions	produktjˈons
Punto	pˈunto
Request	rekwˈest
Rio	rjˈo
Roland	rolˈand
Santana	santˈana
TeleAruba	tˈelearˈuba
VHF	vˌehˌaˈɛf
Vision	visjˈoŋ
WOW	wˈow
Webinar	webinˈar
Zr	zˌɛtˈɛr
aleha	alˈeha
alto	ˈalto
angulo	anɡˈulo
anonimo	anonˈimo
apto	ˈapto
autentico	autentˈiko
awacati	awakˈati
beneficioso	benefisjˈoso
bononan	bonˈonan
braza	brˈaza
cabezante	kabezˈante
campeon	kampeˈoŋ
campo	kˈampo
carece	karˈese
carnavalesco	karnavalˈesko
carson	karsˈoŋ
celebrando	selebrˈando
cen	sˈeŋ
challenge	t͡ʃallˈenxe
charter	t͡ʃartˈer
coi	kˈoj
comprometi	kompromˈeti
consenso	konsˈenso
contingencia	kontinxˈensja
contratistanan	kontratistˈanan
crew	krˈew
definicion	definisjˈoŋ
definitivo	definitˈivo
desapunta	desapˈunta
deseonan	deseˈonan
dienst	djˈenst
dies	djˈes
difunto	difˈunto
diki	dˈiki
djente	d͡ʒˈente
dosis	dosˈis
dunamento	dunamˈento
eGovernment	eɡovernmˈent
efectivamente	efektivamˈente
eherciendo	ehersjˈendo
electrico	elektrˈiko
enfermeria	enfermˈerja
esunan	esˈunan
extension	ekstensjˈoŋ
fabrica	fabrˈika
familiarnan	familjˈarnan
flexibel	fleksibˈel
flexibilidad	fleksibilidˈad
fotografo	fotoɡrˈafo
frieu	frjˈew
funeraria	funerˈarja
grito	ɡrˈito
handle	hˈandle
handschoen	handst͡ʃˈuŋ
higienico	hixjenˈiko
huespednan	hwespˈednan
huntu	hˈuntu
ilumina	ilumˈina
immune	immˈune
inaceptable	inaseptˈable
incansablemente	inkansablemˈente
incompleto	inkomplˈeto
indefini	indefˈini
indole	indˈole
industrianan	industrjˈanan
inhustamente	inhustamˈente
inmoral	inmorˈal
intenta	intˈenta
lague	lˈaɡe
leak	leˈak
legislacion	lexislasjˈoŋ
legislativo	lexislatˈivo
localisa	lokalˈisa
lusnan	lˈusnan
malcontento	malkontˈento
malgasta	malɡˈasta
melding	meldˈinɡ
mina	mˈina
monitoria	monitˈorja
motibu	motˈibu
nacion	nasjˈoŋ
naturalisacion	naturalisasjˈoŋ
paar	pˈaːr
paginanan	paxinˈanan
pirata	pirˈata
presupuestario	presupwestˈarjo
previo	prˈevjo
prudente	prudˈente
rand	rˈand
re	rˈe
recoge	rekˈoxe
reparticion	repartisjˈoŋ
sabiduria	sabidˈurja
sabor	sabˈor
sacudi	sakˈudi
sangra	sˈanɡra
siete	sjˈete
spart	spˈart
specifica	spesifˈika
stakeholder	stakeholdˈer
suplente	suplˈente
susha	sˈuʃa
ter	tˈer
tolerancia	tolerˈansja
ultimamente	ultimamˈente
una	ˈuna
universidad	universidˈad
upload	uploˈad
usual	uswˈal
utilidad	utilidˈad
vacunanan	vakunˈanan
votonan	votˈonan
workshops	workʃˈops
AB	ˈab
Abuse	abˈuse
Afortunadamente	afortunadamˈente
Angela	anxˈela
Angelo	anxˈelo
Anselmo	ansˈelmo
Antiano	antjˈano
Area	arˈea
Arubianismo	arubjanˈismo
Bisti	bˈisti
C	sˈe
CFT	sˌeˌɛftˈe
Cachi	kˈat͡ʃi
Carta	kˈarta
Chiquito	t͡ʃikwˈito
Cinco	sˈinko
Clarisca	klarˈiska
Comandante	komandˈante
Comun	komˈuŋ
Contact	kontˈakt
Cuentanan	kwentˈanan
DEA	dˈea
DJ	dˌejˈe
DUO	dwˈo
Debe	dˈebe
Do	dˈo
Expression	ekspressjˈoŋ
Exterior	eksterjˈor
Global	ɡlobˈal
Go	ɡˈo
Gruponan	ɡrupˈonan
Het	hˈet
Hilton	hiltˈoŋ
Imsan	imsˈaŋ
Instagram	instaɡrˈam
Irausquin	irauskwˈiŋ
Johnson	johnsˈoŋ
Junior	junjˈor
Keto	kˈeto
Kiko	kˈiko
Land	lˈand
Landsverordening	landsverordenˈinɡ
Managing	manaxˈinɡ
Marc	mˈark
Marsman	marsmˈaŋ
Mey	mˈej
Natural	naturˈal
Ocho	ˈot͡ʃo
Oranje	orˈanje
Oro	ˈoro
Pago	pˈaɡo
Paskel	paskˈel
Politiconan	politikˈonan
Prevencion	prevensjˈoŋ
RFT	ˌɛrˌɛftˈe
Remarcabel	remarkabˈel
Richi	rˈit͡ʃi
Ruth	rˈuth
SOGA	sˈoɡa
Safety	safˈeti
Saliña	salˈiɲa
Shailiny	ʃa͡ɪlˈini
Tamarijn	tamarˈe͡ɪŋ
Tele	tˈele
UAV	wˈav
Utilities	utilitjˈes
Vroegop	vruɡˈop
Weganan	weɡˈanan
Wel	wˈel
YouTube	jˈowtˈube
Zika	zˈika
abusado	abusˈado
aliento	aljˈento
anticua	antˈikwa
azota	azˈota
barku	bˈarku
berdaderamente	berdaderamˈente
bezoldiging	bezoldixˈinɡ
biahero	bjahˈero
blo	blˈo
board	boˈard
buske	bˈuske
cabayero	kabajˈero
camp	kˈamp
campamento	kampamˈento
caretera	karetˈera
cede	sˈede
celebracionnan	selebrasjˈonnan
chines	t͡ʃinˈes
clientela	kljentˈela
colaborador	kolaboradˈor
comedia	komˈedja
competencianan	kompetensjˈanan
comunidadnan	komunidˈadnan
concientiza	konsjentˈiza
contractnan	kontrˈaktnan
costonan	kostˈonan
crioyo	krjˈojo
cruz	krˈuz
crèche	krˈɛt͡ʃe
cumindanan	kumindˈanan
deportista	deportˈista
determinante	determinˈante
duo	dwˈo
ehercicionan	ehersisjˈonan
enfocando	enfokˈando
enormemente	enormemˈente
espantoso	espantˈoso
explosion	eksplosjˈoŋ
faborabel	faborabˈel
fayonan	fajˈonan
flexibilizacion	fleksibilizasjˈoŋ
fracaso	frakˈaso
funcionando	funsjonˈando
funcionnan	funsjˈonnan
gobernador	ɡobernadˈor
hefenan	hefˈenan
horor	horˈor
huurgrond	hyrɡrˈond
inovacion	inovasjˈoŋ
interoga	interˈoɡa
it	ˈit
kas	kˈas
kiebra	kjˈebra
lift	lˈift
linear	lineˈar
mail	mˈa͡ɪl
mall	mˈall
manehando	manehˈando
manteni	mantˈeni
mentalmente	mentalmˈente
mereci	merˈesi
modernisa	modernˈisa
muha	mˈuha
naar	nˈaːr
noble	nˈoble
noticianan	notisjˈanan
ofishi	ofˈiʃi
olanan	olˈanan
papiamento	papjamˈento
paradanan	paradˈanan
pensamentonan	pensamentˈonan
permanece	permanˈese
pica	pˈika
pidie	pˈidje
popularidad	popularidˈad
presupuestonan	presupwestˈonan
prevalece	prevalˈese
procede	prosˈede
propiedadnan	propjedˈadnan
publicacionnan	publikasjˈonnan
quorum	kworˈum
refugio	refˈuxjo
relatonan	relatˈonan
reparacion	reparasjˈoŋ
reputacion	reputasjˈoŋ
riñon	riɲˈoŋ
rolluik	rollˈujk
rutanan	rutˈanan
salvo	sˈalvo
scenarionan	ssenarjˈonan
scuridad	skuridˈad
separacion	separasjˈoŋ
shop	ʃˈop
sicario	sikˈarjo
simanan	simˈanan
sociaal	sosjˈaːl
solar	solˈar
spuit	spˈujt
strena	strˈena
stuurgroep	styrɡrˈup
suficientemente	sufisjentemˈente
suspenso	suspˈenso
timon	timˈoŋ
trend	trˈend
tripulantenan	tripulantˈenan
vacatura	vakatˈura
viahenan	vjahˈenan
webinars	webinˈars
welga	wˈelɡa
welo	wˈelo
x	ˈɛks
yobe	jˈobe
zijn	zˈe͡ɪŋ
Abou	abˈow
Americas	amerikˈas
Artificial	artifisjˈal
Arubaanse	arubˈaːnse
Aseguro	aseɡˈuro
Barbados	barbadˈos
Big	bˈiɡ
Blue	blwˈe
Boca	bˈoka
Boeing	bˈujnɡ
Breaking	breakˈinɡ
Car	kˈar
Christmas	t͡ʃristmˈas
Conrado	konrˈado
Consulado	konsulˈado
Cultural	kulturˈal
DPS	dˌepˌeˈɛs
Dianan	djˈanan
Federacion	federasjˈoŋ
Finalisando	finalisˈando
First	fˈirst
Fresh	frˈeʃ
Gonzalo	ɡonzˈalo
Goshen	ɡoʃˈeŋ
Grand	ɡrˈand
HIV	hˈiv
Hall	hˈall
Hendrik	hendrˈik
Home	hˈome
In	ˈiŋ
Incinerator	insineratˈor
Inteligencia	intelixˈensja
Janine	janˈine
Jeon	jeˈoŋ
Kabinet	kabinˈet
Kort	kˈort
LG	ˌɛlɡˈe
Leynan	lˈejnan
MAS	mˈas
MOT	mˈot
Mainta	mˈa͡ɪnta
Martin	martˈiŋ
Mihor	mihˈor
Museum	musˈewm
Noka	nˈoka
Nomber	nombˈer
Old	ˈold
Partidonan	partidˈonan
RAIZ	rˈa͡ɪz
RCC	ˌɛrsˌesˈe
Rosel	rosˈel
SPO	spˈo
Sagrado	saɡrˈado
Seguro	seɡˈuro
Sharina	ʃarˈina
Simar	simˈar
Simplemente	simplemˈente
Situacion	sitwasjˈoŋ
Smart	smˈart
Soca	sˈoka
Solange	solˈanxe
Spaans	spˈaːns
Subway	subwˈaj
Surinam	surinˈam
Takelwagen	takelwaxˈeŋ
Tipline	tiplˈine
Tisa	tˈisa
Toets	tˈuts
Tour	tˈowr
Truck	trˈukk
Tuitt	tˈujtt
Turista	turˈista
UNOCA	unˈoka
Web	wˈeb
Wega	wˈeɡa
Williams	willjˈams
Yuda	jˈuda
abilidad	abilidˈad
academia	akadˈemja
account	akkˈownt
acercamento	aserkamˈento
aclaracion	aklarasjˈoŋ
actor	aktˈor
afortunadamente	afortunadamˈente
agricultornan	aɡrikultˈornan
alcance	alkˈanse
aliado	aljˈado
all	ˈall
anochinan	anot͡ʃˈinan
atmosfera	atmosfˈera
atracador	atrakadˈor
babuca	babˈuka
batata	batˈata
blvd	bˌeˌɛlvˌedˈe
bolo	bˈolo
cabando	kabˈando
candidata	kandidˈata
ceramento	seramˈento
chofer	t͡ʃofˈer
cinema	sinˈema
colorido	kolorˈido
compasion	kompasjˈoŋ
compensacion	kompensasjˈoŋ
comprencion	komprensjˈoŋ
comprendibel	komprendibˈel
concurso	konkˈurso
contactonan	kontaktˈonan
contradeci	kontradˈesi
creciendo	kresjˈendo
crecimento	kresimˈento
cueste	kwˈeste
decora	dekˈora
deporta	depˈorta
desayuno	desajˈuno
deteccion	deteksjˈoŋ
diesdos	djesdˈos
digno	dˈiɡno
disciplinario	dissiplinˈarjo
disertacion	disertasjˈoŋ
dolornan	dolˈornan
eigenlijk	e͡ɪxenlˈe͡ɪk
empresarionan	empresarjˈonan
encarecidamente	enkaresidamˈente
encaso	enkˈaso
entrenamento	entrenamˈento
erornan	erˈornan
error	errˈor
especienan	espesjˈenan
espectaculo	espektakˈulo
etica	etˈika
eventualmente	eventwalmˈente
extendi	ekstˈendi
fasenan	fasˈenan
fracasa	frakˈasa
frecuencia	frekwˈensja
gasoline	ɡasolˈine
gewoon	xewˈoːŋ
gigante	xiɡˈante
grill	ɡrˈill
hincamento	hinkamˈento
hole	hˈole
horibel	horibˈel
hungando	hunɡˈando
identificacion	identifikasjˈoŋ
ingles	inɡlˈes
intencional	intensjonˈal
intension	intensjˈoŋ
interupcion	interupsjˈoŋ
jeans	jeˈans
juffrouw	juffrˈoww
kWh	kˈawˌehˈa
licencia	lisˈensja
logo	lˈoɡo
mandatorio	mandatˈorjo
materno	matˈerno
merca	mˈerka
mokete	mokˈete
moviendo	movjˈendo
nister	nistˈer
nuebe	nwˈebe
nunka	nˈunka
pacient	pasjˈent
pasco	pˈasko
periodismo	perjodˈismo
podernan	podˈernan
policlinica	poliklinˈika
pompstation	pompstatjˈoŋ
profesionalismo	profesjonalˈismo
prohimo	prohˈimo
promesanan	promesˈanan
propaga	propˈaɡa
proposicionnan	proposisjˈonnan
psycologo	psikolˈoɡo
puntre	pˈuntre
quadracer	kwadrasˈer
rapidez	rapidˈez
recomendabel	rekomendabˈel
recordatorio	rekordatˈorjo
recreacion	rekreasjˈoŋ
refinancia	refinˈansja
restructuracion	restrukturasjˈoŋ
revista	revˈista
revolver	revolvˈer
riguroso	riɡurˈoso
salanan	salˈanan
saliente	saljˈente
scarsedad	skarsedˈad
secretario	sekretˈarjo
shete	ʃˈete
speech	spˈeːt͡ʃ
splike	splˈike
sufrimento	sufrimˈento
susto	sˈusto
telefonico	telefonˈiko
tercera	tersˈera
toke	tˈoke
traductor	traduktˈor
trampa	trˈampa
transaccionnan	transaksjˈonnan
transmicion	transmisjˈoŋ
tripulante	tripulˈante
tuberia	tubˈerja
tucson	tuksˈoŋ
tèst	tˈɛst
urgentemente	urxentemˈente
videoclip	videoklˈip
visa	vˈisa
AGA	ˈaɡa
Academia	akadˈemja
Action	aktjˈoŋ
Agricultura	aɡrikultˈura
Andicuri	andikˈuri
Antiyas	antijˈas
Apenas	apenˈas
Apple	ˈapple
BZK	bˌezˌɛtkˈa
Baho	bˈaho
Bienestar	bjenestˈar
Black	blˈakk
CPR	sˌepˌeˈɛr
Cabana	kabˈana
Cafe	kˈafe
Cambionan	kambjˈonan
Choudhry	t͡ʃˈowdhri
Cien	sjˈeŋ
Compara	kompˈara
Consul	konsˈul
Copa	kˈopa
Corporate	korporˈate
Cuminsando	kuminsˈando
Dabian	dabjˈaŋ
Department	departmˈent
Depresion	depresjˈoŋ
Ey	ˈej
Fatima	fatˈima
Fitch	fˈitt͡ʃ
Fuerte	fwˈerte
Gaalen	ɡaːlˈeŋ
Glenda	ɡlˈenda
Grant	ɡrˈant
Growell	ɡrowˈell
HBO	hbˈo
Hulp	hˈulp
Imeldahof	imeldahˈof
Impact	impˈakt
India	ˈindja
Infantil	infantˈil
Interest	interˈest
James	jamˈes
Jet	jˈet
Kamp	kˈamp
Kendrick	kendrˈikk
Kids	kˈids
LABHOH	labhˈoh
Laboratorio	laboratˈorjo
MP	ˌɛmpˈe
Mantene	mantˈene
Mayor	majˈor
Miguel	miɡˈel
Moderna	modˈerna
Montaña	montˈaɲa
Montenegro	montenˈeɡro
Motibo	motˈibo
Nes	nˈes
Nuhad	nuhˈad
Oost	ˈoːst
Open	opˈeŋ
POREDmep	pˈoredmˈep
Palace	palˈase
Papilon	papilˈoŋ
Paula	paˈula
Pedro	pˈedro
Piscadonan	piskadˈonan
Prison	prisˈoŋ
Progreso	proɡrˈeso
Public	publˈik
Richardson	rit͡ʃardsˈoŋ
Rosario	rosˈarjo
Rumbastraat	rumbastrˈaːt
SSA	ssˈa
Sagicor	saxikˈor
Sostenible	sostenˈible
Special	spesjˈal
Stadhuis	stadhˈujs
Tera	tˈera
Terminal	terminˈal
Texier	teksjˈer
Trabao	trabˈao
Traimerdia	tra͡ɪmˈerdja
Unavez	unavˈez
VBA	vbˈa
Vondellaan	vondellˈaːŋ
WCA	wkˈa
Walk	wˈalk
Week	wˈeːk
absolutamente	absolutamˈente
aconseha	akonsˈeha
ader	adˈer
adresa	adrˈesa
afirma	afˈirma
agresor	aɡresˈor
aparatonan	aparatˈonan
artikel	artikˈel
auspicio	auspˈisjo
bacteria	baktˈerja
baseball	basebˈall
binidero	binidˈero
bisindario	bisindˈarjo
body	bˈodi
boost	bˈoːst
bosonan	bosˈonan
burocracia	burokrˈasja
camaranan	kamarˈanan
caracterisa	karakterˈisa
caracteristicanan	karakteristikˈanan
caravana	karavˈana
checklist	t͡ʃekklˈist
ciclo	sˈiklo
circumstancia	sirkumstˈansja
civico	sivˈiko
clapchi	klˈapt͡ʃi
clinico	klinˈiko
cocolishi	kokolˈiʃi
combate	kombˈate
comodo	komˈodo
compensa	kompˈensa
competitivo	kompetitˈivo
complicacionnan	komplikasjˈonnan
compornde	kompˈornde
comunismo	komunˈismo
condicionan	kondisjˈonan
conducta	kondˈukta
congreso	konɡrˈeso
consistente	konsistˈente
cualnan	kwˈalnan
cuartal	kwartˈal
cuidador	kujdadˈor
cyclista	siklˈista
d	dˈe
dañonan	daɲˈonan
debilita	debilˈita
deleita	delˈe͡ɪta
desigualdad	desiɡwaldˈad
desmantela	desmantˈela
deze	dˈeze
discucion	diskusjˈoŋ
dive	dˈive
ecosistema	ekosistˈema
educacional	edukasjonˈal
enfaticamente	enfatikamˈente
engrandece	enɡrandˈese
entusiasma	entusjˈasma
epicentro	episˈentro
excelencia	eksselˈensja
explosivo	eksplosˈivo
festivo	festˈivo
file	fˈile
free	frˈeː
front	frˈont
frontliners	frontlinˈers
fructifero	fruktifˈero
greppel	ɡreppˈel
hasiendo	hasjˈendo
heridanan	heridˈanan
hobby	hˈobbi
imparcial	imparsjˈal
inauguracion	inauɡurasjˈoŋ
indicadornan	indikadˈornan
indirectamente	indirektamˈente
inspecciona	inspeksjˈona
interumpi	interˈumpi
inventario	inventˈarjo
invisibel	invisibˈel
joyas	jojˈas
kaba	kˈaba
komo	kˈomo
lastimamente	lastimamˈente
logistica	loxistˈika
logistico	loxistˈiko
maestra	maˈestra
mancha	mˈant͡ʃa
manifestacionnan	manifestasjˈonnan
manifiesto	manifjˈesto
minuutnan	minˈytnan
misterio	mistˈerjo
mondmasker	mondmaskˈer
moringa	morˈinɡa
multiple	multˈiple
natacion	natasjˈoŋ
neglisha	neɡlˈiʃa
nervioso	nervjˈoso
notando	notˈando
obligatoriamente	obliɡatorjamˈente
off	ˈoff
opinionnan	opinjˈonnan
oponentenan	oponentˈenan
oportuno	oportˈuno
organisacionan	orɡanisasjˈonan
pacifico	pasifˈiko
pagara	paɡˈara
parkeo	parkˈeo
patientnan	patjˈentnan
pedofilnan	pedofˈilnan
perdiendo	perdjˈendo
pianan	pjˈanan
pico	pˈiko
pilarnan	pilˈarnan
plaats	plˈaːts
probecho	probˈet͡ʃo
procesverbaal	prosesverbˈaːl
proclama	proklˈama
pura	pˈura
puro	pˈuro
reactivacion	reaktivasjˈoŋ
recobra	rekˈobra
recompensa	rekompˈensa
reenforsa	reːnfˈorsa
reglamentonan	reɡlamentˈonan
rekesito	rekesˈito
remarcabel	remarkabˈel
responsabilisa	responsabilˈisa
restante	restˈante
restonan	restˈonan
retene	retˈene
selecciona	seleksjˈona
short	ʃˈort
sintonisa	sintonˈisa
slow	slˈow
speedboat	speːdboˈat
sunu	sˈunu
supla	sˈupla
taira	tˈa͡ɪra
tardando	tardˈando
taskforce	taskfˈorse
tecnica	teknˈika
thee	thˈeː
tilda	tˈilda
tragedia	traxˈedja
tribi	trˈibi
unilateralmente	unilateralmˈente
util	utˈil
validez	validˈez
variacion	varjasjˈoŋ
venezolano	venezolˈano
vitamina	vitamˈina
windshield	windʃjˈeld
yuinan	jˈujnan
Abraham	abrahˈam
Acaso	akˈaso
Andre	ˈandre
Andrew	andrˈew
Animal	animˈal
AruBIG	ˈarubˈiɡ
Banconan	bankˈonan
Benchi	bˈent͡ʃi
Bill	bˈill
Bisiñanan	bisiɲˈanan
Bloomberg	bloːmbˈerɡ
Board	boˈard
Calidad	kalidˈad
Cannabis	kannabˈis
Caribisch	karibˈist͡ʃ
Carolina	karolˈina
Comerciantenan	komersjantˈenan
Comite	komˈite
Compania	kompˈanja
Computer	komputˈer
Cuna	kˈuna
DE	dˈe
Dado	dˈado
Dengue	dˈenɡe
Dijkhoff	de͡ɪkhˈoff
Douaneronan	dowanerˈonan
Droga	drˈoɡa
Duarte	dwˈarte
Elements	elemˈents
Emanstraat	emanstrˈaːt
Encuanto	enkwˈanto
Escolar	eskolˈar
Financia	finˈansja
Fontein	fontˈe͡ɪŋ
Frances	fransˈes
Frere	frˈere
Futura	futˈura
Garcia	ɡˈarsja
Garden	ɡardˈeŋ
Gemeente	xemˈeːnte
Gradus	ɡradˈus
Great	ɡreˈat
Halloween	hallowˈeːŋ
High	hˈiɡh
Iglesia	iɡlˈesja
Integriteit	inteɡritˈe͡ɪt
Jeep	jˈeːp
Jucuri	jukˈuri
Kerstboomlandia	kerstboːmlˈandja
Kisas	kisˈas
Kralendijk	kralendˈe͡ɪk
Kwartaal	kwartˈaːl
LaSorte	lˈasˈorte
Lanta	lˈanta
Little	lˈittle
Mabon	mabˈoŋ
Mall	mˈall
Marchena	mart͡ʃˈena
Mercado	merkˈado
Molina	molˈina
Movimiento	movimjˈento
Muher	muhˈer
Number	numbˈer
Nunes	nunˈes
Paramedico	paramedˈiko
Pashentnan	paʃˈentnan
Patrick	patrˈikk
Pelican	pelikˈaŋ
Percura	perkˈura
Peterson	petersˈoŋ
Presente	presˈente
Preto	prˈeto
Problemanan	problemˈanan
RAiZ	ˈɛrˈa͡ɪzˈɛt
ROP	rˈop
Red	rˈed
Relacionista	relasjonˈista
Ruso	rˈuso
SDG	ˌɛsdˌeɡˈe
Samenscholingsverbod	samenst͡ʃolinɡsverbˈod
Sostenemi	sostenˈemi
Speransa	sperˈansa
TOQUE	tˈokwe
Testnan	tˈestnan
Thomas	thomˈas
Tico	tˈiko
Turibana	turibˈana
Wak	wˈak
Winklaar	winklˈaːr
Zoom	zˈoːm
adaptacionnan	adaptasjˈonnan
annual	annwˈal
aplauso	aplaˈuso
argumentonan	arɡumentˈonan
aruba	arˈuba
autismo	autˈismo
auxiliar	auksiljˈar
beyesa	bejˈesa
bieuw	bjˈeww
bisabo	bisˈabo
budget	budxˈet
buelta	bwˈelta
cadenanan	kadenˈanan
camanan	kamˈanan
careteranan	kareterˈanan
centenares	sentenarˈes
chat	t͡ʃˈat
ciruhano	siruhˈano
clasico	klasˈiko
clip	klˈip
conrector	konrektˈor
controle	kontrˈole
cordialidad	kordjalidˈad
coremento	koremˈento
correcto	korrˈekto
database	databˈase
debit	debˈit
decoracion	dekorasjˈoŋ
decreta	dekrˈeta
derota	derˈota
discrepancia	diskrepˈansja
discrimina	diskrimˈina
dispensacion	dispensasjˈoŋ
do	dˈo
domino	domˈino
donacionnan	donasjˈonnan
economianan	ekonomjˈanan
elo	ˈelo
embahada	embahˈada
emplea	emplˈea
encabesa	enkabˈesa
encuestanan	enkwestˈanan
endemico	endemˈiko
enfermero	enfermˈero
envolvimento	envolvimˈento
equiponan	ekwipˈonan
estafa	estˈafa
evidente	evidˈente
exigiendo	eksixjˈendo
experencianan	eksperensjˈanan
fantasma	fantˈasma
favor	favˈor
formato	formˈato
formulanan	formulˈanan
friu	frjˈu
ganado	ɡanˈado
gigantesco	xiɡantˈesko
good	ɡˈoːd
gracia	ɡrˈasja
grato	ɡrˈato
habitat	habitˈat
haf	hˈaf
hanja	hˈanja
huiswerk	hujswˈerk
ilegalidad	ileɡalidˈad
individualmente	individwalmˈente
informal	informˈal
iniciativanan	inisjativˈanan
input	inpˈut
insigur	insiɡˈur
insiguridad	insiɡuridˈad
institucionnan	institusjˈonnan
instructor	instruktˈor
interaccion	interaksjˈoŋ
international	internatjonˈal
ja	jˈa
karentena	karentˈena
klasse	klˈasse
laborando	laborˈando
lantamento	lantamˈento
legitimo	lexitˈimo
lineanan	lineˈanan
liñanan	liɲˈanan
lobby	lˈobbi
mala	mˈala
marcanan	markˈanan
market	markˈet
masal	masˈal
medicamento	medikamˈento
menornan	menˈornan
mensualmente	menswalmˈente
mini	mˈini
mobil	mobˈil
mortalidad	mortalidˈad
movimento	movimˈento
natal	natˈal
navega	navˈeɡa
neishi	nˈe͡ɪʃi
network	netwˈork
nr	ˌɛnˈɛr
observacionnan	observasjˈonnan
omo	ˈomo
onderwijs	onderwˈe͡ɪs
parecido	paresˈido
patruyahe	patrujˈahe
pena	pˈena
perhudicando	perhudikˈando
pleita	plˈe͡ɪta
poko	pˈoko
porshento	porʃˈento
precisamente	presisamˈente
premie	prˈemje
procedimento	prosedimˈento
profila	profˈila
prominente	prominˈente
proteina	protˈe͡ɪna
protestanan	protestˈanan
rabo	rˈabo
raiz	rˈa͡ɪz
rating	ratˈinɡ
recicla	resˈikla
recuerdo	rekwˈerdo
refleho	reflˈeho
regionnan	rexjˈonnan
regulacionnan	reɡulasjˈonnan
rek	rˈek
renovacion	renovasjˈoŋ
responsabilidadnan	responsabilidˈadnan
rutina	rutˈina
samenscholingsverbod	samenst͡ʃolinɡsverbˈod
sanea	sanˈea
scogi	skˈoxi
sende	sˈende
service	servˈise
skol	skˈol
soborno	sobˈorno
sobrepasa	sobrepˈasa
soledad	soledˈad
sondea	sondˈea
statuto	statˈuto
stem	stˈem
suv	sˈuv
tabel	tabˈel
tenso	tˈenso
tipico	tipˈiko
toxico	toksˈiko
viahero	vjahˈero
vigilando	vixilˈando
wave	wˈave
whatsapp	whatsˈapp
yudabo	judˈabo
yui	jˈuj
ATSA	ˈatsa
Armando	armˈando
Asia	ˈasja
BaluArte	bˈaluˈarte
Biemans	bjemˈans
Bingo	bˈinɡo
Boliviastraat	bolivjastrˈaːt
Boston	bostˈoŋ
Britanico	britanˈiko
Brown	brˈowŋ
Buena	bwˈena
CIBC	sˈibk
CMB	sˌeˌɛmbˈe
Café	kafˈe
Cali	kˈali
Candela	kandˈela
Casibari	kasibˈari
Centre	sˈentre
Chef	t͡ʃˈef
Chief	t͡ʃjˈef
Cierto	sjˈerto
Colony	kolˈoni
Consensus	konsensˈus
Constantemente	konstantemˈente
Contabilidad	kontabilidˈad
Corupcion	korupsjˈoŋ
Cumbre	kˈumbre
DIA	djˈa
DNA	dnˈa
DWJZ	dˌewˌejˌezˈɛt
Dentista	dentˈista
Dump	dˈump
Economische	ekonomˈist͡ʃe
Entrega	entrˈeɡa
Ernesto	ernˈesto
Eugene	ewxˈene
FLPD	ˌɛfˌɛlpˌedˈe
FPNM	ˌɛfpˌeˌɛnˈɛm
Faro	fˈaro
Financien	finansjˈeŋ
Frido	frˈido
Futbol	futbˈol
Gezaghebber	xezaɡhebbˈer
Goedhoop	ɡudhˈoːp
Gumbs	ɡˈumbs
Heights	hˈe͡ɪɡhts
Helpdesk	helpdˈesk
Higiena	hixjˈena
Inn	ˈinŋ
Insurance	insurˈanse
Irani	irˈani
Jairzinho	ja͡ɪrzˈinho
Jordan	jordˈaŋ
Jorge	jˈorxe
Koningstraat	koninɡstrˈaːt
Korps	kˈorps
Legislation	lexislatjˈoŋ
Lidernan	lidˈernan
Life	lˈife
Medical	medikˈal
Meiveld	me͡ɪvˈeld
Mimi	mˈimi
Minimarket	minimarkˈet
Naturalisacion	naturalisasjˈoŋ
Nel	nˈel
Night	nˈiɡht
Nort	nˈort
OC	ˈok
Odillia	odˈillja
Olsen	olsˈeŋ
Patruyanan	patrujˈanan
Pereira	perˈe͡ɪra
Pesca	pˈeska
Pesei	pˈese͡ɪ
Poets	pˈuts
Port	pˈort
Preguntanan	preɡuntˈanan
Prinses	prinsˈes
Probablemente	probablemˈente
Program	proɡrˈam
Psicologo	psikolˈoɡo
Realidad	realidˈad
Registracion	rexistrasjˈoŋ
Rene	rˈene
Rep	rˈep
Reposicionando	reposisjonˈando
Rodenburg	rodenbˈurɡ
Rolando	rolˈando
Ruyter	rujtˈer
Schloss	st͡ʃlˈoss
Scientology	ssjentolˈoxi
Sustainable	susta͡ɪnˈable
Tapaboca	tapabˈoka
Telecomunicacion	telekomunikasjˈoŋ
Teller	tellˈer
Temporada	temporˈada
Trafico	trafˈiko
Traveler	travelˈer
UN	ˈuŋ
UNICEF	unisˈef
Uzi	ˈuzi
VNO	vnˈo
VO	vˈo
Villas	villˈas
Virgin	virxˈiŋ
Vitamina	vitamˈina
WTO	wtˈo
X	ˈɛks
Zeewijk	zeːwˈe͡ɪk
agencianan	axensjˈanan
agradable	aɡradˈable
ambicioso	ambisjˈoso
anota	anˈota
argumenta	arɡumˈenta
asfalt	asfˈalt
asientonan	asjentˈonan
asocia	asˈosja
awenochi	awenˈot͡ʃi
balanza	balˈanza
bariga	barˈiɡa
baña	bˈaɲa
beschikking	best͡ʃikkˈinɡ
bloki	blˈoki
briya	brˈija
bulando	bulˈando
bulto	bˈulto
business	businˈess
c	sˈe
cahanan	kahˈanan
cantidadnan	kantidˈadnan
caranan	karˈanan
caritativo	karitatˈivo
carteranan	karterˈanan
carton	kartˈoŋ
casamento	kasamˈento
casualidad	kaswalidˈad
catolico	katolˈiko
cedula	sedˈula
charlanan	t͡ʃarlˈanan
cierre	sjˈerre
comandante	komandˈante
combustible	kombustˈible
comestibles	komestiblˈes
comisionnan	komisjˈonnan
compilacion	kompilasjˈoŋ
componentenan	komponentˈenan
concientisa	konsjentˈisa
constant	konstˈant
constructivo	konstruktˈivo
contrata	kontrˈata
coperacion	koperasjˈoŋ
crash	krˈaʃ
credit	kredˈit
creencia	krˈeːnsja
cultiva	kultˈiva
cup	kˈup
custumbernan	kustumbˈernan
deliberadamente	deliberadamˈente
demonstra	demˈonstra
descansa	deskˈansa
desinfectante	desinfektˈante
dibiaha	dibjˈaha
dibo	dˈibo
dictatorial	diktatorjˈal
dimension	dimensjˈoŋ
dividendo	dividˈendo
double	dˈowble
edadnan	edˈadnan
eficaz	efikˈaz
embahador	embahadˈor
emision	emisjˈoŋ
entregamento	entreɡamˈento
entregando	entreɡˈando
entrena	entrˈena
envelope	envelˈope
evacua	evˈakwa
exclusivamente	eksklusivamˈente
excluyendo	eksklujˈendo
experienciando	eksperjensjˈando
facultad	fakultˈad
fake	fˈake
favorito	favorˈito
felis	felˈis
filosofia	filosˈofja
findishi	findˈiʃi
florece	florˈese
formalmente	formalmˈente
foyeto	fojˈeto
give	xˈive
grandura	ɡrandˈura
hancho	hˈant͡ʃo
hera	hˈera
hobencita	hobensˈita
hospeda	hospˈeda
hulp	hˈulp
hòmber	hˈɔmber
ilegalmente	ileɡalmˈente
iluminacion	iluminasjˈoŋ
impeachment	impeat͡ʃmˈent
implementando	implementˈando
imposible	imposˈible
impresionante	impresjonˈante
impulso	impˈulso
indicenan	indisˈenan
informenan	informˈenan
ingresonan	inɡresˈonan
innecesariamente	innesesarjamˈente
inspector	inspektˈor
integra	intˈeɡra
intensidad	intensidˈad
invadi	invˈadi
jet	jˈet
lancer	lansˈer
landsverordening	landsverordenˈinɡ
loteria	lotˈerja
mascotanan	maskotˈanan
mencion	mensjˈoŋ
mentornan	mentˈornan
mexicano	meksikˈano
ministerionan	ministerjˈonan
miyonario	mijonˈarjo
mondmask	mondmˈask
motorcycle	motorsˈikle
municipio	munisˈipjo
nubia	nˈubja
onderzoek	onderzˈuk
opositornan	opositˈornan
optimalisa	optimalˈisa
opvang	opvˈanɡ
pakiko	pakˈiko
piedad	pjedˈad
plantamento	plantamˈento
poesia	pˈusja
porcierto	porsjˈerto
positivamente	positivamˈente
prestigioso	prestixjˈoso
print	prˈint
propagacion	propaɡasjˈoŋ
radical	radikˈal
rebelde	rebˈelde
rectifica	rektifˈika
recuri	rekˈuri
referencia	referˈensja
refinerianan	refinerjˈanan
rehabilita	rehabilˈita
remedia	remˈedja
reportahe	reportˈahe
resolvi	resˈolvi
sacamento	sakamˈento
sancionnan	sansjˈonnan
satelite	satelˈite
scirbi	ssˈirbi
sentra	sˈentra
sexualmente	sekswalmˈente
share	ʃˈare
sindicalista	sindikalˈista
sintie	sˈintje
snacks	snˈakks
socialista	sosjalˈista
solidarismo	solidarˈismo
sondeo	sondˈeo
sonrisa	sonrˈisa
speculacion	spekulasjˈoŋ
splicando	splikˈando
stagna	stˈaɡna
stakeholdernan	stakeholdˈernan
suceso	susˈeso
support	suppˈort
suspension	suspensjˈoŋ
tanta	tˈanta
tatanan	tatˈanan
telefonicamente	telefonikamˈente
tellernan	tellˈernan
temporadanan	temporadˈanan
tokante	tokˈante
tools	tˈoːls
torneo	tornˈeo
tos	tˈos
tot	tˈot
touch	tˈowt͡ʃ
transcuri	transkˈuri
transitorio	transitˈorjo
transmission	transmissjˈoŋ
u	ˈu
use	ˈuse
vangrail	vanɡrˈa͡ɪl
violento	vjolˈento
visible	visˈible
west	wˈest
winstbelasting	winstbelastˈinɡ
Accent	aksˈent
Administracion	administrasjˈoŋ
All	ˈall
Antillas	antillˈas
Arubadag	arubadˈaɡ
Arubig	arubˈiɡ
Autobus	autobˈus
Awa	ˈawa
Bachelor	bat͡ʃelˈor
Ben	bˈeŋ
Benjamin	benjamˈiŋ
Beverage	beverˈaxe
Birgen	birxˈeŋ
British	britˈiʃ
Cabesante	kabesˈante
Chikungunya	t͡ʃikunɡˈunja
Chile	t͡ʃˈile
Choller	t͡ʃollˈer
Cientificonan	sjentifikˈonan
Clinton	klintˈoŋ
Coca	kˈoka
Comerciante	komersjˈante
Complex	komplˈeks
Concierto	konsjˈerto
Condé	kondˈe
Conhuntamente	konhuntamˈente
Conservation	konservatjˈoŋ
Cruises	krujsˈes
Decision	desisjˈoŋ
Dor	dˈor
Dorp	dˈorp
Doño	dˈoɲo
EU	ˈew
Eduardo	edwˈardo
Ehecutivo	ehekutˈivo
Embahada	embahˈada
Entrevista	entrevˈista
Envez	envˈez
Eric	erˈik
Financial	finansjˈal
Financiamento	finansjamˈento
Financieel	finansjˈeːl
Flora	flˈora
Frontera	frontˈera
Gina	xˈina
Goeloe	ɡˈulu
Grace	ɡrˈase
Guillermo	ɡjllˈermo
Gusto	ɡˈusto
Hoek	hˈuk
Hong	hˈonɡ
Hooyboer	hoːjbˈur
Horeca	horˈeka
Hub	hˈub
IOWA	jˈowa
IQ	ˈik
Idioma	idjˈoma
Iniciativa	inisjatˈiva
Interior	interjˈor
It	ˈit
JZP	jˌezˌɛtpˈe
Jade	jˈade
Jetblue	jˈetblwe
KB	kˌabˈe
Kas	kˈas
Korpschef	korpst͡ʃˈef
LLC	ˌɛlˌɛlsˈe
Lab	lˈab
Las	lˈas
Lighthouse	liɡhthˈowse
Lisette	lisˈette
MS	ˌɛmˈɛs
Marine	marˈine
Marquez	markwˈez
Martinez	martinˈez
Meteorologico	meteoroloxˈiko
MiSVb	miˌɛsvˌebˈe
Migracion	miɡrasjˈoŋ
Milio	mˈiljo
Mira	mˈira
Monarch	monˈart͡ʃ
Movies	movjˈes
Music	musˈik
Myron	mirˈoŋ
NVT	ˌɛnvˌetˈe
Nast	nˈast
Nederlandse	nederlˈandse
Network	netwˈork
Nightclub	niɡhtklˈub
ODEA	odˈea
Orde	ˈorde
Orlando	orlˈando
PIN	pˈiŋ
Pacifico	pasifˈiko
Paraguana	paraɡwˈana
Paris	parˈis
Participacion	partisipasjˈoŋ
Pasa	pˈasa
Pecho	pˈet͡ʃo
Pelea	pelˈea
Penha	pˈenha
Petronia	petrˈonja
Plus	plˈus
Posiblemente	posiblemˈente
Positivo	positˈivo
Programa	proɡrˈama
Project	projˈekt
Pronk	prˈonk
Punta	pˈunta
Quality	kwalˈiti
Quant	kwˈant
RADEX	radˈeks
Rampen	rampˈeŋ
Rapportnan	rappˈortnan
Rescue	rˈeskwe
Rodriguez	rodriɡˈez
SI	sˈi
Sacrificio	sakrifˈisjo
Scan	skˈaŋ
Seis	sˈe͡ɪs
Seyo	sˈejo
South	sˈowth
Surnam	surnˈam
Theater	theatˈer
Thru	thrˈu
Travel	travˈel
USA	ˈusa
VWO	vwˈo
Wernet	wernˈet
Wil	wˈil
Wilhelminastraat	wilhelminastrˈaːt
abilidadnan	abilidˈadnan
aceptacion	aseptasjˈoŋ
acreditacion	akreditasjˈoŋ
adecuadamente	adekwadamˈente
agilisa	axilˈisa
ahustacion	ahustasjˈoŋ
alentador	alentadˈor
analiza	analˈiza
ancianonan	ansjanˈonan
anhela	anhˈela
artesania	artesˈanja
asbesto	asbˈesto
asegura	aseɡˈura
asesina	asesˈina
ataka	atˈaka
auditoria	auditˈorja
averigua	averˈiɡwa
bakinan	bakˈinan
bandanan	bandˈanan
barancanan	barankˈanan
batayon	batajˈoŋ
beleid	belˈe͡ɪd
beyeza	bejˈeza
bisami	bisˈami
brabo	brˈabo
bruin	brˈujŋ
buffer	buffˈer
campa	kˈampa
cantantenan	kantantˈenan
cashi	kˈaʃi
categorisa	kateɡorˈisa
censo	sˈenso
censura	sensˈura
ciclon	siklˈoŋ
cobrando	kobrˈando
comunitario	komunitˈarjo
conceptonan	konseptˈonan
concretisa	konkretˈisa
conocir	konosˈir
contempla	kontˈempla
conteniendo	kontenjˈendo
contractonan	kontraktˈonan
corantnan	korˈantnan
coro	kˈoro
cumbini	kumbˈini
daggeldvergoeding	daɡxeldverɡudˈinɡ
dental	dentˈal
depresivo	depresˈivo
desconecta	deskonˈekta
difamacion	difamasjˈoŋ
directivanan	direktivˈanan
disco	dˈisko
distingui	distˈinɡj
districtonan	distriktˈonan
disturbio	distˈurbjo
diversidad	diversidˈad
diverso	divˈerso
divorcio	divˈorsjo
donante	donˈante
dosnan	dˈosnan
edicionnan	edisjˈonnan
educador	edukadˈor
elegi	elˈexi
emocionnan	emosjˈonnan
enrikece	enrikˈese
er	ˈer
erfpacht	erfpˈat͡ʃt
eventual	eventwˈal
evitando	evitˈando
expectativanan	ekspektativˈanan
expo	ˈekspo
eybao	ejbˈao
faha	fˈaha
first	fˈirst
flexibiliza	fleksibilˈiza
foi	fˈoj
forensyco	forensˈiko
fraccionnan	fraksjˈonnan
gaba	ɡˈaba
gritamento	ɡritamˈento
group	ɡrˈowp
guardia	ɡwˈardja
hayabo	hajˈabo
heridonan	heridˈonan
hermana	hermˈana
heroenan	herˈunan
hinka	hˈinka
hinke	hˈinke
hospitalnan	hospitˈalnan
house	hˈowse
hurista	hurˈista
hustificacion	hustifikasjˈoŋ
ilustracion	ilustrasjˈoŋ
impuestonan	impwestˈonan
inclusivo	inklusˈivo
indicacionnan	indikasjˈonnan
infeccionnan	infeksjˈonnan
infraccion	infraksjˈoŋ
ingrediente	inɡredjˈente
ingresa	inɡrˈesa
inn	ˈinŋ
insulto	insˈulto
inteligente	intelixˈente
intensivamente	intensivamˈente
intimida	intimˈida
inunda	inˈunda
inusual	inuswˈal
inventarisa	inventarˈisa
lealtad	lealtˈad
legado	leɡˈado
legalisa	leɡalˈisa
legitimidad	lexitimidˈad
letter	lettˈer
light	lˈiɡht
line	lˈine
listramento	listramˈento
lokaalnan	lokˈaːlnan
lucrativo	lukratˈivo
maluza	malˈuza
maneranan	manerˈanan
meti	mˈeti
migrante	miɡrˈante
modelonan	modelˈonan
momentu	momˈentu
morocoy	morokˈoj
motorunit	motorunˈit
movecionnan	movesjˈonnan
musca	mˈuska
noordwest	noːrdwˈest
nubianan	nubjˈanan
nulo	nˈulo
observador	observadˈor
oraño	orˈaɲo
orientacion	orjentasjˈoŋ
overtime	overtˈime
paciente	pasjˈente
paliativo	paljatˈivo
palonan	palˈonan
paranda	parˈanda
parha	pˈarha
part	pˈart
pasamento	pasamˈento
patria	pˈatrja
perdidanan	perdidˈanan
periodistico	perjodistˈiko
piesanan	pjesˈanan
plania	plˈanja
plat	plˈat
politicamente	politikamˈente
populacion	populasjˈoŋ
posibelmente	posibelmˈente
posicionnan	posisjˈonnan
positive	positˈive
postura	postˈura
poz	pˈoz
problematico	problematˈiko
procesamento	prosesamˈento
profundidad	profundidˈad
promé	promˈe
psicologico	psikoloxˈiko
que	kwˈe
raad	rˈaːd
recepcion	resepsjˈoŋ
regalonan	reɡalˈonan
regio	rˈexjo
repatria	repˈatrja
respalda	respˈalda
respetando	respetˈando
restablece	restablˈese
revision	revisjˈoŋ
sacrificionan	sakrifisjˈonan
saka	sˈaka
sake	sˈake
salbaguardia	salbaɡwˈardja
schoolnan	st͡ʃˈoːlnan
schouder	st͡ʃowdˈer
shopping	ʃoppˈinɡ
sifuera	sifwˈera
sigaria	siɡˈarja
simbolico	simbolˈiko
size	sˈize
siñamento	siɲamˈento
smart	smˈart
socialisa	sosjalˈisa
speed	spˈeːd
stempel	stempˈel
sumario	sumˈarjo
surseance	surseˈanse
tamaño	tamˈaɲo
tarhetanan	tarhetˈanan
tasa	tˈasa
terminonan	terminˈonan
tocando	tokˈando
tono	tˈono
trainingnan	tra͡ɪnˈinɡnan
transformacion	transformasjˈoŋ
transplante	transplˈante
trip	trˈip
vanguardia	vanɡwˈardja
versa	vˈersa
veterinario	veterinˈarjo
volumen	volumˈeŋ
wardanan	wardˈanan
web	wˈeb
werki	wˈerki
ARUBA	arˈuba
ASF	ˈasf
Accion	aksjˈoŋ
Adventista	adventˈista
Alzheimer	alzhe͡ɪmˈer
Amalia	amˈalja
Ambtenaar	ambtenˈaːr
Andres	andrˈes
Anteriormente	anterjormˈente
Anti	ˈanti
Aressa	arˈessa
Argus	arɡˈus
Asegurado	aseɡurˈado
Ata	ˈata
Aurora	aurˈora
Autismo	autˈismo
BCMS	bˌesˌeˌɛmˈɛs
BNA	bnˈa
Barconan	barkˈonan
Biba	bˈiba
Bloemond	blumˈond
Britten	brittˈeŋ
Brokke	brˈokke
CBA	kbˈa
CENSO	sˈenso
COHO	kˈoho
Cabai	kˈaba͡ɪ
CableTV	kˈabletˌevˈe
Castigo	kastˈiɡo
Catalina	katalˈina
Categoria	kateɡˈorja
Celebracion	selebrasjˈoŋ
Centronan	sentrˈonan
Chavez	t͡ʃavˈez
Ciudadano	sjudadˈano
Cola	kˈola
Communicatie	kommunikˈatje
Compleho	komplˈeho
Convention	konventjˈoŋ
Creando	kreˈando
Cubano	kubˈano
Dialogo	djalˈoɡo
Dogcatcher	doɡkatt͡ʃˈer
Driemasterstraat	drjemasterstrˈaːt
Drs	dˌeˌɛrˈɛs
Dunadornan	dunadˈornan
Duque	dˈukwe
Empleado	empleˈado
Empresa	emprˈesa
Esunnan	esˈunnan
Excellence	ekssellˈense
FHMD	ˌɛfhˌaˌɛmdˈe
FLEXO	flˈekso
Franklin	franklˈiŋ
Golfo	ɡˈolfo
Gomes	ɡomˈes
Haseth	hasˈeth
Havenstraat	havenstrˈaːt
Hogarnan	hoɡˈarnan
Holding	holdˈinɡ
Hudicial	hudisjˈal
Huize	hˈujze
Huridico	huridˈiko
IBIS	ibˈis
IMAX	imˈaks
Ing	ˈinɡ
Instancianan	instansjˈanan
Integracion	inteɡrasjˈoŋ
Interes	interˈes
Interno	intˈerno
Iron	irˈoŋ
Japon	japˈoŋ
Jessica	jessˈika
Joaquin	joakwˈiŋ
KYPA	kˈipa
Kawaiah	kawa͡ɪˈah
Kennedy	kennˈedi
Kiwanistico	kiwanistˈiko
Koningin	koninxˈiŋ
Kranwinkel	kranwinkˈel
Lama	lˈama
League	leˈaɡe
Lid	lˈid
Lion	ljˈoŋ
Locura	lokˈura
London	londˈoŋ
Lorentzstraat	lorentzstrˈaːt
MC	ˌɛmsˈe
Mahestad	mahestˈad
Mando	mˈando
Massive	massˈive
Mesun	mesˈuŋ
Monseigneur	monse͡ɪɡnˈewr
Monserat	monserˈat
Moringa	morˈinɡa
Mucho	mˈut͡ʃo
Nathaly	nathˈali
Nature	natˈure
Nest	nˈest
Nota	nˈota
Novel	novˈel
Oficialmente	ofisjalmˈente
Openbare	openbˈare
Ordenansa	ordenˈansa
Pabao	pabˈao
Padu	pˈadu
Paloma	palˈoma
Parlamentonan	parlamentˈonan
Pasaheronan	pasaherˈonan
Peter	petˈer
Picanto	pikˈanto
Play	plˈaj
Politica	politˈika
Porta	pˈorta
Produccion	produksjˈoŋ
QUEDA	kwˈeda
RIU	rjˈu
RWZI	rwzˈi
Radisson	radissˈoŋ
Rampenbestrijding	rampenbestre͡ɪdˈinɡ
Recupera	rekupˈera
Regis	rexˈis
Resiliente	resiljˈente
Resorts	resˈorts
Reyes	rejˈes
Rhuggenaath	rhuɡxenˈaːth
Ritmo	rˈitmo
Roos	rˈoːs
Run	rˈuŋ
SLM	ˌɛsˌɛlˈɛm
SVGA	svɡˈa
Saladin	saladˈiŋ
Scoop	skˈoːp
Sexual	sekswˈal
Signs	sˈiɡns
Siguientemente	siɡjentemˈente
Silva	sˈilva
Smartphone	smartphˈone
Snor	snˈor
Society	sosjˈeti
Staatsregeling	staːtsrexelˈinɡ
Stella	stˈella
Superfood	superfˈoːd
Titular	titulˈar
Trupialen	trupjalˈeŋ
Turkia	tˈurkja
Ultimamente	ultimamˈente
Unidadnan	unidˈadnan
Up	ˈup
Vehiculo	vehikˈulo
Vis	vˈis
Webb	wˈebb
Wiki	wˈiki
Wyatt	wjˈatt
accesibilidad	aksesibilidˈad
acercando	aserkˈando
acta	ˈakta
adaptando	adaptˈando
admiracion	admirasjˈoŋ
agradeci	aɡradˈesi
ahustacionnan	ahustasjˈonnan
alcanza	alkˈanza
alegra	alˈeɡra
alergia	alˈerxja
algu	ˈalɡu
altezza	altˈezza
ampliamente	ampljamˈente
an	ˈaŋ
asintomatico	asintomatˈiko
asistente	asistˈente
astronomico	astronomˈiko
atrapa	atrˈapa
atribui	atribˈuj
autoriza	autorˈiza
avancenan	avansˈenan
ayo	ˈajo
balanan	balˈanan
baldadi	baldˈadi
balia	bˈalja
bankroet	bankrˈut
barrio	bˈarrjo
behes	behˈes
bestel	bestˈel
bestuurskantoor	bestyrskantˈoːr
bingo	bˈinɡo
blaas	blˈaːs
boternan	botˈernan
bril	brˈil
buena	bwˈena
buraconan	burakˈonan
cabuya	kabˈuja
canabis	kanabˈis
cansancio	kansˈansjo
carchinan	kart͡ʃˈinan
care	kˈare
catastrofe	katastrˈofe
causante	kausˈante
cayendo	kajˈendo
cerando	serˈando
certamen	sertamˈeŋ
certidumbre	sertidˈumbre
cine	sˈine
claim	klˈa͡ɪm
clasificacion	klasifikasjˈoŋ
comestible	komestˈible
complementa	komplemˈenta
composicion	komposisjˈoŋ
conferencianan	konferensjˈanan
conforma	konfˈorma
consequencia	konsekwˈensja
consultanan	konsultˈanan
consumi	konsˈumi
contradictorio	kontradiktˈorjo
coordinadornan	koːrdinadˈornan
cordialmente	kordjalmˈente
corolla	korˈolla
creditornan	kreditˈornan
criminalnan	kriminˈalnan
cuando	kwˈando
cumpre	kˈumpre
curiculo	kurikˈulo
dao	dˈao
decisivo	desisˈivo
desaroyadornan	desarojadˈornan
desaroyando	desarojˈando
diciplina	disiplˈina
digitalizacion	dixitalizasjˈoŋ
dimas	dimˈas
dinamismo	dinamˈismo
diputado	diputˈado
dominio	domˈinjo
drempel	drempˈel
economisa	ekonomˈisa
ekivalente	ekivalˈente
embarazo	embarˈazo
emisora	emisˈora
empeño	empˈeɲo
empleada	empleˈada
enfermo	enfˈermo
entendimento	entendimˈento
escalacion	eskalasjˈoŋ
escohi	eskˈohi
escritor	eskritˈor
estadistica	estadistˈika
estadisticanan	estadistikˈanan
eta	ˈeta
eventualidad	eventwalidˈad
examennan	eksamˈennan
exigente	eksixˈente
extranhero	ekstranhˈero
f	ˈɛf
fayecidonan	fajesidˈonan
figuranan	fiɡurˈanan
finalisacion	finalisasjˈoŋ
fini	fˈini
flota	flˈota
fotografianan	fotoɡrafjˈanan
freezer	freːzˈer
fundador	fundadˈor
gedoogbeleid	xedoːɡbelˈe͡ɪd
genetico	xenetˈiko
gerente	xerˈente
graduacion	ɡradwasjˈoŋ
graduadonan	ɡradwadˈonan
habla	hˈabla
hazaña	hazˈaɲa
hospice	hospˈise
hungadornan	hunɡadˈornan
iglesia	iɡlˈesja
impactante	impaktˈante
incidentenan	insidentˈenan
indicador	indikadˈor
infeccioso	infeksjˈoso
inhumano	inhumˈano
inhusticia	inhustˈisja
instiga	instˈiɡa
integrantenan	inteɡrantˈenan
intensiva	intensˈiva
kentel	kentˈel
kies	kjˈes
lachi	lˈat͡ʃi
landspakket	landspakkˈet
larga	lˈarɡa
lid	lˈid
malisimo	malisˈimo
maltratando	maltratˈando
margen	marxˈeŋ
mashinnan	maʃˈinnan
mediador	medjadˈor
meer	mˈeːr
menasanan	menasˈanan
menase	menˈase
miembrecia	mjembrˈesja
miya	mˈija
moda	mˈoda
modo	mˈodo
monumental	monumentˈal
motornan	motˈornan
multanan	multˈanan
nek	nˈek
nieto	njˈeto
nietonan	njetˈonan
night	nˈiɡht
obstaculonan	obstakulˈonan
occasion	okkasjˈoŋ
orador	oradˈor
oral	orˈal
organizando	orɡanizˈando
pagado	paɡˈado
parhanan	parhˈanan
pasivo	pasˈivo
patronchi	patrˈont͡ʃi
pedofilia	pedofˈilja
penoso	penˈoso
planes	planˈes
platonan	platˈonan
populista	populˈista
porvenir	porvenˈir
pre	prˈe
preferiblemente	preferiblemˈente
preisnan	prˈe͡ɪsnan
presidi	presˈidi
primeramente	primeramˈente
project	projˈekt
protehe	protˈehe
racha	rˈat͡ʃa
raportahe	raportˈahe
raro	rˈaro
refresco	refrˈesko
remarka	remˈarka
restringi	restrˈinxi
risiconan	risikˈonan
saconan	sakˈonan
salo	sˈalo
sangrando	sanɡrˈando
sanitizers	sanitizˈers
sclama	sklˈama
seca	sˈeka
separadamente	separadamˈente
setup	setˈup
sinceridad	sinseridˈad
skeiro	skˈe͡ɪro
specialismo	spesjalˈismo
sponsornan	sponsˈornan
sportage	sportˈaxe
steun	stˈewŋ
strobando	strobˈando
subidanan	subidˈanan
sugerencianan	suxerensjˈanan
suppose	suppˈose
tactica	taktˈika
talentonan	talentˈonan
tasnan	tˈasnan
teamnan	teˈamnan
terapia	terˈapja
tercel	tersˈel
teror	terˈor
terorismo	terorˈismo
tesis	tesˈis
thru	thrˈu
tim	tˈim
tirando	tirˈando
toets	tˈuts
toezicht	tuzˈit͡ʃt
tracing	trasˈinɡ
trafica	trafˈika
transferencianan	transferensjˈanan
triunfo	trjˈunfo
tsunami	tsunˈami
tubo	tˈubo
uit	ˈujt
uitkering	ujtkerˈinɡ
unanime	unanˈime
unilateral	unilaterˈal
universidadnan	universidˈadnan
variante	varjˈante
variedad	varjedˈad
virtualmente	virtwalmˈente
vitrina	vitrˈina
voorzitter	voːrzittˈer
zodiacal	zodjakˈal
zomaar	zomˈaːr
zonanan	zonˈanan
zoom	zˈoːm
zwaailicht	zwaːjlˈit͡ʃt
APP	ˈapp
Acto	ˈakto
Adriaan	adrjˈaːŋ
Africa	afrˈika
Agencia	axˈensja
Airbus	a͡ɪrbˈus
Alarma	alˈarma
Anochi	anˈot͡ʃi
Astrid	astrˈid
Aumento	aumˈento
Award	awˈard
Aworo	awˈoro
Ayo	ˈajo
BBQ	bˌebˌekˈy
Belasting	belastˈinɡ
Bermudez	bermudˈez
Biezen	bjezˈeŋ
Bolivar	bolivˈar
Boroncana	boronkˈana
Boto	bˈoto
Branch	brˈant͡ʃ
CHE	t͡ʃˈe
CUA	kwˈa
Carlo	kˈarlo
Casinonan	kasinˈonan
Cayman	kajmˈaŋ
Centrum	sentrˈum
Chito	t͡ʃˈito
Ciudadanonan	sjudadanˈonan
Company	kompˈani
Conclusion	konklusjˈoŋ
Conducta	kondˈukta
Corporation	korporatjˈoŋ
Cuatro	kwˈatro
Customer	kustomˈer
D	dˈe
Dance	dˈanse
Davelaar	davelˈaːr
Defensie	defˈensje
Deposit	deposˈit
Dimas	dimˈas
DirecTV	dirˈektˌevˈe
Dunado	dunˈado
Elizabeth	elizabˈeth
Energia	enˈerxja
Enfermeria	enfermˈerja
Enid	enˈid
Entretanto	entretˈanto
Eseynan	esˈejnan
FMTB	ˌɛfˌɛmtˌebˈe
FUTURA	futˈura
Facultad	fakultˈad
Family	famˈili
Farro	fˈarro
Fatum	fatˈum
Fijo	fˈe͡ɪo
Financiën	finansjˈeŋ
Full	fˈull
Fund	fˈund
Gasoline	ɡasolˈine
Generalmente	xeneralmˈente
Gino	xˈino
Gloria	ɡlˈorja
Gold	ɡˈold
Gouverneur	ɡowvernˈewr
Hand	hˈand
Harms	hˈarms
Hassell	hassˈell
Hepple	hˈepple
Hofi	hˈofi
Hoge	hˈoxe
Holiday	holidˈaj
Hot	hˈot
Hugo	hˈuɡo
Incluso	inklˈuso
Innovation	innovatjˈoŋ
Integrity	inteɡrˈiti
Israel	israˈel
Jean	jeˈaŋ
Jimenez	jimenˈez
Justicia	justˈisja
KOR	kˈor
Kamay	kamˈaj
Katholiek	katholjˈek
Kaya	kˈaja
Kayak	kajˈak
Kooyman	koːjmˈaŋ
LIVE	lˈive
LVV	ˌɛlvˌevˈe
Lantamento	lantamˈento
Leoncita	leonsˈita
Loves	lovˈes
Luanne	lwˈanne
Luenne	lwˈenne
Malesanan	malesˈanan
Maris	marˈis
Maritimo	maritˈimo
Mavo	mˈavo
Meneer	menˈeːr
Mesa	mˈesa
Millennials	millennjˈals
Milo	mˈilo
MiniMega	mˈinimˈeɡa
Mobile	mobˈile
Monica	monˈika
Monuments	monumˈents
Nacion	nasjˈoŋ
Negoshi	neɡˈoʃi
Newark	newˈark
OCTA	ˈokta
ONU	ˈonu
Organisacionnan	orɡanisasjˈonnan
Oriente	orjˈente
PHP	pˌehˌapˈe
Pan	pˈaŋ
Papaya	papˈaja
Party	pˈarti
Pashent	paʃˈent
Passions	passjˈons
Pier	pjˈer
Pieters	pjetˈers
Pietersz	pjetˈersz
Poder	podˈer
Principalmente	prinsipalmˈente
Productonan	produktˈonan
Públiko	pˈubliko
Ranger	ranxˈer
Reglanan	reɡlˈanan
Representante	representˈante
Rescate	reskˈate
Restaurantnan	restaurˈantnan
Retiro	retˈiro
Rina	rˈina
Riu	rjˈu
Roma	rˈoma
Roza	rˈoza
SIN	sˈiŋ
SV	ˌɛsvˈe
Samsung	samsˈunɡ
Sanchez	sant͡ʃˈez
Sasaki	sasˈaki
Seco	sˈeko
Shanayah	ʃanajˈah
Shariska	ʃarˈiska
Softball	softbˈall
Spearfishing	spearfiʃˈinɡ
Sportsubsidie	sportsubsˈidje
Star	stˈar
Strategico	stratexˈiko
Suites	sujtˈes
TOB	tˈob
Texas	teksˈas
Thornton	thorntˈoŋ
Timeshare	timeʃˈare
Utrecht	utrˈet͡ʃt
VIP	vˈip
Vallejo	vallˈejo
Virma	vˈirma
Visitor	visitˈor
Vivienda	vivjˈenda
Voetbal	vutbˈal
Welcome	welkˈome
Wheels	whˈeːls
William	willjˈam
Wilmer	wilmˈer
Wim	wˈim
Wingo	wˈinɡo
Yen	jˈeŋ
Zeeland	zeːlˈand
aanwijzing	aːnwe͡ɪzˈinɡ
abierto	abjˈerto
abusadornan	abusadˈornan
accionan	aksjˈonan
acomodacionnan	akomodasjˈonnan
acontecimento	akontesimˈento
acostumbrado	akostumbrˈado
actornan	aktˈornan
adress	adrˈess
advertencianan	advertensjˈanan
afilia	afˈilja
afortuna	afortˈuna
afspraaknan	afsprˈaːknan
alinea	alinˈea
amante	amˈante
amargo	amˈarɡo
amputacion	amputasjˈoŋ
ana	ˈana
anos	anˈos
aportando	aportˈando
appel	appˈel
as	ˈas
aspira	aspˈira
atraconan	atrakˈonan
aunque	aˈunkwe
ausente	ausˈente
automatisacion	automatisasjˈoŋ
aveo	avˈeo
avioneta	avjonˈeta
away	awˈaj
ba	bˈa
bachi	bˈat͡ʃi
background	bakkɡrˈownd
banana	banˈana
banki	bˈanki
bankinan	bankˈinan
bilingual	bilinɡwˈal
bocht	bˈot͡ʃt
bondad	bondˈad
bora	bˈora
boroto	borˈoto
boton	botˈoŋ
brainstorming	bra͡ɪnstormˈinɡ
brake	brˈake
briyante	brijˈante
cabesantenan	kabesantˈenan
cadaver	kadavˈer
canasta	kanˈasta
caotico	kaotˈiko
caracteristica	karakteristˈika
carnet	karnˈet
cashier	kaʃjˈer
casinonan	kasinˈonan
cea	sˈea
chikitonan	t͡ʃikitˈonan
circo	sˈirko
clarificacion	klarifikasjˈoŋ
clausula	klausˈula
climatico	klimatˈiko
codering	koderˈinɡ
colaboradornan	kolaboradˈornan
compacto	kompˈakto
comprendible	komprendˈible
condenabel	kondenabˈel
conociendo	konosjˈendo
conscientemente	konssjentemˈente
consehabel	konsehabˈel
consequencianan	konsekwensjˈanan
contrincante	kontrinkˈante
convivencia	konvivˈensja
cordial	kordjˈal
coreccion	koreksjˈoŋ
corrupcion	korrupsjˈoŋ
costumbra	kostˈumbra
crypto	krˈipto
cubico	kubˈiko
cuminzamento	kuminzamˈento
cumprado	kumprˈado
debilidad	debilidˈad
decepciona	desepsjˈona
deliberando	deliberˈando
desafionan	desafjˈonan
desagradable	desaɡradˈable
desaprobacion	desaprobasjˈoŋ
desconocinan	deskonosˈinan
descubrimento	deskubrimˈento
descuido	deskˈujdo
desicionnan	desisjˈonnan
desk	dˈesk
destructivo	destruktˈivo
deteriora	deterjˈora
deterioro	deterjˈoro
dictadura	diktadˈura
direcion	diresjˈoŋ
distancing	distansˈinɡ
dobla	dˈobla
du	dˈu
ecologico	ekoloxˈiko
emailadres	ema͡ɪladrˈes
encuestion	enkwestjˈoŋ
enfermera	enfermˈera
entiteit	entitˈe͡ɪt
essencial	essensjˈal
excepto	ekssˈepto
exepcion	eksepsjˈoŋ
exihi	eksˈihi
experiencianan	eksperjensjˈanan
expertisio	ekspertˈisjo
explicitamente	eksplisitamˈente
eyriba	ejrˈiba
factibel	faktibˈel
fenomenal	fenomenˈal
flaco	flˈako
frecuenta	frekwˈenta
fumiga	fumˈiɡa
furioso	furjˈoso
fuseer	fusˈeːr
grandioso	ɡrandjˈoso
ham	hˈam
hanchi	hˈant͡ʃi
hardware	hardwˈare
holoshi	holˈoʃi
horcannan	horkˈannan
hortamento	hortamˈento
hortando	hortˈando
humamento	humamˈento
hungador	hunɡadˈor
huramento	huramˈento
husga	hˈusɡa
hygiene	hixjˈene
ijs	ˈe͡ɪs
impulsa	impˈulsa
inaugural	inauɡurˈal
incidental	insidentˈal
insecticida	insektisˈida
insistencia	insistˈensja
iregularidad	ireɡularidˈad
jingle	jˈinɡle
judicial	judisjˈal
juf	jˈuf
juffrouwnan	juffrˈowwnan
kabel	kabˈel
kantidat	kantidˈat
kens	kˈens
kual	kwˈal
lantando	lantˈando
lapso	lˈapso
lastima	lastˈima
lease	leˈase
leiding	le͡ɪdˈinɡ
lesion	lesjˈoŋ
libra	lˈibra
limpia	lˈimpja
links	lˈinks
luchador	lut͡ʃadˈor
lunch	lˈunt͡ʃ
maligno	malˈiɡno
manehador	manehadˈor
manifestante	manifestˈante
mano	mˈano
mantenimento	mantenimˈento
marina	marˈina
masalmente	masalmˈente
mastanto	mastˈanto
materianan	materjˈanan
mediacion	medjasjˈoŋ
mediconan	medikˈonan
mehorando	mehorˈando
men	mˈeŋ
menasando	menasˈando
mescla	mˈeskla
misanan	misˈanan
molinanan	molinˈanan
mondkapjes	mondkapjˈes
muestranan	mwestrˈanan
murayanan	murajˈanan
new	nˈew
news	nˈews
niester	njestˈer
nominado	nominˈado
nucleo	nuklˈeo
numeroso	numerˈoso
nutricion	nutrisjˈoŋ
ocupantenan	okupantˈenan
ook	ˈoːk
open	opˈeŋ
oponente	oponˈente
oradornan	oradˈornan
organisadornan	orɡanisadˈornan
pabo	pˈabo
paradero	paradˈero
payaso	pajˈaso
pedagogico	pedaɡoxˈiko
peligernan	pelixˈernan
penetracion	penetrasjˈoŋ
pertenencia	pertenˈensja
pesei	pˈese͡ɪ
piscador	piskadˈor
piscina	pissˈina
planeando	planeˈando
planning	plannˈinɡ
ploeg	plˈuɡ
plussers	plussˈers
pomp	pˈomp
pornada	pornˈada
postkantoor	postkantˈoːr
precis	presˈis
preocupacionan	preokupasjˈonan
presonan	presˈonan
privilegio	privilˈexjo
probabilidad	probabilidˈad
profesor	profesˈor
professional	professjonˈal
program	proɡrˈam
protega	protˈeɡa
provincia	provˈinsja
rasonnan	rasˈonnan
ratifica	ratifˈika
rebiba	rebˈiba
recept	resˈept
refuerso	refwˈerso
refugiadonan	refuxjadˈonan
rehabilitacion	rehabilitasjˈoŋ
republica	republˈika
resistente	resistˈente
respiracion	respirasjˈoŋ
respuesta	respwˈesta
reunionan	rewnjˈonan
ridiculo	ridikˈulo
riesga	rjˈesɡa
rifnan	rˈifnan
rijnan	rˈe͡ɪnan
risibí	risibˈi
roga	rˈoɡa
romantico	romantˈiko
ronda	rˈonda
rondo	rˈondo
rumornan	rumˈornan
salarial	salarjˈal
salon	salˈoŋ
satisfactorio	satisfaktˈorjo
scuchando	skut͡ʃˈando
secrecia	sekrˈesja
secura	sekˈura
seguramente	seɡuramˈente
servisio	servˈisjo
shift	ʃˈift
siguramente	siɡuramˈente
simbolonan	simbolˈonan
simultaneamente	simultaneamˈente
sinceramente	sinseramˈente
site	sˈite
situation	sitwatjˈoŋ
sobrepeso	sobrepˈeso
solicitante	solisitˈante
sostenedornan	sostenedˈornan
soña	sˈoɲa
spiritual	spiritwˈal
sport	spˈort
spula	spˈula
stacion	stasjˈoŋ
sterilisa	sterilˈisa
store	stˈore
strategianan	stratexjˈanan
structuralmente	strukturalmˈente
substancianan	substansjˈanan
t	tˈe
talves	talvˈes
tardanza	tardˈanza
tembla	tˈembla
timeshare	timeʃˈare
tombola	tombˈola
traicion	tra͡ɪsjˈoŋ
tratamentonan	tratamentˈonan
triage	trjˈaxe
tumba	tˈumba
tume	tˈume
unidat	unidˈat
upgrade	upɡrˈade
ventilacion	ventilasjˈoŋ
verboden	verbodˈeŋ
versus	versˈus
vet	vˈet
vice	vˈise
voucher	vowt͡ʃˈer
werksternan	werkstˈernan
wèpsait	wˈɛpsa͡ɪt
ziek	zjˈek
zundra	zˈundra
