a	a
a	ɐ
aba	aβɐ
abacate	ɐβɐkatɨ
abacateiro	ɐbakɐtɐjɾu
abacaxi	ɐbɐkɐʃi
abacaxizeiro	ɐbɐkɐʃizɐjɾu
abacial	ɐbɐsial
abacista	ɐbasiʃtɐ
abactor	ɐbɐktoɾ
abade	ɐbadɨ
abadesa	abadeza
abadessa	abɐdesɐ
abadia	ɐbɐdiɐ
abafada	ɐbɐfadɐ
abafadamente	ɐbɐfadɐmẽtɨ
abafadiço	ɐbɐfɐdisu
abafado	ɐbɐfadu
abafador	ɐbɐfɐdoɾ
abafar	ɐbɐfaɾ
abafação	ɐbɐfɐsɐ̃w̃
abaixamento	ɐbajʃɐmẽtu
abaixar	ɐbɐjʃaɾ
abaixo	ɐbajʃu
abajur	abɐʒuɾ
abalado	ɐbɐladu
abalar	ɐbɐlaɾ
abalava	ɐbɐlavɐ
abalizado	ɐbɐlizadu
abalou	ɐbɐlow
abanar	ɐbɐnaɾ
abandonada	ɐβɐ̃dunaðɐ
abandonado	ɐβɐ̃dunaðu
abandonar	ɐbɐ̃dunaɾ
abandonara	ɐβɐ̃dunaɾɐ
abandonará	ɐβɐ̃dunɐɾa
abandono	ɐβɐ̃donu
abandono	ɐβɐ̃dɔnu
abas	aβɐʃ
abastado	ɐβɐʃtaðu
abastar	ɐβɐʃtaɾ
abastecer	ɐβɐʃtɨseɾ
abater	ɐbɐteɾ
abatimento	ɐβɐtimẽtu
abaxial	ɐβɐksjal
abdicar	ɐbdikaɾ
abdicar	ɐβðikaɾ
abduzir	aβðuziɾ
abdómen	ɐbdɔmɛn
abel	abɛɫ
abelha	ɐβeʎɐ
abelha	ɐβɐjʎɐ
abelha	ɐβɐʎɐ
abençoado	ɐβẽswaðu
abençoar	ɐβẽswaɾ
aberta	ɐβɛɾtɐ
abertas	ɐβɛɾtɐʃ
aberto	ɐbɛɾtu
abertos	ɐβɛɾtuʃ
abertura	ɐβɨɾtuɾɐ
abeto	ɐβɛtu
abismar	ɐβiʒmaɾ
abismo	ɐβiʒmu
abissal	ɐβisaɫ
abjeto	ɐbʒɛtu
abjeção	ɐbʒɛsɐ̃w̃
abobadar	ɐβuβɐðaɾ
abobado	abobadu
abolição	ɐβulisɐ̃w̃
abominar	ɐβuminaɾ
abominação	ɐβuminɐsɐ̃w̃
abomináveis	ɐβuminavɛʃ
abominável	ɐβuminavɛɫ
abondança	ɐβõdɐ̃sɐ
aborto	ɐboɾtu
aborto	ɐbɔɾtu
aborígene	ɐβuɾiʒɨnɨ
abotoar	ɐbutwaɾ
abrandamento	ɐβɾɐ̃dɐmẽtu
abrandar	ɐbɾɐ̃daɾ
abranger	ɐβɾɐ̃ʒeɾ
abrangência	abɾɐ̃ʒẽsja
abrantes	ɐβɾɐ̃tɨʃ
abraçar	ɐbɾɐsaɾ
abraço	ɐβɾasu
abraços	ɐβɾasus
abria	ɐβɾiɐ
abricó	abɾikɔ
abrigado	ɐβɾiɣaðu
abrigar	ɐbɾiɡaɾ
abrigo	ɐβɾiɣu
abril	ɐbɾil
abrindo	ɐβɾĩdu
abrir	ɐβɾiɾ
abriu	ɐβɾiw
abrunho	ɐβɾuɲu
abrupto	ɐβɾuptu
absolutamente	ɐbsulutɐmẽtɨ
absoluto	ɐbsulutu
absonância	absonɐ̃sja
abstenção	ɐbʃtẽsɐ̃w̃
abstrair	ɐβʃtɾɐiɾ
absurdo	ɐbsuɾðu
abundante	ɐbũdɐ̃tɨ
abundar	ɐbũdaɾ
abundância	ɐbũdɐ̃sjɐ
abusar	ɐbuzaɾ
abusar	ɐβuzaɾ
abutre	ɐβutɾɨ
abóbada	ɐβɔβɐðɐ
abóbeda	ɐβɔβɨðɐ
abóbora	ɐβɔβuɾɐ
acaba	ɐkaβɐ
acabado	ɐkɐβaðu
acabando	ɐkɐβɐ̃du
acabar	ɐkɐbaɾ
acabava	ɐkɐβavɐ
acabou	ɐkɐβow
academia	ɐkɐðɨmiɐ
académico	ɐkɐdɛmiku
acaju	akaʒu
acalmar	ɐkaɫmaɾ
acamado	ɐkɐmaðu
acampamento	ɐkɐ̃pɐmẽtu
acampar	ɐkɐ̃paɾ
acanhado	ɐkɐɲadu
acarretar	ɐkɐʁɨtaɾ
acartar	ɐkɐɾtaɾ
acaso	ɐkazu
aceder	ɐsɨðeɾ
aceitar	ɐsejtaɾ
aceitar	ɐsɐjtaɾ
acelerador	ɐsɨlɨɾɐðoɾ
acelerar	ɐsɨlɨɾaɾ
acendendo	ɐsẽdẽdu
acender	ɐsẽdeɾ
aceno	ɐsenu
acento	ɐsẽtu
acepipe	asepipi
acercar	ɐsɨɾkaɾ
acertar	ɐsɨɾtaɾ
acerto	aseɾtu
acerto	aseʁtu
acerto	asɛɾtu
acerto	asɛʁtu
aceso	ɐsezu
acessar	ɐsɨsaɾ
acesso	ɐsɛsu
acetato	ɐsɨtatu
acha	aʃɐ
achado	ɐʃaðu
achanar	ɐʃɐnar
achando	ɐʃɐ̃du
achaparrado	aʃapaʁadu
achaparrar	aʃapaʁaɾ
achaque	ɐʃakɨ
achar	ɐʃaɾ
achava	ɐʃavɐ
acho	aʃu
achou	ɐʃow
acidente	ɐsidẽtɨ
acima	ɐsimɐ
aclarar	ɐklɐɾaɾ
acolhedor	ɐkuʎɨðoɾ
acolher	ɐkuʎeɾ
acolhimento	ɐkuʎimẽtu
acomete	akomɛtʃi
acompanhado	ɐkõpɐɲaðu
acompanhar	ɐkõpɐɲaɾ
aconchego	ɐkõʃeɣu
aconselhada	ɐkõsɨʎaðɐ
aconselhado	ɐkõsɨʎaðu
aconselhar	ɐkõsɨʎaɾ
acontecer	ɐkõtɨseɾ
acontecimento	ɐkõtɨsimẽtu
acordado	ɐkuɾðaðu
acordar	ɐkuɾdaɾ
acordo	ɐkoɾðu
acordo	ɐkɔɾðu
acostar	ɐkuʃtaɾ
acostumado	ɐkuʃtumaðu
acostumar	ɐkuʃtumaɾ
acre	akɾɨ
acreditar	ɐkɾɨðitaɾ
acrescentar	ɐkɾɨʃsẽtaɾ
acrescentou	ɐkɾɨʃsẽtow
acrescer	ɐkɾɨʃseɾ
acrograma	akɾoɡɾɐ̃mɐ
actuação	ɐtwɐsɐ̃w̃
acudir	ɐkuðiɾ
acudiu	ɐkuðiw
acurácia	akuɾasja
acusado	ɐkuzaðu
acusar	ɐkuzaɾ
acúmulo	akumulu
acúmulo	ɐkumulu
adamastor	ɐðɐmɐʃtoɾ
adaptação	ɐðɐptɐsɐ̃w̃
adega	ɐðɛɣɐ
adelo	ɐðɛlu
adentrar	adẽtɾaʁ
adesão	ɐðɨzɐ̃w̃
adeus	ɐðewʃ
adiantar	ɐdjɐ̃taɾ
adiante	ɐðjɐ̃tɨ
adiantou	ɐdjɐ̃tow
adicionar	ɐðisjunaɾ
adivinhar	ɐðiviɲaɾ
adição	ɐdisɐ̃w̃
administrador	ɐdminiʃtɾɐdoɾ
administrar	ɐdminiʃtrar
admirador	ɐðmiɾɐdoɾ
admirar	ɐdmiɾaɾ
admiração	ɐdmiɾɐsɐ̃w̃
admitir	ɐdmitiɾ
admoestar	ɐdmwɛʃtar
adoecer	ɐðuɨseɾ
adoecer	ɐðwɨseɾ
adolescência	ɐðulɨʃsẽsjɐ
adorar	ɐðuɾaɾ
adormecido	ɐðuɾmɨsiðu
adornar	ɐðuɾnaɾ
adorno	ɐðoɾnu
adorno	ɐðɔɾnu
adorável	ɐðuɾavɛɫ
adotar	ɐðɔtaɾ
adoçante	aðusɐ̃tɨ
adoçar	ɐðusaɾ
adoção	ɐðɔsɐ̃w̃
adrede	ɐðɾeðɨ
adscrito	ɐðɨʃkɾitu
aduela	ɐdwɛlɐ
adufe	ɐðufɨ
adular	ɐdulaɾ
adulto	ɐðuɫtu
adverso	ɐdvɛɾsu
adversário	ɐdvɨɾsaɾju
adão	ɐðɐ̃w̃
adélio	adɛlju
aeroporto	ɐɛɾɔpoɾtu
afagar	ɐfɐɡaɾ
afago	ɐfaɡu
afamar	ɐfɐmaɾ
afastado	ɐfɐʃtaðu
afastar	ɐfɐʃtaɾ
afazendar	ɐfɐzẽdar
afeganistão	ɐfɨɣɐniʃtɐ̃w̃
afeiçoar	ɐfɐjswar
afeição	ɐfɐjsɐ̃w
afetar	ɐfɛtaɾ
afete	afɛtʃi
afeto	ɐfɛtu
afiançar	ɐfjɐ̃saɾ
afiar	ɐfjaɾ
afigurar	ɐfiɡuɾaɾ
afim	afĩ
afinal	ɐfinaɫ
afinar	ɐfinaɾ
afinidade	ɐfiniðaðɨ
afirmar	ɐfiɾmaɾ
afixar	ɐfiksaɾ
aflita	ɐflitɐ
aflito	ɐflitu
aflição	ɐflisɐ̃w̃
aflorar	ɐfluɾaɾ
afogar	ɐfuɡaɾ
afoito	afojtu
afonso	ɐfõsu
afora	ɐfɔɾɐ
afortunadamente	ɐfuɾtunaðɐmẽtɨ
africano	ɐfɾikɐnu
afrontar	ɐfɾõtaɾ
afta	afitɐ
afta	afta
afta	aftɐ
afugentar	ɐfuʒẽtaɾ
afundar	ɐfũdaɾ
afável	ɐfavɛɫ
afã	ɐfɐ̃
agachar	ɐɡaʃaɾ
agadá	ɐɣɐða
agaloar	ɐɡɐlwaɾ
agami	ɐɣɐmi
agasalhar	ɐɣɐzɐʎaɾ
agasalho	ɐɣɐzaʎu
agiota	ɐʒjɔtɐ
agiotagem	ɐʒjutaʒɐ̃j̃
agir	ɐʒiɾ
agitadamente	ɐʒitaðɐmẽtɨ
agitado	ɐʒitaðu
agitar	ɐʒitaɾ
agitação	ɐʒitɐsɐ̃w̃
agoiro	ɐɣojɾu
agoiros	ɐɣojɾuʃ
agora	ɐɡɔɾɐ
agosto	ɐɡoʃtu
agoural	ɐɣowɾaɫ
agourar	ɐɡowɾaɾ
agouro	ɐɡowɾu
agouros	ɐɣowɾuʃ
agradar	ɐɡɾɐdaɾ
agradara	ɐɣɾɐðaɾɐ
agradável	ɐɣɾɐðavɛɫ
agrafador	ɐɡɾɐfɐdoɾ
agrafo	ɐɡɾafu
agreste	ɐɣɾɛʃtɨ
agrupamento	ɐɣɾupɐmẽtu
agrupar	ɐɣɾupaɾ
aguadeiro	aɡwɐdɐjɾu
aguante	ɐɣwɐ̃tɨ
aguar	ɐɡwaɾ
aguardente	aɣwaɾðẽtɨ
agudo	ɐɣuðu
aguerrido	aɡeridu
aguerrido	aɡeʁidu
aguião	ɐɣjɐ̃w̃
aguça	ɐɣusɐ
aguçar	ɐɣusaɾ
agá	ɐɣa
agência	ɐʒẽsjɐ
ah	a
aidético	ajdɛtʃiku
ainda	ɐĩdɐ
aio	aju
aipim	ajpĩ
airoso	ajɾozu
aja	aʒɐ
ajoelhar	ɐʒwɨʎaɾ
ajuda	ɐʒuðɐ
ajudante	ɐʒuðɐ̃tɨ
ajudar	ɐʒudaɾ
ajudar	ɐʒuðaɾ
ajuntamento	ɐʒũtɐmẽtu
ajuntar	ɐʒũtaɾ
ajustado	ɐʒuʃtaðu
ajustar	ɐʒuʃtaɾ
ajuste	ɐʒuʃtɨ
al	aɫ
ala	alɐ
alabarda	alɐbaɾdɐ
alabarda	alɐbaɾðɐ
alambique	ɐlɐ̃bikɨ
alameda	ɐlɐmeðɐ
alameda	ɐlɐmɛðɐ
alandroal	ɐlɐ̃dɾuaɫ
alapar	ɐlɐpaɾ
alar	ɐlaɾ
alargar	ɐlɐɾɣaɾ
alarve	ɐlaɾvɨ
albufeira	ɐɫβufɐjɾɐ
albânia	aɫβɐniɐ
albânia	aɫβɐnjɐ
alcachofra	aɫkɐʃofɾɐ
alcalinidade	ɐɫkɐlinidaðɨ
alcaloide	aɫkɐlɔjdɨ
alcanena	ɐɫkɐnenɐ
alcançar	aɫkɐ̃saɾ
alcanço	aɫkɐ̃su
alcateia	aɫkɐtejɐ
alcateia	aɫkɐtɐjɐ
alcatifa	aɫkɐtifɐ
alcatrão	aɫkɐtɾɐ̃w
alcobaça	ɐɫkuβasɐ
alcochete	ɐɫkuʃetɨ
alcoutim	ɐɫkowtĩ
alcova	aɫkovɐ
alcunha	aɫkuɲɐ
alcácer	aɫkasɛɾ
alcáçova	aɫkasuvɐ
aldeia	aɫdejɐ
aldeia	aɫdɐjɐ
aldraba	aɫdɾaβɐ
alecrim	ɐlɨkɾĩ
alegadamente	ɐlɨɣaðɐmẽtɨ
alegação	ɐlɨɣɐsɐ̃w̃
alegre	ɐlɛɣɾɨ
alegremente	ɐlɛɣɾɨmẽtɨ
alegres	ɐlɛɣɾɨʃ
alegria	ɐlɨɣɾiɐ
aleijado	ɐlɐjʒaðu
aleijamento	ɐlejʒɐmẽtu
aleijamento	ɐlɐjʒɐmẽtu
aleijar	ɐlejʒaɾ
aleijar	ɐlɐjʒaɾ
alemanha	ɐlɨmɐɲɐ
alenquer	ɐlẽkɛɾ
alentejo	ɐlẽtɛʒu
aleppo	ɐlɛpu
alertamente	alɛɾtɐmẽtɨ
aletria	ɐlɨtɾiɐ
alfabetização	alfɐβɨtizɐsɐ̃w̃
alfabeto	aɫfɐβɛtu
alface	aɫfasɨ
alfacinha	aɫfɐsiɲɐ
alfarrábio	aɫfɐʁabiu
alfarrábio	aɫfɐʁabju
alfarrábio	aɫfɐʁaβiu
alfarrábio	aɫfɐʁaβju
alfazema	aɫfɐzemɐ
alfinete	aɫfinɛti
alfisol	alfisɔl
alforge	aɫfɔɾʒɨ
alforria	aɫfuʁiɐ
alforriar	aɫfuʁjɐɾ
alfândega	aɫfɐ̃dɨɣɐ
algaravia	aɫɣɐɾɐviɐ
alghero	alɡɛɾu
algibeira	aɫʒiβɐjɾɐ
algo	aɫɣu
algum	aɫɡũ
alguma	alɡumɐ
algumas	alɡumɐʃ
alguns	alɡũʃ
algures	aɫɣuɾɨʃ
alguém	aɫɡɐ̃j̃
alhear	ɐʎjaɾ
alheio	ɐʎeju
alheio	ɐʎɐju
alho	aʎu
alhur	ɐʎuɾ
alhures	ɐʎuɾɨʃ
ali	ɐli
aliado	ɐljaðu
aliança	aliɐ̃sa
aliança	aliɐ̃sɐ
aliança	ɐljɐ̃sɐ
alicerce	ɐlisɛɾsɨ
alienar	ɐljenaɾ
alijó	ɐliʒɔ
alimentar	alimẽtaɾ
alimento	ɐlimẽtu
alinhado	ɐliɲaðu
alinhamento	ɐliɲɐmẽtu
alinhar	ɐliɲaɾ
alisar	ɐlizaɾ
aliás	ɐljaʃ
aljezur	ɐɫʒɨzuɾ
aljustrel	ɐɫʒuʃtɾɛɫ
aljôfar	aɫʒofaɾ
alma	aɫmɐ
almada	ɐɫmaðɐ
almanaque	aɫmɐnakɨ
almas	aɫmɐʃ
almeida	aɫmejðɐ
almeirim	ɐɫmɐjɾĩ
almodôvar	aɫmudovaɾ
almofada	aɫmufaðɐ
almoçar	aɫmusaɾ
almoço	aɫmosu
almoço	aɫmɔsu
almude	aɫmuðɨ
alongamento	ɐlõɡɐmẽtu
alongar	ɐlõɡaɾ
alperce	aɫpɛɾsɨ
alperche	aɫpɛɾʃɨ
alpestre	aɫpɛʃtɾi
alpiarça	ɐɫpiaɾsɐ
alpinismo	aɫpiniʒmu
alpinista	aɫpiniʃtɐ
alta	aɫtɐ
altar	aɫtaɾ
altas	aɫtɐʃ
altear	aɫtjaɾ
altera	aɫtɛɾa
alternado	aɫtɨɾnaðu
alternar	aɫtɨɾnaɾ
alternativa	aɫtɨɾnɐtivɐ
alteza	aɫtezɐ
altitude	aɫtituðɨ
alto	aɫtu
altos	aɫtuʃ
altura	aɫtuɾɐ
aluado	ɐlwaðu
alucinar	ɐlusinaɾ
aludir	ɐluðiɾ
alugado	ɐluɣaðu
alugar	ɐluɡaɾ
aluguer	ɐluɡɛɾ
alumiado	ɐlumjaðu
alumiar	ɐlumjaɾ
alumínico	ɐluminiku
aluno	ɐlunu
alva	aɫvɐ
alvaiázere	aɫvɐjazɨɾɨ
alves	aɫvɨʃ
alvito	ɐɫvitu
alvo	aɫvu
alvor	aɫvoɾ
alvoroço	aɫvuɾosu
alvoroço	aɫvuɾɔsu
alvíssaras	aɫvisɐɾɐʃ
alça	aɫsɐ
alçar	aɫsaɾ
além	alɐ̃j̃
alínea	ɐlinjɐ
alívio	ɐliviu
alívio	ɐlivju
ama	ɐmɐ
amado	ɐmaðu
amadora	ɐmɐðoɾɐ
amainar	ɐmajnaɾ
amanhecer	ɐmɐɲɨseɾ
amanhã	amɐɲɐ̃
amansador	ɐmɐ̃sɐðoɾ
amansar	ɐmɐ̃saɾ
amante	ɐmɐ̃tɨ
amapá	ɐmɐpa
amar	ɐmaɾ
amaral	ɐmɐɾaɫ
amarante	ɐmɐɾɐ̃tɨ
amarelar	ɐmɐɾɨlaɾ
amarelo	ɐmɐɾɛlu
amares	ɐmaɾɨʃ
amargamente	ɐmaɾɣɐmẽtɨ
amargo	ɐmaɾɣu
amargura	ɐmɐɾɣuɾɐ
amarone	ɐmɐɾonɨ
amassar	ɐmɐsaɾ
amaterasu	ɐmɐtɨɾɐsu
amavio	amaviu
amavioso	amaviozu
amazonas	ɐmɐzonɐʃ
amazonita	ɐmɐzunitɐ
amazonítico	ɐmɐzunitiku
amazônia	amazonja
ambas	ɐ̃bɐʃ
ambiente	ɐ̃bjẽtɨ
ambientes	ɐ̃bjẽtɨʃ
ambição	ɐ̃bisɐ̃w̃
ambos	ɐ̃buʃ
ambulância	ɐ̃bulɐ̃sjɐ
ambíguo	ɐ̃biɣwu
ameaça	ɐmjasɐ
amedrontar	ɐmɨðɾõtaɾ
ameixa	ɐmɐjʃɐ
amendoim	ɐmẽdwĩ
ameno	ɐmenu
ametista	ɐmɨtiʃtɐ
amieiro	ɐmjejɾu
amieiro	ɐmjɐjɾu
amiga	ɐmiɣɐ
amigar	ɐmiɣaɾ
amigdalite	ɐmiɣðɐlitɨ
amigo	ɐmiɣu
amigos	ɐmiɣuʃ
amigável	ɐmiɣavɛɫ
amizade	ɐmizaðɨ
amiúde	ɐmjudɨ
amnistia	ɐmniʃtiɐ
amo	ɐmu
amolar	ɐmulaɾ
amolecer	ɐmulɨseɾ
amolgar	ɐmoɫɡaɾ
amontoado	ɐmõtwaðu
amor	ɐmoɾ
amora	ɐmɔɾɐ
amores	ɐmoɾɨʃ
amplo	ɐ̃plu
ampola	ɐ̃polɐ
ampulheta	ɐ̃puʎetɐ
amuleto	ɐmuletu
amurca	ɐmurkɐ
amável	ɐmavɛɫ
amém	amɐ̃j̃
amém	amɛn
amém	amẽj̃
américa	ɐmɛɾikɐ
amígdala	ɐmiɣðɐlɐ
ana	ɐnɐ
anadia	ɐnɐðiɐ
analisar	ɐnɐlizaɾ
ananás	ɐnɐnaʃ
anarquia	anaɾkiɐ
ancho	ɐ̃ʃu
anchova	ɐ̃ʃovɐ
anchovado	ɐ̃ʃuvaðu
anchoveta	ɐ̃ʃuvetɐ
ancinho	ɐ̃siɲu
ancião	ɐ̃siɐ̃w
ancora	ɐ̃kɔɾɐ
ancorar	ɐ̃kuɾaɾ
anda	ɐ̃dɐ
andaime	ɐ̃dajmɨ
andam	ɐ̃dɐ̃w̃
andando	ɐ̃dɐ̃du
andante	ɐ̃dɐ̃tɨ
andar	ɐ̃daɾ
andas	ɐ̃dɐʃ
andava	ɐ̃davɐ
ando	ɐ̃du
andor	ɐ̃dor
andorinha	ɐ̃duɾiɲɐ
andorra	ɐ̃doʁɐ
andou	ɐ̃dow
andrajo	ɐ̃dɾaʒu
andrajoso	ɐ̃dɾaʒozo
andré	ɐ̃dɾɛ
anedótico	ɐnɨðɔtiku
anel	ɐnɛɫ
anexo	ɐnɛksu
angola	ɐ̃ɡɔlɐ
anguila	ɐ̃ɡilɐ
angular	ɐ̃ɡulaɾ
anguloso	ɐ̃ɡulozu
angústia	ɐ̃ɡuʃtjɐ
anho	ɐɲu
anil	ɐniɫ
animado	ɐnimaðu
animal	ɐnimaɫ
animar	ɐnimaɾ
anime	animi
animosidade	ɐnimuziðaðɨ
animê	anime
aninhado	ɐniɲaðu
aninhar	ɐniɲaɾ
aniquilar	ɐnikilaɾ
anjo	ɐ̃ʒu
anjos	ɐ̃ʒuʃ
ano	ɐnu
anoitecer	ɐnojtɨseɾ
anomalia	ɐnɔmɐliɐ
anonimato	ɐnunimatu
anormal	ɐnɔɾmaɫ
anos	ɐnuʃ
anotador	ɐnutɐðoɾ
anotar	ɐnutaɾ
anotação	ɐnutɐsɐ̃w̃
ansim	ɐ̃sĩ
ansiosamente	ɐ̃sjɔzɐmẽtɨ
ansioso	ɐ̃sjozu
ansião	ɐ̃siɐ̃w
anta	ɐ̃tɐ
antanho	ɐ̃tɐɲu
antano	ɐ̃tɐnu
antebraço	ɐ̃tɨbɾasu
antecâmara	ɐ̃tɨkɐmɐɾɐ
antedatar	ɐ̃tɨdɐtaɾ
anteontem	ɐ̃tjõtɐ̃j̃
anteontem	ɐ̃tjõtẽj̃
antepassado	ɐ̃tɨpɐsaðu
antepassados	ɐ̃tɨpɐsaðuʃ
antes	ɐ̃tɨʃ
anticonstitucionalissimamente	ɐ̃tikõʃtitusjunɐlisimɐmẽtɨ
anticultural	ɐ̃tikuɫtuɾaɫ
antifonário	ɐ̃tifunaɾju
antiga	ɐ̃tiɣɐ
antigamente	ɐ̃tiɣɐmẽtɨ
antigo	ɐ̃tiɣu
antigos	ɐ̃tiɣuʃ
antiguidade	ɐ̃tiɣwiðaðɨ
antimonárquico	ɐ̃timunaɾkiku
antimoral	ɐ̃timuɾaɫ
antiquário	ɐ̃tikwaɾju
antitético	ɐ̃titɛtiku
antontem	ɐ̃tõtɐ̃j̃
antontem	ɐ̃tõtẽj̃
antracífero	ɐ̃tɾɐsifɨɾu
antífona	ɐ̃tifunɐ
anual	ɐnuaɫ
anual	ɐnwaɫ
anuir	ɐnwiɾ
anunciar	ɐnũsjaɾ
anuência	anuẽsja
anzol	ɐ̃zɔɫ
análise	ɐnalizɨ
ao	aw
aonde	ɐõdɨ
aos	awʃ
aosta	ɐɔʃtɐ
apagado	ɐpɐɣaðu
apagar	ɐpɐɣaɾ
apaixonado	ɐpajʃunaðu
apanhar	ɐpɐɲaɾ
aparafusar	ɐpɐɾɐfuzaɾ
aparato	ɐpɐɾatu
aparatoso	ɐpɐɾɐtozu
aparece	ɐpɐɾɛsɨ
aparecer	ɐpɐɾɨseɾ
apareceu	ɐpɐɾɨsew
aparecia	ɐpɐɾɨsiɐ
aparecimento	ɐpɐɾɨsimẽtu
aparentar	ɐpɐɾẽtaɾ
aparente	ɐpɐɾẽtɨ
aparição	ɐpɐɾisɐ̃w̃
apartamento	ɐpɐɾtɐmẽtu
aparência	ɐpɐɾẽsjɐ
apatetado	apatetadu
apavorado	ɐpɐvuɾaðu
apavorar	ɐpɐvuɾaɾ
apenas	ɐpenɐʃ
aperrear	ɐpɨʁjaɾ
apertado	ɐpɨɾtaðu
apertando	ɐpɨɾtɐ̃du
apertar	ɐpɨɾtaɾ
aperto	ɐpeɾtu
aperto	ɐpɛɾtu
apesar	ɐpɨzaɾ
apetite	ɐpɨtitɨ
aplacar	ɐplɐkar
aplanar	ɐplɐnar
aplauso	ɐplawzu
aplicar	ɐplikaɾ
apoio	ɐpoju
apontar	ɐpõtaɾ
aportar	ɐpuɾtaɾ
aposentar	ɐpuzẽtaɾ
aposento	ɐpuzẽtu
aposentos	ɐpuzẽtuʃ
aprazer	ɐpɾɐzeɾ
aprazível	ɐpɾɐzivɛɫ
apreciador	ɐpɾɨsjɐðoɾ
apreciar	ɐpɾɨsjaɾ
apreender	ɐpɾj̃ẽdeɾ
aprender	ɐpɾẽdeɾ
aprendiz	ɐpɾẽdiʃ
aprendizagem	ɐpɾẽdizaʒɐ̃j̃
apresentado	ɐpɾɨzẽtaðu
apresentar	ɐpɾɨzẽtaɾ
apresentação	ɐpɾɨzẽtɐsɐ̃w̃
apressado	ɐpɾɨsaðu
apressar	ɐpɾɨsaɾ
apreço	ɐpɾesu
apreço	ɐpɾɛsu
aprimorar	ɐpɾɨmuɾaɾ
aprofundar	ɐpɾufũdaɾ
aprontar	ɐpɾõtaɾ
apropriado	ɐpɾupɾjaðu
aprovado	ɐpɾuvaðu
aprovar	ɐpɾuvaɾ
aproveitar	ɐpɾuvɐjtaɾ
aproximadamente	ɐpɾɔsimaðɐmẽtɨ
aproximar	ɐpɾɔsimaɾ
aproximação	ɐpɾɔsimɐsɐ̃w̃
aproximou	ɐpɾɔsimow
apurar	ɐpuɾaɾ
apuro	apuɾu
apócrifo	ɐpɔkɾifu
após	ɐpɔʃ
apóstolo	ɐpɔʃtulu
apóstolos	ɐpɔʃtuluʃ
aquela	ɐkɛlɐ
aquelas	ɐkɛlɐʃ
aquele	ɐkelɨ
aquele	ɐkeɫ
aqueles	ɐkelɨʃ
aqui	ɐki
aquilo	ɐkilu
aquário	ɐkwaɾju
aquém	akɐ̃j̃
aquém	akẽj̃
ar	aɾ
arado	ɐɾaðu
aragem	ɐɾaʒɐ̃j̃
aragem	ɐɾaʒẽj̃
arame	ɐɾɐmɨ
arando	ɐɾɐ̃du
aranha	ɐɾɐɲɐ
arar	ɐɾaɾ
arau	ɐɾaw
araújo	aɾauʒu
arbitramento	ɐɾβitɾɐmẽtu
arborizar	ɐɾβuɾizaɾ
arbusto	ɐɾβuʃtu
arca	aɾkɐ
arcabuz	aɾkɐbuʃ
arcanjo	ɐɾkɐ̃ʒu
arcano	ɐɾkɐnu
archote	ɐɾʃɔtɨ
arco	aɾku
ardente	ɐɾdẽtɨ
arder	ɐɾdeɾ
ardina	ɐɾðinɐ
ardor	ɐɾðoɾ
ardósia	aɾdɔziɐ
areia	ɐɾɐjɐ
arena	ɐɾenɐ
ares	aɾɨʃ
arezzo	ɐɾɛtɨsu
arganil	ɐɾɣɐniɫ
argila	ɐɾʒilɐ
argola	aɾɡɔla
argola	aʁɡɔla
arguido	ɐɾɣwiðu
arguir	ɐɾɣwiɾ
argumentador	ɐɾɣumẽtɐðoɾ
argumentar	ɐɾɣumẽtaɾ
argumentação	ɐɾɣumẽtɐsɐ̃w̃
argumentista	ɐɾɣumẽtiʃtɐ
arma	aɾmɐ
armada	ɐɾmaðɐ
armado	ɐɾmaðu
armador	ɐɾmɐðoɾ
armamar	ɐɾmɐmaɾ
armamentista	aɾmamẽtʃista
armamentista	aʁmamẽtʃijʃta
armamento	ɐɾmɐmẽtu
armar	ɐɾmaɾ
armas	aɾmɐʃ
armazenar	ɐɾmɐzɨnaɾ
armazém	ɐɾmɐzɐ̃j̃
armação	ɐɾmɐsɐ̃w̃
arminho	ɐɾmiɲu
armário	ɐɾmaɾju
arménia	ɐɾmɛniɐ
arménia	ɐɾmɛnjɐ
arno	aɾnu
aro	aɾu
aroma	ɐɾomɐ
arouca	ɐɾowkɐ
arpão	ɐɾpɐ̃w̃
arqueiro	aɾkɐjɾu
arquipélago	ɐɾkipɛlɐɣu
arquitetura	ɐɾkitɛtuɾɐ
arrabalde	ɐʁɐβaɫðɨ
arraiolos	ɐʁɐjɔluʃ
arrais	ɐʁajʃ
arrancar	ɐʁɐ̃kaɾ
arranhar	ɐʁɐɲaɾ
arranjado	ɐʁɐ̃ʒaðu
arranjar	ɐʁɐ̃ʒaɾ
arranjo	ɐʁɐ̃ʒu
arrastado	ɐʁɐʃtaðu
arrastando	ɐʁɐʃtɐ̃du
arrastar	ɐʁɐʃtaɾ
arrazoar	ɐʁɐzwaɾ
arrebentar	ɐʁɨβẽtaɾ
arrebol	ɐʁɨβɔɫ
arrecadar	ɐʁɨkɐðaɾ
arredores	ɐʁɨðɔɾɨʃ
arrefecer	ɐʁɨfɛseɾ
arrefecimento	ɐʁɨfɛsimẽtu
arregimentar	aʁeʒimẽtaɾ
arregimentar	aʁeʒimẽtaʁ
arremedar	ɐʁɨmɨðaɾ
arremete	aʁemɛtʃi
arrente	aʁẽti
arrepender	ɐʁɨpẽdeɾ
arrependido	ɐʁɨpẽdiðu
arrependimento	ɐʁɨpẽdimẽtu
arrepiado	ɐʁɨpjaðu
arrepiante	ɐʁɨpjɐ̃tɨ
arrepiar	ɐʁɨpjaɾ
arrepio	ɐʁɨpiu
arriba	ɐʁiβɐ
arritmia	ɐʁitmiɐ
arroba	ɐʁobɐ
arrojo	ɐʁoʒu
arrombar	ɐrõbaɾ
arrombar	ɐʁõbaɾ
arronches	ɐʁõʃɨʃ
arroz	ɐʁoʃ
arrozal	ɐʁuzaɫ
arruaça	aʁuasa
arruinar	ɐʁuinaɾ
arrumar	ɐrumaɾ
arrumar	ɐʁumaɾ
arsenal	aɾsɨnaɫ
arte	aɾtɨ
artes	aɾtɨʃ
artificial	ɐɾtifisjaɫ
artilharia	ɐɾtiʎɐɾiɐ
artista	ɐɾtiʃtɐ
artículo	ɐɾtikulu
arvoredo	ɐɾvuɾeðu
arvoredos	ɐɾvuɾeðuʃ
arábico	ɐɾaβiku
as	ɐʃ
asa	azɐ
asar	ɐzaɾ
asas	azɐʃ
ascenso	ɐʃsẽsu
ascensão	ɐʃsẽsɐ̃w̃
asfalto	ɐʃfaɫtu
asfixiar	ɐʃfiksjaɾ
asilo	ɐzilu
asinha	ɐziɲɐ
asma	aʒmɐ
asneira	ɐʒnɐjɾɐ
asno	aʒnu
aspa	aʃpɐ
aspecto	ɐʃpɛktu
aspecto	ɐʃpɛtu
assado	ɐsaðu
assalariado	ɐsɐlɐɾjaðu
assaltante	ɐsaɫtɐ̃tɨ
assaltar	ɐsaɫtaɾ
assalto	ɐsaɫtu
assar	ɐsaɾ
assassinato	ɐsɐsinatu
assassínio	ɐsɐsinju
assegurar	ɐsɨɣuɾaɾ
asseio	ɐsɐju
assemelhar	ɐsɨmɨʎaɾ
assentar	ɐsẽtaɾ
assento	ɐsẽtu
asserção	ɐsɨɾsɐ̃w̃
assessoria	asesoɾia
assim	ɐsĩ
assimilação	ɐsimilɐsɐ̃w̃
assinalado	ɐsinɐlaðu
assinalar	ɐsinɐlaɾ
assinar	ɐsinaɾ
assistir	ɐsiʃtiɾ
assistência	ɐsiʃtẽsjɐ
asso	asu
assoalho	ɐswaʎu
assobiar	ɐsuβjaɾ
assobio	ɐsuβiu
associação	ɐsusjɐsɐ̃w̃
assombrado	ɐsõbɾaðu
assombro	ɐsõbɾu
assumir	ɐsumiɾ
assunto	ɐsũtu
assur	asuɾ
assustado	ɐsuʃtaðu
assustar	ɐsuʃtaɾ
assédio	ɐsɛðju
astenia	ajʃtenia
astenia	astenia
astro	ajʃtɾu
astro	astɾu
astrofísica	aʃtɾɔfizikɐ
astrolábio	ɐʃtɾɔlaβju
astroso	ɐʃtɾozu
astúcia	ɐʃtusjɐ
atacante	ɐtɐkɐ̃tɨ
atacar	ɐtɐkaɾ
atado	ɐtaðu
atalhar	ɐtɐʎaɾ
ataque	ɐtakɨ
atar	ɐtaɾ
atarracado	ataʁakadu
atarracar	ataʁakaɾ
atarraxar	ɐtɐʁɐʃaɾ
atempar	ɐtẽpaɾ
ateniense	ɐtɨnjẽsɨ
atentado	ɐtẽtaðu
atenção	ɐtẽsɐ̃w̃
aterrado	ɐtɨʁaðu
aterrar	ɐtɨʁaɾ
aterro	ɐteʁu
aterro	ɐtɛʁu
ateísmo	ɐtiiʒmu
atirador	ɐtiɾɐðoɾ
atirando	ɐtiɾɐ̃du
atirou	ɐtiɾow
atitude	ɐtituðɨ
ativador	ativɐðoɾ
ativamente	ativɐmẽtɨ
ativar	ativaɾ
atividade	ɐtiviðaðɨ
ativista	ativiʃtɐ
ativo	ativu
atlas	atlɐʃ
atleta	ɐtlɛtɐ
atmosfera	atmoʃfɛra
ato	atu
ator	atoɾ
atraente	ɐtɾɐẽtɨ
atrair	ɐtɾɐiɾ
atrapalhada	ɐtɾɐpɐʎaðɐ
atrapalhado	ɐtɾɐpɐʎaðu
atrapalhar	ɐtɾɐpɐʎaɾ
atrasado	ɐtɾɐzaðu
atrasar	ɐtɾɐzaɾ
atraso	ɐtɾazu
atrativo	ɐtɾativu
atravessado	ɐtɾɐvɨsaðu
atravessar	ɐtɾɐvɨsaɾ
através	ɐtɾɐvɛʃ
atração	ɐtɾasɐ̃w̃
atribuir	ɐtɾiβwiɾ
atriz	ɐtɾiʃ
atropelar	ɐtɾupɨlaɾ
atrás	ɐtɾaʃ
atual	ɐtwaɫ
atualidade	ɐtwɐliðaðɨ
atualmente	ɐtwaɫmẽtɨ
atuar	ɐtwaɾ
atum	ɐtũ
aturar	atuɾaʁ
aturo	atuɾu
até	ɐtɛ
audaz	awðaʃ
audição	awðisɐ̃w̃
auga	awɡɐ
aula	awɫɐ
aulas	awlɐʃ
aumentar	awmẽtaɾ
aumento	awmẽtu
aurora	awɾɔɾɐ
aurélio	awɾɛlju
auréola	awɾɛulɐ
austeridade	awʃtɨɾiðaðɨ
austero	awʃtɛɾu
austro	awʃtɾu
ausência	awzẽsjɐ
autenticidade	awtẽtisiðaðɨ
auto	awtu
autobiográfico	awtɔbjuɡrafiku
autocarro	awtɔkaʁu
autoestima	awtɔiʃtimɐ
autoestima	awtɔʃtimɐ
autoestrada	awtɔiʃtɾaðɐ
autoestrada	awtɔʃtɾaðɐ
autoevidente	awtwividẽtɨ
automatizar	awtumɐtizaɾ
automático	awtumatiku
autor	awtoɾ
autoria	awtuɾiɐ
autoridade	awtuɾiðaðɨ
autorizar	awtuɾizaɾ
autorização	awtuɾizɐsɐ̃w̃
autorretrato	awtɔʁɨtɾatu
autómato	awtɔmɐtu
avaliar	ɐvɐljaɾ
avaliação	ɐvɐljɐsɐ̃w̃
avançar	ɐvɐ̃saɾ
avanço	avɐ̃su
avariado	ɐvɐɾjaðu
ave	avɛ
ave	avɨ
aveia	ɐvejɐ
aveia	ɐvɐjɐ
aveiro	avejɾu
avelã	ɐvɨlɐ̃
avenida	ɐvɨniðɐ
avental	ɐvẽtaɫ
aventurado	avẽtuɾadu
aventuro	avẽtuɾu
averiguar	ɐvɨɾiɣwaɾ
aversão	ɐvɨɾsɐ̃w̃
aves	avɨʃ
aviar	ɐvjaɾ
avis	ɐviʃ
avisar	ɐvizaɾ
avistar	ɐviʃtaɾ
avião	ɐvjɐ̃w̃
avondança	ɐvõdɐ̃sɐ
avó	ɐvɔ
avós	ɐvɔʃ
avô	ɐvo
azambuja	ɐzɐ̃buʒɐ
azar	ɐzaɾ
azeite	ɐzejtɨ
azeite	ɐzɐjtɨ
azeiteiro	ɐzejtejɾu
azeiteiro	ɐzɐjtɐjɾu
azerbaijão	ɐzɨɾβɐjʒɐ̃w̃
azereiro	ɐzɨɾejɾu
azereiro	ɐzɨɾɐjɾu
azevedo	ɐzɨveðu
azevinho	ɐzɨviɲu
azia	ɐziɐ
aziago	ɐzjaɡu
azinhaga	ɐziɲaɣɐ
azinheira	ɐziɲejɾɐ
azinheira	ɐziɲɐjɾɐ
azuis	ɐzujʃ
azul	ɐzuɫ
azulejo	ɐzuleʒu
azulejo	ɐzulɐjʒu
azulejo	ɐzulɛʒu
azulejos	ɐzuleʒuʃ
azulejos	ɐzulɐjʒuʃ
azulejos	ɐzulɛʒuʃ
azur	ɐzuɾ
açacalar	ɐsɐkɐlaɾ
açafrão	ɐsɐfɾɐ̃w̃
aço	asu
açoite	ɐsojtɨ
açor	ɐsoɾ
açorda	ɐsoɾðɐ
açougue	ɐsowɣɨ
açucena	ɐsusenɐ
açude	ɐsuðɨ
açular	ɐsulaɾ
ação	ɐsɐ̃w̃
açúcar	ɐsukɐɾ
aéreo	ɐɛɾju
aí	ɐi
baba	babɐ
babau	babaw
babe	babi
babosa	bɐβɔzɐ
baboseira	babozejɾa
bacalhau	bɐkɐʎaw
bacharel	bɐʃɐɾɛɫ
bachquir	baʃkɨɾ
bacia	bɐsiɐ
bada	badɐ
badalo	bɐðalu
bafo	bafu
bagatela	baɡatɛla
bagaço	bɐɣasu
bagel	bɛjɣɨl
bagre	baɣɾɨ
baguete	baɡɛtʃi
baiano	bajɐ̃nu
baical	bajkaɫ
bailarina	bajlɐɾinɐ
bailarino	bajlɐɾinu
baile	bajlɨ
bainha	bɐiɲɐ
bairro	bajʁu
baitar	aj
baixa	bajʃɐ
baixada	bɐjʃaðɐ
baixando	bajʃɐ̃du
baixar	bajʃaɾ
baixo	bajʃu
baião	bajɐ̃w
bala	balɐ
balada	bɐlaðɐ
balança	bɐlɐ̃sɐ
balançar	bɐlɐ̃saɾ
balaço	balasu
baldaquino	baɫðɐkinu
baldar	baɫdaɾ
balde	baɫdɨ
baldio	baɫdiu
baleeiro	bɐljɐjɾu
baleia	bɐlejɐ
baleia	bɐlɐjɐ
baliza	bɐlizɐ
balzaquiana	balzɐkjɐnɐ
balázio	balazju
balão	bɐlɐ̃w̃
balé	bɐlɛ
bambu	bɐ̃bu
banana	bɐnɐnɐ
bancar	bɐ̃kaɾ
banco	bɐ̃ku
banda	bɐ̃dɐ
bandeira	bɐ̃dɐjɾɐ
bandeja	bɐ̃deʒɐ
bandicoot	bɐ̃dikutɨ
bandido	bɐ̃diðu
bando	bɐ̃du
bandolim	bɐ̃dulĩ
banguela	bɐ̃ɡɛlɐ
banha	bɐɲɐ
banhar	bɐɲaɾ
banheira	bɐɲɐjɾɐ
banheiro	bɐɲɐjɾu
banho	bɐɲu
banir	bɐniɾ
banzo	bɐ̃zu
bar	baɾ
baralho	bɐɾaʎu
barato	bɐɾatu
baraço	baɾasu
barba	baɾβɐ
barbas	baɾβɐʃ
barbeiro	bɐɾβɐjɾu
barca	baɾkɐ
barcelos	bɐɾsɛluʃ
barco	baɾku
bardo	baɾdu
barlavento	baɾlɐvẽtu
barqueiro	bɐɾkejɾu
barqueiro	bɐɾkɐjɾu
barra	baʁɐ
barraca	bɐʁakɐ
barrancos	bɐʁɐ̃kuʃ
barregã	bɐʁɨɣɐ̃
barreira	bɐʁɐjɾɐ
barreiro	bɐʁɐjɾu
barriga	bɐʁiɡɐ
barrigudo	bɐʁiɡudu
barril	bɐʁiɫ
barro	baʁu
barulho	bɐɾuʎu
basalto	bɐzaɫtu
basco	baʃku
base	bazɨ
basta	baʃtɐ
bastante	bɐʃtɐ̃tɨ
bastar	bɐʃtaɾ
bastardo	bɐʃtaɾðu
bastão	bɐʃtɐ̃w̃
basílica	bɐzilikɐ
batalha	bɐtaʎɐ
batata	bɐtatɐ
batel	bɐtɛɫ
batendo	bɐtẽdu
bater	bɐteɾ
bateu	bɐtew
batia	bɐtiɐ
batina	bɐtinɐ
batismo	batiʒmu
batista	batʃistɐ
batizado	batizaðu
batizar	batizaɾ
batizar	bɐtizaɾ
batom	bɐtõ
bazar	bɐzaɾ
bazófia	bazɔfja
baço	basu
baía	bɐiɐ
baú	bau
bebe	bɛbi
beber	bɨβeɾ
bebida	bɨβiðɐ
bebo	bebu
bebé	bɛbɛ
beco	beku
bege	bɛʒi
beicinho	bɐjsiɲu
beijar	bejʒaɾ
beijo	bejʒu
beijo	bɐjʒu
beijos	bejʒuʃ
beijos	bɐjʒuʃ
beira	bɐjɾɐ
beiço	bɐjsu
beja	bɛʒɐ
bela	bɛlɐ
beladona	bɛlɐdonɐ
belas	bɛlɐʃ
beleza	bɨlezɐ
belezura	belezuɾa
belga	bɛɫɣɐ
belicista	bɛlisiʃtɐ
beliscar	bɨliʃkaɾ
beliz	bɨliʃ
belmonte	bɛɫmõtɨ
belo	bɛlu
belos	bɛluʃ
bem	bɐ̃j̃
bemol	bemɔɫ
benavente	bɨnɐvẽtɨ
bendição	bẽdisɐ̃w̃
beneficiar	bɨnɨfisjaɾ
benefício	bɨnɨfisju
benesse	benɛsi
bengala	bẽɡalɐ
bengali	bẽɡali
benigno	bɨniɣɨnu
bens	bɐ̃j̃ʃ
bento	bẽtu
benvindo	bɐ̃j̃vĩdu
benvindo	bẽj̃vĩdu
benzeno	bẽzenu
benzer	bẽzeɾ
beringela	bɨɾĩʒɛlɐ
berlinês	bɛɾlineʃ
bermuda	bɨɾmuðɐ
bermudas	bɨɾmuðɐʃ
berça	beɾsɐ
berço	beɾsu
besouro	bɨzowɾu
besouro	bɨzoɾu
besta	beʃtɐ
besta	bɛʃtɐ
bestas	beʃtɐʃ
bestial	bɨʃtjaɫ
betar	betaɾ
bete	bɛtʃi
betinho	bɛtiɲu
betume	bɨtumɨ
betão	bɨtɐ̃w̃
bexiga	bɨʃiɣɐ
bezerro	bɨzeʁu
biberão	biβɨɾɐ̃w̃
biblioteca	biβljutɛkɐ
bibliotecário	biβljutɨkaɾju
bibliógrafo	biβliɔɣɾɐfu
bicar	bikaɾ
bicha	biʃɐ
bicho	biʃu
bicla	biklɐ
bico	biku
bicos	bikuʃ
bidé	bidɛ
bielorrússia	bjɛlɔʁusjɐ
bienal	bienaɫ
bife	bifɨ
bigode	biɣɔðɨ
bigodes	biɣɔðɨʃ
bigorna	biɡɔɾnɐ
bilha	biʎɐ
bilhar	biʎaɾ
bilhete	biʎetɨ
bilhetes	biʎetɨʃ
bilhão	biʎɐ̃w̃
bilro	bilʁu
biombo	bjõbu
bis	biʃ
bisavó	bizɐvɔ
bisavô	bizɐvo
bisbilhotice	biʒβilutisɨ
biscoito	biʃkojtu
bispo	biʃpu
bisu	bizu
bit	biti
bitaite	bitajtɨ
bituca	bitukɐ
biênio	bienju
biónico	bioniku
biônico	bioniku
blenda	blẽdɐ
blica	blika
blocagem	blokaʒẽj̃
bloco	blɔku
bloquear	blukjaɾ
boa	boɐ
boas	boɐʃ
bobinar	buβinaɾ
bobo	bobu
boca	bokɐ
bocadinho	bukɐðiɲu
bocado	bukaðu
bocejar	busɨʒaɾ
bocejo	busɐjʒu
bocejo	busɐʒu
bochecha	buʃɐjʃɐ
bochicho	buʃiʃu
boco	boku
bocó	bokɔ
boda	boðɐ
boi	boj
boiadeiro	bojadejɾu
bois	bojʃ
bola	bɔlɐ
bolacha	bulaʃɐ
bolas	bɔlɐʃ
boleia	bulejɐ
boleia	bulɐjɐ
boleto	buletu
bolha	boʎɐ
boliche	buliʃɨ
bolo	bolu
bolota	bulɔtɐ
bolsa	boɫsɐ
bolso	boɫsu
bolsominion	bowsominiõ
bolsominion	bowsominjõ
bolsos	bɔɫsuʃ
bom	bõ
bomba	bõbɐ
bombado	bõbadu
bombarral	bõbɐʁaɫ
bombeiro	bõbejɾu
bombeiro	bõbɐjɾu
bombom	bõbõ
bonacheirão	bonaʃejɾɐ̃w̃
bonachão	bonaʃɐ̃w̃
bondade	bõdaðɨ
boneca	bunɛkɐ
bonina	buninɐ
bonita	bunitɐ
bonito	bunitu
bons	bõʃ
boné	bɔnɛ
bope	bɔpi
boquete	bokɛtʃi
boquiaberto	bukjɐβɛɾtu
borba	bɔɾβɐ
borboleta	buɾβuletɐ
borboletear	buɾβulɨtjaɾ
borboletário	buɾbulɨtaɾju
borda	bɔɾðɐ
bordado	buɾðaðu
bordar	buɾðaɾ
bordel	buɾðɛɫ
bordo	boɾðu
bordo	bɔɾðu
bordoada	buɾduadɐ
boroa	buɾoɐ
borracha	buʁaʃɐ
borrar	buʁaɾ
borzeguim	buɾzɨɣĩ
bosque	bɔʃkɨ
bota	bɔtɐ
botar	butaɾ
bote	bɔtɨ
botequim	butɨkĩ
boticas	butikɐʃ
boticário	botʃikaɾju
boto	botu
boto	bɔtu
botão	butɐ̃w̃
botões	butõj̃ʃ
bouça	bowsɐ
box	bɔks
boçal	bosaw
boçal	bosaɫ
braga	bɾaɣɐ
bragança	bɾɐɣɐ̃sɐ
branca	bɾɐ̃kɐ
brancas	bɾɐ̃kɐʃ
branco	bɾɐ̃ku
brancos	bɾɐ̃kuʃ
brandamente	bɾɐ̃dɐmẽtɨ
brando	bɾɐ̃du
brasa	bɾazɐ
brasil	bɾɐziɫ
brava	bɾavɐ
bravas	bɾavɐʃ
bravateiro	bɾavatejɾu
bravo	bɾavu
bravura	bɾɐvuɾɐ
braça	bɾasɐ
braçada	bɾɐsaðɐ
braço	bɾasu
braços	bɾasuʃ
breca	bɾɛkɐ
brecha	bɾɛʃɐ
bregueço	bɾeɡesu
breja	bɾeʒa
breja	bɾɛʒa
brejeirar	breʒejɾaɾ
brejeirar	breʒejɾaʁ
brejeirice	breʒejɾisi
brejeiro	bɾeʒejɾu
brejo	bɾɛʒu
brenha	bɾejɲɐ
brenha	bɾɐjɲɐ
bretanha	bɾɨtɐɲɐ
bretão	bɾɨtɐ̃w̃
breu	bɾew
breve	bɾɛvɨ
brevemente	bɾɛvɨmẽtɨ
brida	bɾiðɐ
briga	bɾiɡɐ
brigada	bɾiɣaðɐ
brilhando	bɾiʎɐ̃du
brilhante	bɾiʎɐ̃tɨ
brilhar	bɾiʎaɾ
brilho	bɾiʎu
brincadeira	bɾĩkɐðɐjɾɐ
brincar	bɾĩkaɾ
brinco	bɾĩku
brindisi	bɾĩdizi
brinquedo	bɾĩkedu
brisa	bɾizɐ
broa	bɾowɐ
broa	bɾoɐ
brochura	bɾoʃuɾa
brodo	bɾɔdu
bronze	bɾõzɨ
brotar	bɾutaɾ
bruaca	bruaka
bruco	bɾuku
bruma	bɾumɐ
brunir	bɾuniɾ
bruno	bɾunu
bruscamente	bɾuʃkɐmẽtɨ
brusco	bɾuʃku
brusqueta	bɾuʃketɐ
brutal	bɾutaɫ
brutalidade	bɾutɐliðaðɨ
bruxa	bɾuʃɐ
bruços	bɾusuʃ
buchicho	buʃiʃu
bucólico	bukɔliku
buda	buðɐ
buffet	bife
bufo	bufu
bugar	buɡaɾ
bugiganga	buʒiɡɐ̃ɡɐ
bugio	buʒiu
bula	bulɐ
bulbo	buɫbu
bule	bulɨ
bulgária	buɫɣaɾjɐ
bulhufas	buʎufajʃ
bulhufas	buʎufas
bulir	buliɾ
buliçoso	bulisozu
bumbum	bũbũ
buque	bukɨ
buquê	buke
buraco	buɾaku
burca	buɾkɐ
burgo	buɾɣu
burguês	buɾɣeʃ
burro	buʁu
busca	buʃkɐ
buscar	buʃkaɾ
busto	buʃtu
busão	buzɐ̃w̃
buxo	buʃu
bué	buɛ
bv	beve
byte	bajtʃi
bácoro	bakuɾu
báculo	bakulu
básico	baziku
bão	bɐ̃w̃
bélgica	bɛɫʒikɐ
bélico	bɛliku
bê	be
bêbedo	beβɨðu
bênção	bẽsɐ̃w̃
bíblia	biβljɐ
bípede	bipedʒi
bónus	bɔnuʃ
bósnio	bɔʃniu
búlgaro	buɫɡɐɾu
bússola	busulɐ
búzio	buzju
cabaça	kɐβasɐ
cabaço	kabasu
cabeceira	kɐbɨsɐjɾɐ
cabeleireiro	kɐβɨlɐjɾɐjɾu
cabelo	kɐβelu
cabelos	kɐβeluʃ
caber	kɐβeɾ
cabeça	kɐβesɐ
cabeças	kɐβesɐʃ
cabide	kɐβiðɨ
cabisbaixo	kabiʒbajʃu
cabo	kabu
cabra	kaβɾɐ
caca	kakɐ
cacareco	kakarɛku
cacau	kɐkaw
cachar	kɐʃaɾ
cachimbo	kɐʃĩbu
cachopa	kɐʃɔpɐ
cachopo	kɐʃopu
cachorro	kɐʃoʁu
cacofonia	kɐkɔfuniɐ
cada	kɐðɐ
cadaval	kɐðɐvaɫ
cadeado	kɐðjaðu
cadeia	kɐðɐjɐ
cadeira	kɐdɐjɾɐ
cadeiras	kɐdɐjɾɐʃ
cadela	kɐðɛlɐ
caderno	kɐðɛɾnu
cadete	kɐðetɨ
caduco	kɐðuku
caetano	kɐitɐ̃nu
cafofo	kafofu
cafoto	kafotu
cafuné	kafunɛ
café	kɐfɛ
cagueta	kaɡweta
cagueta	kaɡwɛta
caguetar	kaɡuetaɾ
caguetar	kaɡwetaɾ
caguete	kaɡwɛtʃi
caia	kajɐ
caia	kɐiɐ
caimão	kajmɐ̃w̃
caindo	kɐĩdu
caio	kaju
caipira	kajpiɾɐ
caipirinha	kajpiɾiɲɐ
cair	kɐiɾ
cais	kajʃ
caiu	kɐiw
caixa	kajʃɐ
caixilho	kajʃiʎu
caixão	kɐjʃɐ̃w̃
cajado	kɐʒaðu
caju	kaʒu
cal	kaɫ
calado	kɐlaðu
calados	kɐlaðuʃ
calar	kɐlaɾ
calcada	kaɫkaðɐ
calcado	kaɫkaðu
calcanhar	kaɫkɐɲaɾ
calcar	kaɫkaɾ
calculação	kaɫkulɐsɐ̃w̃
calcâneo	kaɫkɐnju
caldeirão	kaɫðɐjɾɐ̃w̃
caldo	kaɫdu
calebe	kalɛbi
calendário	kɐlẽdaɾju
calhambeque	kɐʎɐ̃bɛkɨ
calhar	kɐʎaɾ
calhau	kɐʎaw
calheta	kɐʎetɐ
calibre	kɐlibɾɨ
califa	kɐlifɐ
caligrafia	kɐliɣɾɐfiɐ
calistenia	kalistenia
calma	kaɫmɐ
calmaria	kalmɐɾiɐ
calmo	kaɫmu
calo	kalu
calor	kɐloɾ
calorento	kɐluɾẽtu
caloroso	kɐluɾozu
calão	kɐlɐ̃w̃
calçada	kaɫsaðɐ
calçado	kaɫsaðu
calçar	kaɫsaɾ
calças	kaɫsɐʃ
cama	kɐmɐ
camada	kɐmadɐ
camada	kɐmaðɐ
cambalhota	kɐ̃bɐʎɔtɐ
camelo	kɐmelu
camelódromo	kamelɔdɾomu
camelô	kamelo
caminha	kɐmiɲɐ
caminhada	kɐmiɲadɐ
caminhando	kɐmiɲɐ̃du
caminho	kɐmiɲu
caminhos	kɐmiɲuʃ
camisa	kɐmizɐ
camisola	kɐmizɔlɐ
camião	kɐmjɐ̃w̃
camoniano	kamunjɐnu
campa	kɐ̃pɐ
campainha	kɐ̃pɐiɲɐ
campanha	kɐ̃pɐɲa
campanha	kɐ̃pɐɲɐ
campanário	kɐ̃pɐnaɾju
campeonato	kɐ̃pjunatu
campesino	kɐ̃pɨzinu
campestre	kɐ̃pɛʃtɾɨ
campo	kɐ̃pu
campos	kɐ̃puʃ
camurça	kɐmuɾsɐ
cana	kɐnɐ
canadá	kɐnɐða
canal	kɐnaɫ
canalha	kɐnaʎɐ
canaque	kɐnakɨ
canavês	kɐnɐveʃ
cancioneiro	kɐ̃sjunejɾu
cancioneiro	kɐ̃sjunɐjɾu
candango	kɐ̃dɐ̃ɡu
candeeiro	kɐ̃djɐjɾu
candeia	kɐ̃dejɐ
candeia	kɐ̃dɐjɐ
candelabro	kɐ̃dɨlaβɾu
candidato	kɐ̃diðatu
candil	kɐ̃diɫ
candomblé	kɐ̃dõblɛ
candonga	kɐ̃dõɡɐ
caneca	kɐnɛkɐ
caneco	kɐnɛku
caneta	kɐnetɐ
cangalheiro	kɐ̃ɡɐʎejɾu
cangalheiro	kɐ̃ɡɐʎɐjɾu
canhoto	kɐɲotu
canhão	kɐɲɐ̃w̃
canivete	kanivɛte
canivete	kɐnivɛte
canja	kɐ̃ʒɐ
cano	kɐnu
canoa	kɐnoɐ
cansado	kɐ̃saðu
cansar	kɐ̃saɾ
cansaço	kɐ̃sasu
canseira	kɐ̃sejɾa
canso	kɐ̃su
cantador	kɐ̃tɐðoɾ
cantanhede	kɐ̃tɐɲeðɨ
cantar	kɐ̃taɾ
cante	kɐ̃tɨ
canteiro	kɐ̃tɐjɾu
cantiga	kɐ̃tiɣɐ
cantina	kɐ̃tinɐ
canto	kɐ̃tu
cantochão	kɐ̃tuʃɐ̃w̃
cantor	kɐ̃toɾ
cantos	kɐ̃tuʃ
cantão	kɐ̃tɐ̃w̃
canudo	kɐnuðu
canário	kɐnaɾju
canção	kɐ̃sɐ̃w̃
canções	kɐ̃sõj̃ʃ
caos	kawʃ
capa	kapɐ
capacidade	kɐpɐsiðaðɨ
capacitar	kɐpɐsitaɾ
capaz	kɐpaʃ
capela	kɐpɛlɐ
capelão	kɐpɨlɐ̃w̃
capicua	kɐpikuɐ
capitais	kɐpitaiʃ
capital	kɐpitaɫ
capitão	kɐpitɐ̃w̃
capixaba	kapiʃabɐ
capoeira	kɐpuejɾɐ
capoeira	kɐpuɐjɾɐ
capoeira	kɐpwejɾɐ
capoeira	kɐpwɐjɾɐ
capoeirista	kɐpwɐjɾistɐ
caprichar	kapɾiʃar
capricho	kɐpɾiʃu
captar	kaptaɾ
capturo	kaptuɾu
capucho	kɐpuʃu
capuz	kɐpuʃ
capítulo	kɐpitulu
caquesseitão	kɐkɨsejtɐ̃w̃
caquesseitão	kɐkɨsɐjtɐ̃w̃
cara	kaɾɐ
caracal	kɐɾɐkaɫ
caralho	kɐɾaʎu
caramba	kɐɾɐ̃bɐ
caramelo	kɐɾɐmɛlu
caraminhola	kaɾamij̃ɔla
carapaça	kɐɾɐpasɐ
caravela	kɐɾɐvɛlɐ
carcanhol	kɐɾkɐɲɔɫ
carcaça	kɐɾkasɐ
cardeal	kɐɾdjaɫ
cardiff	kaɾðifɨ
cardinal	kaɾðinaɫ
cardume	kɐɾðumɨ
careca	kɐɾɛkɐ
carga	kaɾɣɐ
cargo	kaɾɣu
carica	kɐrikɐ
caridade	kɐɾiðaðɨ
carimbar	kɐɾĩbaɾ
carimbo	kɐɾĩbu
carinho	kɐɾiɲu
carmim	kɐɾmĩ
carnal	kɐɾnaɫ
carnaval	kɐɾnɐvaɫ
carne	kaɾnɨ
carneiro	kɐɾnejɾu
carneiro	kɐɾnɐjɾu
carnificina	kɐɾnifisinɐ
carniça	kɐɾnisɐ
caro	kaɾu
carola	kaɾɔla
caronte	kɐɾõtɨ
caroça	kɐɾɔsɐ
caroço	kɐɾosu
carpete	kaɾpɛtɨ
carpideira	kɐɾpiðejɾɐ
carpideira	kɐɾpiðɐjɾɐ
carpir	kɐɾpiɾ
carranca	kɐʁɐ̃kɐ
carrapato	kɐʁɐpatu
carrapicho	kaʁapiʃu
carrasco	kɐʁaʃku
carregado	kɐʁɨɣaðu
carregar	kɐʁɨɡaɾ
carreira	kɐʁɐjɾɐ
carreiro	kɐʁɐjɾu
carreta	kɐʁetɐ
carrilhão	kɐʁiʎɐ̃w̃
carrinho	kɐʁiɲu
carro	karu
carro	kaʁu
carros	kaʁuʃ
carroça	kɐʁɔsɐ
carruagem	kɐʁwaʒɐ̃j̃
carta	kaɾtɐ
cartas	kaɾtɐʃ
cartaxo	kɐɾtaʃu
cartaz	kɐɾtaʃ
carteira	kɐɾtɐjɾɐ
carteiro	kɐɾtɐjɾu
cartilha	kɐɾtiʎɐ
cartomante	kaɾtumɐ̃tɨ
cartune	kaɾtunɨ
cartune	kaɾtũ
cartão	kɐɾtɐ̃w̃
carvalho	kɐɾvaʎu
carvão	kɐɾvɐ̃w̃
cará	kɐɾa
carácter	kɐɾaktɛɾ
carácter	kɐɾatɛɾ
caráter	kɐɾaktɛɾ
caráter	kɐɾatɛɾ
carão	kɐɾɐ̃w̃
carícia	kɐɾisjɐ
casa	kazɐ
casaca	kɐzakɐ
casaco	kɐzaku
casal	kɐzaɫ
casamento	kɐzɐmẽtu
casar	kɐzaɾ
casario	kɐzɐɾiu
casarão	kɐzɐɾɐ̃w̃
casas	kazɐʃ
cascais	kɐʃkajʃ
cascata	kɐʃkatɐ
cascavel	kɐʃkɐvɛɫ
casco	kaʃku
casebre	kɐzɛβɾɨ
caseiro	kɐzejɾu
caseiro	kɐzɐjɾu
caserna	kɐzɛɾnɐ
casino	kɐzinu
caso	kazu
casos	kazuʃ
casota	kɐzɔtɐ
caspa	kaʃpɐ
casquilho	kajʃkiʎu
casquilho	kaskiʎu
cassete	kasɛtʃi
cassetete	kasɨtɛtɨ
casta	kaʃtɐ
castanho	kɐʃtɐɲu
castelhano	kɐʃtɨʎɐnu
castelo	kɐʃtɛlu
castidade	kɐʃtɨðaðɨ
castigar	kɐʃtiɣaɾ
castigo	kɐʃtiɣu
castiçal	kɐʃtisaɫ
casto	kaʃtu
castrejo	kɐʃtɾejʒu
castrejo	kɐʃtɾɐjʒu
castro	kaʃtɾu
castroverde	kaʃtɾuveɾdɨ
casula	kɐzulɐ
catafalco	kɐtɐfaɫku
cataplana	kɐtɐplɐnɐ
catapúcia	katapusja
catar	kataɾ
catar	kataʁ
catar	kɐtaɾ
catedral	kɐtɨðɾaɫ
catequista	katekista
catinga	kɐtʃĩɡɐ
catita	kɐtitɐ
cativar	kɐtivaɾ
cativo	kɐtivu
cato	katu
catorze	kɐtoɾzɨ
catraio	kɐtɾaju
catástrofe	kɐtaʃtɾufɨ
cauda	kawðɐ
caulinita	kawlinitɐ
causa	kawzɐ
causar	kawzaɾ
cauã	kawɐ̃
cauê	kawe
cava	kavɐ
cavalaria	kɐvɐlɐɾiɐ
cavaleiro	kɐvɐlejɾu
cavaleiro	kɐvɐlɐjɾu
cavalheiro	kɐvɐʎɐjɾu
cavalo	kɐvalu
cavalos	kɐvaluʃ
cavaquinho	kɐvɐkiɲu
caveira	kavejɾɐ
caveira	kavɐjɾɐ
caviar	kavjaɾ
caxinguelê	kaʃĩɡele
caxumba	kɐʃũbɐ
cazaquistão	kazɐkiʃtɐ̃w̃
caça	kasɐ
caçar	kɐsaɾ
caçula	kɐsulɐ
caído	kɐiðu
caô	kao
cear	siaɾ
cebola	sebolɐ
cebolinha	sɨβuliɲɐ
cedilha	sɨðiʎɐ
cedo	seðu
cedro	sɛðɾu
cegar	sɨɣaɾ
cego	sɛɣu
cegonha	sɨɣoɲɐ
cegueta	seɡeta
ceia	sejɐ
ceia	sɐjɐ
ceifa	sejfɐ
ceifa	sɐjfɐ
ceifar	sejfaɾ
ceifar	sɐjfaɾ
cela	sɛlɐ
celeiro	sɨlejɾu
celeiro	sɨlɐjɾu
celeste	sɨlɛʃtɨ
celestial	sɨlɨʃtjaɫ
celeuma	sɨlewmɐ
celibato	sɨliβatu
cem	sɐ̃j̃
cem	sẽj̃
cena	senɐ
cenoira	sɨnojɾɐ
cenoura	sɨnowɾɐ
cenrada	sẽʁaðɐ
censo	sẽsu
censura	sẽsuɾɐ
censurar	sẽsuɾaɾ
censuro	sẽsuɾu
centauro	sẽtawɾu
centavo	sẽtavu
centeio	sẽteju
centeio	sẽtɐju
cento	sẽtu
central	sẽtɾaɫ
centro	sẽtɾu
centrípeto	sẽtɾipetu
centímetro	sẽtimɨtɾu
cepo	sepu
cera	seɾɐ
cerca	seɾkɐ
cerca	sɛɾkɐ
cereal	sɨɾjaɫ
cerebral	sɨɾɨβɾaɫ
cereja	sɨɾejʒɐ
cereja	sɨɾɐjʒɐ
cerimónia	sɨɾimɔnjɐ
cerrado	sɨʁaðu
cerrados	sɨʁaðuʃ
cerrar	sɨʁaɾ
certa	sɛɾtɐ
certamente	sɛɾtɐmẽtɨ
certeza	sɨɾtezɐ
certo	sɛɾtu
certos	sɛɾtuʃ
cerval	sɨɾvaɫ
cerveja	sɨɾvejʒɐ
cerveja	sɨɾveʒɐ
cerveja	sɨɾvɐjʒɐ
cerveja	sɨɾvɐʒɐ
cervo	seɾvu
cervo	sɛɾvu
cessar	sɨsaɾ
cesto	seʃtu
cetim	sɨtĩ
cetro	sɛtɾu
ceuta	sewtɐ
cevar	sɨvaɾ
chacina	ʃasina
chada	ʃadɐ
chafariz	ʃɐfɐɾiʃ
chafurdar	ʃɐfuɾðaɾ
chaga	ʃaɣɐ
chaleira	ʃɐlɐjɾɐ
chama	ʃamɐ
chama	ʃɐmɐ
chamado	ʃɐmaðu
chamar	ʃɐmaɾ
chamava	ʃɐmavɐ
chamejar	ʃɐmeʒaɾ
chaminé	ʃɐminɛ
champanha	ʃɐ̃pɐɲɐ
champanhe	ʃɐ̃pɐɲɨ
champô	ʃɐ̃po
chamusca	ʃɐmuʃkɐ
chamuscar	ʃɐmuʃkaɾ
chance	ʃɐ̃sɨ
chantagem	ʃɐ̃taʒɐ̃j̃
chapa	ʃapɐ
chapéu	ʃɐpɛw
charamela	ʃɐɾɐmɛlɐ
charco	ʃaɾku
charneca	ʃɐɾnɛkɐ
charque	ʃaɾkɨ
charrete	ʃarɛtʃi
charrete	ʃaʁɛtʃi
charuto	ʃɐɾutu
chatear	ʃɐtjaɾ
chato	ʃatu
chau	ʃaw
chave	ʃavɨ
chavelha	ʃɐveʎɐ
chavelha	ʃɐvɐʎɐ
chaves	ʃavɨʃ
chavão	ʃavɐ̃w̃
checagem	ʃekaʒẽ
chefe	ʃɛfɨ
chefia	ʃɨfiɐ
chefículo	ʃɛfikulu
chega	ʃeɣɐ
chegada	ʃɨɣaðɐ
chegado	ʃɨɣaðu
chegando	ʃɨɣɐ̃du
chegar	ʃɨɡaɾ
chegara	ʃɨɣaɾɐ
chegará	ʃɨɣɐɾa
chegava	ʃɨɣavɐ
chegou	ʃɨɣow
cheia	ʃɐjɐ
cheias	ʃɐjɐʃ
cheio	ʃeju
cheio	ʃɐju
cheios	ʃɐjuʃ
cheirar	ʃejɾaɾ
cheirar	ʃɐjɾaɾ
cheiro	ʃɐjɾu
cheque	ʃɛkɨ
chiar	ʃjaɾ
chiaroscuro	kjaɾuʃkuɾu
chibata	ʃibata
chibo	ʃiβu
chicho	ʃiʃu
chiclete	ʃiklɛtɨ
chico	ʃiku
chicotada	ʃikutaðɐ
chicote	ʃikɔtɨ
chicotear	ʃikutjaɾ
chifre	ʃifɾɨ
chila	ʃilɐ
chimpanzé	ʃĩpɐ̃zɛ
chimpar	ʃĩpaɾ
china	ʃinɐ
chinela	ʃinɛlɐ
chinelas	ʃinɛlɐʃ
chinelo	ʃinɛlu
chinelos	ʃinɛluʃ
chinfrim	ʃĩfɾĩ
chinês	ʃineʃ
chipre	ʃipɾɨ
chiqueiro	ʃikɐjɾu
chita	ʃitɐ
choca	ʃɔkɐ
chocalho	ʃukaʎu
chocar	ʃukaɾ
chocolate	ʃukulatɨ
choldra	ʃɔɫdɾɐ
choque	ʃɔkɨ
chor	ʃoɾ
chorando	ʃuɾɐ̃du
chorar	ʃuɾaɾ
chorinho	ʃuriɲu
choro	ʃoɾu
choro	ʃɔɾu
chororô	ʃoɾoɾo
choupana	ʃowpɐnɐ
choupo	ʃowpu
chouseira	ʃowzejɾɐ
chouseira	ʃowzɐjɾɐ
chover	ʃuveɾ
chuca	ʃuka
chuinga	ʃuĩɡa
chuiva	ʃujvɐ
chulca	ʃuwka
chulipa	ʃulipɐ
chumbaram	ʃũbaɾɐ̃w̃
chumbo	ʃũbu
chupeta	ʃupetɐ
chus	ʃuʃ
chutar	ʃutaɾ
chuto	ʃutu
chuva	ʃuvɐ
chuveiro	ʃuvɐjɾu
chuvisco	ʃuviʃku
chuvoso	ʃuvozu
chuço	ʃusu
chá	ʃa
chádico	ʃaðiku
chávena	ʃavɨnɐ
chã	ʃɐ̃
chão	ʃɐ̃w̃
cicatriz	sikatɾis
cidade	siðaðɨ
cidadão	siðɐðɐ̃w̃
cientista	sjẽtiʃtɐ
científico	sjẽtifiku
cifrão	sifɾɐ̃w̃
cigarro	siɣaʁu
cilha	siʎɐ
cilindrar	sɨlĩdɾaɾ
cima	simɐ
cimento	simẽtu
cimitarra	simɨtaʁɐ
cinamomo	sinɐmomu
cinco	sĩku
cinema	sinemɐ
cinfães	sĩfɐ̃jʃ
cinquenta	sĩkwẽtɐ
cinto	sĩtu
cintura	sĩtuɾɐ
cinturão	sĩtuɾɐ̃w̃
cinza	sĩzɐ
cinzento	sĩzẽtu
cio	siu
cipozão	sipɔzɐ̃w̃
ciprestal	sipɾɨʃtaɫ
cipreste	sipɾɛʃtɨ
cipó	sipɔ
circatejano	siɾkɐtɨʒɐnu
circular	siɾkulaɾ
circulação	siɾkulɐsɐ̃w̃
circumpolar	siɾkũpulaɾ
circuncentro	sirkũsẽtru
circundar	siɾkũdaɾ
circunferência	siɾkũfɨɾẽsjɐ
circunlóquio	siɾkũlɔkju
circunscrição	siɾkũʃkɾisɐ̃w̃
circunspecto	siɾkũʃpɛktu
circunspecto	siɾkũʃpɛtu
circunspecção	siɾkũʃpɛsɐ̃w̃
circunspeção	siɾkũʃpɛsɐ̃w̃
circunstanciar	siɾkũʃtɐ̃sjaɾ
cirurgia	siɾuɾʒiɐ
cirurgião	siɾuɾʒjɐ̃w̃
cisco	siʃku
cismar	siʒmaɾ
cisne	siʒnɨ
cisterna	siʃtɛɾnɐ
cisto	siʃtu
citadino	sitɐðinu
citado	sitadu
citar	sitaɾ
citação	sitɐsɐ̃w̃
citrino	sitrinu
civil	siviɫ
civilizado	sivilizaðu
civilizado	sɨvɨlizaðu
civilização	sivilizɐsɐ̃w̃
civilização	sɨvɨlizɐsɐ̃w̃
ciência	sjẽsjɐ
ciúme	sjumɨ
clandestino	klɐ̃dɨʃtinu
clara	klaɾɐ
claramente	klaɾɐmẽtɨ
claridade	klɐɾiðaðɨ
claro	klaɾu
claros	klaɾuʃ
clarão	klɐɾɐ̃w̃
classe	klasɨ
claustro	klawʃtɾu
clausura	klawzuɾɐ
clava	klavɐ
clemente	klɨmẽtɨ
clerical	klɨɾikaɫ
clima	klimɐ
cloroplasto	kloɾoplastu
clube	kluβɨ
clássico	klasiku
clã	klɐ̃
clérigo	klɛɾiɣu
clínica	klinikɐ
clínico	kliniku
clítoris	klitoɾis
coador	kwɐðoɾ
coar	kuaɾ
coar	kwaɾ
coaxar	kwɐʃaɾ
cobarde	kuβaɾðɨ
coberta	kuβɛɾtɐ
cobertas	kuβɛɾtɐʃ
coberto	kuβɛɾtu
cobertor	kuβɨɾtoɾ
cobiça	kuβisɐ
cobiçar	kubisaɾ
cobra	kɔβɾɐ
cobrar	kuβɾaɾ
cobre	kɔβɾɨ
cobria	kuβɾiɐ
cobrir	kuβɾiɾ
coche	kɔʃɨ
cocheira	kuʃejɾɐ
cocheira	kuʃɐjɾɐ
cocheiro	kuʃɐjɾu
cochicho	kuʃiʃu
cochinchina	kuʃĩʃinɐ
coclear	kukljaɾ
coco	koku
cocota	kokota
cocô	koko
cogumelo	kuɣumɛlu
coimbra	kwĩbɾɐ
coiote	kɔjɔtɨ
coisa	kojzɐ
coisas	kojzɐʃ
coitada	kojtaðɐ
coitado	kojtaðu
coitar	kojtaɾ
cola	kɔlɐ
colaboração	kulɐbuɾɐsɐ̃w̃
colante	kulɐ̃tɨ
colar	kolaʁ
colar	kulaɾ
colarinho	kulɐɾiɲu
colcha	koɫʃɐ
colchão	koɫʃɐ̃w̃
colchão	kuɫʃɐ̃w̃
colega	kulɛɣɐ
coleira	kulɐjɾɐ
colesterol	kɔlɨʃtɨɾɔɫ
coleta	kuletɐ
coleta	kulɛtɐ
colete	kolɛtʃi
colete	kuletɨ
coletivamente	kulɛtivɐmẽtɨ
coleção	kulɛsɐ̃w̃
colher	kuʎeɾ
colher	kuʎɛɾ
colhão	kuʎɐ̃w̃
colina	kulinɐ
colmeia	koɫmejɐ
colmeia	koɫmɐjɐ
colmo	koɫmu
colo	kɔlu
colocado	kulukaðu
colocar	kulukaɾ
colonização	kulunizɐsɐ̃w̃
colorau	kuluɾaw
colorido	kuluɾiðu
colorir	kuluɾiɾ
coluna	kulunɐ
colégio	kulɛʒju
colónia	kulɔnjɐ
com	kõ
coma	komɐ
comadre	kumaðɾɨ
comandar	kumɐ̃daɾ
comando	kumɐ̃du
combatente	kõbɐtẽtɨ
combinado	kõbinaðu
combinados	kõbinaðu
combinar	kõbinaɾ
combinação	kõbinɐsɐ̃w̃
comboio	kõbɔju
come	komi
comemorar	kumɨmuɾaɾ
comendo	kumẽdu
comer	kumeɾ
comercial	kumɨɾsjaɫ
comercializar	kumɨɾsjalizaɾ
comete	komɛtʃi
comeu	kumew
começa	kumɛsɐ
começar	kumɨsaɾ
começava	kumɨsavɐ
começo	kumesu
começo	kumɛsu
começou	kumɨsow
comida	kumiðɐ
comido	kumiðu
comilão	kumilɐ̃w̃
cominação	kominasɐ̃w̃
comissário	kumisaɾju
comissão	kumisɐ̃w̃
comité	kumitɛ
como	komu
comover	kumuveɾ
comovido	kumuviðu
comoção	kumusɐ̃w̃
compadre	kõpaðɾɨ
compaixão	kõpajʃɐ̃w̃
companha	kõpɐɲɐ
companheiro	kõpɐɲɐjɾu
companheiro	kõpɐ̃j̃ejɾu
companhia	kõpɐɲiɐ
comparar	kõpɐɾaɾ
comparativo	kõpɐɾɐtivu
comparação	kõpɐɾɐsɐ̃w̃
comparável	kõpɐɾavɛɫ
compasso	kõpasu
compatriota	kõpɐtɾjɔtɐ
competia	kõpɨtiɐ
competidor	kõpɨtiðoɾ
competir	kõpɨtiɾ
competição	kõpɨtisɐ̃w̃
competência	kõpɨtẽsjɐ
compilação	kõpilɐsɐ̃w̃
compincha	kõpĩʃɐ
complemento	kõplɨmẽtu
completar	kõplɨtaɾ
completo	kõplɛtu
compor	kõpoɾ
comportamento	kõpuɾtɐmẽtu
comportar	kõpuɾtaɾ
compositor	kõpuzitoɾ
compota	kõpɔtɐ
comprar	kõpɾaɾ
compreende	kõpɾjẽdɨ
compreender	kõpɾjẽdeɾ
compreensão	kõpɾjẽsɐ̃w̃
comprido	kõpɾiðu
comprimento	kõpɾimẽtu
compromete	kõpɾomɛtʃi
compromisso	kõpɾumisu
comprovar	kõpɾuvaɾ
computador	kõmputɐðoɾ
compêndio	kõpẽdju
comum	kumũ
comummente	kumũmẽtɨ
comunicado	kumunikaðu
comunicar	kumunikaɾ
comunicação	kumunikɐsɐ̃w̃
comunismo	kɔmuniʒmu
comunista	kumuniʃtɐ
comédia	kumɛðjɐ
comércio	kumɛɾsju
conceder	kõsɨðeɾ
conceito	kõsejtu
conceito	kõsɐjtu
conceição	kõsejsɐ̃w̃
conceição	kõsɐjsɐ̃w̃
concelho	kõsejʎu
concelho	kõseʎu
concelho	kõsɐjʎu
concelho	kõsɐʎu
conceção	kõsɛsɐ̃w̃
concha	kõʃa
conciliar	kõsiljaɾ
concitador	kõsitɐðoɾ
conclusão	kõkluzɐ̃w̃
concordar	kõkuɾðaɾ
concretizar	kõkɾɨtizaɾ
concreto	kõkɾɛtu
conde	kõdɨ
condensação	kõdẽsɐsɐ̃w̃
condimentar	kõdimẽtaɾ
condizer	kõdizeɾ
condição	kõdisɐ̃w̃
conduta	kõdutɐ
condutor	kõdutoɾ
conduzir	kõduziɾ
condução	kõdusɐ̃w̃
condão	kõdɐ̃w̃
conectar	kunɛktaɾ
conexo	konɛksu
conexão	kunɛksɐ̃w̃
confederação	kõfɨðɨɾɐsɐ̃w̃
confeição	kõfejsɐ̃w̃
confeição	kõfɐjsɐ̃w̃
confessar	kõfɨsaɾ
confete	kõfɛtʃi
confeção	kõfɛsɐ̃w̃
confiança	kõfjɐ̃sɐ
confiar	kõfiaɾ
confiar	kõfjaɾ
confidência	kõfiðẽsjɐ
configuro	kõfiɡuɾu
confinar	kõfinaɾ
confissão	kõfisɐ̃w̃
confortar	kõfuɾtaɾ
conforto	kõfoɾtu
conforto	kõfɔɾtu
confortável	kõfuɾtavɛɫ
confrontar	kõfrõtaɾ
confuso	kõfuzu
confusão	kõfuzɐ̃w̃
congelar	kõʒɨlaɾ
congratulou	kõɡɾatulow
congregação	kõɡɾɨɣɐsɐ̃w̃
congressista	kõɡɾɨsiʃtɐ
congresso	kõɡɾɛsu
congénere	kõʒɛnɨɾɨ
conhaque	kɔɲakɨ
conhece	kuɲɛsɨ
conhecedor	kuɲɨsɨðoɾ
conhecer	kuɲɨseɾ
conhecera	kuɲɨseɾɐ
conhecerá	kuɲɨsɨɾa
conhecia	kuɲɨsiɐ
conhecida	kuɲɨsiðɐ
conhecido	kuɲɨsiðu
conhecimento	kuɲɨsimẽtu
conheço	kuɲesu
conjunto	kõʒũtu
conjuro	kõʒuɾu
connosco	kõnoʃku
conquista	kõkiʃtɐ
conquistar	kõkiʃtaɾ
conquistas	kõkiʃtɐʃ
consagrar	kõsɐɣɾaɾ
consciente	kõʃsjẽtɨ
consciência	kõʃsjẽsjɐ
conseguinte	kõseɡĩti
conseguir	kõsɨɣiɾ
conselheiro	kõsɨʎɐjɾu
conselho	kõseʎu
conselho	kõsɐjʎu
consentimento	kõsẽtimẽtu
consentir	kõsẽtiɾ
consequência	kõsɨkwẽsjɐ
consertar	kõsɨɾtaɾ
conserva	kõsɛɾvɐ
conservava	kõsɨɾvavɐ
considerar	kõsiðɨɾaɾ
consideração	kõsiðɨɾɐsɐ̃w̃
consigo	kõsiɣu
consigo	kũsiɣu
consistir	kõsiʃtiɾ
consoada	kõswaðɐ
consoante	kõswɐ̃tɨ
consolar	kõsulaɾ
consolação	kõsulɐsɐ̃w̃
consolo	kõsolu
consolo	kõsɔlu
conspícuo	kõʃpikwu
constante	kõʃtɐ̃tɨ
constantemente	kõʃtɐ̃tɨmẽtɨ
constança	kõʃtɐ̃sɐ
constatação	kõʃtɐtɐsɐ̃w̃
constipação	kõʃtipɐsɐ̃w̃
constituir	kõʃtitwiɾ
constrangimento	kõstrɐ̃ʒimẽtu
construir	kõʃtɾuiɾ
construtor	kõʃtɾutoɾ
construção	kõʃtɾusɐ̃w̃
constância	kõʃtɐ̃sjɐ
consulado	kõsulaðu
consular	kõsulaɾ
consultório	kõsuɫtɔɾju
consumir	kõsumiɾ
consumo	kõsumu
conta	kõtɐ
contactar	kõtɐktaɾ
contacto	kõtaktu
contagem	kõtaʒɐ̃j̃
contanto	kõtɐ̃tu
contar	kõtaɾ
contas	kõtɐʃ
contato	kõtatu
contentar	kõtẽtaɾ
contente	kõtẽtɨ
contentor	kõtẽtoɾ
conter	kõteɾ
conteúdo	kõtjuðu
contigo	kõtiɣu
continente	kõtinẽtɨ
contingenciamento	kõtĩʒẽsjamẽtu
contino	kõtinu
continua	kõtinuɐ
continuamente	kõtinwɐmẽtɨ
continuar	kõtinwaɾ
continuava	kõtinwavɐ
continuou	kõtinwow
conto	kõtu
contornar	kõtuɾnaɾ
contorno	kõtoɾnu
contos	kõtuʃ
contou	kõtow
contra	kõtɾɐ
contrabaixo	kõtrɐbajʃu
contracetivo	kõtɾɐsɛtivu
contraceção	kõtɾɐsɛsɐ̃w̃
contramestre	kõtɾɐmɛʃtɾɨ
contrariar	kõtɾɐɾjaɾ
contratar	kõtɾɐtaɾ
contribuição	kõtɾiβwisɐ̃w̃
controlador	kõtɾulɐdoɾ
controlo	kõtɾolu
controlo	kõtɾɔlu
contrário	kõtɾaɾju
contudo	kõtuðu
contínuo	kõtinwu
convencer	kõvẽseɾ
convento	kõvẽtu
convenção	kõvẽsɐ̃w̃
conversa	kõvɛɾsɐ
conversando	kõvɨɾsɐ̃du
conversar	kõvɨɾsaɾ
convexo	kõvɛksu
convicção	kõviksɐ̃w̃
convidar	kõviðaɾ
convosco	kõvoʃku
convés	kõvɛʃ
cooptar	kooptaɾ
cooptar	kooptaʁ
coorte	kuɔɾtɨ
coorte	kwɔɾtɨ
copa	kɔpɐ
copeiro	kopejɾu
copiar	kupjaɾ
copla	kɔplɐ
copo	kɔpu
coquete	kokɛtʃi
cor	koɾ
cor	kɔɾ
coragem	kuɾaʒɐ̃j̃
corajoso	kuɾɐʒozu
corar	kɔɾaɾ
coração	kuɾɐsɐ̃w̃
coração	kɔɾɐsɐ̃w̃
corações	kuɾɐsõj̃ʃ
corda	kɔɾdɐ
cordas	kɔɾdɐʃ
cordilheira	kuɾðiʎɐjɾɐ
cordão	kuɾðɐ̃w̃
cordões	kuɾðõj̃ʃ
cores	koɾɨʃ
corintiano	koɾĩtʃiɐ̃nu
corisco	kuɾiʃku
corno	koɾnu
coro	koɾu
coro	kɔɾu
coroa	kuɾoɐ
corolário	kuɾulaɾju
coros	kɔɾuʃ
corpo	koɾpu
corporal	kuɾpuɾaɫ
corpos	kɔɾpuʃ
corre	kɔʁi
corredor	kuʁɨðoɾ
correia	kuʁejɐ
correia	kuʁɐjɐ
correio	kuʁɐju
correndo	kuʁẽdu
corrente	kuʁẽtɨ
correr	kuʁeɾ
corresponder	kuʁɨʃpõdeɾ
correspondência	kuʁɨʃpõdẽsjɐ
corretamente	kuʁɛtɐmẽtɨ
correto	kuʁɛtu
correu	kuʁew
corria	kuʁiɐ
corrida	kuʁiðɐ
corrimão	kuʁimɐ̃w̃
corroboração	kuʁuβuɾɐsɐ̃w̃
corrupio	kuʁupiu
corrupto	kuʁuptu
corrupção	kuʁupsɐ̃w̃
cortado	kuɾtaðu
cortando	kuɾtɐ̃du
cortar	kuɾtaɾ
corte	koɾtɨ
corte	kɔɾtɨ
cortina	kuɾtinɐ
cortiça	kuɾtisɐ
coruche	kuɾuʃɨ
coruja	kuɾuʒɐ
corvo	koɾvu
corça	kɔɾsɐ
coró	koɾɔ
coser	kuzer
cosseno	kusenu
costa	kɔʃtɐ
costas	kɔʃtɐʃ
costumar	kuʃtumaɾ
costumava	kuʃtumavɐ
costume	kuʃtumɨ
cota	kɔta
cotangente	kotɐ̃ʒẽtɨ
cotiano	kotʃiɐ̃nu
cotonete	kotonɛtʃi
cotovelo	kutuvelu
cotovia	kutuviɐ
couraçado	kowɾɐsaðu
couro	kowɾu
cousa	kowzɐ
couto	kowtu
couve	kowvɨ
cova	kɔvɐ
coveiro	kuvejɾu
coveiro	kuvɐjɾu
coveiro	kɔvejɾu
coveiro	kɔvɐjɾu
covilhã	kuviʎɐ̃
covo	kovu
coxa	koʃɐ
cozer	kuzeɾ
cozinha	kuziɲɐ
cozinhar	kuziɲaɾ
cozinheiro	kuziɲɐjɾu
coçar	kusaɾ
crasso	kɾasu
crato	kɾatu
cravejado	kɾɐvɨʒaðu
cravo	kɾavu
creditar	kɾɨðitaɾ
credo	kɾɛðu
credor	kɾɛðoɾ
credulidade	kɾɛðuliðaðɨ
creio	kɾɐju
cremado	kɾemadu
crente	kɾẽtɨ
crença	kɾẽsɐ
creolina	kɾewlinɐ
crepe	kɾɛpe
crepe	kɾɛpi
crepes	kɾɛpes
crepes	kɾɛpis
crepes	kɾɛpiʃ
crepúsculo	kɾɨpuʃkulu
crer	kɾeɾ
crescendo	kɾɨʃsẽdu
crescer	kɾɨʃseɾ
crescido	kɾɨʃsiðu
crescimento	kɾɨʃsimẽtu
creu	kɾew
criada	kɾjaðɐ
criados	kɾiaðuʃ
criança	kɾiɐ̃sɐ
crianças	kɾiɐ̃sɐʃ
criar	kɾiaɾ
criatura	kɾiɐtuɾɐ
criação	kɾiɐsɐ̃w̃
crica	kɾika
cricri	kɾikɾi
crime	kɾimɨ
criminal	kɾiminaɫ
criminoso	kɾiminozu
crioulo	kɾjowlu
criptido	kɾiptʃido
criptoanalista	kɾiptoanalijʃta
criptoanalista	kɾiptoanalista
criptoanálise	kɾiptoanalizi
criptobiose	kɾiptobiɔzi
criptobiótico	kɾiptobiɔtʃiku
criptococose	kɾiptokokɔzi
criptocomunismo	kɾipkomunijʃmu
criptocomunismo	kɾipkomunismu
criptocomunista	kɾipkomunijʃta
criptocomunista	kɾipkomunista
criptofascismo	kɾiptofasijʃmu
criptofascismo	kɾiptofasismu
criptofascista	kɾiptofasijʃta
criptofascista	kɾiptofasista
criptofone	kɾiptofoni
criptoftalmia	kɾiptoftawmia
criptoftalmia	kɾiptoftaɫmia
criptoftalmo	kɾiptoftaɫmu
criptografia	kɾiptoɡɾafia
criptograma	kɾiptoɡɾɐma
criptogâmico	kɾipɡɐmiku
criptologia	kɾiptoloʒia
criptológico	kɾiptolɔʒiku
criptomnésia	kɾiptomnɛzja
criptomnésico	kɾiptomnɛziku
criptomoeda	kɾiptomuɛda
criptorquia	kɾiptoɾkia
criptorquia	kɾiptoʁkia
criptoscopia	kɾiptoskopia
criptoscopia	kɾiptoʃkopia
criptossistema	kɾipsijʃtema
criptossistema	kɾipsistema
criptozoologia	kɾiptozooloʒia
criptozoólogo	kɾiptozoɔloɡu
criptídeo	kɾiptʃidʒiu
criptógama	kɾiptɔɡɐma
criptógrafo	kɾiptɔɡɾafu
criptósporo	kɾiptɔspoɾu
criptósporo	kɾiptɔʃpoɾu
criptônimo	kɾiptonimu
crise	kɾizɨ
crisol	kɾizɔɫ
crista	kɾiʃtɐ
cristal	kɾiʃtaɫ
cristiano	kɾiʃtjɐnu
cristo	kɾiʃtu
cristão	kɾiʃtɐ̃w̃
criticar	kɾitikaɾ
crocodilo	kɾokuðilu
cronómetro	kɾunɔmɨtɾu
croquete	kɾokɛtʃi
croácia	kɾuasjɐ
cru	kɾu
cruel	kɾuɛɫ
crueldade	kɾuɛɫdaðɨ
cruz	kɾuʃ
cruzada	kɾuzadɐ
cruzado	kɾuzaðu
cruzados	kɾuzaðuʃ
cruzeta	kɾuzetɐ
crápula	kɾapula
crás	kɾaʃ
crânio	kɾɐnju
crédito	kɾɛðitu
crítico	kɾitiku
cu	ku
cuba	kuβɐ
cubicar	kuβikaɾ
cubículo	kuβikulu
cuca	kuka
cuca	kukɐ
cuecas	kwɛkɐʃ
cueiro	kwejɾu
cueiro	kwɐjɾu
cuiabá	kujaba
cuidado	kujðaðu
cuidado	kwiðaðu
cuja	kuʒɐ
cujo	kuʒu
cujos	kuʒuʃ
culpa	kuɫpɐ
culposamente	kuɫpozɐmẽtɨ
cultura	kuɫtuɾɐ
cultural	kuɫtuɾaɫ
cume	kumɨ
cumprimento	kũpɾimẽtu
cumprir	kũprir
cuneta	kuneta
cunha	kuɲɐ
cunhada	kuɲaðɐ
cunhado	kuɲaðu
cupido	kupiðu
cupincha	kupĩʃɐ
cupom	kupõ
curação	kuɾɐsɐ̃w̃
curcuma	kuɾkumɐ
curinga	kuɾĩɡɐ
curiosidade	kuɾjuziðaðɨ
curioso	kuɾjozu
curitiba	kuɾitibɐ
curo	kuɾu
curral	kuʁaɫ
currículo	kuʁikulu
curta	kuɾtɐ
curtir	kuɾtiɾ
curto	kuɾtu
curtume	kuɾtumɨ
curva	kuɾvɐ
curvar	kuɾvaɾ
cuspir	kuʃpiɾ
custa	kuʃtɐ
custar	kuʃtaɾ
custo	kuʃtu
custódia	kuʃtɔðjɐ
cutelo	kutɛlu
cuzão	kuzɐ̃w̃
czar	tsaɾ
cá	ka
cágado	kaɣɐðu
cálcio	kalsju
cálice	kalisɨ
cárcere	kaɾsɨɾɨ
cávado	kavɐðu
câmara	kɐmɐɾɐ
câmbio	kɐ̃biu
câmbio	kɐ̃bju
câncer	kɐ̃sɛɾ
cânhamo	kɐɲɐmu
cântaro	kɐ̃tɐɾu
cântico	kɐ̃tiku
cã	kɐ̃
cães	kɐ̃j̃ʃ
cãibra	kɐ̃j̃bɾɐ
cão	kɐ̃w̃
cãozinho	kɐ̃w̃ziɲu
célere	sɛlɨɾɨ
célula	sɛlulɐ
cénico	sɛniku
cérebro	sɛɾɨβɾu
césar	sɛzɐɾ
céu	sɛw
céus	sɛwʃ
cê	se
cêntimo	sẽtimu
cílio	silju
círculo	siɾkulu
cítara	sitɐɾɐ
código	kɔðiɣu
cólera	kɔlɨɾɐ
cómoda	kɔmuðɐ
cómodo	kɔmuðu
cópia	kɔpjɐ
córsico	kɔɾsiku
cômpito	kõpitu
côncavo	kõkɐvu
cônsul	kõsuɫ
côvão	kovɐ̃w̃
cúmplice	kũplisɨ
cúmulo	kumulu
cúpula	kupulɐ
cúrcuma	kuɾkumɐ
da	dɐ
dacito	dɐsitu
dado	daðu
dai	daj
dali	dɐli
dalmática	dalmatikɐ
dama	dɐmɐ
damas	dɐmɐʃ
damasco	dɐmaʃku
danado	dɐnaðu
danbo	dɐ̃bu
dando	dɐ̃du
dano	dɐnu
danoso	dɐnozu
dança	dɐ̃sɐ
dançarino	dɐ̃sɐɾinu
danço	dɐ̃su
danúbio	dɐnuβju
daquela	dɐkɛlɐ
daquelas	dɐkɛlɐʃ
daquele	dɐkelɨ
daqueles	dɐkelɨʃ
daqui	dɐki
daquilo	dɐkilu
dar	daɾ
das	dɐʃ
data	datɐ
datiloscopia	dɐktilɔʃkupiɐ
datilógrafo	dɐktilɔɣɾɐfu
dava	davɐ
davam	davɐ̃w̃
daí	dɐi
de	dɨ
debelar	debelaɾ
debilidade	dɨβiliðaðɨ
debilidade	dɨβɨliðaðɨ
debruçou	debɾusow
debuxar	dɨβuʃaɾ
decente	dɨsẽtɨ
decerto	dɨsɛɾtu
decidido	dɨsiðiðu
decidido	dɨsɨðiðu
decidir	dɨsiðiɾ
decidir	dɨsɨðiɾ
decidira	dɨsiðiɾɐ
decidirá	dɨsiðiɾa
decisivo	dɨsizivu
decisão	dɨsizɐ̃w̃
declarar	dɨklɐɾaɾ
declaração	dɨklɐɾɐsɐ̃w̃
declarou	dɨklɐɾow
declive	dɨklivɨ
decompor	dɨkõpoɾ
decorador	dɨkuɾɐðoɾ
decorar	dɨkuɾaɾ
decoração	dɨkuɾɐsɐ̃w̃
decágono	dɨkaɡunu
dedal	dɨðaɫ
dedetização	dedetʃizasɐ̃w̃
dedo	deðu
dedos	deðuʃ
deduro	deduɾu
deduzir	dɨðuziɾ
deem	deɐ̃j
defeito	dɨfejtu
defeito	dɨfɐjtu
defender	dɨfẽdeɾ
defesa	dɨfezɐ
defeso	dɨfezu
deficitário	defisitarju
definitivamente	dɨfinitivɐmẽtɨ
definitivo	dɨfinitivu
definitivo	dɨfɨnitivu
deflagrar	deflaɡɾaɾ
deflagração	deflaɡɾasɐ̃w̃
deformação	dɨfuɾmɐsɐ̃w̃
defronte	dɨfɾõtɨ
degrau	dɨɣɾaw
degraus	dɨɣɾɐwʃ
deia	dɛjɐ
deificação	deifikɐsɐ̃w̃
deitado	dɐjtaðu
deitar	dɐjtaɾ
deixa	dɐjʃɐ
deixado	dɐjʃaðu
deixara	dɐjʃaɾɐ
deixará	dɐjʃɐɾa
deixava	dɐjʃavɐ
deixou	dɐjʃow
dela	dɛlɐ
dele	delɨ
delegar	dɨlɨɣaɾ
delete	dlɛtʃi
delgado	dɛɫɣaðu
delicado	dɨlikaðu
deliciosa	dɨlisjɔzɐ
deliciosamente	dɨlisjɔzɐmẽtɨ
delicioso	dɨlisjozu
delito	dɨlitu
delta	dɛɫtɐ
delírio	dɨliɾju
demais	dɨmajʃ
demasiado	dɨmɐziaðu
demasiado	dɨmɐzjaðu
demissexual	demiseksuaɫ
demo	demu
democracia	dɨmukɾɐsiɐ
demográfico	dɨmuɣɾafiku
demonstrar	dɨmõʃtɾaɾ
demora	dɨmɔɾɐ
demorar	dɨmuɾaɾ
demónio	dɨmɔnju
dendê	dẽde
denso	dẽsu
dental	dẽtaɫ
dente	dẽtɨ
dentes	dẽtɨʃ
dentista	dẽtiʃtɐ
dentre	dẽtɾɨ
dentro	dẽtɾu
dentário	dẽtaɾju
dentífrico	dẽtifɾiku
depender	dɨpẽdeɾ
dependência	dɨpẽdẽsjɐ
depois	dɨpojʃ
deprecar	depɾekaɾ
depreciativo	depɾesjatʃivu
depressa	dɨpɾɛsɐ
deprê	depɾe
deputado	dɨputaðu
deque	dɛki
dera	dɛɾɐ
derradeiro	dɨʁɐðɐjɾu
derramamento	dɨʁɐmɐmẽtu
derramar	dɨʁɐmaɾ
derrame	dɨʁamɨ
derrete	deʁɛtʃi
derrocar	dɨʁukaɾ
desafiar	dɨzɐfjaɾ
desafio	dɨzɐfiu
desaforamento	dezafoɾamẽtu
desaforamento	dʒizafoɾamẽtu
desaforar	dʒizafoɾaɾ
desaforo	dezafoɾu
desaforo	dezafɔɾu
desaforo	dʒizafoɾu
desaforo	dʒizafɔɾu
desaparecer	dɨzɐpɐɾɨseɾ
desaparecido	dɨzɐpɐɾɨsiðu
desaparecimento	dɨzɐpɐɾɨsimẽtu
desapercebido	dezapeɾsebidu
desapercebido	dʒizapeɾsebidu
desarmamentista	dezaʁmamẽtʃijʃta
desarmamentista	dʒizaɾmamẽtʃista
desarrazoar	dɨzɐʁɐzwaɾ
desarticular	dezartʃikular
desasar	dɨzazaɾ
desastre	dɨzaʃtɾɨ
desatar	dɨzɐtaɾ
desatarraxar	dɨzɐtɐʁɐʃaɾ
desbocado	dezbokadu
descalçar	dɨʃkaɫsaɾ
descalço	dɨʃkaɫsu
descansar	dɨʃkɐ̃saɾ
descanso	dɨʃkɐ̃su
descarregar	dɨʃkɐʁɨɣaɾ
desce	dɛʃsɨ
descendo	dɨʃsẽdu
descer	dɨʃseɾ
desceu	dɨʃsew
descia	dɨʃsiɐ
descida	dɨʃsiðɐ
descido	dɨʃsiðu
descoberta	dɨʃkuβɛɾtɐ
descoberto	dɨʃkuβɛɾtu
descobridor	dɨʃkuβɾiðoɾ
descobrimento	dɨʃkuβɾimẽtu
descobrir	dɨʃkuβɾiɾ
desconexo	dʒijʃkonɛksu
desconexo	dʒiskonɛksu
desconfiado	dɨʃkõfjaðu
desconhecer	dɨʃkuɲɨseɾ
desconhecido	dɨʃkuɲɨsiðu
desconhecimento	dɨʃkuɲɨsimẽtu
desconsideração	dɨʃkõsiðɨɾɐsɐ̃w̃
desconsolado	dɨʃkõsulaðu
descrição	dɨʃkɾisɐ̃w̃
desculpa	dɨʃkuɫpɐ
desde	deʒðɨ
desdenhar	dɨʒðɐɲaɾ
desdenhoso	dɨʒðɐɲozu
desdo	deʒðu
desdém	dɨʒðɐ̃j̃
deseducado	dʒizedukadu
desejar	dɨzɨʒaɾ
desejo	dɨzeʒu
desejo	dɨzɐjʒu
desejoso	dɨzɨʒozu
desencadear	dɨzẽkɐðjaɾ
desenhar	dɨzɨɲaɾ
desenho	dɨzeɲu
desenho	dɨzɐjɲu
desenho	dɨzɐɲu
desentendimento	dezẽtẽdʒimẽtu
desenvencilhar	desẽvẽsiʎaɾ
desenvincilhar	desẽvĩsiʎaɾ
desenvolver	dɨzẽvoɫveɾ
desenvolvimento	dɨzẽvoɫvimẽtu
desequilibrou	dezekilibɾow
desertificar	dɨzɨɾtifikaɾ
deserto	dɨzɛɾtu
desesperadamente	dɨzɨʃpɨɾaðɐmẽtɨ
desfazer	dɨʃfɐzeɾ
desfazimento	desfazimẽtu
desfazimento	dʒisfazimẽtu
desferir	dɨʃfɨɾiɾ
desgostar	dɨʒɣuʃtaɾ
desgosto	dɨʒɣoʃtu
desgraça	dɨʒɣɾasɐ
desgraçado	dɨʒɣɾɐsaðu
desidratação	dɨzidɾɐtɐsɐ̃w̃
designadamente	dɨziɣnaðɐmẽtɨ
designado	dɨziɣnaðu
desilusão	dɨziluzɐ̃w̃
desinteresse	dɨzĩtɨɾesɨ
desjejum	dɨʒɨʒũ
desleixar	dɨʒlɐjʃar
desligado	dɨʒliɣaðu
desligar	dɨʒliɣaɾ
deslindar	dɨʒlĩdaɾ
deslizar	dɨʒlizaɾ
desmaiar	dɨʒmajaɾ
desmaio	dɨʒmaju
desmanchar	dɨʒmɐ̃ʃaɾ
desolado	dɨzulaðu
desolar	dezolaɾ
desolação	dezolasɐ̃w̃
desonerar	dɨzunɨɾaɾ
desonroso	dɨzõʁozu
desordem	dɨzɔɾðɐ̃j̃
desorganizado	dɨzɔɾɣɐnizaðu
desorganizar	dɨzɔɾɣɐnizaɾ
desorganização	dɨzɔɾɣɐnizɐsɐ̃w̃
despassarado	dɨʃpɐsɐɾaðu
despedido	dɨʃpɨðiðu
despedir	dɨʃpɨðiɾ
despeito	dɨʃpɐjtu
despender	dɨʃpẽdeɾ
despenhadeiro	dɨʃpɐɲɐðɐjɾu
despensa	dɨʃpẽsɐ
desperdiçar	dɨʃpɨɾðisaɾ
desperdício	dɨʃpɨɾðisju
despertador	dɨʃpɨɾtɐðoɾ
despertar	dɨʃpɨɾtaɾ
desperto	dɨʃpɛɾtu
despesa	dɨʃpezɐ
despesas	dɨʃpezɐʃ
despir	dɨʃpiɾ
desportivo	dɨʃpuɾtivu
desporto	dɨʃpoɾtu
desqualificar	dɨʃkwɐlifikaɾ
dessa	dɛsɐ
dessas	dɛsɐʃ
desse	desɨ
desses	desɨʃ
desta	dɛʃtɐ
destacamento	dɨʃtakɐmẽtu
destacar	dɨʃtɐkaɾ
destas	dɛʃtɐʃ
deste	deʃtɨ
deste	dɛʃtɨ
desterrar	dɨʃtɨʁaɾ
desterro	dɨʃteʁu
destes	deʃtɨʃ
destes	dɛʃtɨʃ
destino	dɨʃtinu
destra	dɛʃtɾɐ
destras	dɛʃtɾɐʃ
destreza	dɨʃtɾezɐ
destro	dɛʃtɾu
destruidor	dɨʃtɾuiðoɾ
destruir	dɨʃtɾuiɾ
destruição	dɨʃtɾuisɐ̃w̃
destrutivo	dɨʃtɾutivu
destruído	dɨʃtɾuiðu
desvencilhar	desvẽsiʎaɾ
desviar	dɨʒvjaɾ
desídia	dezidʒja
desígnio	deziɡnju
detalhe	dɨtaʎɨ
detalhes	dɨtaʎɨʃ
deteriorar	dɨtɨɾjuɾaɾ
deterioração	dɨtɨɾjuɾɐsɐ̃w̃
determinação	dɨtɨɾminɐsɐ̃w̃
deturpação	detuɾpasɐ̃w̃
deturpação	detuʁpasɐ̃w̃
deu	dew
deus	dewʃ
deusa	dewzɐ
deuses	dewzɨʃ
devagar	dɨvɐɣaɾ
devagarinho	dɨvɐɣɐɾiɲu
devassa	dɨvasɐ
devasso	dɨvasu
deve	dɛvɨ
devedor	dɨvɨðoɾ
dever	deveʁ
dever	dɨveɾ
deveres	dɨveɾɨʃ
deveria	dɨvɨɾiɐ
devesa	dɨvezɐ
devia	dɨviɐ
devido	devidu
devorar	dɨvuɾaɾ
devoção	dɨvusɐ̃w̃
dez	dɛʃ
dezanove	dzɐnɔvɨ
dezanove	dɨzɐnɔvɨ
dezasseis	dzɐsɐjʃ
dezasseis	dɨzɐsɐjʃ
dezassete	dɨzɐsɛtɨ
dezembro	dɨzẽbɾu
dezoito	dɨzojtu
dezoito	dɨzɔjtu
dia	diɐ
diabete	dʒiabɛtʃi
diabo	diaβu
diabo	djaβu
diacho	djaʃu
dialeto	djɐlɛtu
diamante	djɐmɐ̃tɨ
diante	djɐ̃tɨ
diariamente	diaɾiamẽtɨ
dias	diɐʃ
dica	dikɐ
dicionário	disjunaɾju
diferente	difɨɾẽtɨ
diferentes	difɨɾẽtɨʃ
diferença	difɨɾẽsɐ
diferir	difɨɾiɾ
dificuldade	difikuɫðaðɨ
difuso	difuzu
difícil	difisiɫ
difícil	dɨfisiɫ
diga	diɣɐ
digestão	diʒɨʃtɐ̃w̃
digital	diʒitaɫ
dignidade	diɡniðaðɨ
dignificar	diɣɨnifikaɾ
digno	diɡnu
digo	diɡu
dildo	dildu
dilúvio	diluvju
diminuir	diminwiɾ
diminuir	dɨminwiɾ
diminuição	diminuisɐ̃w̃
dinamarca	dinɐmaɾkɐ
dinastia	dinɐʃtiɐ
dindim	dĩdĩ
dindim	dʒĩdʒĩ
dinheiro	diɲɐjɾu
dino	dinu
dinossauro	dinɔsawɾu
diospireiro	djɔʃpiɾɐjɾu
diplomata	diplumatɐ
diplomático	diplumatiku
direita	diɾɐjtɐ
direito	diɾɐjtu
direitos	diɾɐjtuʃ
diretiva	diɾɛtivɐ
direto	diɾɛtu
diretor	diɾɛtoɾ
direção	diɾɛsɐ̃w̃
dirigir	diɾiʒiɾ
dirigível	diɾiʒivɛɫ
dirigível	dɨɾiʒivɛɫ
discente	disẽtʃi
discernimento	diʃsɨɾnimẽtu
disciplina	diʃsiplinɐ
discurso	dɨʃkuɾsu
discussão	diʃkusɐ̃w̃
discutir	diʃkutiɾ
disgeusia	disʒewzia
disjunção	diʒũsɐ̃ũ
disponibilidade	diʃpuniβiliðaðɨ
disponibilizar	diʃpuniβilizaɾ
disponível	diʃpunivɛɫ
dispor	diʃpoɾ
disposição	diʃpuzisɐ̃w̃
disposto	diʃpoʃtu
disputar	diʃputaɾ
disse	disɨ
dissera	disɛɾɐ
dissertação	disɨɾtɐsɐ̃w̃
dissesse	disɛsɨ
dissipar	disipaɾ
disso	disu
dissociável	dʒisosiavew
dissonância	dʒisonɐ̃sja
distante	diʃtɐ̃tɨ
distinguiam	diʃtĩɡiɐ̃w̃
distinguir	diʃtĩɡiɾ
distinto	diʃtĩtu
distinção	diʃtĩsɐ̃w̃
disto	diʃtu
distorção	dɨʃtuɾsɐ̃w̃
distrair	diʃtɾɐiɾ
distração	dɨʃtɾasɐ̃w̃
distraído	diʃtɾɐiðu
distribuidor	diʃtɾiβwiðoɾ
distribuidor	dɨʃtɾiβwiðoɾ
distribuir	diʃtɾiβuiɾ
distribuir	diʃtɾiβwiɾ
distribuir	dɨʃtɾiβuiɾ
distribuir	dɨʃtɾiβwiɾ
distribuição	diʃtɾiβwisɐ̃w̃
distribuição	dɨʃtɾiβwisɐ̃w̃
distância	diʃtɐ̃sjɐ
distúrbio	dɨʃtuɾβju
dita	ditɐ
dita	dʒitɐ
ditado	ditaðu
ditador	ditɐðoɾ
ditadura	ditɐðuɾɐ
ditar	ditaɾ
dito	ditu
diurese	dʒiuɾɛzi
diurno	djuɾnu
diversão	divɨɾsɐ̃w̃
divertido	divɨɾtiðu
divertimento	divɨɾtimẽtu
divertir	divɨrtir
dividir	dividiɾ
dividir	dɨvidiɾ
divina	divinɐ
divindade	divĩdaðɨ
divino	divinu
divisa	divizɐ
divisão	divizɐ̃w̃
divulgar	divuɫɣaɾ
divulgação	divuɫɣɐsɐ̃w̃
divã	divɐ̃
divãs	divɐ̃ʃ
diz	diʃ
dizem	dizɐ̃j̃
dizendo	dizẽdu
dizer	dizeɾ
dizia	diziɐ
diário	djaɾju
diáspora	djaʃpuɾɐ
dióspiro	djɔʃpiɾu
do	du
doar	duaɾ
doação	duɐsɐ̃w̃
dobra	dɔβɾɐ
dobradiça	dubrɐdisɐ
dobrar	duβɾaɾ
dobras	dɔβɾɐʃ
dobro	doβɾu
dobro	dɔβɾu
doca	dɔkɐ
doce	dosɨ
doceiro	dusɐjɾu
docemente	dosɨmẽtɨ
docente	dusẽtɨ
documental	dukumẽtaɫ
documento	dukumẽtu
dodecaedro	duðɨkɐɛðɾu
dodó	dɔðɔ
doente	dwẽtɨ
doentio	dwẽtiu
doença	dwẽsɐ
doer	dueɾ
doer	dweɾ
doido	dojdu
dois	dojʃ
doloroso	duluɾozu
dom	dõ
dominatrix	dominatriks
dominatrixes	dominatriksis
domingo	dumĩɡu
domingueiro	dumĩɡɐjɾu
dominó	dɔminɔ
doméstica	dumɛʃtikɐ
doméstico	dumɛʃtiku
dona	donɐ
donaire	dunajɾɨ
donatário	dunɐtaɾju
donbass	dõbas
donde	dõdɨ
doninha	dɔniɲɐ
dono	donu
donos	donuʃ
donzela	dõzɛlɐ
dores	doɾɨʃ
dorido	duɾiðu
dormente	duɾmẽtɨ
dormia	duɾmiɐ
dormindo	duɾmĩdu
dorminhoco	duɾmiɲoku
dormir	duɾmiɾ
dormitar	duɾmitaɾ
dorso	doɾsu
dos	duʃ
dossel	dusɛɫ
dossiê	dɔsje
dosso	dosu
doudo	dowdu
dourado	dowɾaðu
dourar	dowɾaɾ
douro	dowɾu
doutor	dowtoɾ
doutrina	dowtɾinɐ
doutrinação	dowtɾinɐsɐ̃w̃
doutro	dowtɾu
doze	dozɨ
doçaria	dusɐɾiɐ
doçura	dusuɾɐ
dragão	dɾɐɣɐ̃w̃
droga	dɾɔɣɐ
drogaria	dɾuɣɐɾiɐ
drusa	dɾuzɐ
drácula	dɾakulɐ
duas	duɐʃ
duende	duẽdɨ
duende	dwẽdɨ
dum	dũ
duma	dumɐ
dumas	dumɐʃ
duns	dũʃ
dupla	duplɐ
duque	dukɨ
duradouro	duɾɐðowɾu
durante	duɾɐ̃tɨ
durar	duɾaɾ
durazzo	duɾatsu
durex	durɛks
dureza	duɾezɐ
duro	duɾu
duunvirato	duũviɾatu
duvidar	duviðaɾ
duvidoso	duviðozu
duzentos	duzẽtuʃ
dá	da
dácio	dasju
dádiva	daðivɐ
dão	dɐ̃w̃
década	dɛkɐðɐ
décimo	dɛsimu
déficit	dɛfisit
dê	de
dêem	deɐ̃j
dígito	diʒitu
díptico	diptiku
dívida	dividɐ
dó	dɔ
dócil	dɔsiɫ
dólar	dɔlaɾ
dúvida	duvidɐ
dúzia	duzjɐ
e	e
e	i
e	ɛ
eau	eau
ebó	ebɔ
eclesiástico	iklɨzjaʃtiku
eco	ɛku
economia	ikɔnumiɐ
economista	ikunumiʃtɐ
económico	ikunɔmiku
ecrã	ɛkɾɐ̃
eczema	iɡzɛmɐ
edificar	iðifikaɾ
edificação	iðifikɐsɐ̃w̃
edifício	iðifisju
edimburgo	ɛðĩbuɾɣu
edito	editu
editor	iðitoɾ
editorial	iðituɾjaɫ
edredom	edɾedõ
educado	iðukaðu
educar	iðukaɾ
educação	iðukɐsɐ̃w̃
efe	ɛfɨ
efeito	ifɐjtu
efetivo	efetʃivu
efetuar	ifɛtuaɾ
efetuar	ifɛtwaɾ
egito	iʒitu
ego	ɛɣu
egoísmo	iɣwiʒmu
egoísta	iɣwiʃtɐ
egrégio	eɡrɛʒju
egrégio	iɡrɛʒju
ei	ej
eira	ɐjɾɐ
eis	ejʃ
eis	ɐjʃ
eixo	ejʃu
eixo	ɐjʃu
ejete	eʒɛtʃi
ela	ɛlɐ
elas	ɛlɐʃ
elasticidade	ilɐʃtisiðaðɨ
elasticidade	ilɐʃtɨsiðaðɨ
ele	elɨ
ele	ɛlɨ
elefante	ilɨfɐ̃tɨ
elegante	ilɨɣɐ̃tɨ
elegantemente	ilɨɣɐ̃tɨmẽtɨ
eleger	ilɨʒeɾ
elegível	ilɨʒivɛɫ
elemento	ilɨmẽtu
eles	elɨʃ
eletricidade	ilɛtɾisiðaðɨ
eletrão	ilɛtɾɐ̃w̃
elevado	ilɨvaðu
elevador	ilɨvɐðoɾ
elevar	ilɨvaɾ
elevação	ilɨvɐsɐ̃w̃
eliminação	ilɨminɐsɐ̃w̃
elmo	ɛɫmu
elo	ɛlu
eloquência	elukwẽsjɐ
eloquência	ilukwẽsjɐ
eloá	eloa
elucubrar	elukubraɾ
elucubração	elukubɾasɐ̃w̃
elástico	ilaʃtiku
elétrico	ilɛtɾiku
em	ɐ̃j̃
emascular	imɐskulaɾ
embaixada	ẽbajʃaðɐ
embaixador	ẽbajʃɐðoɾ
embaraço	ẽbɐɾasu
embarcar	ẽbɐɾkaɾ
embarcação	ẽbɐɾkɐsɐ̃w̃
embargo	ẽbaɾɣu
embolar	ĩbolaɾ
embora	ẽbɔɾɐ
emboscada	ẽbuʃkadɐ
emboscar	ẽbuʃkaɾ
embrulhado	ẽbɾuʎaðu
embrulhar	ẽbɾuʎaɾ
embrulho	ẽbɾuʎu
emburrecer	ĩbuʁeseɾ
emburrecimento	ĩbuʁesimẽtu
eme	ɛmɨ
emendar	imẽdaɾ
ementa	imẽtɐ
emigrante	emiɣɾɐ̃tɨ
emigrante	imiɣɾɐ̃tɨ
emigrar	emiɡɾaɾ
emigrar	imiɡɾaɾ
emitir	imitiɾ
emoldurar	imoɫduɾaɾ
emoção	imusɐ̃w̃
empecilho	ĩpesiʎu
empenho	ẽpeɲu
empenho	ẽpɐjɲu
empenho	ẽpɐɲu
empertigar	empeɾtiɣaɾ
empiorar	ẽpjuɾaɾ
empolado	ĩmpoladu
empreender	ẽpɾjẽdeɾ
empregado	ẽpɾɨɣaðu
empregar	ẽpɾɨɣaɾ
emprego	ẽpɾeɣu
emprego	ẽpɾɛɣu
empréstimo	ẽpɾɛʃtimu
empunhar	ẽpuj̃aɾ
empurrar	ẽpuʁaɾ
empáfia	ĩpafjɐ
emu	emu
emular	emulaɾ
emular	imulaɾ
emulação	imulɐsɐ̃w̃
encafifar	ĩkafifaɾ
encaixilhar	ẽkajʃiʎaɾ
encaixotar	ẽkajʃutaɾ
encalistrar	ĩkalijʃtɾaʁ
encalistrar	ĩkalistɾaɾ
encalço	ĩkawsu
encantado	ẽkɐ̃tadu
encantar	ẽkɐ̃taɾ
encantação	ẽkɐ̃tɐsɐ̃w̃
encanto	ẽkɐ̃tu
encarnação	ẽkɐɾnɐsɐ̃w̃
encavacar	ĩkavakaɾ
encenação	ẽsɨnɐsɐ̃w̃
encharcado	ẽʃɐɾkadu
enchendo	ẽʃẽdu
encher	ẽʃeɾ
enchimento	ẽʃimẽtu
encolher	ẽkuʎeɾ
encolheu	ẽkuʎew
encolhido	ẽkuʎiðu
encomenda	ẽkumẽdɐ
encomendar	ẽkumẽdaɾ
encontrado	ẽkõtɾaðu
encontrar	ẽkõtɾaɾ
encontro	ẽkõtɾu
encontrão	ẽkõtɾɐ̃w̃
encorajamento	ẽkuɾɐʒɐmẽtu
encorajar	ẽkuɾɐʒaɾ
encosta	ẽkɔʃtɐ
encostado	ẽkuʃtaðu
encostar	ẽkuʃtaɾ
endomingado	ẽdumĩɡaðu
endoscopia	ĩdoskopia
endoscopia	ĩdoʃkopia
endoscopia	ẽdoskopia
endoscopia	ẽdoʃkopia
endurecer	ẽduɾɨseɾ
ene	ɛnɨ
energia	inɨɾʒiɐ
enervar	inɨɾvaɾ
eneágono	ɛnjaɣunu
enfermaria	ẽfɨɾmɐɾiɐ
enfermeiro	ẽfɨɾmɐjɾu
enfermidade	ẽfɨɾmiðaðɨ
enfiar	ẽfjaɾ
enfim	ẽfĩ
enfrentar	ẽfɾẽtaɾ
enfurecer	ẽfuɾɨseɾ
enganar	ẽɡɐnaɾ
engano	ĩɡɐnu
engano	ẽɡɐnu
enganoso	ẽɡɐnozu
engarrafamento	ẽɡɐʁɐfɐmẽtu
engarrafar	ẽɡɐʁɐfaɾ
engavete	ẽɡavɛtʃi
engenho	ẽʒeɲu
engenho	ẽʒɐjɲu
engenho	ẽʒɐɲu
engordar	ĩɡuɾðaɾ
engordar	ẽɡuɾðaɾ
engorgitamentos	ẽɡoʁʒitamẽtus
engorovinhado	ĩɡoɾoviɲadu
engrandecer	ẽɡɾɐ̃dɨseɾ
engruvinhado	ĩɡɾuviɲadu
enguia	ẽɡiɐ
enguiçar	ẽɡisaɾ
enguiço	ẽɡisu
enjoar	ẽʒwaɾ
enjoo	ẽʒou
enlevo	ej̃levu
enlouquecer	ẽlowkɨseɾ
enojar	inuʒaɾ
enorme	inɔɾmɨ
enormemente	inɔɾmɨmẽtɨ
enquadramento	ẽkwɐðɾɐmẽtu
enquadrar	ẽkwɐðɾaɾ
enquanto	ẽkwɐ̃tu
enraizar	ẽʁɐizaɾ
enriquecer	ẽʁikɨseɾ
ensinar	ẽsinaɾ
ensino	ẽsinu
ensonado	ẽsunaðu
entalhe	ẽtaʎɨ
entanto	ẽtɐ̃tu
ente	ẽtɨ
enteado	ẽtjaðu
entender	ẽtẽdeɾ
entendido	ẽtẽdiðu
entendimento	ẽtẽdimẽtu
enterrado	ẽtɨʁaðu
enterrar	ẽtɨʁaɾ
entra	ẽtɾɐ
entrada	ẽtɾaðɐ
entrando	ẽtɾɐ̃du
entrava	ẽtɾavɐ
entre	ẽtɾɨ
entreaberto	ẽtɾjɐβɛɾtu
entregador	ĩtɾeɡadoɾ
entregar	ẽtɾɨɣaɾ
entregou	ẽtɾɨɣow
entremeio	ẽtɾemeiu
entremez	ẽtɾɨmeʃ
entretanto	ẽtɾɨtɐ̃tu
entretenimento	ẽtɾɨtɨnimẽtu
entrevista	ẽtɾɨviʃtɐ
entrevistar	ẽtɾɨviʃtaɾ
entristecer	ẽtɾiʃtɨseɾ
entroncamento	ẽtɾõkɐmẽtu
entrou	ẽtɾow
entrudo	ĩtɾuðu
entrudo	ẽtɾuðu
entruido	ĩtɾujðu
entruido	ẽtɾujðu
entusiasmar	ẽtuzjɐʒmaɾ
entusiasmo	ẽtuzjaʒmu
entusiasta	ẽtuzjaʃtɐ
entusiasticamente	ẽtuzjaʃtikɐmẽtɨ
entusiástico	ẽtuzjaʃtiku
então	ẽtɐ̃w̃
envelhecer	ẽvɨʎɨseɾ
envelhecimento	ẽvɨʎɨsimẽtu
envelope	ẽvɨlɔpɨ
envencilhar	ẽvẽsiʎaɾ
envenenamento	ẽvɨnɨnɐmẽtu
envenenar	ẽvɨnɨnaɾ
envergonhado	ẽvɨɾɣuɲaðu
envergonhar	ẽvɨɾɣuɲaɾ
enviar	ẽvjaɾ
envio	ẽviu
envolver	ẽvoɫveɾ
envólucro	ĩvɔlukɾu
enxaguar	ẽʃɐɡwar
enxame	ẽʃɐmɨ
enxofre	ẽjʃofɾi
enxuto	ẽʃutu
enérgico	inɛɾʒiku
eoo	eɔu
epidemia	epiðɨmiɐ
epidemia	ipiðɨmiɐ
epifania	ipifɐniɐ
epigenesia	epiʒenezia
epigenia	epiʒenia
epigênese	epiʒenezi
episódio	epizɔðju
episódio	ipizɔðju
epopeia	epopɛjɐ
equidade	ikwiðaðɨ
equilibrar	ekilibɾaɾ
equilibrar	ikilibɾaɾ
equino	ekwinu
equipa	ikipɐ
equipamento	ikipɐmẽtu
equipar	ekipaɾ
equipar	ikipaɾ
equipendência	ikwipẽdẽsiɐ
equivalente	ikivɐlẽtɨ
equivocou	ekivokow
era	ɛɾɐ
eram	ɛɾɐ̃w̃
eremita	iɾɨmitɐ
erguendo	iɾɣẽdu
erguer	eɾɡeɾ
ergueu	eɾɣew
ergueu	iɾɣew
erguido	eɾɣiðu
erguido	iɾɣiðu
ergástulo	ɛɾɡaʃtulu
ermida	eɾmiðɐ
ermida	iɾmiðɐ
ermo	eɾmu
erradamente	iʁɐðɐmẽtɨ
errado	iʁaðu
errar	iʁaɾ
erre	ɛʁɨ
erro	eʁu
erro	ɛʁu
erróneo	eʁɔnju
erróneo	iʁɔnju
erva	ɛɾvɐ
ervilha	eɾviʎɐ
ervilha	iɾviʎɐ
esboçar	ɨʒβusaɾ
esboço	ɨʒbosu
esbranquiçado	ɨʒβɾɐ̃kisaðu
esburacar	iʒβuɾɐkaɾ
escabelo	iʃkɐβelu
escachar	ɨʃkɐʃaɾ
escada	iʃkaðɐ
escadaria	eskadaɾia
escadaria	eskadaɾiɐ
escadaria	eʃkadaɾiɐ
escadaria	iskadaɾiɐ
escadaria	iʃkadaɾiɐ
escala	iʃkalɐ
escalar	iʃkɐlaɾ
escancarar	iʃkɐ̃kɐɾaɾ
escandinávia	ɨʃkɐ̃dinavjɐ
escanho	iʃkɐɲu
escano	iʃkɐnu
escapar	iʃkɐpaɾ
escaravelho	iʃkɐɾɐveʎu
escaravelho	iʃkɐɾɐvɐjʎu
escarlate	iʃkɐɾlatɨ
escarnecer	iʃkɐɾnɨseɾ
escasso	iʃkasu
escoamento	iʃkwɐmẽtu
escoar	iʃkuaɾ
escoar	iʃkwaɾ
escola	iʃkɔlɐ
escolha	iʃkoʎɐ
escolher	iʃkuʎeɾ
esconder	ɨʃkõdeɾ
escondido	iʃkõdiðu
esconjurar	iʃkõʒuɾaɾ
esconjuro	iʃkõʒuɾu
escorpião	iʃkuɾpjɐ̃w̃
escorrega	iʃkuʁɛɣɐ
escorregar	iʃkuʁɨɣaɾ
escova	iʃkovɐ
escovar	iʃkuvaɾ
escravização	iʃkɾɐvizɐsɐ̃w̃
escravo	iʃkɾavu
escrever	iʃkɾɨveɾ
escrita	iʃkɾitɐ
escrito	iʃkɾitu
escritor	iʃkɾitoɾ
escritório	iʃkɾitɔɾju
escrivão	iʃkɾivɐ̃w̃
escrotal	ɨʃkɾutaɫ
escrúpulo	iʃkɾupulu
escudo	iʃkudu
escultura	ɨʃkuɫtuɾɐ
escumalha	iskumaʎa
escumalha	iʃkumaʎa
escumalho	iskumaʎu
escumalho	iʃkumaʎu
escura	iʃkuɾɐ
escurecer	iʃkuɾɨseɾ
escuridão	iʃkuɾiðɐ̃w̃
escuro	iʃkuɾu
escutar	iʃkutaɾ
escárnio	iʃkaɾnju
escândalo	iʃkɐ̃dɐlu
escócia	iʃkɔsiɐ
esforçar	iʃfuɾsaɾ
esforço	ɨʃfoɾsu
esfregar	ɨʃfɾɨɣaɾ
esfênio	ɨʃfenju
esguio	iʒɣiu
eslavo	ɨʒlavu
eslováquia	iʒluvakiɐ
eslovénia	iʒlɔvɛnjɐ
esmagado	iʒmɐɣaðu
esmagamento	ɨʒmɐɣɐmẽtu
esmagar	ɨʒmɐɣaɾ
esmeralda	iʒmɨɾaɫdɐ
esmola	iʒmɔlɐ
espada	ɨʃpadɐ
espadachim	iʃpɐðɐʃĩ
espadas	iʃpadɐʃ
espalhar	ɨʃpɐʎaɾ
espanha	iʃpɐɲɐ
espanhol	ɨʃpɐɲɔɫ
espantado	iʃpɐ̃taðu
espanto	ɨʃpɐ̃tu
espantoso	ɨʃpɐ̃tozu
esparavel	iʃpɐɾɐvɛɫ
espaço	iʃpasu
espaçoso	iʃpɐsozu
especial	iʃpɨsjaɫ
especialidade	iʃpɨsjɐliðaðɨ
especialmente	iʃpɨsjaɫmẽtɨ
espectador	iʃpɛktɐdoɾ
espectro	iʃpɛktɾu
espectro	iʃpɛtɾu
espectro	ɨʃpɛktɾu
espectro	ɨʃpɛtɾu
espelho	ɨʃpɐjʎu
espelho	ɨʃpɛʎu
espera	ɨʃpɛɾɐ
esperando	iʃpɨɾɐ̃du
esperança	iʃpɨɾɐ̃sɐ
esperar	iʃpɨɾaɾ
esperar	ɨʃpɨɾaɾ
esperar	ʃpɨɾaɾ
esperava	iʃpɨɾavɐ
esperma	ɨʃpɛɾmɐ
esperto	ɨʃpɛɾtu
espesso	iʃpesu
espessura	iʃpɨsuɾɐ
espetacular	iʃpɛtɐkulaɾ
espeto	iʃpetu
espeto	iʃpɛtu
espetou	ispetow
espetáculo	iʃpɛtakulu
espiga	iʃpiɣɐ
espinafre	iʃpinafɾɨ
espinela	ɨʃpinɛlɐ
espingarda	ɨʃpĩɡaɾðɐ
espinha	ɨʃpiɲɐ
espinhaço	espiɲasu
espinho	ɨʃpiɲu
espinho	ʃpiɲu
espiritual	iʃpiɾitwaɫ
espirrar	iʃpiʁaɾ
espirro	iʃpiʁu
esplendor	iʃplẽdoɾ
esplêndido	iʃplẽdiðu
esponja	ɨʃpõʒɐ
esponsal	iʃpõsaɫ
espora	ɨʃpɔɾɐ
esposa	iʃpozɐ
esposende	ɨʃpɔzẽdɨ
esposo	iʃpozu
espreitar	iʃpɾejtaɾ
espreitar	iʃpɾɐjtaɾ
espécie	ɨʃpɛsjɨ
espírito	iʃpiɾitu
esquecer	iʃkɨseɾ
esquecido	iʃkɨsiðu
esqueleto	ɨʃkɨletu
esquerda	iʃkeɾðɐ
esquerdino	iʃkɨɾðinu
esquerdo	iʃkeɾðu
esquina	ɨʃkinɐ
esquisito	iʃkizitu
esquisito	iʃkɨzitu
essa	ɛsɐ
essas	ɛsɐʃ
esse	esɨ
esse	ɛsɨ
essencial	isẽsjaɫ
esses	esɨʃ
essência	isẽsjɐ
esta	ɛʃtɐ
estaca	iʃtakɐ
estacionamento	iʃtɐsjunɐmẽtu
estacionar	iʃtɐsjunaɾ
estado	iʃtaðu
estalagem	iʃtɐlaʒɐ̃j̃
estalar	iʃtɐlaɾ
estamos	iʃtamuʃ
estandarte	iʃtɐ̃daɾtɨ
estando	iʃtɐ̃du
estanho	iʃtɐɲu
estante	iʃtɐ̃tɨ
estar	iʃtaɾ
estar	taɾ
estar	ɨʃtaɾ
estar	ʃtaɾ
estaria	iʃtɐɾiɐ
estarreja	ɨʃtɐʁɐjʒɐ
estas	ɛʃtɐʃ
estatal	ɨʃtɐtal
estatura	iʃtatuɾɐ
estatuto	ɨʃtɐtutu
estava	iʃtavɐ
estavam	iʃtavɐ̃w̃
estação	iʃtɐsɐ̃w̃
este	eʃtɨ
este	ɛʃtɨ
esteio	iʃteju
esteio	iʃtɐju
esteira	iʃtɐjɾɐ
estendendo	iʃtẽdẽdu
estender	iʃtẽdeɾ
estendeu	iʃtẽdew
estes	eʃtɨʃ
esteve	iʃtevɨ
esteve	ɨʃtevɨ
esticado	iʃtikaðu
esticar	iʃtikaɾ
estilete	iʃtileti
estilo	iʃtilu
estilo	ɨʃtilu
estima	iʃtimɐ
estimulador	ɨʃtimulɐðoɾ
estimulante	ɨʃtimulɐ̃tɨ
estio	iʃtiu
estio	ɨʃtiu
estival	iʃtivaɫ
estivar	iʃtivaɾ
estivera	iʃtivɛɾɐ
estivesse	iʃtivɛsɨ
estofado	estofadu
estola	iʃtɔlɐ
estoma	ɨʃtomɐ
estontear	iʃtõtjaɾ
estopim	ijʃtupĩ
estopim	istupĩ
estore	iʃtɔɾɨ
estou	ɨʃtow
estourar	iʃtowɾaɾ
estrada	iʃtɾaðɐ
estragar	iʃtɾɐɣaɾ
estrangeiro	iʃtɾɐ̃ʒɐjɾu
estranha	ʃtɾɐɲɐ
estranhar	iʃtɾɐɲaɾ
estranhas	ʃtɾɐɲɐʃ
estranho	iʃtɾɐɲu
estranhos	ʃtɾɐɲuʃ
estratagema	ɨʃtɾɐtɐʒemɐ
estrear	iʃtɾjaɾ
estreia	iʃtɾejɐ
estreia	iʃtɾɐjɐ
estreitar	iʃtɾɐjtaɾ
estreitas	iʃtɾɐjtɐʃ
estreito	iʃtɾɐjtu
estrela	iʃtɾelɐ
estrela	ɨʃtɾelɐ
estrelas	iʃtɾelɐʃ
estrelas	ɨʃtɾelɐʃ
estribilho	iʃtɾiβiʎu
estrondo	ɨʃtɾõdu
estropear	iʃtɾupjaɾ
estrume	ɨʃtɾumɨ
estrumpfe	ɨʃtɾũfɨ
estrutura	iʃtɾutuɾɐ
estrutura	ʃtɾutuɾɐ
estudante	iʃtuðɐ̃tɨ
estudar	iʃtuðaɾ
estudioso	iʃtuðjozu
estudo	ɨʃtuðu
estufa	iʃtufɐ
estupidamente	iʃtupiðɐmẽtɨ
estupro	ijʃtupɾu
estupro	istupɾu
está	iʃta
está	ta
está	ɨʃta
está	ʃta
estás	iʃtaʃ
estátua	iʃtatwɐ
estável	iʃtavɛɫ
estância	ɨʃtɐ̃sjɐ
estão	ɨʃtɐ̃w̃
estética	ɨʃtɛtikɐ
estético	iʃtɛtiku
estéticos	iʃtɛtikuʃ
estónia	ɨʃtɔniɐ
estômago	ɨʃtomɐɣu
estúpido	iʃtupidu
esvair	iʒvɐiɾ
esvaziar	iʒvɐzjaɾ
etapa	itapɐ
eternamente	itɛɾnɐmẽtɨ
eternidade	itɨɾniðaðɨ
eterno	itɛɾnu
etna	ɛtɨnɐ
etólogo	etɔloɡu
eu	ew
euro	ewɾu
euro	ewɾɔ
europeia	ewɾupɐjɐ
europeu	ewɾupew
euzinha	ewziɲa
euzinho	ewziɲu
evaporar	ivɐpuɾaɾ
evaporação	ivɐpuɾɐsɐ̃w̃
evento	ivẽtu
eventual	ivẽtwaɫ
evidente	iviðẽtɨ
evidentemente	iviðẽtɨmẽtɨ
evitar	ivitaɾ
evocar	ivukar
exame	izɐmɨ
examinar	izɐminaɾ
exatamente	izatɐmẽtɨ
exato	izatu
exausto	izawʃtu
excelente	iʃslẽt
excelente	iʃsɨlẽtɨ
excelente	ɐjʃsɨlẽtɨ
excelência	iʃsɨlẽsjɐ
excelência	ɐjʃsɨlẽsjɐ
excessivamente	iʃsɨsivɐmẽtɨ
excessivamente	ɐjʃsɨsivɐmẽtɨ
excessivo	iʃsɨsivu
excessivo	ɐjʃsɨsivu
excesso	iʃsɛsu
excesso	ɐjʃsɛsu
exceto	iʃsɛtu
exceto	ɐjʃsɛtu
exceto	ʃɛtu
excitado	iʃsitaðu
excitado	ɐjʃsitaðu
excitador	ɐjʃsitɐðoɾ
excitador	ɨʃsitɐðoɾ
excitar	iʃsitaɾ
excitar	ɐjʃsitaɾ
exclamar	ɐjʃklɐmaɾ
exclamava	ɐjʃklɐmavɐ
exclamou	iʃklɐmow
exclamou	ɐjʃklɐmow
excremento	iʃkɾɨmẽtu
excremento	ɐjʃkɾɨmẽtu
executivo	ezɨkutivu
exegese	ezeʒɛzi
exemplar	izẽplaɾ
exemplo	izẽplu
exequibilidade	ezekwibilidadʒi
exequível	izɨkwivɛɫ
exibido	ezibidu
exibir	izɨbiɾ
exigente	iziʒẽtɨ
exigir	iziʒiɾ
exiguidade	iziɣwiðaðɨ
exigência	iziʒẽsjɐ
exilar	izilaɾ
existente	iziʃtẽtɨ
existir	iziʃtiɾ
existência	iziʃtẽsjɐ
exonerar	izunɨɾaɾ
exoplaneta	ezoplaneta
expandir	iʃpɐ̃diɾ
expandir	ɐjʃpɐ̃diɾ
expansão	iʃpɐ̃sɐ̃w̃
expansão	ɐjʃpɐ̃sɐ̃w̃
expectativa	ɐjʃpɛtɐtivɐ
expectativa	ɨʃpɛtɐtivɐ
expedição	ɐjʃpɨdisɐ̃w̃
experimentar	iʃpɨɾimẽtaɾ
experimentar	ɐjʃpɨɾimẽtaɾ
experiência	iʃpɨɾjẽsjɐ
experiência	ɐjʃpɨɾjẽsjɐ
experiência	ʃpɾjẽsjɐ
experto	ɐjʃpɛɾtu
experto	ɨʃpɛɾtu
explicado	iʃplikaðu
explicado	ɐjʃplikaðu
explicar	iʃplikaɾ
explicar	ɐjʃplikaɾ
explicação	iʃplikɐsɐ̃w̃
explicação	ɐjʃplikɐsɐ̃w̃
explicação	ʃplikɐsɐ̃w̃
explicações	iʃplikɐsõj̃ʃ
explicações	ɐjʃplikɐsõj̃ʃ
explicações	ʃplikɐsõj̃ʃ
explodir	ɐjʃpluðiɾ
explosivo	ɐjʃpluzivu
explosão	ɐjʃpluzɐ̃w̃
expressão	iʃpɾɨsɐ̃w̃
expressão	ɐjʃpɾɨsɐ̃w̃
exsicar	esikaɾ
exsicar	esikaʁ
exsudar	ɐjʃsuðaɾ
externo	iʃtɛrnu
externo	ɐjʃtɛrnu
extraordinário	iʃtɾɐɔɾðinaɾju
extraordinário	ɐjʃtɾɐɔɾðinaɾju
extravio	estɾaviu
extravio	istɾaviu
extração	ɐjʃtɾasɐ̃w̃
extremista	ɐjʃtɾɨmiʃtɐ
extremista	ɨʃtɾɨmiʃtɐ
extremo	iʃtɾemu
extremo	ɐjʃtɾemu
exumação	izumɐsɐ̃w̃
exéquias	ezɛkjas
exército	izɛɾsitu
exíguo	iziɡwu
exílio	izilju
exímio	izimju
exótico	ezɔtʃiku
fabricante	faβɾikɐ̃tɨ
fabricar	fɐβɾikaɾ
fabricação	fɐβɾikɐsɐ̃w̃
faca	fakɐ
face	fasɨ
facebook	fejzbuk
fachada	fɐʃaðɐ
facilmente	fasiɫmẽtɨ
facto	faktu
factível	fɐktivɛɫ
facão	fakɐ̃w̃
fada	faðɐ
fadiga	fɐðiɣɐ
fadigar	fɐðiɣaɾ
fado	faðu
fafe	fafɨ
faiança	fajɐ̃sɐ
faiança	fɐjɐ̃sɐ
fala	falɐ
falado	fɐlaðu
falando	fɐlɐ̃du
falange	fɐlɐ̃ʒɨ
falante	fɐlɐ̃tɨ
falar	fɐlaɾ
falara	fɐlaɾɐ
falará	fɐlɐɾa
falava	fɐlavɐ
falcatrua	faɫkɐtɾuɐ
falecer	fɐlɨseɾ
falena	fɐlenɐ
falha	faʎɐ
falhar	fɐʎaɾ
falo	faɫu
falou	fɐlow
falsidade	faɫsiðaðɨ
falso	faɫsu
faltar	faɫtaɾ
fama	fɐmɐ
faminto	fɐmĩtu
famoso	fɐmozu
família	fɐmiljɐ
fantasma	fɐ̃taʒmɐ
faraó	fɐɾɐɔ
farda	faɾðɐ
farejar	fɐɾɨʒaɾ
farelo	fɐɾɛlu
faria	fɐɾiɐ
farinha	fɐɾiɲɐ
farmácia	fɐɾmasjɐ
faro	faɾu
farol	fɐɾɔɫ
farra	faʁɐ
farsa	farsɐ
farto	faɾtu
fartura	faɾtuɾa
fartura	faʁtuɾa
fase	fazɨ
fashion	fɛʃõ
fatal	fɐtaɫ
fatalidade	fɐtɐliðaðɨ
fatalismo	fɐtɐliʒmu
fatia	fɐtiɐ
fatiota	fatʃiɔtɐ
fato	fatu
fatura	fatuɾɐ
fatwa	fatwɐ
fauno	fawnu
faustoso	fawstozu
fava	favɐ
favor	fɐvoɾ
favoravelmente	fɐvuɾavɛɫmẽtɨ
favorecer	fɐvuɾɨseɾ
favorecido	fɐvuɾɨsiðu
faz	faʃ
fazem	fazɐ̃j̃
fazenda	fɐzẽdɐ
fazendo	fɐzẽdu
fazer	fɐzeɾ
fazes	fazɨʃ
fazia	fɐziɐ
faça	fasɐ
façanha	fɐsɐɲɐ
faço	fasu
faísca	fɐiʃkɐ
febre	fɛβɾɨ
fechada	fɨʃaðɐ
fechadas	fɨʃaðɐʃ
fechado	fɨʃaðu
fechados	fɨʃaðuʃ
fechadura	fɨʃɐðuɾɐ
fechar	fɨʃaɾ
fecho	fɐjʃu
fedelho	fɨðejʎu
fedelho	fɨðeʎu
fedelho	fɨðɐjʎu
fedelho	fɨðɐʎu
feder	fɨðeɾ
federal	fɨðɨɾaɫ
federação	fɨðɨɾɐsɐ̃w̃
fedor	fɨðoɾ
fedorento	fɨðuɾẽtu
feijoada	fejʒwaðɐ
feijoada	fɐjʒwaðɐ
feijão	fejʒɐ̃w̃
feijão	fɐjʒɐ̃w̃
feio	feju
feio	fɐju
feioso	fejozu
feira	fejɾɐ
feira	fɐjɾɐ
feita	fɐjtɐ
feitas	fɐjtɐʃ
feitio	fɐjtiu
feitiço	fejtisu
feitiço	fɐjtisu
feito	fɐjtu
feitos	fɐjtuʃ
feixe	fejʃɨ
feixe	fɐjʃɨ
feição	fejsɐ̃w̃
feição	fɐjsɐ̃w̃
felgueiras	fɛɫɡɐjɾɐʃ
felicidade	fɨlisiðaðɨ
felicidade	fɨlɨsiðaðɨ
felino	fɨlinu
feliz	fɨliʃ
felizmente	fɨliʒmẽtɨ
femicídio	femisidʒju
feminicídio	feminisidʒju
feminilidade	fɨminiliðaðɨ
feminilidade	fɨmɨniliðaðɨ
feminino	fɨmininu
feminino	fɨmɨninu
feminismo	fɨmɨniʒmu
fenestra	fɨnɛʃtɾɐ
feno	fenu
fera	fɛɾa
ferida	fɨɾidɐ
ferido	fɨɾiðu
ferir	fɨɾiɾ
fernandes	feɾnɐ̃dʒis
fernandes	fɨɾnɐ̃dɨʃ
ferradura	fɨʁɐðuɾɐ
ferramenta	fɛʁɐmẽtɐ
ferreira	fɨʁejɾɐ
ferreira	fɨʁɐjɾɐ
ferreiro	fɨʁɐjɾu
ferrenho	fɨʁɐjɲu
ferrenho	fɨʁɐɲu
ferro	fɛʁu
ferros	fɛʁuʃ
ferrugem	fɨʁuʒɐ̃j̃
ferrugem	fɨʁuʒẽj̃
fertilizante	fɛɾtilizɐ̃tɨ
ferver	fɨɾveɾ
fervor	fɨɾvoɾ
festa	fɛʃtɐ
feto	fɛtu
feudal	fewðaɫ
feudalismo	fewdalismo
feudalismo	fewdalismu
feudalismo	fewdaliʃmu
feudo	fewdu
fevereiro	fɨvɨɾejɾu
fevereiro	fɨvɨɾɐjɾu
fez	feʃ
fi	fi
fiambre	fjɐ̃bɾɨ
fiar	fjaɾ
fica	fikɐ
ficado	fikaðu
ficando	fikɐ̃du
ficar	fikaɾ
ficara	fikaɾɐ
ficaram	fikaɾɐ̃w̃
ficará	fikɐɾa
ficava	fikavɐ
ficha	fiʃɐ
fico	fiku
ficou	fikow
fictício	fiktisju
ficção	fiksɐ̃w̃
fidalgo	fiðaɫɣu
fidalgos	fiðaɫɣuʃ
fidúcia	fidusja
fiel	fjɛɫ
figo	fiɡu
figueira	fiɡejɾɐ
figueira	fiɡɐjɾɐ
figueiral	fiɡejɾal
figueiral	fiɡɐjɾal
figueiredo	fiɡejɾedu
figueiredo	fiɡɐjɾedu
figura	fiɣuɾɐ
fila	filɐ
filha	fiʎɐ
filho	fiʎu
filhos	fiʎuʃ
filhote	fiʎɔtɨ
filhó	fiʎɔ
filial	filjaɫ
filigrana	filiɣɾɐnɐ
filme	fiɫmɨ
filosofia	filuzufiɐ
filáucia	filawsjɐ
filão	filɐ̃w̃
filé	filɛ
filósofo	filɔzufu
filósofos	filɔzufuʃ
fim	fĩ
fina	finɐ
final	finaɫ
finalizar	finɐlizaɾ
finalização	finɐlizɐsɐ̃w̃
finalmente	finaɫmẽtɨ
finar	finaɾ
findar	fĩdaɾ
findo	fĩdu
fineza	finezɐ
fingimento	fĩʒimẽtu
fingir	fĩʒiɾ
finlândia	fĩlɐ̃diɐ
fino	finu
fins	fĩʃ
fio	fiu
fiquei	fikej
fiquei	fikɐj
firme	fiɾmɨ
firmemente	fiɾmɨmẽtɨ
firula	fiɾula
fisgada	fiʒɣaðɐ
fisionomia	fizjunumiɐ
fissurar	fisuɾaɾ
fita	fitɐ
fivela	fivɛlɐ
fixar	fiksaɾ
fixe	fiksɨ
fixo	fiksu
fiz	fiʃ
fizera	fizɛɾa
fizera	fizɛɾɐ
fizeram	fizɛɾɐ̃w̃
flagelo	flɐʒelu
flamengo	flɐmẽɡu
flamingo	flɐmĩɡu
flamífero	flamifeɾu
flamígero	flamiʒeɾu
flanco	flɐ̃ku
flanela	flɐnɛlɐ
flauta	flawta
flauta	flawtɐ
flecha	flɛʃɐ
flor	floɾ
flora	flɔɾɐ
flores	floɾɨʃ
floresta	fluɾɛʃtɐ
florete	fluɾetɨ
florir	fluɾiɾ
florista	fluɾiʃtɐ
flume	flumɨ
fluvial	fluvjaɫ
fluxo	fluksu
fluência	fluẽsja
flúmen	flumɐ̃j̃
flúmen	flumɛn
flúmen	flumẽj̃
fobia	fuβiɐ
foca	fɔkɐ
focinho	fusiɲu
foco	fɔku
foder	fudeɾ
fodão	fɔdɐ̃w̃
fodões	fɔdõj̃s
fodões	fɔdõj̃ʃ
fofo	fofu
fofoca	fɔfɔka
fofura	fofuɾa
fogal	fuɡaɫ
fogaréu	fuɣɐɾɛw
fogaça	foɡasa
fogo	foɣu
fogueira	fuɣɐjɾɐ
foguete	fuɣetɨ
fogão	fuɣɐ̃w̃
foi	foj
foice	fojsɨ
folha	foʎɐ
folhas	foʎɐʃ
folhear	fuʎjaɾ
folia	fuliɐ
fome	fɔmɨ
fona	fonɐ
fonema	funɛmɐ
fonte	fõtɨ
fonêmico	fonemiku
for	foɾ
fora	foɾɐ
fora	fɔɾɐ
foram	foɾɐ̃w̃
forasteiro	fuɾɐʃtɐjɾu
forja	fɔɾʒɐ
forma	foɾmɐ
forma	fɔɾmɐ
formado	fuɾmaðu
formador	fuɾmɐðoɾ
formal	fuɾmal
formar	fuɾmaɾ
formação	fuɾmɐsɐ̃w̃
formiga	fuɾmiɣɐ
formigueiro	fuɾmiɣɐjɾu
formosa	fuɾmɔza
formoso	fuɾmozu
fornalha	fuɾnaʎɐ
fornecimento	fuɾnɨsimẽtu
forno	foɾnu
foro	foɾu
forrado	fuʁaðu
forrar	fuʁaɾ
forro	foʁu
forro	fɔʁu
forró	fɔʁɔ
forte	fɔɾtɨ
fortemente	fɔɾtɨmẽtɨ
fortes	fɔɾtɨʃ
fortificação	fɔɾtifikɐsɐ̃w̃
fortuna	fuɾtunɐ
força	foɾsɐ
forçado	fuɾsaðu
forçar	fuɾsaɾ
forças	foɾsɐʃ
fosse	fosɨ
fosse	fɔsɨ
fossem	fosɐ̃j̃
foto	fɔtu
fotografia	futuɣɾɐfiɐ
fouce	fosɨ
fouce	fowsɨ
foz	fɔʃ
fraco	fɾaku
frade	fɾaðɨ
fraga	fɾaɣɐ
fragata	fɾɐɣatɐ
fragilidade	fɾɐʒiliðaðɨ
fragilidade	fɾɐʒɨliðaðɨ
fragrância	fɾɐɣɾɐ̃sjɐ
fralda	fɾaɫdɐ
francesa	fɾɐ̃sezɐ
franco	fɾɐ̃ku
frango	fɾɐ̃ɡu
frança	fɾɐ̃sɐ
frapê	fɾape
fraquejar	fɾɐkɨʒaɾ
fraqueza	fɾɐkezɐ
frasco	fɾaʃku
frase	fɾazɨ
fraseado	fɾɐzjadu
frases	fɾazɨʃ
fraternidade	fɾɐtɨɾniðaðɨ
fração	fɾasɐ̃w̃
freguesia	fɾɛɣɨziɐ
freguês	fɾɛɣeʃ
frei	fɾej
frei	fɾɐj
freira	fɾejɾɐ
freira	fɾɐjɾɐ
freire	fɾejɾɨ
freire	fɾɐjɾɨ
freixo	fɾɐjʃu
fremente	fɾemẽtʃi
frente	fɾẽtɨ
frequentar	fɾɨkwẽtaɾ
frequência	fɾɨkwẽsjɐ
fresco	fɾeʃku
frescura	fɾɨʃkuɾɐ
fresta	fɾɛʃtɐ
frete	fɾɛtʃi
fria	fɾiɐ
friagem	fɾiaʒẽj
frialdade	fɾiaɫðaðɨ
frincha	fɾĩʃɐ
frio	fɾiu
frio	fɾiw
friorento	fɾiuɾẽtu
frisa	fɾizɐ
friso	fɾizu
froixo	fɾojʃu
frol	fɾɔɫ
frontal	fɾõtaɫ
fronte	fɾõtɨ
fronteira	fɾõtɐjɾɐ
frouxidão	fɾowʃidɐ̃w̃
frouxo	fɾowʃu
frufru	fɾufɾu
fruiteira	fɾujtɐjɾɐ
fruição	fɾuisɐ̃w̃
fruição	fɾujsɐ̃w̃
fruta	fɾutɐ
fruteira	fɾutɐjɾɐ
fruto	fɾutu
frágil	fɾaʒiɫ
frágua	fɾaɣwɐ
frângão	fɾɐ̃ɣɐ̃w̃
fueguino	fwɨɣinu
fugido	fuʒiðu
fugindo	fuʒĩdu
fugir	fuʒiɾ
fugitivo	fuʒitivu
fugiu	fuʒiw
fui	fuj
fuinha	fwiɲɐ
fulano	fulɐnu
fulgurar	fuɫɡuɾaɾ
fulá	fula
fumando	fumɐ̃du
fumar	fumaɾ
fumo	fumu
fumoso	fumozu
fumígeno	fumiʒenu
funchal	fũʃaɫ
funcho	fũʃu
funcionar	fũsjunaɾ
funcionário	fũsjunaɾju
funda	fũdɐ
fundamentar	fũdamẽtaɾ
fundar	fũdaɾ
fundação	fũdɐsɐ̃w̃
fundir	fũdiɾ
fundição	fũdisɐ̃w̃
fundo	fũdu
fundão	fũdɐ̃w
funeral	funɨɾaɫ
fungar	fũɡaɾ
fungo	fũɡu
fungou	fũɡow
funil	funiɫ
funk	fɐ̃k
funk	fɐ̃kɨ
funks	fɐ̃kis
função	fũsɐ̃w̃
furibundo	fuɾibũdu
furiosamente	fuɾjɔzɐmẽtɨ
furioso	fuɾiozu
furioso	fuɾjozu
furo	fuɾu
furto	fuɾtu
furão	fuɾɐ̃w̃
fusa	fuzɐ
fusco	fuʃku
fustigar	fuʃtiɣaɾ
fusão	fuzɐ̃w̃
futicar	futʃikaɾ
futicar	futʃikaʁ
futrica	futɾika
futricada	futɾikada
futricagem	futɾikaʒi
futricagem	futɾikaʒɐ̃j̃
futricar	futɾikaɾ
futricar	futɾikaʁ
futriqueiro	futɾikejɾu
futucar	futukaɾ
futucar	futukaʁ
futuro	futuɾu
fuxicar	fuʃika
fuxicar	fuʃikaɾ
fuxico	fuʃiku
fá	fa
fábrica	faβɾikɐ
fábula	fabulɐ
fácil	fasiɫ
fã	fɐ̃
fé	fɛ
fémur	fɛmuɾ
féria	fɛɾjɐ
férias	fɛɾjɐʃ
fértil	fɛɾtiɫ
fêmea	femjɐ
fígado	fiɡɐdu
física	fizikɐ
físico	fiziku
fórmula	fɔɾmulɐ
fórum	fɔɾũ
fósforo	fɔʃfuɾu
fúria	fuɾjɐ
gabinete	ɡɐβinetɨ
gadanha	ɡɐðɐɲɐ
gado	ɡaðu
gafanhoto	ɡɐfɐɲotu
gaiatar	ɡajataɾ
gaiatice	ɡajatʃisi
gaiato	ɡajatu
gaio	ɡaju
gaiola	ɡajɔlɐ
gaitar	ɡajtaɾ
gaivota	ɡajvɔtɐ
gajeiro	ɡaʒejɾu
gajeiro	ɡaʒɐjɾu
gajo	ɡaʒu
galardão	ɡɐlɐɾðɐ̃w̃
galego	ɡɐleɣu
galera	ɡɐlɛɾɐ
galeria	ɡɐlɨɾiɐ
galgo	ɡaɫɣu
galho	ɡaʎu
galilé	ɡɐlilɛ
galinha	ɡɐliɲɐ
galinheiro	ɡɐliɲejɾu
galinheiro	ɡɐliɲɐjɾu
galiza	ɡɐlizɐ
galo	ɡalu
galopeado	ɡalopiadu
galáxia	ɡɐlaksiɐ
galáxia	ɡɐlaksjɐ
galé	ɡɐlɛ
gamar	ɡɐmaɾ
gamba	ɡɐ̃bɐ
gamo	ɡɐmu
gancho	ɡɐ̃ʃu
ganhador	ɡɐɲɐðoɾ
ganhar	ɡɐɲaɾ
ganho	ɡaɲu
ganho	ɡɐɲu
ganhão	ɡɐɲɐ̃w̃
ganso	ɡɐ̃su
garantir	ɡɐɾɐ̃tiɾ
garbo	ɡaɾβu
garfo	ɡaɾfu
garganta	ɡɐɾɣɐ̃tɐ
gari	ɡaɾi
garoto	ɡɐɾotu
garrafa	ɡɐʁafɐ
garrancho	ɡarɐ̃ʃu
garrano	ɡɐʁɐnu
garrido	ɡɐʁidu
garrir	ɡɐʁiɾ
garça	ɡaɾsɐ
gasolina	ɡɐzulinɐ
gata	ɡatɐ
gatilho	ɡatiʎw
gato	ɡatu
gaveta	ɡɐvetɐ
gavião	ɡɐviɐ̃w
gavião	ɡɐvjɐ̃w
gazua	ɡazua
gaúcho	ɡɐuʃu
geada	ʒjaðɐ
geado	ʒjaðu
geladaria	ʒɨlɐðɐɾiɐ
geladinho	ʒeladʒiɲu
gelado	ʒɨlaðu
gelar	ʒɨlaɾ
geleia	ʒɨlɐjɐ
gelinho	ʒeliɲu
gelo	ʒelu
gelo	ʒɛlu
gelosia	ʒɨluziɐ
gema	ʒemɐ
gemer	ʒɨmeɾ
gemido	ʒɨmiðu
general	ʒɨnɨɾaɫ
generalidade	ʒɨnɨɾɐliðaðɨ
generosidade	ʒɨnɨɾuziðaðɨ
generoso	ʒɨnɨɾozu
genioso	ʒeniozu
genro	ʒẽʁu
gente	ʒẽtɨ
gentil	ʒẽtɨɫ
gentileza	ʒẽtʃilezɐ
gentílico	ʒẽtʃiliku
geocêntrico	ʒeosẽtɾiku
geracional	ʒɨɾɐsjunaɫ
gerador	ʒɨɾɐðoɾ
geral	ʒɨɾaɫ
gerar	ʒɨɾaɾ
geração	ʒɨɾɐsɐ̃w̃
geringonça	ʒɨɾĩɡõsɐ
gesso	ʒesu
gesto	ʒɛʃtu
gestão	ʒɨʃtɐ̃w̃
geórgia	ʒjɔɾʒjɐ
gibi	ʒibi
gibraltar	ʒiβɾaɫtaɾ
gibão	ʒiβɐ̃w̃
giga	ʒiɣɐ
gigabit	ʒiɡabiti
gigabyte	ʒiɡabajtʃi
gigote	ʒiɡɔtʃi
gigó	ʒiɡɔ
gigô	ʒiɡo
gilete	ʒilɛtʃi
gim	ʒĩ
gineta	ʒinetɐ
ginga	ʒĩɡɐ
ginásio	ʒinazju
ginástica	ʒinaʃtikɐ
giovana	ʒiovɐna
girafa	ʒiɾafɐ
girassol	ʒiɾɐsɔɫ
girassóis	ʒiɾɐsɔjʃ
giro	ʒiru
giz	ʒis
giz	ʒiʃ
glande	ɡlɐ̃dɨ
glauco	ɡlawku
gleba	ɡlɛba
globo	ɡloβu
glorificação	ɡloɾifikasɐ̃w̃
glorioso	ɡluɾjozu
glosar	ɡluzaɾ
glossário	ɡlusaɾju
gládio	ɡlaðju
glúten	ɡlutɛn
gnomo	ɡnomu
goa	ɡoɐ
godo	ɡodu
goi	ɡɔj
goivo	ɡojvu
gola	ɡɔlɐ
golegã	ɡulɨɣɐ̃
golfinho	ɡoɫfiɲu
golo	ɡolu
golo	ɡɔlu
golpe	ɡɔɫpɨ
golpelha	ɡoɫpejʎɐ
golpelha	ɡoɫpɐjʎɐ
gomes	ɡomɨʃ
gomo	ɡomu
gondomar	ɡõdumaɾ
google	ɡuɡow
google	ɡuɡoɫ
gorda	ɡoɾðɐ
gordo	ɡoɾðu
gordura	ɡuɾðuɾɐ
gorila	ɡuɾilɐ
gorovinha	ɡoɾɔviɲa
gostar	ɡuʃtaɾ
gostava	ɡuʃtavɐ
gota	ɡotɐ
gota	ɡɔtɐ
goteira	ɡotejɾa
gouveia	ɡowvɐjɐ
governador	ɡuvɨɾnɐðoɾ
governar	ɡuvɨɾnaɾ
governo	ɡuveɾnu
gozando	ɡuzɐ̃du
gozar	ɡuzaɾ
gozo	ɡozu
gozo	ɡɔzu
graal	ɡɾaal
gracejar	ɡɾɐsɨʒaɾ
gracioso	ɡɾɐsjozu
grade	ɡɾaðɨ
grado	ɡɾaðu
gradualmente	ɡɾɐdwaɫmẽtɨ
graduação	ɡɾɐðwɐsɐ̃w̃
grafiteiro	ɡɾɐfitɐjɾu
grafo	ɡɾafu
grafíti	ɡɾafiti
grama	ɡɾɐ̃mɐ
gramatical	ɡramatʃikaw
grampo	ɡɾɐ̃pu
grana	ɡrɐnɐ
granada	ɡɾɐnaðɐ
grande	ɡɾɐ̃d
grande	ɡɾɐ̃dɨ
grandes	ɡɾɐ̃dɨʃ
granito	ɡɾɐnitu
granja	ɡɾɐ̃ʒɐ
gratinar	ɡɾɐtinaɾ
gratuito	ɡɾatuitu
gratuito	ɡɾatujtu
grau	ɡɾaw
gravata	ɡɾɐvatɐ
grave	ɡɾavɨ
gravidade	ɡɾɐviðaðɨ
gravura	ɡɾɐvuɾɐ
graxa	ɡɾaʃa
graxo	ɡɾaʃu
graça	ɡɾasɐ
graças	ɡɾasɐʃ
grego	ɡɾeɣu
grei	ɡrej
grei	ɡrɛj
grelo	ɡɾelu
grenha	ɡɾeɲɐ
grife	ɡɾifi
grifo	ɡɾifu
grilo	ɡɾilu
grinalda	ɡɾinaɫðɐ
gris	ɡɾiʃ
grisalho	ɡɾizaʎu
grisu	ɡɾizu
gritando	ɡɾitɐ̃du
gritar	ɡɾitaɾ
grito	ɡɾitu
gritos	ɡɾituʃ
gritou	ɡɾitow
groselha	ɡɾɔzejʎɐ
groselha	ɡɾɔzɐjʎɐ
grosseiro	ɡɾusejɾu
grosseiro	ɡɾusɐjɾu
grosso	ɡɾosu
grupo	ɡɾupu
gruta	ɡɾutɐ
grândola	ɡɾɐ̃dulɐ
grânulo	ɡɾɐnulu
grão	ɡɾɐ̃w̃
grécia	ɡɾɛsiɐ
grémio	ɡɾɛmju
guadiana	ɡwɐdjɐnɐ
guai	ɡwaj
guapo	ɡwapu
guarda	ɡwaɾdɐ
guardado	ɡwɐɾðaðu
guardanapo	ɡwɐɾðɐnapu
guardar	ɡwɐɾðaɾ
guarida	ɡwaɾida
guarita	ɡwaɾita
guarnecer	ɡwɐɾnɨseɾ
guarujá	ɡwaɾuʒa
guarulhense	ɡwaɾuʎẽsi
guarulhos	ɡwaɾuʎus
gude	ɡudʒi
guepardo	ɡɨpaɾðu
guerra	ɡɛʁɐ
guia	ɡiɐ
guiar	ɡiaɾ
guiar	ɡjaɾ
guilherme	ɡiʎɛɾmɨ
guinéu	ɡinɛw
guisa	ɡizɐ
guita	ɡitɐ
guitarra	ɡitaʁɐ
guizo	ɡizu
guião	ɡjɐ̃w̃
gulodice	ɡulodʒisi
gulosice	ɡulozisi
gunda	ɡũdɐ
guri	ɡuɾi
guru	ɡuɾu
guê	ɡe
gás	ɡaʃ
gástrico	ɡaʃtɾiku
gávea	ɡavjɐ
géis	ʒɛjʃ
género	ʒɛnɨɾu
génio	ʒɛnju
gê	ʒe
góes	ɡɔjʃ
gói	ɡɔj
góis	ɡɔjʃ
gótico	ɡɔtiku
gôndola	ɡõdulɐ
h	ɐɣa
habilidade	abiliðaðɨ
habitante	ɐbitɐ̃tɨ
habitar	ɐβitaɾ
habitação	ɐβitɐsɐ̃w̃
haia	ajɐ
haja	aʒɐ
hamburger	ɐ̃burɡer
hangul	ɐ̃ɡul
harmonia	ɐɾmuniɐ
harmonioso	ɐɾmunjozu
harmonizar	ɐɾmunizaɾ
harpa	aɾpɐ
hasta	aʃtɐ
haste	aʃtɨ
hater	ʁejteɾ
havai	avaj
havendo	ɐvẽdu
haver	ɐveɾ
haveria	ɐvɨɾiɐ
haverá	ɐvɨɾa
havia	ɐviɐ
hebreia	iβɾejɐ
hebreia	iβɾɐjɐ
hebreu	iβɾew
hei	ej
hein	ẽj̃
heleno	ilɛnu
heliocêntrico	ɛljosẽtɾiku
henrique	ẽʁikɨ
henriques	ẽʁikɨʃ
heptágono	ɛptaɣunu
herança	eɾɐ̃sɐ
herança	iɾɐ̃sɐ
herdar	eɾdaɾ
herdar	eɾðaɾ
herdeiro	eɾðejɾu
herdeiro	eɾðɐjɾu
herdeiro	iɾðejɾu
herdeiro	iɾðɐjɾu
heráldico	eɾaɫdiku
heráldico	ɛɾaɫdiku
herói	eɾɔj
herói	iɾɔj
heterossexual	ɛteɾuseksuaɫ
hexa	ɛksa
hexágono	ɛzaɣunu
hibernal	iβɨɾnaɫ
hibernar	iβɨɾnaɾ
hidrelétrico	idɾelɛtɾiku
hidroelétrico	idɾoelɛtɾiku
hidrografia	idɾoɡɾafia
hidrogénio	idɾɔʒɛniu
hiena	jenɐ
higiene	iʒjɛnɨ
higienização	iʒienizasɐ̃w̃
hindu	ĩdu
hino	inu
hipogrifo	ipɔɣɾifu
hipopótamo	ipɔpɔtɐmu
hipódromo	ipɔðɾumu
hirto	iɾtu
historicamente	iʃtɔɾikɐmẽtɨ
história	iʃtɔɾjɐ
histórias	iʃtɔɾjɐʃ
histórico	iʃtɔɾiku
hodiernamente	odʒieɾnamẽtʃi
hoje	oʒɨ
holanda	ɔlɐ̃dɐ
holandês	ɔlɐ̃deʃ
holofote	ɔlɔfɔtɨ
homem	ɔmẽj̃
homenagem	ɔmɨnaʒɐ̃j̃
homenagem	ɔmɨnaʒẽj̃
homologação	omoloɡasɐ̃w̃
homossexual	omoseksuaɫ
honestidade	unɛʃtiðaðɨ
honesto	onɛʃtu
honesto	unɛʃtu
honesto	ɔnɛʃtu
honra	õʁɐ
honrado	õʁaðu
honroso	õʁozu
hora	ɔɾɐ
horas	ɔɾɐʃ
horizonte	ɔɾizõtɨ
horror	ɔʁoɾ
horrível	ɔʁivɛɫ
horta	ɔɾtɐ
hortelã	ɔɾtɨlɐ̃
hortelão	ɔɾtɨlɐ̃w̃
horário	oɾaɾju
horário	uɾaɾju
horário	ɔɾaɾju
hospedagem	ɔʃpɨðaʒɐ̃j̃
hospital	ɔʃpitaɫ
hospitalar	ɔʃpitɐlaɾ
hospitaleiro	ɔʃpitɐlɐjɾu
hospitalidade	ɔʃpitɐliðaðɨ
hospitalizar	ɔʃpitɐlizaɾ
hospício	ɔʃpisju
hoste	ɔʃtɨ
hostil	uʃtiɫ
hotel	ɔtɛɫ
houve	owvɨ
houvesse	owvɛsɨ
hulha	uʎɐ
humana	umanɐ
humanidade	umɐniðaðɨ
humano	umɐnu
humidade	umiðaðɨ
humildade	umiɫðaðɨ
humilde	umiɫdɨ
humilhação	umiʎɐsɐ̃w̃
humo	umu
humor	umoɾ
hungria	ũɡɾiɐ
há	a
hábito	aβitu
hécate	ɛkɐtɨ
hétero	ɛteɾu
hóplon	ɔplõ
hóstia	ɔʃtjɐ
húmido	umiðu
húmus	umuʃ
ia	iɐ
iam	iɐ̃w̃
iate	jatɨ
iberismo	iβɨɾiʒmu
ibéria	iβɛɾjɐ
ibérico	iβɛɾiku
icônico	ikoniku
ida	iðɐ
idade	iðaðɨ
ideal	iðjaɫ
ideia	iðejɐ
ideia	iðɐjɐ
ideias	iðɐjɐʃ
identidade	idẽtiðaðɨ
ideologia	iðjuluʒiɐ
idioma	iðjomɐ
idiossincrasia	iðjɔsĩkɾɐziɐ
ido	iðu
idolatrar	iðulɐtɾaɾ
idoso	iðozu
idílio	iðilju
idóneo	idonju
idôneo	idonju
ignaro	iɡnaɾu
ignóbil	iɡnɔβiɫ
igreja	iɣɾejʒɐ
igreja	iɣɾeʒɐ
igreja	iɣɾɐjʒɐ
igreja	iɣɾɐʒɐ
igrejas	iɡɾɐjʒɐʃ
igual	iɣwaɫ
igualdade	iɣwaɫdaðɨ
igualha	iɣwaʎɐ
igualmente	iɣwaɫmẽtɨ
ilegal	ilɨɣaɫ
ilegível	ilɨʒivɛɫ
ilha	iʎɐ
ilharga	iʎaɾɣɐ
ilibado	ilibadu
iludir	iluðiɾ
iluminar	iluminaɾ
iluminação	iluminɐsɐ̃w̃
ilusionista	iluzjuniʃtɐ
ilustrado	iluʃtɾaðu
ilustrar	iluʃtɾaɾ
ilustração	iluʃtɾɐsɐ̃w̃
ilusão	iluzɐ̃w̃
imagem	imaʒɐ̃j̃
imaginar	imɐʒinaɾ
imaginação	imɐʒinɐsɐ̃w̃
imaginário	imɐʒinaɾiu
imaginário	imɐʒinaɾju
imanente	imanẽtʃi
imanência	imanẽsja
imaterial	imɐtɨɾjaɫ
imbecil	ĩbɨsiɫ
imediatamente	imɨðjatɐmẽtɨ
imenso	imẽsu
imigrante	imiɣɾɐ̃tɨ
imigração	imiɣɾɐsɐ̃w̃
imitar	imitaɾ
imortal	imuɾtaɫ
impaciente	ĩpɐsjẽtɨ
impacto	ĩpaktu
impedimento	ĩpɨðimẽtu
impedir	ĩpɨðiɾ
impenetrável	ĩpɨnɨtɾavɛɫ
impera	ĩpɛɾa
imperador	ĩpɨɾɐðoɾ
imperecibilidade	ĩperesibilidadʒi
imperial	ĩpɨɾjaɫ
imperialmente	ĩpɨɾjaɫmẽtɨ
impertinente	ĩpɨɾtɨnẽtɨ
impessoal	ĩmpswal
impessoalidade	ĩpesualidadʒi
impingir	ĩpĩʒiɾ
implementar	ĩplɨmẽtaɾ
impoluto	ĩpolutu
impopular	ĩpupulaɾ
impopularidade	ĩpupulɐɾiðaðɨ
impor	ĩpoɾ
importante	ĩpuɾtɐ̃tɨ
importar	ĩpuɾtaɾ
importância	ĩpuɾtɐ̃sjɐ
impossibilidade	ĩpusiβiliðaðɨ
impossibilitar	ĩpusiβilitaɾ
impossível	ĩpusivɛɫ
imposto	ĩpoʃtu
impraticabilidade	ĩpratʃikabilidadʒi
impraticável	ĩpratʃikavew
imprensa	ĩpɾẽsɐ
imprescritível	ĩpɾeskritʃivew
impressionado	ĩpɾɨsjunaðu
impressionante	ĩpɾɨsjunɐ̃tɨ
impressionar	ĩpɾɨsjunaɾ
impressora	ĩpɾɨsoɾɐ
impressão	ĩpɾɨsɐ̃w̃
imprevisto	ĩpɾɨviʃtu
imprimir	ĩpɾimiɾ
improvável	ĩpɾuvavɛɫ
impulsionar	ĩpuɫsjunaɾ
impulsivamente	ĩpuɫsivɐmẽtɨ
impuro	ĩpuɾu
império	ĩpɛɾju
imundo	imũdu
imóvel	imɔvɛɫ
inacabado	inɐkɐβaðu
incapacidade	ĩkɐpasiðaðɨ
incapacitar	ĩkɐpasitaɾ
incapaz	ĩkɐpaʃ
incendiar	ĩsẽdjaɾ
incendiário	ĩsẽdjaɾju
incensar	ĩsẽsaɾ
incenso	ĩsẽsu
incentivar	ĩsẽtivaɾ
incerteza	ĩsɨɾtezɐ
incerto	ĩsɛɾtu
incisão	ĩsizɐ̃w̃
incitador	ĩsitɐðoɾ
inclinado	ĩklinaðu
inclinar	ĩklinaɾ
inclinação	ĩklinɐsɐ̃w̃
incluso	ĩkluzu
incolumidade	ĩkolumidadʒi
incomparável	ĩkõpɐɾaveɫ
inconstante	ĩkõʃtɐ̃tɨ
inconveniente	ĩkõvɨnjẽtɨ
incorretamente	ĩkuʁɛtɐmẽtɨ
incorreto	ĩkuʁɛtu
incrementar	ĩkremẽtaɾ
incrível	ĩkɾivɛɫ
incumprimento	ĩkũpɾimẽtu
incêndio	ĩsẽdiu
incêndio	ĩsẽdju
incómodo	ĩkɔmuðu
indecente	ĩdɨsẽtɨ
indemne	ĩdẽnɨ
indicador	ĩdikɐðoɾ
indicar	ĩdikaɾ
indiferente	ĩdifɨɾẽtɨ
indiferença	ĩdifɨɾẽsɐ
indispensável	ĩdiʃpẽsavɛɫ
indissociável	ĩdʒisosiavew
indivíduo	ĩdividuu
indivíduo	ĩdividwu
indo	ĩdu
indolente	ĩdulẽtɨ
industrial	ĩduʃtɾjaɫ
indústria	ĩduʃtɾjɐ
inepto	inɛptu
inerência	ineɾẽsja
inexequibilidade	inezekwibilidadʒi
inexequível	inezekwivew
inexistir	ineziʃtiɾ
infame	ĩfamɨ
infantaria	ĩfɐ̃tɐɾiɐ
infante	ĩfɐ̃tɨ
infelizmente	ĩfɨliʒmẽtɨ
inferior	ĩfɨɾjoɾ
inferno	ĩfɛɾnu
infeção	ĩfɛsɐ̃w̃
infiltração	ĩfiltɾɐsɐ̃w̃
infindo	ĩfĩdu
infinito	ĩfinitu
inflamatório	ĩflɐmɐtɔɾju
inflamação	ĩflɐmɐsɐ̃w̃
inflamável	ĩflɐmavɛɫ
inflexível	ĩflɛksivɛɫ
influência	ĩflwẽsjɐ
informação	ĩfuɾmɐsɐ̃w̃
informações	ĩfuɾmɐsõj̃ʃ
infrassom	ĩfɾɐsõ
infrassónico	ĩfɾɐsɔniku
infâmia	ĩfɐmjɐ
ingerência	ĩʒeɾẽsja
inglaterra	ĩɡlɐtɛʁɐ
inglês	ĩɡleʃ
ingratidão	ĩɡɾɐtiðɐ̃w̃
inhapa	iɲapɐ
inicial	inisjaɫ
inicialmente	inisjaɫmẽtɨ
inimigo	inimiɣu
inimizade	inimizaðɨ
iniquidade	inikwidadʒi
injete	ĩʒɛtʃi
injeção	ĩʒɛsɐ̃w̃
injúria	ĩʒuɾjɐ
inocente	inusẽtɨ
inocência	inusẽsjɐ
inovar	inuvaɾ
inovação	inuvɐsɐ̃w̃
inquisição	ĩkizisɐ̃w̃
insalubre	ĩsɐluβɾɨ
insano	ĩsɐnu
inscrição	ĩʃkɾisɐ̃w̃
insensato	ĩsẽsatu
insensibilidade	ĩsẽsiβɨliðaðɨ
insensivelmente	ĩsẽsivɛɫmẽtɨ
inseticida	ĩsɛtisiðɐ
inseto	ĩsɛtu
insistir	ĩsiʃtiɾ
insolvente	ĩsɔlvẽtɨ
inspirado	ĩʃpiɾaðu
inspirar	ĩspiɾar
inspirar	ĩʃpiɾaɾ
inspiração	ĩʃpiɾɐsɐ̃w̃
instalado	ĩʃtɐlaðu
instalar	ĩʃtɐlaɾ
instalação	ĩʃtɐlɐsɐ̃w̃
instante	ĩʃtɐ̃tɨ
instigador	ĩʃtiɣɐdoɾ
instruir	ĩʃtɾuiɾ
instrumento	ĩʃtɾumẽtu
instrutor	ĩʃtɾutoɾ
instrução	ĩʃtɾusɐ̃w̃
instância	ĩʃtɐ̃sjɐ
insubordinação	ĩsuboɾdʒinasɐ̃w̃
insuficiente	ĩsufisjẽtɨ
insulina	ĩsulinɐ
insumo	ĩsumu
insuportável	ĩsupuɾtavɛɫ
insurreição	ĩsuʁɐjsɐ̃w̃
insuscetível	ĩsusetʃivew
insígnia	ĩsiɣnjɐ
insónia	ĩsɔnjɐ
intacto	ĩtaktu
inteiramente	ĩtejɾɐmẽtɨ
inteiramente	ĩtɐjɾɐmẽtɨ
inteiro	ĩtɐjɾu
intelectual	ĩtɨlɛktwaɫ
inteligente	ĩtɨliʒẽtɨ
inteligência	ĩtɨliʒẽsjɐ
intencionalmente	ĩtẽsjunaɫmẽtɨ
intensamente	ĩtẽsɐmẽtɨ
intenso	ĩtẽsu
intento	ĩtẽtu
intenção	ĩtẽsɐ̃w̃
intercessor	ĩtɨɾsesoɾ
intercorrência	ĩteɾkoʁẽsja
interessante	ĩtɨɾɨsɐ̃tɨ
interessar	ĩtɨɾɨsaɾ
interesse	ĩtɨɾesɨ
interesseiro	ĩteɾesejɾu
interferência	ĩtɨɾfɨɾẽsjɐ
interior	ĩtɨɾioɾ
interiorano	ĩteɾjoɾɐnu
internacional	ĩtɨɾnɐsjunaɫ
internalização	ĩteɾnalizasɐ̃w̃
internauta	ĩtɛɾnawtɐ
internação	ĩteɾnasɐ̃w̃
internet	ĩtɛɾnɛt
interrobang	ĩtɛʁubɐ̃ɡɨ
intimidade	ĩtimiðaðɨ
introdução	ĩtɾudusɐ̃w̃
introjetar	ĩtɾoʒetaɾ
introjeção	ĩtɾoʒesɐ̃w̃
intromete	ĩtɾomɛtʃi
intuição	ĩtuisɐ̃w̃
intuição	ĩtwisɐ̃w̃
invadir	ĩvaðiɾ
invariavelmente	ĩvɐɾjavɛɫmẽtɨ
invasão	ĩvazɐ̃w̃
invencível	ĩvẽsivɛɫ
inventar	ĩvẽtaɾ
invenção	ĩvẽsɐ̃w̃
inverno	ĩvɛɾnu
investigador	ĩvɨʃtiɣaðoɾ
investigar	ĩvɨʃtiɣaɾ
investigação	ĩvɨʃtiɣɐsɐ̃w̃
inviabilidade	ĩviabilidadʒi
invicto	ĩviktu
invisível	ĩvizivɛɫ
invocar	ĩvukaɾ
invólucro	ĩvɔlukɾu
início	inisju
iníquo	inikwu
inútil	inutiɫ
ioga	jɔɣɐ
iogurte	jɔɣuɾtɨ
ionosfera	jonojʃfɛɾa
ionosfera	jonosfɛɾa
ipê	ipe
ir	iɾ
ira	iɾɐ
iria	iɾiɐ
irlanda	iɾlɐ̃dɐ
irlandês	iɾlɐ̃deʃ
irmandade	iɾmɐ̃daðɨ
irmã	iɾmɐ̃
irmão	iɾmɐ̃w̃
irmãos	iɾmɐ̃w̃ʃ
ironicamente	iɾɔnikɐmẽtɨ
irracional	iʁɐsjunal
irracionalidade	iʁɐsjunaliðaðɨ
irrepreensível	iʁepɾeẽsivew
irresponsabilidade	iʁɨʃpõsɐβiliðaðɨ
irrupção	iʁupsɐ̃w̃
irá	iɾa
isentar	izẽtaɾ
isento	izẽtu
isenção	izẽsɐ̃w̃
islândia	iʒlɐ̃diɐ
isolação	izulɐsɐ̃w̃
isopor	izopoɾ
isopor	izopoʁ
isqueiro	iʃkɐjɾu
israel	iʒʁɐɛɫ
isso	isu
istambul	iʃtɐ̃buɫ
istmo	iʃtmu
isto	iʃtu
itamaraty	itamaɾatʃi
item	itɐ̃j̃
item	itɛm
itera	itɛra
iterar	iteɾaɾ
itália	italjɐ
iá	ja
içado	isaðu
içar	isaɾ
iço	isu
j	ʒɔta
jaborandi	ʒɐβuɾɐ̃di
jacarandá	ʒɐkɐɾɐ̃da
jacaré	ʒɐkɐɾɛ
jacinto	ʒɐsĩtu
jacto	ʒaktu
jaez	ʒɐeʃ
jaleco	ʒɐlɛku
jamais	ʒamajʃ
janeiras	ʒɐnejɾɐʃ
janeiras	ʒɐnɐjɾɐʃ
janeireiro	ʒɐnejɾejɾu
janeireiro	ʒɐnɐjɾɐjɾu
janeirento	ʒɐnejɾẽtu
janeirento	ʒɐnɐjɾẽtu
janeiro	ʒɐnejɾu
janeiro	ʒɐnɐjɾu
janela	ʒɐnɛlɐ
janelamento	ʒɐnɨlɐmẽtu
janelar	ʒɐnɨlaɾ
janelas	ʒɐnɛlɐʃ
janeleiro	ʒɐnɨlejɾu
janeleiro	ʒɐnɨlɐjɾu
janelinha	ʒɐnɨliɲɐ
janelo	ʒɐnelu
janelão	ʒɐnɨlɐ̃w̃
jangada	ʒɐ̃ɡaðɐ
jano	ʒɐnu
janota	ʒɐnɔtɐ
janotar	ʒanotaɾ
jantar	ʒɐ̃taɾ
japa	ʒapɐ
japonesa	ʒɐpunezɐ
japonês	ʒɐpuneʃ
japão	ʒɐpɐ̃w̃
jaqueta	ʒɐketɐ
jardim	ʒɐɾðĩ
jardinagem	ʒɐɾðinaʒɐ̃j̃
jardinar	ʒɐɾðinaɾ
jardineiro	ʒɐɾðinɐjɾu
jargão	ʒɐɾɣɐ̃w̃
jasmim	ʒɐʒmĩ
jaspe	ʒaʃpɨ
jato	ʒatu
javali	ʒɐvɐli
jeito	ʒɐjtu
jejuar	ʒɨʒwaɾ
jejum	ʒɨʒũ
jesus	ʒɨzuʃ
joalharia	ʒwɐʎɐɾiɐ
joalheiro	ʒwɐʎɐjɾu
joaninha	ʒwɐniɲɐ
joaquim	ʒwakĩ
job	dʒɔbi
joelho	ʒwɐjʎu
joelho	ʒwɐʎu
joelhos	ʒwɐjʎuʃ
jogador	ʒuɣɐðoɾ
jogar	ʒuɣaɾ
jogo	ʒoɡu
jogo	ʒɔɡu
jogral	ʒuɣɾaɫ
joguetar	ʒoɡetaɾ
joguete	ʒoɡɛtʃi
joia	ʒɔjɐ
joio	ʒoju
jorge	ʒɔɾʒɨ
jornada	ʒoʁnadɐ
jornais	ʒuɾnajʃ
jornal	ʒuɾnaɫ
jornaleiro	ʒuɾnɐlejɾu
jornaleiro	ʒuɾnɐlɐjɾu
jornalismo	ʒuɾnɐliʒmu
jornalista	ʒuɾnɐliʃtɐ
jornalístico	ʒuɾnɐliʃtiku
jota	ʒɔtɐ
jovem	ʒɔvɐ̃j̃
jovem	ʒɔvẽj̃
joão	ʒwɐ̃w̃
juba	ʒuβɐ
judaico	ʒudajku
judaísmo	ʒuðɐiʃmu
judeu	ʒudew
judicial	ʒuðisjaɫ
jugo	ʒuɣu
juiz	ʒuiʃ
juizado	ʒuizadu
juju	ʒuʒu
julgamento	ʒuɫɣɐmẽtu
julgar	ʒuɫɣaɾ
julho	ʒuʎu
juliet	ʒuliɛtʃi
jumento	ʒumẽtu
junho	ʒuɲu
junta	ʒũtɐ
juntar	ʒũtaɾ
juntas	ʒũtɐʃ
junto	ʒũtu
juntos	ʒũtuʃ
junção	ʒũsɐ̃w̃
jura	ʒuɾa
juramento	ʒuɾɐmẽtu
juro	ʒuɾu
justamente	ʒuʃtɐmẽtɨ
justeza	ʒuʃtezɐ
justiça	ʒuʃtisɐ
justo	ʒuʃtu
juventude	ʒuvẽtuðɨ
juízo	ʒwizu
já	ʒa
jóquer	ʒɔkɛɾ
júnior	ʒunjɔɾ
júpiter	ʒupitɛɾ
k	kapa
k	kapɐ
kamikaze	kamikazɨ
karaoke	kaɾaɔkɨ
kawaii	kɐwɐji
kilimanjaro	kilimɐ̃ʒaɾu
kilobit	kilobiti
kilobyte	kilobajtʃi
kombi	kombi
kombi	kõbi
kuduro	kuduru
kyat	kjatɨ
la	lɐ
labareda	labaɾeda
laboratório	lɐβuɾɐtɔɾju
lacera	lasɛɾa
lacrau	lɐkɾaw
lacração	lakɾasɐ̃w̃
ladainha	lɐðɐiɲɐ
ladeira	lɐðejɾɐ
ladeira	lɐðɐjɾɐ
lado	laðu
lados	laðuʃ
ladrar	lɐðɾaɾ
ladrão	lɐðɾɐ̃w̃
lagar	lɐɣaɾ
lagarta	lɐɣaɾtɐ
lagartixa	lɐɣɐɾtiʃɐ
lagarto	lɐɣaɾtu
lago	laɣu
lagoa	lɐɣoɐ
lagos	laɣuʃ
laico	lajku
lama	lɐmɐ
lamego	lɐmeɣu
lameira	lamejɾɐ
lameiro	lamejɾu
lamento	lɐmẽtu
lamparina	lɐ̃pɐɾinɐ
lampejo	lɐ̃peʒu
lampejo	lɐ̃pɛʒu
lampião	lɐ̃piɐ̃w̃
lampião	lɐ̃pjɐ̃w̃
lamúria	lamuɾja
lancha	lɐ̃ʃɐ
lanchar	lɐ̃ʃar
lanche	lɐ̃ʃɨ
lande	lɐ̃ðɨ
lanterna	lɐ̃tɛɾnɐ
lança	lɐ̃sɐ
lançando	lɐ̃sɐ̃du
lançar	lɐ̃saɾ
lanço	lɐ̃su
lançou	lɐ̃sow
lapa	lapɐ
lapidar	lɐpiðaɾ
laquê	lake
lar	laɾ
laranja	lɐɾɐ̃ʒɐ
lareira	lɐɾɐjɾɐ
larga	laɾɣɐ
largamente	laɾɣɐmẽtɨ
largar	lɐɾɣaɾ
largas	laɾɣɐʃ
largo	laɾɡu
largos	laɾɣuʃ
largura	lɐɾɣuɾɐ
larica	lɐɾikɐ
las	lɐʃ
lasso	lasu
lata	latɐ
latim	lɐtĩ
latinar	lɐtinaɾ
lato	latu
latão	lɐtɐ̃w̃
lava	lavɐ
lavagem	lɐvaʒɐ̃j̃
lavanda	lɐvɐ̃dɐ
lavar	lɐvaɾ
lavrar	lɐvɾaɾ
lazer	lɐzeɾ
laçar	lɐsaɾ
laço	lasu
lealdade	ljaɫdaðɨ
lebre	lɛβɾɨ
lecionar	lesjonaɾ
ledice	lɨðisɨ
lediça	lɨðisɐ
ledo	leðu
legal	lɨɣaɫ
legenda	leʒẽda
legislar	lɨʒiʒlaɾ
legislativo	lɨʒiʒlɐtivu
legislação	lɨʒiʒlɐsɐ̃w̃
legítimo	lɨʒitimu
lei	lej
lei	lɐj
leigo	lejɡu
leilão	lejlɐ̃w̃
leilão	lɐjlɐ̃w̃
leira	lejɾɐ
leira	lɐjɾɐ
leite	lɐjtɨ
leito	lejtu
leito	lɐjtu
leitor	lɐjtoɾ
leituga	lejtuɣɐ
leituga	lɐjtuɣɐ
leitura	lɐjtuɾɐ
leitão	lejtɐ̃w̃
leitão	lɐjtɐ̃w̃
lembrança	lẽbɾɐ̃sɐ
lembrar	lẽbɾaɾ
lembrava	lẽbɾavɐ
lembrou	lẽbɾow
lenda	lẽdɐ
lendo	lẽdu
lene	lenɨ
lengalenga	lẽɡɐlẽɡɐ
lenha	lejɲɐ
lenha	leɲɐ
lenha	lɐjɲɐ
lenha	lɐɲɐ
leniência	leniẽsja
lenta	lẽtɐ
lentamente	lẽtɐmẽtɨ
lento	lẽtu
lentos	lẽtuʃ
lenço	lẽsu
lençol	lẽsɔɫ
lepra	lɛpɾɐ
leque	lɛkɨ
ler	leɾ
leste	leʃtɨ
leste	lɛʃtɨ
lesto	lɛʃtu
letra	letɾɐ
letras	letɾɐʃ
letónia	lɨtɔnjɐ
leu	lew
leva	lɛvɐ
levado	lɨvaðu
levando	lɨvɐ̃du
levantando	lɨvɐ̃tɐ̃du
levantar	lɨvɐ̃taɾ
levar	lɨvaɾ
levava	lɨvavɐ
leve	lɛvɨ
levou	lɨvow
lezíria	lɨziɾiɐ
leão	ljɐ̃w̃
lha	ʎɐ
lhas	ʎɐʃ
lhe	lɨ
lhe	ʎɨ
lhes	ʎɨʃ
lho	ʎu
lhos	ʎuʃ
liberal	liβɨɾaɫ
liberação	liβɨɾɐsɐ̃w̃
liberdade	libɨɾdadɨ
liberdade	liβɨɾðaðɨ
libertar	liβɨɾtaɾ
libertação	liβɨɾtɐsɐ̃w̃
libra	liβɾɐ
libélula	libɛlulɐ
licença	lisẽsɐ
liceu	lisew
licor	likoɾ
licranço	likɾɐ̃su
lidar	liðaɾ
lidera	lidɛɾa
liderança	liðɨɾɐ̃sɐ
liderar	liðɨɾaɾ
ligado	liɣaðu
ligamento	liɣɐmẽtu
ligar	liɣaɾ
ligação	liɣɐsɐ̃w̃
lilongwe	lilõɡwɛ
lima	lima
lima	limɐ
limitado	limitaðu
limitar	limitaɾ
limitação	limitɐsɐ̃w̃
limoeiro	limwejɾu
limoeiro	limwɐjɾu
limpando	lĩpɐ̃du
limpar	lĩpaɾ
limpeza	lĩpezɐ
limpo	lĩpu
limão	limɐ̃w̃
limítrofe	lɨmitɾufɨ
lince	lĩsɨ
linda	lĩdɐ
lindo	lĩdu
lindos	lĩduʃ
lingerie	lɐ̃ʒeʁi
linguagem	lĩɡwaʒɐ̃j̃
lingual	lĩɡwaɫ
linguiça	lĩɡuisɐ
linguiça	lĩɡwisɐ
linha	liɲɐ
linhas	liɲɐʃ
linho	liɲu
lintel	lĩtɛw
lisboa	liʒboɐ
liso	lizu
lista	liʃtɐ
listagem	listaʒẽj̃
lisura	lizuɾa
literatura	litɨɾɐtuɾɐ
lituânia	litwɐnjɐ
livrar	livɾaɾ
livraria	livɾɐɾiɐ
livre	livɾɨ
livreiro	livrɐjɾu
livremente	livɾɨmẽtɨ
livro	livɾu
lixa	liʃɐ
lixo	liʃu
lição	lisɐ̃w̃
lo	lu
loa	loɐ
lobo	loβu
lobo	lɔβu
local	lukaɫ
localmente	lukaɫmẽtɨ
locomotiva	lokumutivɐ
lodo	loðu
logo	loɣu
logo	lɔɣu
logro	loɡɾu
loiro	lojɾu
loiça	lojsɐ
loja	lɔʒɐ
lojista	luʒiʃtɐ
lombo	lõbu
londres	lõdɾɨʃ
longa	lõɡɐ
longanimidade	lõɡɐnimidadʒi
longas	lõɡɐʃ
longe	lõʒɨ
longitude	lõʒituðɨ
longo	lõɡu
longos	lõɡuʃ
longínquo	lõʒĩkwu
lontra	lontɾɐ
lopes	lɔpɨʃ
los	luʃ
losango	lozɐ̃ɡu
lotado	lutaðu
lotar	lutaɾ
lotear	lutjaɾ
louco	lowku
loucura	lowkuɾɐ
loulé	lolɛ
loureiro	lowɾejɾu
loureiro	lowɾɐjɾu
loures	lowɾɨʃ
lourinhã	loɾiɲɐ̃
louro	lowɾu
lousa	lowzɐ
lousada	lowzaðɐ
lousã	lowzɐ̃
louvar	lowvaɾ
louvor	lowvoɾ
louça	losɐ
louça	lowsɐ
lua	luɐ
luanda	lwɐ̃dɐ
luar	lwaɾ
lucerna	lusɛɾnɐ
lucrar	lukɾaɾ
lucro	lukɾu
lugar	luɣaɾ
lugares	luɣaɾɨʃ
lume	lumɨ
luminoso	luminozu
lunar	lunaɾ
lunático	lunatiku
lupa	lupɐ
lusitano	luzitɐnu
lusitânia	luzitɐnjɐ
luso	luzu
lusofobia	luzɔfuβiɐ
lustre	luʃtɾɨ
luta	lutɐ
lutador	lutɐðoɾ
lutar	lutaɾ
luto	lutu
luva	luvɐ
luvas	luvɐʃ
luxemburgo	luʃẽbuɾɣu
luxo	luʃu
luxúria	luʃuɾjɐ
luz	luʃ
luzerna	luzɛɾnɐ
luzes	luzɨʃ
luzidio	luzidiu
luzir	luziɾ
luís	luiʃ
lá	la
lábia	laβjɐ
lábio	laβiu
lábio	laβju
lábios	laβjuʃ
lácteo	laktju
lágrima	laɣɾimɐ
lágrimas	laɣɾimɐʃ
lápis	lapiʃ
lâmina	lɐminɐ
lâmpada	lɐ̃pɐðɐ
lã	lɐ̃
lémure	lɛmuɾɨ
léu	lɛw
lê	le
líder	liðɛɾ
lídimo	liðimu
língua	lĩɡwɐ
lípsia	lipsjɐ
líquido	likiðu
lírica	liɾikɐ
lírico	liɾiku
lírio	liɾju
lítio	litiu
lívido	liviðu
lógia	lɔʒjɐ
lógica	lɔʒikɐ
lógico	lɔʒiku
lótus	lɔtuʃ
lúcia	lusjɐ
macaco	mɐkaku
machado	mɐʃaðu
machico	mɐʃiku
machista	mɐʃiʃtɐ
macho	maʃu
macieira	mɐsjɐjɾɐ
macio	mɐsiu
maciço	mɐsisu
macla	maklɐ
maconha	makoɲa
madalena	mɐðɐlenɐ
madeira	mɐðejɾɐ
madeira	mɐðɐjɾɐ
madrasta	mɐðɾaʃtɐ
madre	maðɾɨ
madrepérola	maðɾɨpɛɾulɐ
madressilva	maðɾɨsilvɐ
madrigal	mɐðɾiɣaɫ
madrinha	mɐðɾiɲɐ
madrugada	mɐðɾuɣaðɐ
madrugar	mɐðɾuɣaɾ
maduro	maduɾu
mafra	mafɾɐ
magia	maʒia
magistratura	mɐʒiʃtɾɐtuɾɐ
magistério	maʒijʃtɛɾju
magistério	maʒistɛɾju
magnífico	maɡnifiku
mago	maɣu
magoar	mɐɣwaɾ
magreza	mɐɣɾezɐ
magro	maɣɾu
magusto	mɐɣuʃtu
maia	majɐ
mainel	majnɛɫ
maio	maju
maior	mɐjɔɾ
maioria	mɐjuɾiɐ
mais	majʃ
maisena	majzena
majestade	mɐʒɨʃtaðɨ
mal	maɫ
mala	malɐ
malaquita	mɐlɐkitɐ
maldito	maɫditu
maldição	maldisɐ̃w̃
maleficiar	malefisiaɾ
malefício	malefisju
malga	maɫɣɐ
malha	maʎɐ
malho	maʎu
maligno	mɐliɡnu
maloca	malɔka
malograr	maloɡɾar
malograr	maloɡɾaʁ
maloqueiro	malokejɾu
malta	maɫtɐ
maluco	mɐluku
malva	maɫvɐ
malvão	maɫvɐ̃w̃
maléfico	mɐlɛfiku
mama	mɐmɐ
mambembe	mɐ̃bẽjbi
mamute	mɐmutɨ
mamã	mɐmɐ̃
mamão	mɐmɐ̃w̃
manada	manada
manada	manadɐ
manancial	mɐnɐ̃sjaɫ
mancha	mɐ̃ʃɐ
manchester	mɐ̃tʃɛstɨɾ
manda	mɐ̃dɐ
mandado	mɐ̃daðu
mandar	mɐ̃daɾ
mandarim	mɐ̃dɐɾĩ
mandatário	mɐ̃dɐtaɾju
mando	mɐ̃du
mandorla	mɐ̃dɔɾlɐ
mandou	mɐ̃dow
mandíbula	mɐ̃diβulɐ
maneira	mɐnɐjɾɐ
maneiras	mɐnɐjɾɐʃ
maneiro	mɐnɐjɾu
manga	mɐ̃ɡɐ
mangas	mɐ̃ɡɐʃ
mangra	mɐ̃ɡɾɐ
mangual	mɐ̃ɡwaɫ
mangualde	mɐ̃ɡwaɫdɨ
manha	mɐɲɐ
manhã	mɐɲɐ̃
manhãs	mɐɲɐ̃ʃ
manicómio	mɐnikɔmju
manifestante	mɐnifɨstɐ̃tɨ
manifestar	mɐnifɨʃtaɾ
manifestação	mɐnifɨʃtɐsɐ̃w̃
manilha	mɐniʎɐ
manipulação	mɐnipulɐsɐ̃w̃
manipulável	manipulaveɫ
manjar	mɐ̃ʒaɾ
manjar	mɐ̃ʒaʁ
manjerico	mɐ̃ʒɨɾiku
manjericão	mɐ̃ʒɨɾikɐ̃w̃
manjerona	mɐ̃ʒɨɾonɐ
mano	mɐnu
manobra	mɐnɔβɾɐ
mansidão	mɐ̃siðɐ̃w̃
manso	mɐ̃su
mansão	mɐ̃sɐ̃w̃
manta	mɐ̃tɐ
manteiga	mɐ̃tejɣɐ
manteiga	mɐ̃tɐjɣɐ
manteigas	mɐ̃tɐjɣɐʃ
manter	mɐ̃teɾ
mantimento	mɐ̃timẽtu
manual	mɐnwaɫ
manumissão	mɐnumisɐ̃w̃
manuscrito	mɐnuʃkɾitu
mapa	mapɐ
maputo	mɐputu
maquete	makɛtʃi
maquinaria	mɐkinɐɾiɐ
mar	maɾ
maracujá	mɐɾɐkuʒa
marafona	mɐɾɐfonɐ
marajá	mɐɾɐʒa
maravilha	mɐɾɐviʎɐ
marca	maɾkɐ
marcar	mɐɾkaɾ
marcação	mɐɾkɐsɐ̃w̃
marcha	maɾʃɐ
marchar	mɐɾʃaɾ
maresia	mɐɾɨziɐ
marfim	mɐɾfĩ
marga	maɾɣɐ
margarida	mɐɾɡɐɾidɐ
margarina	mɐɾɣɐɾinɐ
margem	maɾʒɐ̃j̃
marginal	mɐɾʒinaɫ
maria	mɐɾiɐ
mariana	mɐɾjɐnɐ
marido	mɐɾiðu
marinha	mɐɾiɲɐ
marinheiro	mɐɾiɲejɾu
marinheiro	mɐɾiɲɐjɾu
marinho	mɐɾiɲu
marmelada	mɐɾmɨlaðɐ
marmelo	mɐɾmɛlu
maromba	maɾõba
maroto	mɐɾotu
marquesa	mɐɾkezɐ
marquise	maɾkizɨ
marquês	mɐɾkeʃ
marra	maʁa
marrano	mɐʁɐnu
marreca	mɐʁɛku
marreco	mɐʁɛku
marrento	maʁẽtu
marta	maɾtɐ
marte	maɾtɨ
martelar	mɐɾtɨlaɾ
martelo	mɐɾtɛlu
martins	mɐɾtĩʃ
martírio	mɐɾtiɾju
marujo	mɐɾuʒu
marvão	mɐɾvɐ̃w
marxista	maɾksista
março	maɾsu
maré	mɐɾɛ
mas	mɐʃ
mascote	mɐʃkɔtɨ
masculinidade	mɐʃkuliniðaðɨ
masculino	mɐʃkulinu
masmorra	mɐʒmoʁɐ
massa	masɐ
mastro	maʃtɾu
masturbação	maʃtuɾβɐsɐ̃w̃
mata	matɐ
matador	mɐtɐðoɾ
matamatá	matamata
matar	mɐtaɾ
maternidade	mɐtɨɾniðaðɨ
matilda	mɐtiɫdɐ
matilde	mɐtiɫdɨ
mato	matu
matosinhos	mɐtuziɲuʃ
matrícula	mɐtɾikulɐ
matéria	mɐtɛɾjɐ
mau	maw
mavioso	maviozu
mazela	mɐzɛlɐ
maça	masɐ
maçada	mɐsaðɐ
maçaneta	mɐsɐnetɐ
maçante	mɐsɐ̃tɨ
maço	masu
maçã	mɐsɐ̃
mação	mɐsɐ̃w
mc	mɛki
me	mɨ
mealha	mjaʎɐ
mealhada	miɐʎaðɐ
mealheiro	mjɐʎejɾu
mealheiro	mjɐʎɐjɾu
meação	mjɐsɐ̃w̃
mec	mɛki
medalha	mɨðaʎɐ
mediação	mɨðjɐsɐ̃w̃
medicina	mɨðisinɐ
medicina	mɨðɨsinɐ
medidor	mɨðiðoɾ
medir	mɨðiɾ
medição	mɨðisɐ̃w̃
medo	medu
medonho	mɨdoɲu
medrica	medɾika
medricas	medɾikas
medrincas	medɾĩkas
medronheiro	mɨðɾuɲejɾu
medronheiro	mɨðɾuɲɐjɾu
medronho	mɨðɾoɲu
medroso	mɨðɾozu
mega	mɛɡa
megabit	mɛɡabiti
megabyte	mɛɡabajtʃi
meia	mɐjɐ
meigo	mejɣu
meigo	mɐjɣu
meio	mɐju
mel	mɛɫ
melancia	mɨlɐ̃siɐ
melancolia	mɨlɐ̃kuliɐ
melancolicamente	mɨlɐ̃kɔlikɐmẽtɨ
melancólico	mɨlɐ̃kɔliku
melecar	melekaɾ
melgaço	mɛɫɣasu
melhor	mɨʎɔɾ
melhores	mɨʎɔɾɨʃ
melindroso	melĩdɾozu
meloa	mɨloɐ
melodia	mɨluðiɐ
melro	mɛɫʁu
melão	mɨlɐ̃w̃
membrana	mẽbɾɐnɐ
membro	mẽbɾu
memorizar	mɨmuɾizaɾ
memorização	mɨmuɾizɐsɐ̃w̃
memória	mɨmɔɾjɐ
mencionar	mẽsjunaɾ
mendaz	mendajs
mendaz	mendajʃ
mendigar	mẽdiɣaɾ
mendigo	mẽdiɣu
mene	meni
menina	mɨninɐ
meninas	mɨninɐʃ
menino	mɨninu
meninos	mɨninuʃ
menor	mɨnɔɾ
menos	menuʃ
mensagem	mẽsaʒɐ̃j̃
mensal	mẽsaɫ
mensalidade	mẽsalidadʒi
menta	mẽtɐ
mental	mẽtaɫ
mentalidade	mẽtɐliðaðɨ
mentalmente	mẽtaɫmẽtɨ
mente	mẽtɨ
mentira	mẽtiɾɐ
menu	mɛnu
menu	mɨnu
mera	mɛɾa
mercado	mɨɾkadu
mercadologia	mɨɾkɐðuluʒiɐ
mercador	mɨɾkɐðoɾ
mercadoria	mɨɾkɐðuɾiɐ
merceeiro	mɨɾsjejɾu
merceeiro	mɨɾsjɐjɾu
mercúrio	mɨɾkurju
merda	mɛɾdɐ
mergulho	mɨɾɣuʎu
meridional	mɨɾiðjunaɫ
merreca	meʁɛka
mesa	mezɐ
mesada	mɨzaðɐ
mesclar	mɛʃklaɾ
meses	mezɨʃ
mesma	meʒmɐ
mesmas	meʒmɐʃ
mesmo	meʒmu
mesmos	meʒmuʃ
mesquita	mɨʃkitɐ
messe	mɛsɨ
mestre	mɛʃtɾɨ
mesóclise	mezɔklizi
meta	metɐ
meta	mɛtɐ
metade	mɨtaðɨ
metafísico	mɛtɐfiziku
metal	mɨtaɫ
mete	mɛtʃi
meter	mɨteɾ
meteu	mɨtew
metido	mɨtiðu
metodista	metodʒistɐ
metro	mɛtɾu
metrô	metɾo
meu	mew
meus	mewʃ
mexer	mɨʃeɾ
mezinha	mɛziɲɐ
mi	mi
miasma	miaʒmɐ
miasma	mjaʒmɐ
micho	miʃu
microclima	mikɾɔklimɐ
micáceo	mikasiu
migalha	miɣaʎɐ
migrante	miɣɾɐ̃tɨ
migrar	miɣɾaɾ
migração	miɣɾɐsɐ̃w̃
miguel	miɣɛɫ
migué	miɡɛ
mil	miɫ
milagre	milaɣɾɨ
milgrada	miɫɣɾaðɐ
milhares	miʎaɾɨʃ
milho	miʎu
milhão	miʎɐ̃w̃
militar	militaɾ
mim	mĩ
mimimi	mimimi
mimosa	mimɔzɐ
mina	minɐ
minar	minaɾ
mineiro	minɐjɾu
mineral	minɨɾaɫ
mingar	mĩɡaɾ
mingau	mĩɡaw
minguar	mĩɡaɾ
minguar	mĩɡwaɾ
minha	miɲɐ
minhas	miɲɐʃ
minho	miɲu
minhoca	miɲɔkɐ
minhoto	miɲotu
minissaia	minisajɐ
ministro	miniʃtɾu
ministro	mɨniʃtɾu
minuto	minutu
minério	minɛɾju
minúcia	minusja
miolo	mjolu
mira	miɾɐ
miraculoso	miɾɐkulozu
miradoiro	miɾɐðojɾu
miradouro	miɾɐðowɾu
mirandela	miɾɐ̃dɛlɐ
mirandês	miɾɐ̃deʃ
mirar	miɾaɾ
mirra	miʁɐ
mirrar	miʁaɾ
mirtilo	miɾtilu
miríade	miɾiɐðɨ
miserável	mizɨɾavɛɫ
missa	misɐ
missão	misɐ̃w̃
mister	mistɛɾ
mistura	miʃtuɾɐ
misturar	miʃtuɾaɾ
misturo	mistuɾu
misturo	miʃtuɾu
mistério	miʃtɛɾju
miséria	mizɛɾjɐ
mito	mitu
mitra	mitɾɐ
mixe	miʃi
mixuruca	miʃuɾuka
miúdo	miuðu
miúdo	mjuðu
mobilizador	mobilizadoɾ
mobília	muβiljɐ
mochila	muʃilɐ
mocho	moʃu
mocidade	musiðaðɨ
moda	mɔðɐ
modelo	muðelu
moderno	muðɛɾnu
modificar	muðifikaɾ
modo	mɔðu
modos	mɔðuʃ
moeda	mwɛdɐ
moela	mwɛlɐ
moer	mweɾ
mofo	mofu
mogadouro	muɣɐðowɾu
mogúncia	muɣũsjɐ
moinho	muiɲu
moinho	mwiɲu
moirama	mojɾɐmɐ
moirisma	mojɾiʒmɐ
moita	mojtɐ
mola	mɔlɐ
moldura	moɫduɾɐ
moldura	muɫduɾɐ
moldávia	mɔɫðavjɐ
mole	mɔlɨ
moleiro	mulɐjɾu
moletom	moletõ
molhado	muʎaðu
molhar	muʎaɾ
molho	moʎu
molho	mɔʎu
momento	mumẽtu
momice	momisi
mona	mona
monarca	munaɾkɐ
monarquia	munɐɾkiɐ
monchique	mõʃikɨ
mondar	mõdaɾ
mondego	mõdeɣu
monforte	mõfɔɾtɨ
monge	mõʒɨ
monja	mõʒɐ
monogamia	monoɡɐ̃mia
monogâmico	monoɡɐ̃miku
monotonia	monotonia
monstro	mõʃtɾu
monstruoso	mõstɾuozu
montalegre	mõtɐlɛɣɾɨ
montanha	mõtɐɲɐ
montar	mõtaɾ
monte	mõtɨ
montenegro	mõteneɡɾu
montenegro	mõtineɡɾu
montijo	mõtiʒu
montra	mõtɾɐ
monturo	mõtuɾu
monumento	munumẽtu
monárquico	munaɾkiku
monção	mõsɐ̃w
monção	mõsɐ̃w̃
mor	moɾ
mor	mɔɾ
mora	mɔɾɐ
morada	muɾaðɐ
morador	muɾɐðoɾ
moradores	muɾɐðoɾɨʃ
moraes	moɾajs
morais	moɾajs
moral	muɾaɫ
moranga	muɾɐ̃ɡɐ
morango	muɾɐ̃ɡu
morar	muɾaɾ
morcego	muɾseɣu
morder	muɾðeɾ
mordida	muɾðiðɐ
mordidela	muɾðiðɛlɐ
mordomo	muɾðomu
mordomo	mɔɾðomu
more	mɔɾɨ
moreira	muɾejɾɐ
moreira	muɾɐjɾɐ
moreno	muɾenu
morrendo	muʁẽdu
morrer	muʁeɾ
morrera	muʁeɾɐ
morrerá	muʁɨɾa
morreu	muʁew
morria	muʁiɐ
morrido	muʁiðu
morrinha	muʁiɲɐ
morro	moʁu
morsa	mɔɾsɐ
morta	mɔɾtɐ
mortal	muɾtaɫ
morte	mɔɾtɨ
morto	moɾtu
mortos	mɔɾtuʃ
mortágua	mɔɾtaɣwɐ
mosaico	muzajku
mosca	moʃkɐ
mosteiro	muʃtejɾu
mosteiro	muʃtɐjɾu
mostra	mɔʃtɾɐ
mostrando	muʃtɾɐ̃du
mostrar	muʃtɾaɾ
mostrava	muʃtɾavɐ
motivo	mutivu
motor	mutoɾ
motorista	mutuɾiʃtɐ
mouco	mowku
moura	mowɾɐ
mourama	mowɾɐmɐ
mourisco	mowɾiʃku
mourisma	mowɾiʒmɐ
mouro	mowɾu
mourão	mowɾɐ̃w
mover	muveɾ
movimentado	muvimẽtaðu
movimento	muvimẽtu
moça	mosɐ
moçambique	musɐ̃bikɨ
moço	mosu
moçárabe	musaɾɐbɨ
moção	musɐ̃w̃
moído	mwiðu
muda	muðɐ
mudança	muðɐ̃sɐ
mudar	muðaɾ
mudo	muðu
mudéjar	mudɛʒaɾ
mufti	mufti
mugir	muʒiɾ
mui	muj
mui	mũj̃
muita	mũj̃tɐ
muitas	mũj̃tɐs
muitas	mũj̃tɐʃ
muito	mwĩtu
muito	mũj̃tu
muitos	mũj̃tuʃ
mula	mulɐ
mulato	mulatu
mulher	muʎɛɾ
mulheres	muʎɛɾɨʃ
mulherão	muʎɛɾɐ̃w̃
multa	muɫtɐ
multar	muɫtaɾ
multidão	muɫtiðɐ̃w̃
multiúso	muɫtiuzu
mundial	mũdjaɫ
mundo	mũdu
município	munisipju
munir	muniɾ
muralha	muɾaʎɐ
murar	muɾaɾ
murcho	muɾʃu
mure	muɾɨ
murganho	muɾɣɐɲu
murmurando	muɾmuɾɐ̃du
murmurar	muɾmuɾaɾ
murmurava	muɾmuɾavɐ
murmúrio	muɾmuɾju
muro	muɾu
muros	muɾuʃ
murta	muɾtɐ
murtosa	muɾtɔzɐ
murça	muɾsɐ
musa	muzɐ
muscular	muʃkulaɾ
museu	muzew
musgo	muʒɣu
musical	muzikaɫ
musicista	muzisiʃtɐ
mutar	mutaɾ
mutação	mutɐsɐ̃w̃
mutuamente	mutwɐmẽtɨ
muçulmano	musuɫmɐnu
muçununga	musunũɡɐ
má	ma
mácula	makulɐ
mágico	maʒiku
mágoa	maɣwɐ
máquina	makinɐ
mármore	maɾmuɾɨ
mártir	maɾtiɾ
máscara	maʃkɐɾɐ
máximo	masimu
mãe	mɐ̃j̃
mães	mɐ̃j̃ʃ
mão	mɐ̃w̃
mãos	mɐ̃w̃ʃ
médico	mɛdiku
mértola	mɛɾtulɐ
método	mɛtudu
méxico	mɛʃiku
mêda	meðɐ
mês	meʃ
míngua	mĩɡwɐ
mó	mɔ
móveis	mɔvɐjʃ
móvel	mɔvɛɫ
mô	mo
músculo	muʃkulu
música	muzikɐ
músico	muziku
mútuo	mutwu
na	nɐ
nababesco	nababejʃku
nababesco	nababesku
nababo	nababu
nabo	nabu
nacional	nɐsjunaɫ
nacionalidade	nɐsjunɐliðaðɨ
nada	naðɐ
nadador	nɐðɐðoɾ
nadar	nɐðaɾ
nadir	nɐðiɾ
nado	naðu
naipe	najpɨ
namoro	namoɾu
namoro	namɔɾu
naquela	nɐkɛlɐ
naquelas	nɐkɛlɐʃ
naquele	nɐkelɨ
naqueles	nɐkelɨʃ
naquilo	nɐkilu
narciso	nɐɾsizu
narguilé	narɡilɛ
narigudo	nɐɾiɣuðu
nariz	nɐɾiʃ
narval	naɾval
nas	nɐʃ
nasal	nɐzaɫ
nascente	nɐʃsẽtɨ
nascer	nɐseɾ
nascer	nɐʃeɾ
nascer	nɐʃseɾ
nasceu	nɐʃsew
nascido	nɐʃsiðu
nascimento	nɐsimẽtu
nascimento	nɐʃimẽtu
nascimento	nɐʃsimẽtu
nascituro	nasituɾu
natal	nɐtaɫ
natalino	natalinu
natação	nɐtɐsɐ̃w̃
natural	nɐtuɾaɫ
naturalidade	nɐtuɾɐliðaðɨ
natureza	nɐtuɾezɐ
nau	naw
naufrágio	nɐufraʒju
navalha	nɐvaʎɐ
navegador	nɐvɨɣɐðoɾ
navegar	nɐvɨɣaɾ
navegação	nɐvɨɣɐsɐ̃w̃
navio	nɐviu
navios	nɐviuʃ
nazaré	nɐzɐɾɛ
nazi	nazi
nazismo	naziʒmu
nação	nɐsɐ̃w̃
nações	nɐsõj̃ʃ
neblina	nɨβlinɐ
nebuloso	nɨβulozu
necedade	nɨsɨdadɨ
necessidade	nɨsɨsiðaðɨ
necessitar	nɨsɨsitaɾ
necessário	nɨsɨsaɾju
nectarina	nɛktɐɾinɐ
neerlândia	njerlɐ̃djɐ
negar	nɨɣaɾ
negativamente	nɨɣɐtivɐmẽtɨ
negativo	nɨɣɐtivu
negação	nɨɡɐsɐ̃w̃
nego	nɛɣu
negociar	nɨɣusjaɾ
negra	neɣɾɐ
negro	neɡɾu
negável	nɨɣavɛɫ
negócio	nɨɣɔsju
negócios	nɨɣɔsjuʃ
nela	nɛlɐ
nelas	nɛlɐʃ
nele	nelɨ
neles	nelɨʃ
nem	nɐ̃j̃
nenhum	nɨɲũ
nenhuma	nɨɲumɐ
nenhures	nɨɲuɾɨʃ
neptuno	nɛptunu
neri	neɾi
nero	nɛɾu
nervo	neɾvu
nescidade	nɨsidadɨ
nescidade	nɨʃidadɨ
nescidade	nɨʃsidadɨ
nessa	nɛsɐ
nessas	nɛsɐʃ
nesse	nesɨ
nesses	nesɨʃ
nesta	nɛʃtɐ
nestas	nɛʃtɐʃ
neste	neʃtɨ
net	nɛtʃi
neta	nɛtɐ
neto	nɛtu
nevada	nevada
nevar	nɨvaɾ
neve	nɛvɨ
nevoeiro	nɨvwɐjɾu
nevão	nɨvɐ̃w̃
nexo	nɛksu
neónio	njɔnju
nhaca	ɲaka
nhanhanhã	ɲɐɲɐɲɐ̃
nica	nikɐ
nicho	niʃu
nilo	nilu
nim	nĩ
nimbo	nĩbu
ninfa	nĩfɐ
ninguém	nĩɡɐ̃j̃
ninguém	nĩɡẽj̃
ninho	niɲu
ninjete	nĩʒɛtʃi
nisa	nizɐ
nisso	nisu
nisto	niʃtu
no	nu
nobre	nɔβɾɨ
nobreza	nuβɾezɐ
nobélio	nuβɛlju
noia	nɔjɐ
noite	nojtɨ
noites	nojtɨʃ
noiturno	nojtuɾnu
noiva	nojvɐ
noivo	nojvu
nojeira	noʒejɾa
nojo	noʒu
nom	nõ
nome	nomɨ
nomear	numiaɾ
nomear	numjaɾ
nomeação	numjɐsɐ̃w̃
nomes	nomɨʃ
nominal	numinaɫ
nona	nona
nona	nonɐ
nono	nonu
nora	nɔɾɐ
nordeste	nɔɾðɛʃtɨ
normais	nɔɾmajʃ
normal	nɔɾmaɫ
normalmente	nuɾmalmẽtɨ
noroeste	nɔɾwɛʃtɨ
norte	nɔɾtɨ
nos	nuʃ
nosocómio	nɔzɔkɔmju
nossa	nɔsɐ
nossas	nɔsɐʃ
nosso	nɔsu
nossos	nɔsuʃ
nostalgia	nuʃtaɫʒiɐ
nota	nɔtɐ
notar	nutaɾ
notas	nɔtɐʃ
noticiário	nutisjaɾju
noturno	nɔtuɾnu
notário	nutaɾju
notícia	nutisjɐ
notícias	nutisjɐʃ
noutra	nowtɾɐ
noutras	nowtɾɐʃ
noutro	nowtɾu
noutros	nowtɾuʃ
nova	nɔvɐ
novaes	novajs
novais	novajs
novamente	nɔvɐmẽtɨ
novas	nɔvɐʃ
nove	nɔvɨ
novecentos	nɔvɨsẽtuʃ
novembro	nuvẽbɾu
noventa	nuvẽtɐ
novidade	nuviðaðɨ
novo	novu
novos	nɔvuʃ
noz	nɔʃ
noção	nusɐ̃w̃
nu	nu
nua	nuɐ
nuca	nukɐ
nudez	nuðeʃ
nulidade	nuliðaðɨ
num	nũ
numa	numɐ
numas	numɐʃ
numera	numɛɾa
numeral	numɨɾaɫ
nunca	nũkɐ
nuns	nũʃ
nuvem	nuvɐ̃j̃
nuvens	nuvɐ̃j̃ʃ
nágua	naɡwa
náiade	najɐðɨ
não	nɐ̃w̃
nè	nɛ
né	nɛ
néctar	nɛktaɾ
néscio	nɛsju
néscio	nɛʃju
néscio	nɛʃsju
névoa	nɛvwɐ
nêspera	neʃpɨɾɐ
nítido	nitidu
nível	nivɛɫ
nó	nɔ
nóbrega	nɔbɾeɡa
nós	nɔʃ
núbil	nuβiɫ
número	numɨɾu
números	numɨɾuʃ
obedecer	ɔβɨðɨseɾ
obesidade	ɔβɨziðaðɨ
obeso	ɔβezu
objete	obʒɛtʃi
objetividade	ɔbʒɛtiviðaðɨ
objetivo	ɔbʒɛtivu
objeto	ɔbʒɛtu
objeção	ɔbʒɛsɐ̃w̃
obnubilado	obnubiladu
oboé	oβwɛ
obra	ɔβɾɐ
obras	ɔβɾɐʃ
obreiro	ɔβɾejɾu
obreiro	ɔβɾɐjɾu
obrigada	ɔβɾiɣaðɐ
obrigado	ɔβɾiɣaðu
obrigação	ɔβɾiɣɐsɐ̃w̃
obsceno	ɔpʃsenu
obscuridade	ɔbʃkuɾiðaðɨ
obscuro	ɔbʃkuɾu
obsequiar	obzekiaɾ
observar	ɔbsɨɾvaɾ
observatório	ɔbsɨɾvɐtɔɾju
observação	ɔbsɨɾvɐsɐ̃w̃
obstante	ɔpʃtɐ̃tɨ
obséquio	obzɛkju
obtenção	ɔbtẽsɐ̃w̃
obter	ɔbteɾ
obtuso	obtuzu
ocarina	okɐɾinɐ
ocasião	okɐzjɐ̃w̃
ocasião	ɔkɐzjɐ̃w̃
oceano	ɔsjɐnu
oceanário	ɔsjɐnaɾju
ocidental	ɔsiðẽtaɫ
ocidente	ɔsiðẽtɨ
ociosidade	ɔsjuziðaðɨ
ocioso	ɔsjozu
oco	oku
octógono	ɔktɔɣunu
ocupação	ukupɐsɐ̃w̃
odiana	ɔdjɐnɐ
odiar	ɔðjaɾ
odin	oðĩ
odivelas	odivɛlɐʃ
odor	oðoɾ
odor	uðoɾ
odor	ɔðoɾ
odre	oðɾɨ
oeiras	oɐjɾɐʃ
oeste	wɛʃtɨ
oeste	ɔɛʃtɨ
ofender	ɔfẽdeɾ
oferecer	ɔfɨɾɨseɾ
oferta	ufɛɾtɐ
oferta	ɔfɛɾtɐ
oficial	ɔfisjaɫ
oficina	ufisinɐ
oficina	ɔfisinɐ
oftalmo	oftawmu
ofício	ɔfisju
ogano	ɔɣɐnu
ogre	ɔɣɾɨ
oi	oj
oiro	ojɾu
oitavo	ojtavu
oiteiro	ojtejɾu
oiteiro	ojtɐjɾu
oitenta	ojtẽtɐ
oito	ojtu
oitocentos	ojtusẽtuʃ
oleiros	olɐjɾuʃ
olfato	ɔɫfatu
olha	oʎɐ
olha	ɔʎɐ
olhando	ɔʎɐ̃du
olhar	oʎaɾ
olhar	ɔʎaɾ
olhava	ɔʎavɐ
olhe	ɔʎɨ
olhinho	oʎĩɲu
olho	oʎu
olho	ɔʎu
olhos	ɔʎuʃ
olhou	ɔʎow
olhão	oʎɐ̃w
oliveira	olivejɾɐ
oliveira	olivɐjɾɐ
oliveira	ɔlivejɾɐ
oliveira	ɔlivɐjɾɐ
olivina	olivinɐ
olmo	owmu
olvidar	oɫviðaɾ
olvidar	ɔɫviðaɾ
olá	ɔla
ombro	õbɾu
ombros	õbɾuʃ
omitir	omitiɾ
omnisciência	õniʃsjẽsjɐ
onda	õdɐ
onde	õdɨ
ondulado	õdulaðu
ondular	õdulaɾ
onera	onɛɾa
ontem	õtɐ̃j̃
ontem	õtẽj̃
onze	õzɨ
onça	õsɐ
opera	opɛɾa
operador	ɔpɨɾɐðoɾ
operar	ɔpɨɾaɾ
operação	ɔpɨɾɐsɐ̃w̃
operário	ɔpɨɾaɾju
opinião	ɔpinjɐ̃w̃
opor	ɔpoɾ
oportunidade	ɔpuɾtuniðaðɨ
oportunismo	ɔpuɾtuniʒmu
oportunista	ɔpuɾtuniʃtɐ
oportuno	ɔpuɾtunu
oposição	ɔpuzisɐ̃w̃
opressão	upɾɨsɐ̃w̃
opróbrio	opɾɔbɾju
optar	uptaɾ
opulento	opulẽtu
opulência	opulẽsja
opção	ɔpsɐ̃w̃
ora	ɔɾɐ
orar	ɔɾaɾ
oratório	ɔɾɐtɔɾju
oração	ɔɾɐsɐ̃w̃
orca	ɔɾkɐ
ordeiro	ɔɾðɐjɾu
ordem	ɔɾðɐ̃j̃
ordenado	ɔɾðɨnaðu
ordenar	ɔɾðɨnaɾ
ordenação	ɔɾðɨnɐsɐ̃w̃
ordens	ɔɾðɐ̃j̃ʃ
ordinário	ɔɾðinaɾiu
ordinário	ɔɾðinaɾju
orelha	oɾejʎɐ
orelha	oɾɐjʎɐ
orelha	ɔɾejʎɐ
orelha	ɔɾɐjʎɐ
orelhas	oɾɐjʎɐʃ
orelhão	oɾeʎɐ̃w̃
organizado	ɔɾɣɐnizaðu
organizar	ɔɾɣɐnizaɾ
organização	ɔɾɣɐnizɐsɐ̃w̃
orgia	oɾʒia
orgia	oʁʒia
orgulhar	oɾɡuʎaɾ
orgulhar	ɔɾɡuʎaɾ
orgulho	ɔɾɣuʎu
orientação	oɾiẽntasɐ̃w̃
oriente	ɔɾjẽtɨ
origem	oɾiʒɐ̃j̃
origem	ɔɾiʒɐ̃j̃
original	uɾɨʒinaɫ
original	ɔɾiʒinaɫ
oriundo	ɔɾiũdu
ornamentar	ɔɾnɐmẽtaɾ
ornamento	ɔɾnɐmẽtu
ornato	ɔɾnatu
orquestra	ɔɾkɛʃtɾɐ
orquídea	ɔɾkiðjɐ
orvalho	ɔɾvaʎu
oráculo	uɾakulu
orégano	uɾɛɣɐnu
os	uʃ
osasquense	ozaskẽsi
oscular	oskulaɾ
oslo	ɔʒlu
osso	osu
ossos	ɔsuʃ
ostra	oʃtɾɐ
otaku	otaku
otimista	ɔtimiʃtɐ
otimizar	ɔtimizaɾ
otorrino	otoʁinu
otário	ɔtaɾju
ou	ow
ourela	owɾɛla
ourique	owɾikɨ
ourives	owɾivɨʃ
ouriço	owɾisu
ouro	owɾu
ouros	owɾuʃ
ourém	owɾɐ̃j
outeiro	owtejɾu
outeiro	owtɐjɾu
outonal	owtunaɫ
outono	owtonu
outra	owtɾɐ
outrem	owtɾɐ̃j̃
outro	owtɾu
outrora	otɾɔɾɐ
outrora	owtɾɔɾɐ
outubro	owtuβɾu
ouve	owvɨ
ouvi	owvi
ouvido	owviðu
ouvindo	owvĩdu
ouvir	owviɾ
ouvir	owβiɾ
ouvira	owviɾɐ
ouvirá	owviɾa
ouvisto	owviʃtu
ouviu	owviw
ova	ɔvɐ
ovar	ovaɾ
ovação	ovasɐ̃w̃
ovelha	ɔvɐjʎɐ
ovelha	ɔvɐʎɐ
ovo	ovu
ovos	ɔvuʃ
oxalá	oʃɐla
oxalá	ɔʃɐla
oxe	oʃ
oxe	oʃe
oxe	oʃi
oxigénio	ɔksiʒɛnju
ozono	ɔzonu
ozónio	ɔzɔnju
oásis	oazis
pabulagem	pabulaʒẽj̃
paciente	pɐsjẽtɨ
pacificar	pɐsifikaɾ
paciência	pɐsjẽsjɐ
pacote	pɐkɔtɨ
pacto	paktu
pactuar	pɐktwaɾ
pacóvio	pakɔvju
padaria	paðɐɾiɐ
padeiro	padɐjɾu
padoca	padɔka
padrasto	pɐdɾaʃtu
padre	paðɾɨ
padrinho	pɐðɾiɲu
padroeiro	pɐðɾwɐjɾu
pagamento	pɐɣɐmẽtu
pagar	pɐɣaɾ
pagode	pɐɣɔðɨ
pagão	pɐɣɐ̃w̃
pai	paj
painel	pajnɛɫ
painço	pɐĩsu
pairar	pajɾaɾ
pais	pajʃ
paisagem	pajzaʒɐ̃j̃
paixão	pajʃɐ̃w̃
pajem	paʒɐ̃j̃
pajem	paʒẽj̃
pajubá	paʒuba
pajé	paʒɛ
palacete	pɐlɐsetɨ
paladar	pɐlɐðaɾ
palanquim	palɐ̃kĩ
palavra	pɐlavɾɐ
palavras	pɐlavɾɐʃ
palco	paɫku
palha	paʎɐ
palhaço	paʎasu
palito	pɐlitu
palmas	paɫmɐʃ
palmela	pɐɫmɛlɐ
palmou	pawmow
palácio	pɐlasju
palíndromo	pɐlĩdrumu
pamonha	pamoɲa
pandeiro	pɐ̃dɐjɾu
panela	pɐnɛlɐ
panfleto	pɐ̃fletu
pano	pɐnu
panos	pɐnuʃ
pantomima	pɐ̃tumimɐ
pança	pɐ̃sɐ
papa	papɐ
papagaio	pɐpɐɣaju
papar	pɐpaɾ
paparazzo	papaɾatsu
paparicar	pɐpɐɾikaɾ
paparicho	papaɾiʃu
paparrotão	papaʁotɐ̃w̃
papel	pɐpɛɫ
papelão	pɐpɨlɐ̃w̃
papo	papu
papoila	pɐpojlɐ
papoula	pɐpowlɐ
papão	pɐpɐ̃w̃
papéis	pɐpɛjʃ
paquera	pakɛɾa
paquerar	pakeɾaɾ
paquerar	pakeɾaʁ
par	paɾ
para	paɾɐ
para	pɐɾɐ
parabéns	pɐɾɐβɐ̃j̃ʃ
parado	pɐɾaðu
parafuso	pɐɾɐfuzu
paragem	pɐɾaʒɐ̃j̃
paralelo	pɐɾɐlɛlu
parando	pɐɾɐ̃du
parapeito	pɐɾɐpɐjtu
paraquedas	paɾɐkɛðɐʃ
parar	pɐɾaɾ
parara	pɐɾaɾɐ
parará	pɐɾɐɾa
paraíso	pɐɾɐizu
parceiro	pɐɾsejɾu
parceiro	pɐɾsɐjɾu
parcelar	pɐɾsɨlaɾ
parcial	pɐɾsjaɫ
parcialmente	pɐɾsiaɫmẽtɨ
pardal	pɐɾðaɫ
pardo	paɾðu
parece	pɐɾɛsɨ
parecer	pɐɾɨseɾ
pareceu	pɐɾɨsew
parecia	pɐɾɨsiɐ
pareciam	pɐɾɨsiɐ̃w̃
parecido	pɐɾɨsiðu
parede	pɐɾeðɨ
paredes	pɐɾeðɨʃ
parente	pɐɾẽtɨ
parestesia	paɾestezia
parestesia	paɾeʃtezia
parir	pɐɾiɾ
parlapatice	paɾlapatʃisi
parlapatão	paɾlapatɐ̃w̃
parolar	pɐɾulaɾ
parou	pɐɾow
parque	paɾkɨ
parra	paʁa
parrudo	paʁudu
parte	paɾtɨ
partes	paɾtɨʃ
participar	pɐɾtisipaɾ
particular	pɐɾtikulaɾ
particularmente	pɐɾtikulaɾmẽtɨ
partida	pɐɾtiðɐ
partido	pɐɾtiðu
partidário	pɐɾtiðaɾju
partilhar	pɐɾtiʎaɾ
partir	pɐɾtiɾ
parvo	paɾvu
pascácio	pajʃkasju
pascácio	paskasju
paspalho	paspaʎu
passa	pasɐ
passado	pɐsaðu
passados	pɐsaðuʃ
passagem	pɐsaʒɐ̃j̃
passando	pɐsɐ̃du
passar	pɐsaɾ
passara	pɐsaɾɐ
passaralho	pasaraʎu
passaralho	pɐsɐrɐʎu
passaram	pɐsaɾɐ̃w̃
passarinheiro	pɐsɐɾiɲɐjɾu
passarinho	pɐsɐɾiɲu
passará	pɐsɐɾa
passava	pɐsavɐ
passeando	pɐsjɐ̃du
passear	pɐsjaɾ
passeio	pɐsɐju
passo	pasu
passos	pasuʃ
passou	pɐsow
pastel	pɐʃtɛɫ
pastelaria	pɐʃtɨlɐɾiɐ
pasteleiro	pɐʃtɨlɐjɾu
pastor	pɐʃtoɾ
pata	patɐ
patamar	pɐtɐmaɾ
patas	patɐʃ
patinete	patʃinɛtʃi
pato	patu
patota	patɔtɐ
patrazana	patɾazɐ̃na
patriarca	pɐtɾiaɾkɐ
património	pɐtɾimɔnju
patrono	pɐtɾonu
patrão	pɐtɾɐ̃w̃
patrício	pɐtɾisju
pau	paw
paul	pɐuɫ
paus	pawʃ
pausa	pawzɐ
pauta	pawtɐ
pavimento	pɐvimẽtu
pavor	pɐvoɾ
pavão	pɐvɐ̃w̃
paz	paʃ
pazes	pazɨʃ
paço	pasu
país	pɐiʃ
pc	pese
pec	pɛki
pecado	pɨkaðu
pedaço	pɨðasu
pedido	pɨðiðu
pedir	pɨdiɾ
pediu	pɨðiw
pedra	pɛðɾɐ
pedraria	pɨðɾɐɾiɐ
pedras	pɛðɾɐʃ
pedregulho	pɨðɾɨɣuʎu
pedreira	pɨðɾɐjɾɐ
pedreiro	pɨðɾɐjɾu
pega	peɣɐ
pega	pɛɣɐ
pegajoso	pɨɣɐʒozu
pegar	pɨɣaɾ
pego	peɣu
pego	pɛɣu
peguete	peɡɛtʃi
peito	pɐjtu
peitudo	pɐjtudu
peixe	pejʃɨ
peixe	pɐjʃɨ
pela	pelɐ
pela	pɛlɐ
pelado	pɨlaðu
pelar	pɨlaɾ
pelas	pelɐʃ
pele	pɛlɨ
pelo	pelu
pelo	plu
pelo	pɛlu
pelo	pɨlu
pelos	peluʃ
pelourinho	pɨlowɾiɲu
pelouro	pɨlowɾu
peluche	pɨluʃɨ
peludo	pɨluðu
pelúcia	pelusja
pena	penɐ
pena	pɛnɐ
penacova	pɨnɐkɔvɐ
penafiel	pɨnɐfiɛɫ
penal	penaɫ
penamacor	penɐmɐkoɾ
penar	pɨnaɾ
penas	penɐʃ
pender	pẽdeɾ
pendurar	pẽduɾaɾ
pendão	pẽdɐ̃w̃
penedo	pɨnedu
penedono	pɨnɨðonu
penela	pɨnɛlɐ
penha	pejɲɐ
penha	peɲɐ
penha	pɐjɲɐ
penha	pɐɲɐ
penhasco	pɨɲaʃku
penhascos	pɨɲaʃkuʃ
peniche	pniʃ
penicilina	pɨnisilinɐ
penico	pɨniku
peninsular	penĩsulaɾ
penitência	pɨnitẽsjɐ
pensamento	pẽsɐmẽtu
pensamentos	pẽsɐmẽtuʃ
pensando	pẽsɐ̃du
pensar	pẽsaɾ
pensativo	pẽsɐtivu
pensava	pẽsavɐ
penso	pẽsu
pensoso	pẽsozu
pensou	pẽsow
pente	pẽtɨ
penteado	pẽtjaðu
pentear	pẽtjaɾ
pentelho	pẽteʎu
pentelho	pẽtɐjʎu
pentágono	pẽtaɣunu
penumbra	pɨnũbɾɐ
península	pɨnĩsulɐ
pepino	pepinu
pepino	pipinu
pequena	pɨkenɐ
pequenino	pɨkɨninu
pequeno	pɨkenu
pera	peɾɐ
pera	pɛɾɐ
peraí	pɛɾai
perca	peɾkɐ
perca	pɛɾkɐ
perceber	pɨɾsɨbeɾ
perceção	pɨɾsɛsɐ̃w̃
percorrer	pɨɾkuʁeɾ
perda	peɾðɐ
perder	pɨɾðeɾ
perdida	pɨɾðiðɐ
perdidamente	pɨɾðiðɐmẽtɨ
perdido	pɨɾðiðu
perdição	pɨɾðisɐ̃w̃
perdoar	pɨɾdwaɾ
perdulário	peɾdulaɾju
perdão	pɨɾdɐ̃w̃
pereba	peɾɛbɐ
perecibilidade	peresibilidadʒi
pereira	pɨɾejɾɐ
pereira	pɨɾɐjɾɐ
perene	pɨɾɛnɨ
perentoriamente	pɨɾẽtɔɾjɐmẽtɨ
perentório	pɨɾẽtɔɾju
perfeitamente	pɨɾfɐjtɐmẽtɨ
perfeito	pɨɾfɐjtu
perfeição	pɨɾfejsɐ̃w̃
perfeição	pɨɾfɐjsɐ̃w̃
perfil	pɨɾfiɫ
pergunta	pɨɾɣũtɐ
perguntando	pɨɾɣũtɐ̃du
perguntar	pɨɾɣũtaɾ
perguntas	pɨɾɣũtɐʃ
perguntava	pɨɾɣũtavɐ
perguntou	pɨɾɣũtow
perigo	pɨɾiɣu
perigoso	pɨɾiɣozu
permanecer	pɨɾmɐnɨseɾ
permitir	pɨɾmitiɾ
perna	pɛɾnɐ
pernas	pɛɾnɐʃ
pernóstico	peɾnɔstʃiku
perpendicular	pɨɾpẽdikulaɾ
perplexo	peɾplɛksu
perplexo	peʁplɛksu
perro	peʁu
persa	pɛɾsɐ
perseguir	pɨɾsɨɣiɾ
perseguição	pɨɾsɨɣisɐ̃w̃
personagem	pɨɾsunaʒɐ̃j̃
perspetiva	pɨɾʃpɛtiva
perspetivar	pɨɾʃpɛtivaɾ
pertencer	pɨɾtẽseɾ
perto	pɛɾtu
perturbado	pɨɾtuɾβaðu
perturbador	pɨɾtuɾβaðoɾ
perturbar	perturbar
perturbação	pɨɾtuɾβɐsɐ̃w̃
peru	pɨɾu
peruca	pɨɾukɐ
perversão	pɨɾvɨɾsɐ̃w̃
período	pɨɾiuðu
perónio	pɨɾɔnju
pesadelo	pɨzɐdelu
pesado	pɨzaðu
pesados	pɨzaðuʃ
pesagem	pɨzaʒɐ̃j̃
pesar	pɨzaɾ
pesca	pɛʃkɐ
pescador	pɨʃkɐðoɾ
pescoço	pɨʃkosu
peso	pezu
peso	pɛzu
pesquisar	pɨʃkizaɾ
pessoa	pɨsoɐ
pessoal	pɨswaɫ
pessoalmente	pɨswaɫmẽtɨ
pessoas	pɨsoɐʃ
pestana	pɨʃtɐnɐ
pestanas	pɨʃtɐnɐʃ
peste	pɛʃtɨ
peteminion	peteminiõ
peteminion	peteminjõ
petróleo	pɨtɾɔlju
petúnia	pɨtunjɐ
pezinho	peziɲu
pezinho	pɛziɲu
peão	pjɐ̃w̃
peça	pɛsɐ
peçonha	pɨsoɲɐ
pi	pi
pianinho	piɐniɲu
piano	pjɐnu
piaçaba	pjasaβɐ
picadeiro	pikadejɾu
picante	pikɐ̃tɨ
picar	pikaɾ
picareta	pikɐɾetɐ
pichação	piʃasɐ̃w̃
picho	piʃu
pico	piku
picolé	pikolɛ
piedade	pjɛðaðɨ
piedoso	pjɛðozu
piemonte	pjɨmõtɨ
pigídio	piʒidju
pijama	piʒɐmɐ
pilar	pilaɾ
pilha	piʎɐ
pilo	pilu
piloto	pilotu
piloto	pilɔtu
pimenta	pimẽtɐ
pimento	pimẽtu
pimentão	pimẽtɐ̃w̃
pimpão	pĩpɐ̃w̃
pincel	pĩsɛɫ
pindaíba	pindaibɐ
pingo	pĩɡu
pingolim	pĩɡulĩ
pinguim	pĩɡwĩ
pinha	piɲɐ
pinheiro	piɲejɾu
pinheiro	piɲɐjɾu
pinhel	piɲɛɫ
pinho	piɲu
pinoia	pinɔja
pinque	pĩkɨ
pinta	pĩtɐ
pintar	pĩtaɾ
pintassilgo	pĩtɐsiɫɣu
pinto	pĩtu
pintor	pĩtoɾ
pintura	pĩtuɾɐ
pinturesco	pĩtuɾeʃku
pináculo	pinakulu
piolho	pioʎu
piolho	pjoʎu
pior	pjɔɾ
piorar	pjuɾaɾ
pipa	pipɐ
pipi	pipi
pipoca	pipɔkɐ
pique	piki
pira	piɾɐ
pirata	piɾatɐ
pires	piɾis
pires	piɾɨʃ
piriguete	peɾiɡɛtʃi
piriguete	piɾiɡɛtʃi
pirilampo	piɾilɐ̃pu
piroxena	piɾɔksɛnɐ
pirralho	piʁaʎu
pirão	piɾɐ̃w̃
pisar	pɨzaɾ
piscar	piʃkaɾ
piscina	piʃsinɐ
piso	pizu
pistola	piʃtɔlɐ
pitaco	pitaku
pito	pitu
pitoresco	pituɾeʃku
pitéu	pitɛw
pivete	pivɛtʃi
pizza	pizɐ
piá	pia
pião	pjɐ̃w̃
placar	plakar
placar	plɐkar
placebo	plasebu
placenta	plasẽtɐ
plaina	plajnɐ
planear	plɐnjaɾ
planeta	plɐnetɐ
plano	plɐnu
planta	plɐ̃tɐ
plantar	plɐ̃taɾ
plantação	plɐ̃tɐsɐ̃w̃
plataforma	plɐtɐfɔɾmɐ
plateia	plɐtɐjɐ
plateia	plɐtɛjɐ
pleito	plejtu
plotador	plotadoɾ
plotador	plotadoʁ
plotadora	plotadoɾa
plotagem	plotaʒi
plotagem	plotaʒɐ̃
plotar	plotaɾ
plotar	plotaʁ
plural	pluɾal
plutão	plutɐ̃w̃
plutónio	plutɔniu
plátano	platɐnu
pneu	pnew
poaense	poaẽsi
pobre	pɔβɾɨ
pobres	pɔβɾɨʃ
pobreza	puβɾezɐ
pobrezinho	pɔβɾɨziɲu
pode	pɔðɨ
podem	pɔðɐ̃j̃
podemos	puðemuʃ
podendo	puðẽdu
poderia	puðɨɾiɐ
poderoso	puðɨɾozu
podes	pɔdɨʃ
podes	pɔðɨʃ
podia	puðiɐ
podre	poðɾɨ
podrão	podɾɐ̃w̃
poeira	pwɐjɾɐ
poema	pwemɐ
poente	puẽtɨ
poente	pwẽtɨ
poesia	pwɛziɐ
poeta	pwɛtɐ
poetisa	pwɛtizɐ
poio	poju
pois	pojʃ
polaco	pulaku
polegar	pulɨɣaɾ
poliandria	poliɐ̃dɾia
poliban	pɔlibɐ̃
polichinelo	puliʃinɛlu
polido	puliðu
poligamia	poliɡɐ̃mia
poliginia	poliʒinia
poligâmico	poliɡɐ̃miku
polimento	pulimẽtu
polir	puliɾ
poliuria	pɔliuɾia
polivalente	polivalẽtʃi
poliúria	pɔliuɾja
polo	polu
polo	pulu
polo	pɔlu
poltrona	poɫtɾonɐ
poltrona	puɫtɾonɐ
poluir	pulwiɾ
poluição	pulwisɐ̃w̃
polução	pulusɐ̃w̃
polvilho	pɔlviʎu
polvo	poɫvu
polícia	pulisjɐ
políptico	puliptiku
política	pulitikɐ
político	pulitiku
polónia	pulɔnjɐ
pomada	pumaðɐ
pomba	põbɐ
pombal	põbaɫ
pompom	põpõ
poncho	põʃu
pondera	põdɛɾa
pondo	põdu
ponta	põtɐ
pontapé	põtɐpɛ
pontas	põtɐʃ
ponte	põtɨ
ponteiro	põtɐjɾu
pontiagudo	põtjɐɣuðu
ponto	põtu
pontualmente	põtwaɫmẽtɨ
pontuar	põtwaɾ
pontuação	põtwɐsɐ̃w̃
popularizar	pupulɐɾizaɾ
população	pupulɐsɐ̃w
por	poɾ
por	puɾ
porcaria	puɾkɐɾiɐ
porco	poɾku
porcos	pɔɾkuʃ
pornografia	puɾnuɡɾafiɐ
porongo	puɾõɡu
porque	puɾkɨ
porquê	puɾke
porrete	poʁetʃi
porta	pɔɾtɐ
portada	puɾtaðɐ
portal	puɾtaɫ
portalegre	puɾtɐlɛɣɾɨ
portanto	puɾtɐ̃tu
portar	puɾtaɾ
portas	pɔɾtɐʃ
porteiro	puɾtɐjɾu
portel	puɾtɛɫ
portimão	puɾtimɐ̃w
porto	poɾtu
porto	pɔɾtu
portugal	puɾtuɣaɫ
portugueses	puɾtuɣezɨʃ
portuguesismo	puɾtuɣɨziʒmu
português	poɾtuɣeʃ
português	puɾtuɣeʃ
portunhol	puɾtuɲɔɫ
portão	puɾtɐ̃w̃
porventura	puɾvẽtuɾɐ
porão	purɐ̃w̃
porém	puɾɐ̃j̃
positivo	puzitivu
posição	puzisɐ̃w̃
possa	pɔsɐ
posse	pɔsɨ
possibilidade	pusibilidadɨ
possibilitar	pusiβilitaɾ
posso	pɔsu
possível	psivɛɫ
possível	pusivɛɫ
postal	puʃtaɫ
poste	pɔʃtɨ
posterioridade	puʃtɨɾjoɾiðaðɨ
posteriormente	puʃtɨɾjoɾmẽtɨ
postigo	puʃtiɣu
pote	pɔtɨ
potencialidade	potẽsjalidadʒi
potro	potɾu
pouca	powkɐ
poucas	powkɐʃ
pouco	powku
poucos	powkuʃ
poupança	powpɐ̃sɐ
poupar	powpar
pousada	powzaðɐ
pousado	powzaðu
pousando	powzɐ̃du
pousar	powzaɾ
poveiro	pɔvejɾu
povo	povu
povoar	puvwaɾ
povoação	puvuɐsɐ̃w
povos	pɔvus
poça	posɐ
poça	pɔsɐ
poço	posu
poção	pusɐ̃w̃
pra	pɾɐ
praga	pɾaɣɐ
praia	pɾajɐ
prancha	pɾɐ̃ʃɐ
pranto	pɾɐ̃tu
prata	pɾatɐ
prateado	pɾɐtjaðu
prateleira	pɾɐtɨlɐjɾɐ
praticabilidade	pratʃikabilidadʒi
prato	pɾatu
prazenteiro	pɾɐzẽtejɾu
prazenteiro	pɾɐzẽtɐjɾu
prazer	pɾɐzeɾ
prazo	pɾazu
praça	pɾasɐ
prece	pɾɛsɨ
precedente	pɾɨsɨðẽtɨ
precioso	pɾɨsjozu
precipitadamente	pɾɨsipitaðɐmẽtɨ
precisa	pɾɨsizɐ
precisar	pɾɨsizaɾ
preciso	pɾɨsizu
precisão	pɾɨsizɐ̃w̃
preconceito	pɾɨkõsejtu
preconceito	pɾɨkõsɐjtu
predela	pɾɨðɛlɐ
preeminência	preeminẽsja
prefeito	pɾɨfejtu
prefeito	pɾɨfɐjtu
preferir	pɾɨfɨɾiɾ
prega	pɾɛɣɐ
pregar	pɾɛɣaɾ
pregar	pɾɨɣaɾ
prego	pɾɛɣu
preguiça	pɾɨɣisɐ
preju	pɾeʒu
prejudicar	pɾɨʒuðikaɾ
prejuízo	pɾɨʒwizu
prelado	pɾɨlaðu
premente	pɾemẽtʃi
premiar	pɾɨmjaɾ
prenda	pɾẽdɐ
prender	pɾẽdeɾ
prenhe	pɾeɲɨ
prensa	pɾẽsɐ
preocupar	pɾjɔkupaɾ
preocupação	pɾjɔkupɐsɐ̃w̃
preparado	pɾɨpɐɾaðu
preparar	pɾɨpɐɾaɾ
preparação	pɾɨpɐɾɐsɐ̃w̃
prepotência	pɾɛpotẽsja
presa	pɾezɐ
prescritível	pɾeskritʃivew
presente	pɾɨzẽtɨ
presentear	pɾɨzẽtjaɾ
presença	pɾɨzẽsɐ
presepada	pɾezepada
preservação	pɾɨzɨɾvɐsɐ̃w̃
presidente	pɾɨzidẽtɨ
presilha	pɾiziʎɐ
preso	pɾezu
pressionar	pɾɨsjunaɾ
pressão	pɾɨsɐ̃w̃
presumir	pɾɨzumiɾ
presunto	pɾɨzũtu
presépio	pɾɨzɛpju
preta	pɾetɐ
pretexto	pɾɨtɐjʃtu
pretinho	pɾɨtiɲu
preto	pɾetu
prevenção	pɾɨvẽsɐ̃w̃
previsto	pɾɨviʃtu
previsão	pɾɨvizɐ̃w̃
preço	pɾesu
prima	pɾimɐ
primavera	pɾimɐvɛɾɐ
primaveril	pɾimɐvɨɾiɫ
primeira	pɾimɐjɾɐ
primeiramente	pɾimɐjɾɐmẽtɨ
primeiras	pɾimɐjɾɐʃ
primeiro	pɾimɐjɾu
primeiros	pɾimɐjɾuʃ
primo	pɾimu
princesa	pɾĩsezɐ
principal	pɾĩsipaɫ
principalmente	pɾĩsipaɫmẽtɨ
principiar	prĩsipjar
principiou	pɾĩsipiow
princípio	pɾĩsipiw
princípio	pɾĩsipju
princípios	pɾĩsipjus
print	pɾĩtʃi
prisioneiro	pɾizjunɐjɾu
prisão	pɾizɐ̃w
privado	pɾivadu
privar	pɾivaɾ
privatizar	pɾivɐtizaɾ
privação	pɾivɐsɐ̃w̃
proa	proɐ
probabilidade	pɾuβɐβiliðaðɨ
problema	pɾuβlemɐ
problematizar	pɾuβlɨmɐtizaɾ
problemático	pɾuβlɨmatiku
procedência	pɾusɨðẽsjɐ
processar	pɾusɨsaɾ
processo	pɾusɛsu
procissão	pɾusisɐ̃w̃
procura	pɾɔkuɾɐ
procurando	pɾɔkuɾɐ̃du
procurar	pɾɔkuɾaɾ
procurava	pɾɔkuɾavɐ
procuro	pɾokuɾu
produto	pɾuðutu
produtor	pɾuðutoɾ
produzir	pɾuduziɾ
produção	pɾuðusɐ̃w̃
proeminência	proeminẽsja
proeza	pɾwezɐ
profe	pɾɔfɨ
profecia	pɾufɨsiɐ
professor	pɾufɨsoɾ
profeta	pɾufɛtɐ
profissional	pɾufisjunaɫ
profundamente	pɾufũdɐmẽtɨ
profundidade	pɾufũdiðaðɨ
profundo	pɾufũdu
profícuo	pɾofikwu
programador	pɾuɣɾɐmɐðoɾ
progresso	pɾuɣɾɛsu
proibido	pɾuiβiðu
proibição	pɾuiβisɐ̃w̃
proibição	pɾujβisɐ̃w̃
projete	pɾoʒɛtʃi
projeto	pɾuʒɛtu
projétil	pɾuʒɛtiɫ
promessa	pɾumɛsɐ
promete	pɾomɛtʃi
pronto	pɾõtu
pronuncia	pɾunũsiɐ
pronunciar	pɾonũsjaʁ
pronunciar	pɾunũsjaɾ
pronúncia	pɾunũsjɐ
propaganda	pɾupɐɣɐ̃dɐ
propiciar	prupisjar
proposição	pɾupuzisɐ̃w̃
proposta	pɾupɔʃtɐ
propriedade	pɾupɾiɛðaðɨ
proprietário	pɾupɾiɛtaɾju
propósito	pɾupɔzitu
prosa	pɾɔzɐ
prostituta	pɾɔʃtitutɐ
prostração	pɾostrasɐ̃w̃
proteger	pɾutɨʒeɾ
protelar	pɾotelaɾ
protestante	pɾutɨʃtɐ̃tɨ
protestar	pɾutɨʃtaɾ
protesto	pɾutɛʃtu
proteção	pɾutɛsɐ̃w̃
proteína	pɾutiinɐ
protista	prɔtiʃtɐ
prova	pɾɔvɐ
provar	pɾuvaɾ
provavelmente	pɾuvavɛɫmẽtɨ
proveito	pɾuvejtu
proveito	pɾuvɐjtu
provinha	pɾuviɲɐ
provocador	pɾuvukɐdoɾ
provocar	pɾuvukaɾ
provocatório	pɾuvukɐtɔɾju
provável	pɾuvavɛɫ
província	pɾuvĩsjɐ
prudente	pɾudẽtɨ
prudência	pɾuðẽsjɐ
prácrito	pɾakɾitu
prática	pɾatikɐ
prático	pɾatiku
prédio	pɾɛðju
prémio	pɾɛmju
príncipe	pɾĩsipɨ
príncipe	pɾĩsɨpɨ
pró	pɾɔ
próclise	pɾɔklizi
prólogo	pɾɔluɣu
própria	pɾɔpɾjɐ
próprias	pɾɔpɾjɐʃ
próprio	pɾɔpɾju
próprios	pɾɔpɾjuʃ
próximo	pɾɔsimu
prússia	pɾusja
pseudónimo	psewðɔnimu
psicologia	psikoloʒia
psicológico	psikolɔʒiku
psicóloga	psikɔloɡa
psicólogo	psikɔloɡu
psiquiatria	psikiatɾia
pua	puɐ
publicamente	puβlikɐmẽtɨ
publicano	puβlikɐnu
publicar	puβlikaɾ
publicidade	puβlisiðaðɨ
publicitado	puβlisitaðu
publicitar	puβlisitaɾ
pudera	pudɛɾa
pudesse	puðɛsɨ
pudim	puðĩ
pueril	pwɛɾiɫ
pugnar	puɣɨnaɾ
pulga	puɫɣɐ
pulha	puʎɐ
pulsar	puɫsaɾ
pulsação	puɫsɐsɐ̃w̃
pulseira	puɫsɐjɾɐ
pulso	puɫsu
pulôver	pulovɛɾ
puma	pumɐ
punha	puɲɐ
punhal	puɲaɫ
punheta	puɲetɐ
punhete	puɲɛtʃi
punho	puɲu
punhos	puɲuʃ
pupila	pupilɐ
pureza	puɾezɐ
purga	puɾɣɐ
purificar	puɾifikaɾ
puro	puɾu
purulento	puɾulẽtu
pus	puʃ
puto	putu
puxa	puʃɐ
puxando	puʃɐ̃du
puxar	puʃaɾ
puxou	puʃow
pá	pa
página	paʒinɐ
páli	pali
pálido	paliðu
pálpebra	paɫpɨβɾɐ
pária	paɾjɐ
páscoa	paʃkwɐ
pássaro	pasɐɾu
pátio	patju
pátria	patɾjɐ
pânico	pɐniku
pântano	pɐ̃tɐnu
pães	pɐ̃j̃ʃ
pão	pɐ̃w̃
pé	pɛ
pérola	pɛɾulɐ
pés	pɛʃ
pê	pe
pêssego	pesɨɣu
pílula	pilulɐ
pó	pɔ
pólvora	pɔɫvuɾɐ
pós	pɔʃ
póvoa	pɔvwɐ
pô	po
pôde	poðɨ
pôr	poɾ
pôs	poʃ
põem	põj̃ɐ̃j̃
público	puβliku
púcaro	pukɐɾu
púlpito	puɫpitu
pústula	puʃtulɐ
q	ke
quadra	kwaðɾɐ
quadrado	kwɐðɾaðu
quadro	kwaðɾu
qual	kwaɫ
qualidade	kwɐliðaðɨ
qualquer	kwaɫkɛɾ
quando	kwɐ̃du
quantia	kwɐ̃tiɐ
quantidade	kwɐ̃tiðaðɨ
quanto	kwɐ̃tu
quantos	kwɐ̃tuʃ
quarenta	kwɐɾẽtɐ
quaresma	kwɐɾɛʒmɐ
quarta	kwaɾtɐ
quarto	kwaɾtu
quartos	kwaɾtuʃ
quase	kwazɨ
quati	kwati
quatro	kwatɾu
quatrocentos	kwatɾusẽtuʃ
que	kɨ
quebra	kɛbɾɐ
quebradeira	kɨβɾɐðɐjɾɐ
quebradiço	kɨβɾɐðisu
quebrado	kɨβɾaðu
quebrar	kɨβɾaɾ
queda	kɛðɐ
queijo	kejʒu
queijo	kɐjʒu
queimadura	kɐjmɐðuɾɐ
queimar	kejmaɾ
queimar	kɐjmaɾ
queirós	kɐjɾɔʃ
queixa	kɐjʃɐ
queixo	kɐjʃu
queixume	kɐjʃum
quelónio	kɨlɔnju
quem	kɐ̃j̃
quente	kẽtɨ
queque	kɛkɨ
quer	kɛɾ
quera	kwɛɾa
querem	kɛɾɐ̃j̃
querendo	kɨɾẽdu
querer	kɨɾeɾ
queres	kɛɾɨʃ
queria	kɨɾiɐ
querido	kɨɾiðu
quero	kɛɾu
querubim	kɨɾuβĩ
questionar	kwestʃjonaʁ
questionar	kwestʃonaʁ
questionar	kɨʃtjunaɾ
questão	kɨʃtɐ̃w̃
quieto	kjɛtu
quilha	kiʎɐ
quilo	kilu
quilómetro	kilɔmɨtɾu
quimera	kimɛɾa
quina	kinɐ
quinar	kinaɾ
quinhentos	kiɲẽtuʃ
quinhão	kiɲɐ̃w̃
quinta	kĩtɐ
quintal	kĩtaɫ
quinto	kĩtu
quinze	kĩzɨ
quiosque	kjɔʃkɨ
quiprocó	kipɾokɔ
quiproquó	kipɾokwɔ
quiproquó	kwipɾokwɔ
quis	kiʃ
quiser	kizɛɾ
quisto	kijʃtu
quisto	kistu
quitar	kitaɾ
quite	kitɨ
quitinete	kitʃinɛtʃi
quitute	kituti
quitute	kitutʃi
quivi	kivi
quiçá	kisa
quotidiano	kutiðjɐnu
quotidiano	kɔtiðjɐnu
quão	kwɐ̃w̃
quê	ke
química	kimikɐ
químico	kimiku
quórum	kɔɾũ
qüiproquó	kwipɾokwɔ
rabanada	ʁɐβɐnaðɐ
rabicho	ʁabiʃu
rabino	ʁɐβinu
rabo	ʁabu
racha	ʁaʃɐ
racial	ʁɐsjaɫ
raciocínio	rɐsiusiniu
raciocínio	rɐsjusinju
raciocínio	ʁɐsiusiniu
raciocínio	ʁɐsjusinju
racional	ʁɐsjunal
radical	ʁɐðikaɫ
ragu	ʁaɡu
raia	ʁajɐ
raiano	ʁajɐnu
raiar	ʁajaɾ
rainha	ʁɐiɲɐ
raio	ʁaju
raiva	ʁajvɐ
raiz	ʁɐiʃ
rajada	ʁɐʒaðɐ
rali	ʁali
ralé	ʁɐlɛ
ramagem	ʁɐmaʒɐ̃j̃
ramagens	ʁɐmaʒɐ̃j̃ʃ
ramificação	ʁɐmifikɐsɐ̃w̃
ramo	ʁɐmu
ramos	ʁɐmuʃ
rampa	ʁɐ̃pɐ
rancor	ʁɐ̃koɾ
ranger	ʁɐ̃ʒeɾ
rango	rɐ̃ɡu
rango	ʁɐ̃ɡu
ranço	ʁɐ̃su
rapadura	ʁɐpɐðuɾɐ
rapar	ʁɐpaɾ
rapariga	ʁɐpɐɾiɣɐ
rapaz	ʁɐpaʃ
rapazes	ʁɐpazɨʃ
rapaziada	ʁɐpɐzjaðɐ
rapidamente	ʁapiðɐmẽtɨ
raposa	ʁɐpozɐ
rapto	ʁaptu
raquete	ʁakɛtɨ
raro	ʁaɾu
raspar	ʁɐʃpaɾ
rasuro	ʁazuɾu
ratazana	ʁɐtɐzɐnɐ
rato	ʁatu
razão	ʁɐzɐ̃w̃
razões	ʁɐzõj̃ʃ
raça	ʁasɐ
ração	ʁɐsɐ̃w̃
reagir	ʁiɐʒiɾ
real	ʁjaɫ
realidade	ʁjɐliðaðɨ
realmente	ʁjaɫmẽtɨ
realçar	ʁjaɫsaɾ
reativação	riativɐsɐ̃w
reativação	rɨativɐsɐ̃w
reativação	ʁiativɐsɐ̃w
reativação	ʁɨativɐsɐ̃w
reator	ʁjatoɾ
reação	ʁjasɐ̃w̃
rebanho	ʁɨβɐɲu
rebentar	ʁɨβẽtaɾ
rebobinar	ʁɨβuβinaɾ
recado	ʁɨkaðu
recalcar	ʁɨkaɫkaɾ
recanto	ʁɨkɐ̃tu
recato	ʁɨkatu
recear	ʁɨsjaɾ
receber	ʁɨsɨβeɾ
recebera	ʁɨsɨβeɾɐ
receberá	ʁɨsɨβɨɾa
recebido	ʁɨsɨβiðu
receio	ʁɨsɐju
receita	ʁɨsejtɐ
receita	ʁɨsɐjtɐ
receitar	ʁɨsɐjtaɾ
receoso	ʁɨsjozu
recetor	ʁɨsɛtoɾ
receção	ʁɨsɛsɐ̃w̃
recibo	ʁɨsiβu
reciclar	ʁɨsiklaɾ
recinto	ʁesĩntu
recipiente	ʁɨsipjẽtɨ
recitar	ʁɨsitaɾ
reclinou	ʁeklinow
reco	ʁɛku
recolher	ʁɨkuʎeɾ
recombinação	ʁɨkõbinɐsɐ̃w̃
recompensa	ʁɨkõpẽsɐ
reconhecer	ʁɨkuɲɨseɾ
recordação	ʁɨkuɾðɐsɐ̃w̃
recostou	ʁekostow
recuar	ʁɨkwaɾ
recurso	ʁɨkuɾsu
recusar	ʁɨkuzaɾ
redação	ʁɨðasɐ̃w̃
rede	ʁeðɨ
redenção	ʁɨðẽsɐ̃w̃
redobrar	ʁɨðuβɾaɾ
redondo	ʁɨdõdu
redondo	ʁɨðõdu
redor	ʁɨðɔɾ
redundância	ʁɨðũdɐ̃sjɐ
reduzir	ʁɨðuziɾ
refeição	ʁɨfɐjsɐ̃w̃
refletir	ʁɨflɛtiɾ
reflexo	ʁɨflɛksu
reflexão	ʁɨflɛksɐ̃w̃
reflexão	ʁɨflɛsɐ̃w̃
reforma	ʁɨfɔɾmɐ
reformista	ʁɨfɔɾmiʃtɐ
reforçar	ʁɨfuɾsaɾ
reforço	ʁɨfoɾsu
refrescar	ʁɨfɾɨʃkaɾ
refresco	ʁɨfɾeʃku
refém	ʁɨfɐ̃j̃
regalo	ʁɨɣalu
regata	ʁɨɡatɐ
regente	ʁɨʒẽtɨ
regime	ʁɨʒimɨ
registar	ʁɨʒiʃtaɾ
registo	ʁɨʒiʃtu
regra	ʁɛɣɾɐ
regressar	ʁɨɣɾɨsaɾ
regresso	ʁɨɣɾɛsu
regulamento	ʁɨɣulɐmẽtu
regular	ʁɨɣulaɾ
regularidade	ʁɨɣulɐɾiðaðɨ
regímen	ʁɨʒimɛn
rei	ʁej
rei	ʁɐj
reino	ʁejnu
reino	ʁɐjnu
reis	ʁɐjʃ
rejuvenescer	ʁɨʒuvɨnɨʃseɾ
relacionado	ʁɨlɐsjunaðu
relacionamento	ʁɨlɐsjunɐmẽtu
relacionar	ʁɨlɐsjunaɾ
relance	ʁɨlɐ̃sɨ
relatar	ʁɨlɐtaɾ
relativamente	ʁɨlɐtivɐmẽtɨ
relato	ʁɨlatu
relação	ʁɨlɐsɐ̃w
relações	ʁɨlɐsõj̃ʃ
reles	ʁɛlɨʃ
relicário	ʁɨlikaɾju
religiosidade	ʁɨliʒjuziðaðɨ
religioso	ʁɨliʒjozu
religião	ʁɨliʒjɐ̃w̃
relojoeiro	ʁɨluʒwɐjɾu
relva	ʁɛɫvɐ
relâmpago	ʁɨlɐ̃pɐɣu
relíquia	ʁɨlikjɐ
relógio	ʁɨlɔʒiu
relógio	ʁɨlɔʒju
remanejamento	ʁemaneʒamẽtu
remanejar	ʁemaneʒaɾ
remela	ʁɨmɛlɐ
remendo	ʁɨmẽdu
remete	ʁemɛtʃi
remo	ʁemu
remo	ʁɛmu
remoer	ʁɨmweɾ
remoinho	ʁɨmwiɲu
remorso	ʁɨmɔɾsu
remoto	ʁɨmɔtu
remover	ʁɨmuveɾ
remédio	ʁɨmɛðju
rena	ʁenɐ
renda	ʁẽdɐ
rendas	ʁẽdɐʃ
rendição	ʁẽdisɐ̃w̃
renegado	ʁɨnɨɣaðu
renunciar	rɨnũsiaɾ
renunciar	ʁɨnũsiaɾ
reparar	ʁɨpɐɾaɾ
reparação	ʁɨpɐɾɐsɐ̃w̃
repartir	ʁɨpɐɾtiɾ
repartição	ʁɨpɐɾtisɐ̃w̃
repetidamente	ʁɨpɨtiðɐmẽtɨ
repetir	ʁɨpɨtiɾ
reportagem	ʁɨpuɾtaʒɐ̃j̃
reportar	ʁɨpuɾtaɾ
repouso	ʁɨpowzu
represa	ʁɨpɾezɐ
represa	ʁɨpɾɛzɐ
representando	ʁɨpɾɨzẽtɐ̃du
representante	ʁɨpɾɨzẽtɐ̃tɨ
representar	ʁɨpɾɨzẽtaɾ
representativo	ʁɨpɾɨzẽtɐtivu
representação	ʁɨpɾɨzẽtɐsɐ̃w̃
reprise	reprizi
reprodutor	ʁɨpɾuðutoɾ
reproduzir	ʁɨpɾuðuziɾ
reprodução	ʁɨpɾuðusɐ̃w̃
repórter	ʁɨpɔɾtɛɾ
república	ʁɛpuβlikɐ
requinte	ʁɨkĩtɨ
resende	ʁɛzẽdɨ
reserva	ʁɨzɛɾvɐ
reservar	ʁɨzɨɾvaɾ
reset	ʁezɛtʃi
resetar	rezetaɾ
resete	ʁezɛtʃi
residente	ʁɨzidẽtɨ
residência	ʁɨziðẽsjɐ
resignar	ʁɨziɣnaɾ
resignação	ʁɨziɡnɐsɐ̃w̃
resina	ʁɨzinɐ
resistir	ʁiziʃtiɾ
resistência	ʁɨziʃtẽsjɐ
resolução	ʁɨzulusɐ̃w̃
resolver	ʁɨzoɫveɾ
respeitar	ʁɨʃpejtaɾ
respeitar	ʁɨʃpɐjtaɾ
respeito	ʁɨʃpɐjtu
respeitosamente	ʁɨʃpɐjtɔzɐmẽtɨ
respeitável	ʁɨʃpɐjtavɛɫ
respirar	ʁɨʃpiɾaɾ
respiração	ʁɨʃpiɾɐsɐ̃w̃
resplandecente	ʁɨʃplɐ̃dɨsẽtɨ
responder	ʁɨʃpõdeɾ
respondeu	ʁɨʃpõdew
responsabilidade	ʁɨʃpõsɐβiliðaðɨ
responsabilidade	ʁɨʃpõsɐβliðaðɨ
responsável	ʁɨʃpõsavɛɫ
resposta	ʁɨʃpɔʃtɐ
ressarcimento	ʁessaɾsimẽtu
resseção	ʁɨsɛksɐ̃w̃
ressignificar	ʁesiɡnifikaɾ
resto	ʁɛʃtu
resultado	ʁɨzuɫtaðu
resultante	ʁɨzuɫtɐ̃tɨ
resumir	ʁɨzumiɾ
resumo	ʁɨzumu
reta	ʁɛtɐ
retalho	ʁɨtaʎu
retardar	ʁɨtɐɾðaɾ
retirar	rɨtiɾaɾ
retirar	ʁɨtiɾaɾ
reto	ʁɛtu
retornado	ʁɨtuɾnaðu
retrasado	ʁetɾazadu
retrato	ʁɨtɾatu
retrógrado	ʁɨtɾɔɣɾɐðu
retábulo	ʁɨtaβulu
reunir	ʁjuniɾ
reunião	ʁjunjɐ̃w̃
revelar	ʁɨvɨlaɾ
revelação	ʁɨvɨlɐsɐ̃w̃
revestimento	ʁɨvɨʃtimẽtu
revestir	ʁɨvɨʃtiɾ
revezar	ʁevezaɾ
revista	ʁɨviʃtɐ
revisão	ʁɨvizɐ̃w̃
revolto	ʁɨvoɫtu
revolução	ʁɨvulusɐ̃w̃
revés	ʁɨvɛʃ
revólver	ʁɨvɔɫvɨɾ
rezar	ʁɨzaɾ
rezende	ʁezẽdʒi
ria	ʁiɐ
ribatejo	ʁiβɐtɛʒu
ribeira	ʁiβɐjɾɐ
ribeiro	ʁibɐjɾu
rica	ʁikɐ
ricamente	ʁikɐmẽtɨ
rico	ʁiku
ridiculamente	ʁɨðikulɐmẽtɨ
ridículo	ʁiðikulu
rifa	ʁifɐ
rigidamente	ʁiʒiðɐmẽtɨ
rijo	ʁiʒu
rilhar	ʁiʎaɾ
rim	ʁĩ
rindo	ʁĩdu
rinoceronte	ʁinɔsɨɾõtɨ
rio	ʁiu
ripostou	ʁipostow
riqueza	ʁikezɐ
rir	ʁiɾ
risada	ʁizaðɐ
risco	ʁiʃku
riso	ʁizu
risonho	ʁizoɲu
ritmo	ʁitmu
rito	ʁitu
ritual	ʁitwaɫ
riu	ʁiw
rivalidade	ʁivɐliðaðɨ
riável	ɾiavɛɫ
roca	ʁɔkɐ
rocha	ʁɔʃɐ
rocim	ʁusĩ
rock	ʁɔk
roda	ʁɔðɐ
rodapé	ʁɔdɐpɛ
rodar	ʁudaɾ
rodas	ʁɔðɐʃ
rodeado	ʁuðjaðu
rodo	ʁoðu
rodo	ʁɔðu
rodrigo	ʁudɾiɡu
rodrigues	ʁudɾiɡɨʃ
roer	ʁueɾ
roer	ʁweɾ
rogar	ʁuɣaɾ
rojão	ʁoʒɐ̃w̃
rola	ʁola
rola	ʁɔla
rolar	ʁulaɾ
rolha	ʁoʎɐ
rolo	ʁolu
rom	ʁõ
rom	ʁɔm
romaji	ʁumɐʒi
romance	ʁumɐ̃sɨ
romano	ʁumɐnu
rombo	rõbu
rombo	ʁõbu
romper	ʁõpeɾ
rompeu	ʁõpew
romântico	ʁumɐ̃tiku
romã	ʁumɐ̃
roménia	ʁumɛnjɐ
ronco	ʁõku
ronda	ʁõdɐ
ronrom	ʁõʁõ
ronrono	ʁõʁonu
ronrons	ʁõʁõjʃ
ronrons	ʁõʁõs
rosa	ʁɔzɐ
rosado	ʁuzaðu
rosas	ʁɔzɐʃ
rosca	ʁoskɐ
roseira	ʁuzejɾɐ
roseira	ʁuzɐjɾɐ
rosmaninho	ʁuʒmɐniɲu
rosto	ʁoʃtu
rosácea	ʁuzasjɐ
rotura	ʁutuɾɐ
roubar	ʁowβaɾ
roubo	ʁowβu
rouco	ʁowku
roupa	ʁopɐ
roupa	ʁowpɐ
roupas	ʁowpɐʃ
rouxinol	ʁowʃinɔɫ
rovaniemi	ʁuvɐnjɛmi
roça	ʁɔsɐ
roçar	ʁusaɾ
rua	ʁuɐ
ruas	ʁuɐʃ
rubi	ʁubi
ruga	ʁuɣɐ
rugir	ʁuʒiɾ
ruim	ʁuĩ
ruivo	ʁujvu
rumo	ʁumu
runa	ʁunɐ
ruptura	ʁuptuɾɐ
russo	ʁusu
rutilo	ʁutilɐ
ruído	ʁwiðu
ruína	ʁuinɐ
ruína	ʁwinɐ
rádio	ʁaðju
rápido	ʁapiðu
râguebi	ʁɐɣɨβi
rã	ʁɐ̃
ré	ʁɛ
rédea	ʁɛðjɐ
régua	ʁɛɣwɐ
réptil	ʁɛptiɫ
réu	ʁɛw
rígido	ʁiʒiðu
rítmico	ʁitmiku
rótula	ʁɔtula
rótulo	ʁɔtulu
rússia	rusja
rússia	ʁusja
sabe	sabɨ
sabedor	sɐβɨðoɾ
sabedoria	sɐβɨðuɾiɐ
sabem	saβɐ̃j̃
sabemos	sɐβemuʃ
sabendo	sɐβẽdu
saber	sɐbeɾ
sabes	saβɨʃ
sabia	sɐβiɐ
sabido	sɐβiðu
sabonete	sɐβunetɨ
sabor	sɐboɾ
saborear	sɐbuɾjaɾ
saboroso	sɐβuɾozu
sabrosa	sɐβɾɔzɐ
sabugal	sɐβuɣaɫ
sabugo	sɐbuɡu
sabão	sɐβɐ̃w̃
saca	sakɐ
sacar	sɐkaɾ
sacerdote	sɐsɨɾdɔtɨ
sacerdócio	sɐsɨɾðɔsju
sacho	saʃu
saco	saku
sacola	sɐkɔlɐ
sacolé	sakolɛ
sacramento	sɐkɾɐmẽtu
sacrifício	sɐkɾifisiu
sacrifício	sɐkɾifisju
sacristia	sakɾiʃtiɐ
sacro	sakɾu
sacrossanto	sakɾusɐ̃tu
sacrário	sɐkɾaɾju
sacudir	sɐkuðiɾ
sadio	saðiu
sado	saðu
safa	safɐ
safar	sɐfaɾ
safra	safɾɐ
sagrado	sɐɣɾaðu
sagrar	sɐɣɾaɾ
sagu	sɐɣu
saguão	saɡwɐ̃w̃
sai	saj
saia	sajɐ
saias	sajɐʃ
saibro	sajβɾu
saindo	sɐĩdu
saiote	sajɔtʃi
sair	sɐiɾ
sais	sajʃ
saiu	sɐiw
sal	saɫ
sala	salɐ
salada	sɐlaðɐ
salamaleque	sɐlɐmɐlɛkɨ
salamandra	sɐlɐmɐ̃dɾɐ
salas	salɐʃ
salazar	sɐlɐzaɾ
saleta	sɐletɐ
salga	salɣɐ
salgado	saɫɣaðu
salgueiro	saɫɡejɾu
salgueiro	saɫɡɐjɾu
saliva	saliva
salmo	saɫmu
salmoura	saɫmowɾɐ
salsa	saɫsɐ
salsicha	saɫsiʃɐ
salsinha	saɫsiɲɐ
saltar	saɫtaɾ
salto	saɫtu
saltou	saɫtow
salva	saɫvɐ
salvar	saɫvaɾ
salvação	saɫvɐsɐ̃w̃
salvo	saɫvu
salário	sɐlaɾiu
salário	sɐlaɾju
salão	sɐlɐ̃w̃
samba	sɐ̃bɐ
samo	samu
sanar	sɐnaɾ
sanatório	sɐnɐtɔɾju
sandes	sɐ̃dɨʃ
sandeu	sɐ̃dew
sanduíche	sɐ̃duiʃɨ
sanduíche	sɐ̃dwiʃɨ
sandália	sɐ̃daljɐ
sandálias	sɐ̃daljɐʃ
saneamento	sɐnjɐmẽtu
sanfona	sɐ̃fonɐ
sangramento	sɐ̃ɡɾɐmẽtu
sangrar	sɐ̃ɡɾaɾ
sangrento	sɐ̃ɡɾẽtu
sangria	sɐ̃ɡɾiɐ
sangue	sɐ̃ɡɨ
sanguento	sɐ̃ɡwẽtu
sanguessuga	sɐ̃ɡɨsuɣɐ
sansão	sɐ̃sɐ̃w̃
santa	sɐ̃tɐ
santana	sɐ̃tɐnɐ
santarém	sɐ̃tɐɾɐ̃j̃
santarém	sɐ̃tɐɾẽj̃
santidade	sɐ̃tiðaðɨ
santo	sɐ̃tu
santos	sɐ̃tuʃ
santuário	sɐ̃tuaɾiu
santuário	sɐ̃tuaɾju
sanção	sɐ̃sɐ̃w̃
sapateado	sɐpɐtjaðu
sapatilha	sɐpɐtiʎɐ
sapato	sɐpatu
sapatos	sɐpatuʃ
sapo	sapu
sarado	saɾadu
saragoça	sɐɾɐɣɔsɐ
saraiva	sɐɾajvɐ
saraivada	sɐɾajvaðɐ
saraivar	sɐɾajvaɾ
sarar	sɐɾaɾ
sarcasmo	sɐɾkaʒmu
sardinha	sɐɾðiɲɐ
sardoal	sɐɾðuaɫ
sardão	sɐɾðɐ̃w̃
sargaço	sɐɾɣasu
sargento	sɐɾʒẽtu
sarilho	sɐɾiʎu
sarrabulho	sɐʁɐβuʎu
sarça	saɾsɐ
satisfazer	sɐtiʃfɐzeɾ
satisfação	sɐtiʃfɐsɐ̃w̃
satisfeito	sɐtiʃfɐjtu
saturar	sɐtuɾaɾ
saturno	sɐtuɾnu
satélite	sɐtɛlitɨ
saudade	sawðaðɨ
saudade	sɐwðaðɨ
saudades	sawðaðɨʃ
saudar	sɐuðaɾ
saudar	sɐwðaɾ
saudação	sɐuðɐsɐ̃w̃
saudação	sɐwðɐsɐ̃w̃
saudável	sɐwðavɛɫ
saxão	saksɐ̃w̃
sazão	sɐzɐ̃w̃
saída	sɐiðɐ
saído	sɐiðu
saúde	sɐuðɨ
se	sɨ
seara	sjaɾɐ
sebastianismo	sɨβɐʃtjɐniʒmu
sebo	seβu
seca	sekɐ
seca	sɛkɐ
secar	sɨkaɾ
seco	seku
secretamente	sɨkɾɛtɐmẽtɨ
secretaria	sɨkɾɨtɐɾiɐ
secrete	sekɾɛtʃi
secreto	sɨkɾɛtu
secretária	sɨkɾɨtaɾjɐ
secretário	sɨkɾɨtaɾju
sector	sɛktoɾ
secção	sɛksɐ̃w̃
seda	sedɐ
sede	seðɨ
sede	sɛðɨ
sedoso	sɨðozu
sefardi	sɨfɐɾði
sefardim	sɨfɐɾðĩ
sefardita	sɨfɐɾðitɐ
segar	sɨɣaɾ
segmento	seɡmẽtu
segredo	sɨɣɾeðu
segregação	sɨɣɾɨɣɐsɐ̃w̃
segue	sɛɡɨ
segue	sɛɣɨ
seguidor	sɨɣiðoɾ
seguinte	sɨɣĩtɨ
seguir	sɨɡiɾ
seguira	sɨɣiɾɐ
seguirá	sɨɣiɾa
segunda	sɨɣũdɐ
segundo	sɨɣũdu
segundos	sɨɣũduʃ
segurança	sɨɣuɾɐ̃sɐ
segurar	sɨɣuɾaɾ
seguridade	sɨɣuɾiðaðɨ
seguro	sɨɣuɾu
sei	sej
sei	sɐj
seia	sɐjɐ
seio	sɐju
seira	sɐjɾɐ
seis	sejʃ
seis	sɐjʃ
seiscentos	sɐjʃsẽtuʃ
seixal	sɐjʃaɫ
seixo	sejʃu
seixo	sɐjʃu
seja	seʒɐ
seja	sɐjʒɐ
sela	sɛlɐ
selecionar	sɨlɛsjunaɾ
selenita	sɨlɨnitɐ
seleção	sɨlɛsɐ̃w̃
selo	selu
selo	sɛlu
selva	sɛɫvɐ
selvagem	sɛɫvaʒɐ̃j̃
sem	sɐ̃j̃
sem	sẽj̃
semana	sɨmɐnɐ
semanal	sɨmɐnaɫ
semanas	sɨmɐnɐʃ
semeador	sɨmjɐðoɾ
semeadura	sɨmjɐðuɾɐ
semear	sɨmjaɾ
semelhante	sɨmɨʎɐ̃tɨ
semelhança	sɨmɨʎɐ̃sɐ
semelhar	sɨmɨʎaɾ
semente	sɨmẽtɨ
sementeira	sɨmẽtɐjɾɐ
semestral	sɨmɨʃtɾaɫ
semestre	sɨmɛʃtɾɨ
semideus	sɨmiðewʃ
seminu	sɨminu
semirreta	sɨmiʁɛtɐ
semiólogo	semjɔloɡu
sempiterno	sẽpitɛɾnu
sempre	sẽpɾɨ
semáforo	sɨmafuɾu
semáforos	semafoɾus
sena	senɐ
senador	senadoʁ
senador	sɨnaðoɾ
senciente	sẽsjẽtɨ
senda	sẽdɐ
sendo	sẽdu
senectude	sɨnɛktuðɨ
senha	seɲɐ
senha	sɐjɲɐ
senheiro	sɨɲejɾu
senheiro	sɨɲɐjɾu
senhor	sɨɲoɾ
senhora	sɨɲoɾɐ
senhoras	sɨɲoɾɐʃ
senhores	sɨɲoɾɨʃ
senhoria	sɨɲuɾiɐ
senhorio	sɨɲuɾiu
seno	senu
senra	sẽʁɐ
sensato	sẽsatu
sensação	sẽsɐsɐ̃w̃
sensibilidade	sẽsiβiliðaðɨ
senso	sẽsu
sentada	sẽtaðɐ
sentado	sẽtaðu
sentar	sẽtaɾ
sente	sẽtɨ
sentença	sẽtẽsɐ
sentia	sẽtiɐ
sentido	sẽtiðu
sentimental	sẽtimẽtaɫ
sentimento	sẽtimẽtu
sentindo	sẽtĩdu
sentinela	sẽtinɛlɐ
sentir	sẽtiɾ
sentiu	sẽtiw
sentou	sẽtow
senão	sɨnɐ̃w̃
separadamente	sɨpɐɾadɐmẽtɨ
separar	sɨpɐɾaɾ
separação	sɨpɐɾɐsɐ̃w̃
sepultar	sɨpuɫtaɾ
sepultura	sɨpuɫtuɾɐ
sequer	sɨkɛɾ
sequestro	sɨkwɛʃtɾu
sequestro	sɨkɛʃtɾu
ser	seɾ
sereia	sɨɾejɐ
sereia	sɨɾɐjɐ
serem	seɾɐ̃j̃
serenidade	sɨɾɨniðaðɨ
seria	sɨɾiɐ
seriamente	sɛɾjɐmẽtɨ
sernancelhe	sɨɾnɐ̃sɐʎɨ
serpa	sɛɾpɐ
serpe	sɛɾpɨ
serpente	sɨɾpẽtɨ
serra	sɛʁɐ
sertã	sɨɾtɐ̃
serval	sɨɾvaɫ
servidor	sɨɾviðoɾ
servidão	sɨɾviðɐ̃w̃
servir	sɨɾviɾ
serviçal	sɨɾvisaɫ
serviço	sɨɾvisu
servo	sɛɾvu
será	sɨɾa
serão	sɨɾɐ̃w̃
sesimbra	sɨzĩbɾɐ
sessenta	sɨsẽtɐ
sesta	sɛʃtɐ
sestra	sɛʃtɾɐ
sestro	sɛʃtɾu
set	sɛtʃi
seta	sɛtɐ
sete	sɛtɨ
setecentos	sɛtɨsẽtuʃ
setembro	sɨtẽbɾu
setenta	sɨtẽtɐ
setim	setʃĩ
setor	sɛtoɾ
setor	sɨtoɾ
setúbal	sɨtubaɫ
seu	sew
seus	sewʃ
severas	sɨvɛɾɐʃ
severidade	sɨvɨɾiðaðɨ
severo	sɨvɛɾu
sevilha	sɨviʎɐ
sexo	sɛksu
sexto	sejʃtu
sexto	sɐjʃtu
sexual	sɛkswaɫ
si	si
sicofanta	sikofɐ̃ta
sicofanta	sikofɐ̃tɐ
sido	siðu
sidra	siðɾɐ
sievert	sivɐɾt
sigilo	siʒilu
significado	siɡnifikaðu
signo	siɡnu
silenciosa	silẽsjɔzɐ
silencioso	silẽsjozu
silhueta	siʎwetɐ
silva	siɫvɐ
silvestre	siɫvɛʃtɾɨ
silêncio	silẽsju
sim	sĩj̃
simbolizando	sĩbulizɐ̃du
simbolizar	sĩbulizaɾ
simbologia	sĩboloʒia
similar	sɨmilaɾ
simpatizante	sĩpatizɐ̃tɨ
simples	sĩplɨʃ
simplesmente	sĩplɨʒmẽtɨ
simplicidade	sĩplisiðaðɨ
simplificar	sĩplifikaɾ
simpático	sĩpatiku
simulacro	simulakɾu
simulação	simulɐsɐ̃w̃
simum	simũ
sina	sinɐ
sinais	sinajʃ
sinal	sinaɫ
sinalizar	sinɐlizaɾ
sinalização	sinɐlizɐsɐ̃w
sinceramente	sĩsɛɾɐmẽtɨ
sinceridade	sĩsɨɾiðaðɨ
sincero	sĩsɛɾu
sindical	sĩdikaɫ
sindicato	sĩdikatu
sineiro	sinejɾu
sineiro	sinɐjɾu
sines	sinɨʃ
sineta	sinetɐ
sinfonia	sĩfuniɐ
sinfonista	sĩfuniʃtɐ
singrar	sĩɡɾaɾ
sinistro	siniʃtɾu
sino	sinu
sinopse	sinɔpsi
sinquisita	sĩkizitɐ
sintaxe	sĩtaksi
sintaxe	sĩtasi
sinto	sĩtu
sintoma	sĩtomɐ
sintonia	sĩtuniɐ
sintra	sĩtɾɐ
sinó	sinɔ
sirena	siɾenɐ
sirgo	siɾɣu
siririca	siɾiɾika
sismo	siʒmu
siso	sizu
sistema	siʃtemɐ
sistematizar	siʃtɨmɐtizaɾ
situação	sitwɐsɐ̃w̃
soalheiro	swɐʎejɾu
soalheiro	swɐʎɐjɾu
soalho	swaʎu
soar	suaɾ
soar	swaɾ
sob	sob
sobe	sɔβɨ
sobejo	suβejʒu
sobejo	suβeʒu
sobejo	suβɐjʒu
sobejo	suβɐʒu
soberania	suβɨɾɐniɐ
sobra	sɔβɾɐ
sobrancelha	subɾɐ̃seʎɐ
sobrar	suβɾaɾ
sobre	sobɾɨ
sobre	sɔbɾɨ
sobrecasaca	soβɾɨkɐzakɐ
sobreiro	subɾejɾu
sobremesa	soβɾɨmezɐ
sobretudo	soβɾɨtuðu
sobreviver	soβɾɨviveɾ
sobrinha	suβɾiɲɐ
sobrinho	suβɾiɲu
socar	sokaʁ
sociabilidade	sosjabilidadʒi
social	susjaɫ
socialismo	susjaliʒmu
sociedade	susjɐðaðɨ
socorro	sukoʁu
soer	sweɾ
sofreguidão	sofɾɨɣiðɐ̃w̃
sofrer	sufɾeɾ
sofrimento	sufɾimẽtu
sofá	sufa
sogra	sɔɣɾɐ
sois	sojʃ
soito	sojtu
sol	sɔɫ
solar	sulaɾ
soldado	soɫdaðu
soldado	sɔɫdaðu
soleira	sulejɾɐ
soleira	sulɐjɾɐ
solidez	suliðeʃ
solidificar	suliðifikaɾ
solidificação	suliðifikɐsɐ̃w̃
solidão	suliðɐ̃w̃
solidéu	sɔliðɛw
solitário	sulitaɾju
solo	sɔlu
sologamia	sɔloɡɐ̃mia
soltar	soɫtaɾ
solteiro	sultɐjɾu
solto	soɫtu
solucionar	sulusjunaɾ
soluçar	sulusaɾ
soluço	sulusu
solução	sulusɐ̃w̃
som	sõ
soma	somɐ
soma	sɔmɐ
sombra	sõbɾɐ
sombras	sõbɾɐʃ
sombreiro	sõbɾejɾu
sombreiro	sõbɾɐjɾu
sombrinha	sõbɾiɲɐ
sombrio	sõbɾiu
sombrio	sõbɾiw
somente	sɔmẽtɨ
somos	somuʃ
sonda	sõdɐ
sonhador	suɲɐðoɾ
sonhar	suɲaɾ
sonho	soɲu
sonhos	soɲuʃ
sono	sõnu
sonolento	sunulẽtu
soo	sou
sopa	sopɐ
sopesar	sopezaɾ
sopesar	sopezaʁ
soprar	supɾaɾ
sopro	sopɾu
sopro	sɔpɾu
sopé	sopɛ
soro	soɾu
soro	sɔɾu
soror	surɔr
sorria	suʁiɐ
sorridente	suʁiðẽtɨ
sorrindo	suʁĩdu
sorrir	suʁiɾ
sorriso	suʁizu
sorriu	suʁiw
sorte	sɔɾtɨ
sorumbático	suɾũbatiku
sossegado	susɨɡadu
sossegar	susɨɣaɾ
sossego	suseɣu
sossego	susɛɣu
sotaina	sotajna
sotaque	sutakɨ
sou	sow
soube	sowβɨ
soure	sowɾɨ
sousa	sowzɐ
sousel	sowzɛɫ
souto	sowtu
sozinho	sɔziɲu
style	istajli
style	iʃtajli
style	stajli
sua	suɐ
suar	suaɾ
suar	swaɾ
suas	suɐʃ
suave	swavɨ
suavidade	swɐviðaðɨ
suaíli	suaili
suaíli	swaili
suba	suβɐ
subclínico	subkliniku
subdivisão	suβɨðɨvizɐ̃w̃
subindo	suβĩdu
subir	suβiɾ
subitamente	suβitɐmẽtɨ
subiu	suβiw
subjetivamente	subʒɛtivɐmẽtɨ
subjetivo	subʒɛtivu
sublevação	suβlɨvɐsɐ̃w̃
sublimar	suβlimaɾ
sublimação	suβlimɐsɐ̃w̃
sublime	sublimɨ
submete	submɛtʃi
subsistir	subziʃtiɾ
substancial	subʃtɐ̃sjaɫ
substantivo	subʃtɐ̃tivu
substância	subʃtɐ̃sjɐ
subterfúgio	subterfuʒju
subversivo	suβɨvɨɾsivu
subversão	suβɨvɨɾsɐ̃w̃
subúrbio	suβuɾβju
suceder	susɨðeɾ
sucedido	susɨðiðu
sucessivo	susɨsivu
sucesso	susɛsu
sucessão	susɨsɐ̃w̃
sucinto	susĩtu
sucumbir	sukũbiɾ
sudeste	suðɛʃtɨ
sudoeste	suðwɛʃtɨ
sueco	suɛku
sueco	swɛku
suficiente	sufisjẽtɨ
suficiente	sufɨsjẽtɨ
suficientemente	sufisjẽtɨmẽtɨ
suflê	sufle
sufocado	sufukaðu
sufocar	sufukaɾ
sugerir	suʒɨɾiɾ
sugestivo	suʒɨʃtivu
sugestão	suʒɨʃtɐ̃w̃
sujar	suʒaɾ
sujeito	suʒɐjtu
sujeitos	suʒɐjtuʃ
sujo	suʒu
sul	suɫ
sulfossal	suɫfusaɫ
sultão	suɫtɐ̃w̃
sumir	sumiɾ
sumo	sumu
suor	suɔɾ
superar	supɨɾaɾ
superavitário	superavitarju
superfície	supɨɾfisji
superfície	supɨɾfisjɨ
superior	supɨɾjoɾ
superioridade	supɨɾjuɾiðaðɨ
supermercado	supɛɾmɨɾkadu
supersticioso	supɨɾʃtisjozu
superstição	supɨɾʃtisɐ̃w̃
superveniência	supeɾveniẽsja
supervisor	supɛɾvizoɾ
superávit	superavitʃi
supor	supoɾ
suportar	supuɾtaɾ
suporte	supɔɾtɨ
suportável	supuɾtavɛɫ
suposição	supuzisɐ̃w̃
supostamente	supoʃtɐmẽtɨ
supremacia	supɾɨmɐsiɐ
supremo	supɾemu
suprir	supɾiɾ
surdo	suɾðu
surpreender	suɾpɾjẽdeɾ
surpreendido	suɾpɾjẽdiðu
surpresa	suɾpɾezɐ
surpreso	suɾpɾezu
surrão	suʁɐ̃w̃
susana	suzɐnɐ
suspeita	suʃpɐjtɐ
suspenso	suʃpẽsu
suspirar	suʃpiɾaɾ
suspiro	suʃpiɾu
sussurro	susuʁu
sustentar	suʃtẽtaɾ
sustentação	suʃtẽtɐsɐ̃w̃
sustento	suʃtẽtu
sustentável	suʃtẽtavɛɫ
suster	suʃteɾ
susto	suʃtu
sutiã	sutjɐ̃
suécia	swɛsjɐ
suíço	suisu
sábado	saβɐðu
sábio	saβiu
sábio	saβju
sátão	satɐ̃w
sã	sɐ̃
são	sɐ̃w̃
sé	sɛ
século	sɛkulu
séculos	sɛkuluʃ
sémita	sɛmitɐ
série	sɛɾiɨ
série	sɛɾjɨ
sério	sɛɾju
sétimo	sɛtimu
sêmea	semjɐ
sídon	sidõ
sílaba	silɐbɐ
símbolo	sĩbulu
síntese	sĩtɨzɨ
sítio	sitju
só	sɔ
sóbrio	sɔbɾiu
sóbrio	sɔbɾju
sóror	sɔrɔr
sós	sɔʃ
sósia	sɔzjɐ
sótão	sɔtɐ̃w
sôfrego	sofɾɨɣu
súbito	suβitu
súplica	suplikɐ
tabaco	tɐβaku
tabefe	tabɛfi
tabela	tɐβɛlɐ
taberna	tɐβɛɾnɐ
tablete	tablɛtʃi
taboca	tabɔka
tabuada	tɐβwaðɐ
tabuaço	tɐβuasu
tabular	tabular
tabuleiro	tɐβulɐjɾu
tacha	taʃɐ
tachar	tɐʃaɾ
tacho	taʃu
taco	taku
tael	tɐɛɫ
taful	tɐfuɫ
tagarela	tɐɣɐɾɛlɐ
tais	tajʃ
taiwan	tajwɐ̃
tal	taɫ
talento	tɐlẽtu
talhar	tɐʎaɾ
talhe	taʎi
talher	taʎɛɾ
talher	taʎɛʁ
talho	taʎu
talvez	taɫveʃ
tamanho	tɐmɐɲu
tambor	tɐ̃boɾ
tamborilar	tɐ̃borilaɾ
também	tɐ̃bɐ̃j̃
também	tɐ̃bẽj̃
tamos	tɐmus
tampouco	tɐ̃w̃powku
tamém	tɐmẽj̃
tangente	tɐ̃ʒẽtɨ
tangerina	tɐ̃ʒɨɾinɐ
tango	tɐ̃ɡu
tanque	tɐ̃kɨ
tanso	tɐ̃su
tanta	tɐ̃tɐ
tanto	tɐ̃tu
tantos	tɐ̃tuʃ
tanuki	tɐnuki
tapete	tɐpetɨ
tapeçaria	tɐpɨsɐɾiɐ
tapir	tapiɾ
taquara	takwaɾa
tar	taɾ
tarde	taɾðɨ
tardio	tɐɾðiu
tareco	tarɛku
tarefa	tɐɾɛfɐ
tarouca	tɐɾowkɐ
tarrafa	taʁafa
tarraxa	tɐʁaʃɐ
tarraxar	tɐʁɐʃaɾ
tasca	taʃkɐ
tato	tatu
tatu	tɐtu
tava	tavɐ
tavam	tavɐ̃w̃
taverna	tɐvɛɾnɐ
tavira	tɐviɾɐ
taxa	taʃɐ
taxar	tɐʃaɾ
taça	tasɐ
te	tɨ
teatro	tjatɾu
tecer	tɨseɾ
tecla	tɛklɐ
teclado	tɛklaðu
teco	tɛku
teia	tejɐ
teia	tɐjɐ
teias	tejɐʃ
teias	tɐjɐʃ
teima	tejmɐ
teima	tɐjmɐ
teimar	tejmaɾ
teimar	tɐjmaɾ
teixeira	tejʃejɾɐ
teixeira	tɐjʃɐjɾɐ
teixo	tejʃu
teixo	tɐjʃu
teja	teʒɐ
tejo	tɛʒu
tela	tɛlɐ
telecomando	tɛlɛkumɐ̃du
teledramaturgia	tɛledɾamatuɾʒia
teledramaturgia	tɛledɾamatuʁʒia
telemóvel	tɛlɛmɔvɛɫ
telha	teʎɐ
telha	tɐjʎɐ
telha	tɐʎɐ
telhado	tɨʎaðu
telhar	tɨʎaɾ
tem	tɐ̃j̃
temer	tɨmeɾ
temor	tɨmoɾ
temos	temuʃ
tempera	tẽpɛɾa
temperamento	tẽpɨɾɐmẽtu
temperatura	tẽpɨɾɐtuɾɐ
tempero	tẽperu
templo	tẽplu
tempo	tẽpu
temporal	tẽpuɾaɫ
temporão	tẽpoɾɐ̃w̃
tempos	tẽpuʃ
tempurá	tẽpuɾa
tenda	tẽdɐ
tender	tẽdeɾ
tendo	tẽdu
tendência	tẽdẽsjɐ
tenebroso	tɨnɨβɾozu
tenente	tɨnẽtɨ
tenha	teɲɐ
tenha	tɐjɲɐ
tenho	teɲu
tenho	tɐɲu
tenro	tẽʁu
tens	tɐ̃j̃ʃ
tenso	tẽsu
tensão	tẽsɐ̃w̃
tentar	tẽtaɾ
tentativa	tẽtɐtivɐ
tentação	tẽtɐsɐ̃w̃
tença	tẽsa
tenção	tẽsɐ̃w̃
tenência	tenẽsja
teoria	tjuɾiɐ
ter	teɾ
tera	tɛra
terabit	tɛɾabiti
terabyte	tɛɾabajtʃi
terceiro	tɨɾsejɾu
terceiro	tɨɾsɐjɾu
terem	teɾɐ̃j̃
tereré	teɾeɾɛ
tererê	teɾeɾe
tergiversar	teɾʒiveɾsar
tergiversação	teɾʒiveɾsasɐ̃w̃
teria	tɨɾiɐ
terminar	tɨɾminaɾ
terminou	tɨɾminow
termo	teɾmu
ternamente	tɛɾnɐmẽtɨ
terno	tɛɾnu
ternura	tɨɾnuɾɐ
terra	tɛʁɐ
terras	tɛʁɐʃ
terreiro	tɨʁɐjɾu
territorial	tɨʁituɾjaɫ
território	tɨʁitɔɾju
terrivelmente	tɨʁivɛɫmẽtɨ
terror	tɨʁoɾ
terráqueo	tɨʁakju
terrível	tɨʁivɛɫ
terá	tɨɾa
terço	teɾsu
tese	tɛzɨ
tesoura	tɨzowɾɐ
tesouro	tɨzowɾu
testa	tɛʃtɐ
testamento	tɨʃtɐmẽtu
testar	tɨʃtaɾ
teste	tɛʃtɨ
testemunha	tɨʃtɨmuɲɐ
testemunhar	tɨʃtɨmuɲaɾ
testemunho	tɨʃtɨmuɲu
testículo	tɨʃtikuɫu
teto	tɛtu
teu	tew
teus	tewʃ
teutónico	tewtɔniku
teve	tevɨ
texto	tɐjʃtu
texugo	tɨʃuɣu
tez	teʃ
teórico	tjɔɾiku
ti	ti
tia	tiɐ
tiago	tiaɣu
tigela	tiʒɛlɐ
tigre	tiɣɾɨ
tijolo	tiʒolu
til	tiɫ
timidez	timiðeʃ
tingir	tĩʒiɾ
tingitano	tĩʒitɐnu
tinha	tiɲɐ
tinham	tiɲɐ̃w̃
tinhoso	tij̃ozu
tinir	tiniɾ
tinta	tĩtɐ
tinteiro	tĩtɐjɾu
tintim	tĩtĩ
tinto	tĩtu
tio	tiw
tipo	tipu
tira	tiɾɐ
tirando	tiɾɐ̃du
tirano	tiɾɐnu
tirar	tiɾaɾ
tiro	tiɾu
tiros	tiɾuʃ
tirou	tiɾow
tive	tivɨ
tiver	tivɛɾ
tivera	tivɛɾɐ
tivesse	tivɛsɨ
tição	tisɐ̃w̃
toa	toɐ
toalha	twaʎɐ
toca	tɔkɐ
tocando	tukɐ̃du
tocar	tukaɾ
tocara	tukaɾɐ
tocará	tukɐɾa
tocava	tukavɐ
tocha	tɔʃɐ
tocou	tukow
toda	toðɐ
toda	tɔðɐ
todas	toðɐʃ
todavia	toðɐviɐ
todo	toðu
todos	toðuʃ
togliatti	tuʎati
toilette	toalɛtʃi
toirada	tojɾaðɐ
toiro	tojɾu
tolerar	tulɨɾaɾ
tolete	tuletɨ
tolice	tulisɨ
tolo	tolu
tolosa	tulɔzɐ
tom	tõ
toma	tɔmɐ
tomada	tumaðɐ
tomado	tumaðu
tomando	tumɐ̃du
tomar	tumaɾ
tomara	tumaɾɐ
tomas	tɔmɐʃ
tomate	tumatɨ
tomateiro	tumɐtɐjɾu
tomava	tumavɐ
tome	tɔmɨ
tomou	tumow
tondela	tõdɛlɐ
tonel	tunɛɫ
tonfa	tõfa
tons	tõʃ
tonto	tõtu
tontura	tõtuɾɐ
tope	tɔpɨ
topo	topu
toque	tɔki
toranja	tuɾɐ̃ʒɐ
tordo	toɾdu
tormenta	tuɾmẽtɐ
torna	tɔɾnɐ
tornando	tuɾnɐ̃du
tornar	tuɾnaɾ
tornara	tuɾnaɾɐ
tornaria	tuɾnɐɾiɐ
tornará	tuɾnɐɾa
tornasse	tuɾnasɨ
tornava	tuɾnavɐ
torneira	tuɾnɐjɾɐ
torno	tɔɾnu
tornou	tuɾnow
tornozelo	tuɾnuzelu
toro	tɔɾu
torpe	toɾpi
torpe	tɔɾpi
torrada	tuʁaðɐ
torre	toʁɨ
torre	tɔʁɨ
torrente	tuʁẽtɨ
torres	toʁɨʃ
torta	tɔɾtɐ
torto	toɾtu
tortura	tuɾtuɾa
torturar	tuɾtuɾaɾ
tosco	toʃku
tosse	tɔsɨ
tossir	tusiɾ
tostão	tuʃtɐ̃w̃
totais	totajs
totais	totajʃ
total	tutaɫ
totalidade	tutɐliðaðɨ
toucinho	towsiɲu
toupeira	towpejɾɐ
toupeira	towpɐjɾɐ
tourada	towɾaðɐ
trabalhador	tɾɐβɐʎɐðoɾ
trabalhar	tɾɐβɐʎaɾ
trabalho	tɾɐβaʎu
trabalhos	tɾɐβaʎuʃ
trabalhoso	tɾɐβɐʎozu
trabuco	tɾabuku
tradicionalmente	tɾɐðisjunaɫmẽtɨ
tradição	tɾɐðisɐ̃w̃
tradutor	tɾɐðutoɾ
trafalgar	tɾɐfɐlɣaɾ
traidor	tɾajðoɾ
trair	tɾɐiɾ
traição	tɾaisɐ̃w̃
traição	tɾajsɐ̃w̃
trajar	tɾɐʒaɾ
traje	tɾaʒe
traje	tɾaʒi
traje	tɾaʒɨ
trajeto	tɾɐʒɛtu
trajo	tɾaʒu
trama	tɾɐmɐ
tramar	tɾɐmaɾ
trampolim	tɾɐ̃polĩ
trampolim	tɾɐ̃pulĩ
tranca	tɾɐ̃kɐ
trancar	tɾɐ̃kaɾ
trancoso	tɾɐ̃kozu
tranquilamente	tɾɐ̃kwilɐmẽtɨ
tranquilidade	tɾɐ̃kwiliðaðɨ
tranquilo	tɾɐ̃kwilu
transa	tɾɐ̃za
transação	tɾɐ̃zasɐ̃w̃
transfretano	tɾɐ̃ʃfɾɨtɐnu
transitório	tɾɐ̃zitɔɾiu
transitório	tɾɐ̃zitɔɾju
transição	tɾɐ̃zisɐ̃w̃
transmitir	tɾɐ̃ʃmitiɾ
transparente	tɾɐ̃ʃpɐɾẽtɨ
transplantar	tɾɐ̃ʃplɐ̃taɾ
transportar	tɾɐ̃ʃpuɾtaɾ
transporte	tɾɐ̃ʃpɔɾtɨ
trança	tɾɐ̃sa
trançar	tɾɐ̃saɾ
trapaça	tɾɐpasɐ
trapo	tɾapu
trapézio	tɾɐpɛzju
traquejo	tɾakeʒu
trasgo	tɾaʒɡu
trata	tɾatɐ
tratado	tɾɐtaðu
tratamento	tɾɐtɐmẽtu
tratar	tɾɐtaɾ
tratava	tɾɐtavɐ
trato	tɾatu
trator	tɾatoɾ
travando	tɾɐvɐ̃du
travar	tɾɐvaɾ
trave	tɾavɨ
traveco	tɾavɛku
travessa	tɾɐvɛsɐ
travesseiro	tɾɐvɨsejɾu
travesseiro	tɾɐvɨsɐjɾu
travessia	tɾɐvɨsiɐ
travou	tɾɐvow
travão	tɾɐvɐ̃w̃
traz	tɾaʃ
trazem	tɾazɐ̃j̃
trazendo	tɾɐzẽdu
trazer	tɾɐzeɾ
trazia	tɾɐziɐ
trazido	tɾɐziðu
traça	tɾasɐ
traçar	tɾɐsaɾ
traço	tɾasu
traído	tɾɐiðu
traíra	tɾɐiɾɐ
trecho	tɾeʃu
treco	tɾɛku
treinamento	tɾɐjnɐmẽtu
trema	tɾemɐ
tremendo	tɾɨmẽdu
tremer	tɾɨmeɾ
tremia	tɾɨmiɐ
tremor	tɾɨmoɾ
tremoço	tɾɨmosu
tremura	tɾemuɾa
trena	tɾenɐ
treno	tɾenu
trenó	tɾenɔ
trepadeira	tɾɨpɐðɐjɾɐ
trepar	tɾɨpaɾ
trete	tɾɛtʃi
treva	tɾɛvɐ
trevas	tɾɛvɐʃ
trevo	tɾevu
trevoso	tɾɨvozu
treze	tɾezɨ
trezentos	tɾɨzẽtuʃ
tri	tɾi
triangular	tɾiɐ̃ɡulaɾ
tribal	tɾiβaɫ
tribo	tɾibu
tribunal	tɾiβunaɫ
tributo	tɾiβutu
tricô	tɾiko
trigo	tɾiɣu
trigésimo	tɾiʒɛzimu
trilho	tɾiʎu
trimestral	tɾimɨʃtɾaɫ
trincar	tɾĩkaɾ
trindade	tɾĩdadɨ
trinta	tɾĩtɐ
tripa	tɾipɐ
tripeiro	tɾipejɾu
tripeiro	tɾipɐjɾu
trisavó	tɾizɐvɔ
trisavô	tɾizɐvo
triscar	tɾiʃkaɾ
triste	tɾiʃtɨ
tristemente	tɾiʃtɨmẽtɨ
tristes	tɾiʃtɨʃ
tristeza	tɾiʃtezɐ
tristonha	tɾiʃtoɲɐ
tristonho	tɾiʃtoɲu
tritura	tɾituɾa
triturado	tɾituɾaðu
triturar	tɾituɾaɾ
trituro	tɾituɾu
triunfal	tɾjũfaɫ
triunfante	tɾiũfɐ̃tɨ
triunfo	tɾiũfu
trivial	tɾivjaɫ
trivialidade	trivialidadʒi
triângulo	tɾiɐ̃ɡulu
troca	tɾɔkɐ
trocadilho	tɾukɐðiʎu
trocador	tɾukɐðoɾ
trocar	tɾukaɾ
troco	tɾoku
troco	tɾɔku
trofa	tɾɔfɐ
trom	tɾõ
tromba	tɾõbɐ
trombeta	tɾõbetɐ
trombone	tɾõbɔnɨ
tronco	tɾõku
troncos	tɾõkuʃ
trono	tɾonu
tropa	tɾɔpɐ
tropelia	tɾupɨliɐ
tropical	tɾupikaɫ
trotskismo	tɾɔtskiʒmu
trouxe	tɾowsɨ
trouxera	tɾowsɛɾɐ
trova	trɔvɐ
trovador	tɾuvɐðoɾ
trovar	truvar
trovejar	tɾuvɨʒaɾ
trovoada	tɾuvwaðɐ
trovoar	tɾuvwaɾ
trovão	tɾuvɐ̃w̃
trufa	tɾufɐ
trágico	traʒiku
trás	tɾaʃ
trânsito	tɾɐ̃zitu
trégua	tɾɛɡwɐ
trémulo	tɾɛmulu
três	tɾeʃ
tríptico	tɾiptiku
tu	tu
tua	tuɐ
tuas	tuɐʃ
tubarão	tuβɐɾɐ̃w̃
tubo	tuβu
tucano	tukɐnu
tucuxi	tukuʃi
tudo	tuðu
tufo	tufu
tufão	tufɐ̃w̃
tuiuiú	tujuju
tulipa	tulipɐ
tumefação	tumefasɐ̃w̃
tumor	tumoɾ
tumulto	tumuɫtu
tupi	tupi
tupiniquim	tupinikĩ
turba	tuɾβɐ
turbulento	tuɾβulẽtu
turno	tuɾnu
turra	tuʁɐ
turu	tuɾu
turvo	tuɾvu
tussa	tusɐ
tutela	tutɛlɐ
tutelar	tutɨlaɾ
tá	ta
tábua	taβuɐ
tábua	taβwɐ
tácito	tasitu
tágide	taʒiðɨ
tálus	talus
tática	tatikɐ
tático	tatiku
tâmara	tɐmɐɾɐ
tântalo	tɐ̃talu
tão	tɐ̃w̃
tédio	tɛðju
ténis	tɛniʃ
ténue	tɛnwɨ
tépido	tɛpiðu
término	tɛɾminu
tétrico	tɛtɾiku
tê	te
têm	tɐ̃jɐ̃j
têm	tẽj̃
têxtil	tɐjʃtiɫ
tíbia	tiβjɐ
tímida	timiðɐ
tímido	timiðu
tísica	tizikɐ
tísico	tiziku
título	titulu
tó	tɔ
tórax	tɔɾaks
tóxico	tɔksiku
túlipa	tulipɐ
túmulo	tumulu
túnel	tunɛɫ
u	u
uai	uaj
uau	uaw
uau	waw
ubre	ubɾi
ucraniano	ukɾɐniɐnu
ucraniano	ukɾɐnjɐnu
ucrânia	ukɾɐnjɐ
ufa	ufɐ
ufo	ufo
ufólogo	ufɔluɣu
uhul	uʁuw
uivar	ujvaɾ
uivo	ujvu
ulterior	uɫtɨɾjoɾ
ultimamente	uɫtimɐmẽtɨ
ultimar	uɫtimaɾ
ultramar	uɫtɾɐmaɾ
ultrapassar	uɫtɾɐpɐsaɾ
ultrassom	uɫtɾɐsõ
ultrassónico	uɫtɾɐsɔniku
um	ũ
uma	umɐ
uma	ũɐ
umas	umɐʃ
umbigada	ũbiɡadɐ
umbigo	ũbiɣu
umbral	ũbɾaɫ
underline	ɐ̃deɾlajni
ungido	ũʒiðu
ungir	ũʒiɾ
unha	uɲɐ
unhar	uɲaɾ
unhas	uɲɐʃ
unicamente	unikɐmẽtɨ
unidade	uniðaðɨ
unido	uniðu
unificar	unifikaɾ
unificação	unifikɐsɐ̃w̃
uniforme	unifɔɾmɨ
unilateralismo	unilateɾalijʃmu
unilateralismo	unilateɾalismu
unir	uniɾ
universal	univɨɾsaɫ
universidades	universidadʒis
universo	univɛɾsu
união	unjɐ̃w̃
uno	unu
uns	ũʃ
untar	ũtaɾ
unto	ũtu
unção	ũsɐ̃w̃
uníssono	unisunu
urano	uɾɐnu
urbano	uɾβɐnu
urdir	uɾðiɾ
uretra	uɾɛtɾɐ
urgente	uɾʒẽtɨ
urna	uɾnɐ
uro	uɾu
urrar	uʁaɾ
urro	uʁu
urso	uɾsu
urubiciense	uɾubisiẽsi
uruguai	uɾuɡwaj
uruguaio	uɾuɡwaju
urupemense	uɾupemẽsi
urutau	uɾutaw
urze	uɾzɨ
usa	uzɐ
usado	uzaðu
usar	uzaɾ
uso	uzu
usso	usu
usual	uzwaɫ
usufruto	uzufɾutu
usura	uzuɾa
usurpar	uzuɾpaɾ
usurpação	uzuɾpɐsɐ̃w̃
usuário	uzuaɾiu
usuário	uzuaɾju
usuário	uzwaɾju
utilizar	utilizaɾ
utilização	utilizɐsɐ̃w̃
utópico	utɔpiku
uva	uvɐ
uzbeque	uzbɛki
uzbeque	uʒbɛki
ué	uɛ
ué	wɛ
uísque	wiʃki
uísque	wiʃkɨ
vaca	vakɐ
vacante	vɐkɐ̃tɨ
vadio	vaðiu
vadoso	vɐðozu
vaga	vaɣɐ
vagabundagem	vaɡabũdaʒẽj̃
vagabundo	vɐɣɐβũdu
vagamente	vaɣɐmẽtɨ
vagante	vɐɣɐ̃tɨ
vagar	vɐɣaɾ
vagarosamente	vɐɣɐɾɔzɐmẽtɨ
vagaroso	vɐɣɐɾozu
vaginalmente	vɐʒinalmẽtɨ
vago	vaɣu
vagos	vaɣuʃ
vai	vaj
vaidade	vajðaðɨ
vaidoso	vajðozu
vais	vajʃ
vale	valɨ
valente	vɐlẽtɨ
valença	vɐlẽsɐ
valer	vɐleɾ
vales	valɨʃ
valete	valɛtɨ
valeu	vɐlew
valo	valu
valongo	vɐlõɡu
valor	vɐloɾ
valorizar	vɐluɾizaɾ
valpaços	vaɫpasuʃ
valsa	vaɫsɐ
vamos	vɐmuʃ
vampiro	vɐ̃piɾu
vantajoso	vɐ̃tɐʒozu
vapor	vɐpoɾ
vaqueiro	vɐkɐjɾu
vara	vaɾɐ
varanda	vɐɾɐ̃dɐ
varandas	vɐɾɐ̃dɐʃ
varapau	vaɾapaw
variar	vɐɾiaɾ
variar	vɐɾjaɾ
variedade	vɐɾjɛðaðɨ
varonis	vɐɾuniʃ
varão	vɐɾɐ̃w̃
vaso	vazu
vasos	vazuʃ
vassalo	vɐsalu
vassoura	vɐsowɾɐ
vasta	vaʃtɐ
vastidão	vɐʃtiðɐ̃w̃
vasto	vaʃtu
vatapá	vatapa
vaticano	vɐtikanu
vaticano	vɐtikɐnu
vau	vaw
vazamento	vɐzɐmẽtu
vazar	vɐzaɾ
vazias	vɐziɐʃ
vazio	vɐziu
veado	viadu
veado	vjaðu
vede	veðɨ
vede	vɛðɨ
vegetal	vɨʒɨtaɫ
vegete	veʒɛtʃi
veia	vɐjɐ
veias	vɐjɐʃ
veio	veju
veio	vɐju
veja	veʒɐ
veja	vɐjʒɐ
vejo	vɐjʒu
vela	vɛlɐ
velar	vɨlaɾ
velas	vɛlɐʃ
veleiro	vɨlɐjɾu
velejar	vɨlɨʒaɾ
velha	vɛʎɐ
velhaco	vɨʎaku
velhas	vɛʎɐʃ
velhice	vɨʎisɨ
velho	vɛʎu
velhos	vɛʎuʃ
velocidade	vɨlusiðaðɨ
veludo	vɨluðu
veludos	vɨluðuʃ
vem	vɐ̃j̃
vemos	vemuʃ
vencelho	vẽseʎu
vencer	vẽseɾ
vencido	vẽsiðu
vencilho	vẽsiʎu
vencimento	vẽsimẽtu
venda	vẽdɐ
vendar	vẽdaɾ
vendas	vẽdɐʃ
vendaval	vẽdɐvaɫ
vender	vẽdeɾ
veneno	vɨnenu
venenoso	vɨnɨnozu
venera	venɛɾa
veneração	vɨnɨɾɐsɐ̃w̃
venerável	vɨnɨɾavɛɫ
venha	veɲɐ
venha	vɐjɲɐ
venhas	veɲɐʃ
venhas	vɐjɲɐʃ
venhas	vɐɲɐʃ
venho	veɲu
venho	vɐjɲu
venial	vɨnjaɫ
venoso	vɨnozu
vens	vẽʃ
venta	vẽtɐ
ventana	vẽtɐnɐ
ventar	vẽtaɾ
vento	vẽtu
ventoinha	vẽtwiɲɐ
ventos	vẽtuʃ
ventoso	vẽtozu
ventre	vẽtɾɨ
ventura	vẽtuɾɐ
ventã	vẽtɐ̃
ver	veɾ
verbasco	vɨɾβaʃku
verbo	vɛɾβu
verbosamente	vɛɾβozɐmẽtɨ
verboso	vɨɾβozu
verdade	vɨɾðaðɨ
verdadeira	vɨɾðɐðɐjɾɐ
verdadeiramente	vɨɾðɐðɐjɾɐmẽtɨ
verdadeiras	vɨɾðɐðɐjɾɐʃ
verdadeiro	vɨɾðɐðɐjɾu
verdadeiros	vɨɾðɐðɐjɾuʃ
verdades	vɨɾðaðɨʃ
verde	veɾðɨ
verdes	veɾðɨʃ
veremos	vɨɾemuʃ
vergel	vɨɾʒɛɫ
vergonha	vɨɾɣoɲɐ
veria	vɨɾiɐ
verificar	vɨɾifikaɾ
verme	vɛɾmɨ
vermelha	vɨɾmɐjʎɐ
vermelha	vɨɾmɐʎɐ
vermelho	vɨɾmejʎu
vermelho	vɨɾmɐjʎu
vermelhos	vɨɾmɐjʎuʃ
verniz	vɨɾniʃ
vero	vɛɾu
verso	vɛɾsu
versos	vɛɾsuʃ
vertical	vɨɾtikaɫ
verá	vɨɾa
verás	vɨɾaʃ
verão	vɨɾɐ̃w̃
vespa	veʃpɐ
vestida	vɨʃtiðɐ
vestido	vɨʃtiðu
vestidos	vɨʃtiðuʃ
vestimenta	vɨʃtimẽtɐ
vestir	vɨʃtiɾ
vestiário	vɨʃtjaɾju
vestuário	vɨʃtwaɾju
vesícula	vizikula
vetar	vɨtaɾ
vete	vɛtʃi
veto	vɛtu
vexame	veʃɐmi
vez	veʃ
vezes	vezɨʃ
veículo	vɐikulu
vi	vi
via	viɐ
viagem	vjaʒɐ̃j̃
viagens	viaʒẽʃ
viajado	viɐʒaðu
viajante	vjɐʒɐ̃tɨ
viajar	viɐʒaɾ
viandante	vjɐ̃dɐ̃tɨ
vibrar	viβɾaɾ
viciado	visiadu
viciar	visjaɾ
vida	viðɐ
vidas	viðɐʃ
vide	viðɨ
videira	viðejɾɐ
videira	viðɐjɾɐ
vidigueira	viðiɣɐjɾɐ
vidrar	viðɾaɾ
vidraria	viðɾɐɾiɐ
vidraça	viðɾasɐ
vidreiro	viðɾɐjɾu
vidro	viðɾu
vidros	viðɾuʃ
vidrão	viðɾɐ̃w̃
vieira	vjejɾɐ
vieira	vjɐjɾɐ
viela	viɛlɐ
viela	vjɛlɐ
vier	vjɛɾ
viera	vjɛɾɐ
vieram	vjɛɾɐ̃w̃
viesse	vjɛsɨ
vietname	viɛtnɐmɨ
vietname	vjɛtnɐmɨ
vigente	viʒẽtɨ
vigiar	viʒjaɾ
vigo	viɣu
vigoroso	viɣuɾozu
vigésimo	viʒɛzimu
vih	veiɐɡa
vil	viɫ
vila	vilɐ
vilancete	vilɐ̃setɨ
vilancico	vilɐ̃siku
vilhancico	viʎɐ̃siku
vilão	vilɐ̃w̃
vim	vĩ
vimioso	vimiozu
vimos	vimuʃ
vinagre	vinaɣɾɨ
vinagrete	vinaɡɾɛtʃi
vincar	vĩkaɾ
vincilho	vĩseʎu
vinda	vĩdɐ
vindimar	vĩdimaɾ
vindo	vĩdu
vindouro	vĩdowɾu
vingança	vĩɡɐ̃sɐ
vingar	vĩɡaɾ
vinha	viɲɐ
vinhais	viɲajʃ
vinho	viɲu
vinhos	viɲuʃ
vinte	vĩtɨ
vintém	vĩtɐ̃j̃
vintém	vĩtẽj̃
viola	vjɔlɐ
violação	vjulɐsɐ̃w̃
violentamente	vjulẽtɐmẽtɨ
violento	viulẽtu
violento	vjulẽtu
violeta	vjuletɐ
violinista	vjuliniʃtɐ
violino	vjulinu
violência	vjulẽsjɐ
vir	viɾ
vira	viɾɐ
viram	viɾɐ̃w̃
virar	viɾaɾ
virem	viɾɐ̃j̃
vires	viɾɨʃ
virgem	viɾʒɐ̃j̃
virgindade	viɾʒĩdaðɨ
viria	viɾiɐ
viril	viɾil
virilidade	viɾiliðaðɨ
virou	viɾow
virtual	viɾtuaɫ
virtual	viɾtwaɫ
virtude	viɾtuðɨ
virtuoso	viɾtwozu
visar	vizaɾ
viseu	vizew
visita	vizitɐ
visitar	vizitaɾ
visitas	vizitɐʃ
vislumbre	viʒlũbɾɨ
visom	vizõ
visse	visɨ
vista	viʃtɐ
viste	viʃtɨ
visto	viʃtu
vistoso	vijʃtozu
vistoso	vistozu
visual	vizwaɫ
visão	vizɐ̃w̃
visível	vizivɛɫ
visões	vizõj̃ʃ
vitamina	vitaminɐ
vitimar	vitimaɾ
vitimismo	vitimiʃmu
vitimismo	vitʃimizmu
vitorioso	vituɾjozu
vitral	vitɾaɫ
vitrificar	vitɾifikaɾ
vitória	vitɔɾjɐ
viu	viw
viva	vivɐ
vivalma	vivaɫmɐ
vivar	vivaɾ
vivas	vivɐʃ
vivaz	vivaʃ
vive	vivɨ
vivem	vivɐ̃j̃
vivemos	vivemuʃ
vivenda	vivẽdɐ
vivendo	vivẽdu
viver	viveɾ
vivera	viveɾɐ
viverá	vivɨɾa
viveu	vivew
vivia	viviɐ
vivo	vivu
vivos	vivuʃ
vizela	vizɛlɐ
vizinha	viziɲɐ
vizinha	vɨziɲɐ
vizinhança	viziɲɐ̃sɐ
vizinhança	vɨziɲɐ̃sɐ
vizinho	viziɲu
vizinho	vɨziɲu
viço	visu
viçoso	visozu
viúva	vjuvɐ
viúvo	vjuvu
voador	vwɐðoɾ
voadora	vwɐðoɾɐ
voando	vwɐ̃du
voar	vwaɾ
voara	vwaɾɐ
voará	vwɐɾa
vocabulário	vukɐβulaɾju
vocábulo	vukaβulu
você	vɔse
vocês	vɔseʃ
vogar	vuɣaɾ
volante	vulɐ̃tɨ
volta	vɔɫtɐ
voltado	voɫtaðu
voltado	vɔɫtaðu
voltando	voɫtɐ̃du
voltando	vɔɫtɐ̃du
voltar	vɔɫtaɾ
voltara	voɫtaɾɐ
voltará	voɫtɐɾa
voltas	vɔɫtɐʃ
voltasse	vɔɫtasɨ
voltava	voɫtavɐ
voltava	vɔɫtavɐ
voltear	voɫtjaɾ
voltear	vɔɫtjaɾ
volto	vɔɫtu
voltou	vɔɫtow
voluntariamente	vulũtaɾjɐmẽtɨ
voluntário	vulũtaɾiu
voluntário	vulũtaɾju
voluptuoso	vuluptwozu
voluptuário	vuluptwaɾju
volver	voɫveɾ
vomitar	vumitaɾ
vontade	võtaðɨ
vontades	võtaðɨʃ
voo	vou
voragem	vuɾaʒɐ̃j̃
voragem	vuɾaʒẽj̃
vos	vuʃ
vossa	vɔsɐ
vossas	vɔsɐʃ
vosso	vɔsu
vossos	vɔsuʃ
votante	vutɐ̃tɨ
votar	vutaɾ
voto	vɔtu
vou	vow
vouga	vowɣɐ
vouzela	vowzɛlɐ
vovó	vovɔ
voz	vɔʃ
vozear	voziaɾ
vozes	vɔzɨʃ
voçoroca	vosoɾɔka
vulcão	vuɫkɐ̃w̃
vulgar	vuɫɣaɾ
vulgarmente	vuɫɣaɾmẽtɨ
vulgo	vuɫɣu
vulnerar	vuɫnɨɾaɾ
vulnífico	vuɫnifiku
vulto	vuɫtu
vuvuzela	vuvuzɛla
vá	va
vácuo	vakuo
vácuo	vakwo
várias	vaɾjɐʃ
vário	vaɾju
vários	vaɾjuʃ
vã	vɐ̃
vão	vɐ̃w̃
véi	vɛj
véspera	vɛʃpɨɾɐ
véu	vɛw
vê	ve
vêm	vɐ̃j̃ɐ̃j̃
vêm	vẽj̃ẽj̃
vês	veʃ
vício	visju
vínico	viniku
vítima	vitimɐ
vós	vɔʃ
w	v
webnamorada	wɛbinamoɾada
webnamorado	wɛbinamoɾadu
webnamorar	wɛbinamoɾaɾ
webnamoro	wɛbinamoɾu
wikcionário	wiksjunaɾju
wolf	voɫf
wolf	woɫf
x	ʃiʃ
xadrez	ʃɐðɾeʃ
xaile	ʃajlɨ
xampu	ʃɐ̃pu
xamã	ʃɐmɐ̃
xavecar	ʃavekaɾ
xavecar	ʃavekaʁ
xaveco	ʃavɛku
xavier	ʃɐvjɛɾ
xelim	ʃɨlĩ
xeque	ʃɛkɨ
xereca	ʃeɾɛka
xerófilo	ʃeɾɔfilu
xilindró	ʃilĩdɾɔ
xingar	ʃĩɡaɾ
xis	ʃiʃ
xixi	ʃiʃi
xpto	ʃiʃpeteɔ
xurumbambo	ʃuɾũbɐ̃bu
xá	ʃa
xícara	ʃikɐɾɐ
zagal	zɐɣaɫ
zanga	zɐ̃ɡɐ
zangado	zɐ̃ɡaðu
zangar	zɐ̃ɡaɾ
zangão	zɐ̃ɡɐ̃w̃
zarpar	zɐɾpaɾ
zebra	zeβɾɐ
zebro	zeβɾu
zelador	zɨlɐðoɾ
zelha	zeʎɐ
zepelim	zɨpɨlĩ
zero	zɛɾu
zimbabué	zĩbaβwɛ
zincografia	zĩkoɡɾafia
zona	zonɐ
zoneamento	zonjɐmẽtu
zoo	zou
zorra	zoʁɐ
zulu	zulu
zumbi	zũbi
zumbir	zũbiɾ
zurrapa	zuʁapɐ
zás	zaʃ
zâmbia	zɐ̃bjɐ
zângão	zɐ̃ɡɐ̃w̃
zé	zɛ
zê	ze
zêzere	zezɨɾɨ
à	a
àquela	akɛlɐ
àquelas	akɛlɐʃ
àqueles	akelɨʃ
àquilo	akilu
às	aʃ
á	a
ábaco	abɐku
ácido	asidu
ádito	aðitu
ágrafo	aɣɾɐfu
água	aɡwɐ
águeda	aɡɨdɐ
águia	aɣiɐ
águia	aɣjɐ
álbum	aɫβũ
álcool	alkwɔl
árabe	aɾɐβɨ
árbitro	aɾβitɾu
área	aɾjɐ
árvore	aɾvuɾɨ
árvores	aɾvuɾɨʃ
ás	aʃ
áspero	aʃpɨɾu
átomo	atumu
átrio	atɾɨu
áureo	awɾju
áustria	awʃtɾjɐ
â	ɐ
â	ɐ̃
âmago	ɐmɐɣu
âmbar	ɐ̃baɾ
âmbito	ɐ̃bitu
âncora	ɐ̃kuɾɐ
ânfora	ɐ̃fuɾɐ
ângulo	ɐ̃ɡulu
ânimo	ɐnimu
ânsia	ɐ̃sjɐ
ânus	ɐnuʃ
ã	ɐ̃
ç	s
é	ɛ
égua	ɛɣwɐ
época	ɛpukɐ
és	ɛʃ
étimo	ɛtimu
ênclise	ẽklizi
êxito	ɐjzitu
êxodo	ezudu
ícone	ikunɨ
ícone	ikɔnɨ
ídolo	iðulu
ílhavo	iʎɐvu
ímpar	ĩpaɾ
ímprobo	ĩpɾobu
índia	ĩdjɐ
ínsua	ĩswɐ
íntimo	ĩtimu
ípsilon	ipsilɔn
ípsilon	ipslɔn
ó	ɔ
óbidos	ɔβiðuʃ
óbolo	ɔβulu
ócio	ɔsju
óculo	ɔkulu
óculos	ɔkuluʃ
ódio	ɔðju
óleo	ɔlju
ómega	ɔmɨɡɐ
ónix	ɔnikʃ
ópera	ɔpɨɾɐ
óptico	ɔptiku
órbita	ɔɾβitɐ
órgão	ɔɾɣɐ̃w̃
ótico	ɔtiku
ótimo	ɔtimu
óvni	ɔvini
óvni	ɔvni
óxido	ɔksiðu
õ	õ
ú	u
última	uɫtimɐ
últimas	uɫtimɐʃ
último	uɫtimu
últimos	uɫtimuʃ
úmero	umɨɾu
úmido	umiðu
única	unikɐ
único	uniku
útil	utiɫ
ü	i
ü	w
