அஃகம்	ʔʌɡʌm
அகங்காரம்	ʔʌɡʌŋɡɑːɾ̪ʌm
அகங்கை	ʔʌɡʌŋɡʌɪ̯
அகதி	ʔʌɡʌd̪i
அகத்தாழம்	ʔʌɡʌt̪ːɑːɻʌm
அகத்துக்காரர்	ʔʌɡʌt̪ːɯkːɑːɾ̪ʌɾ̪
அகத்துக்காரி	ʔʌɡʌt̪ːɯkːɑːɾ̪i
அகந்தை	ʔʌɡʌn̪d̪ʌɪ̯
அகப்பா	ʔʌɡʌpːɑː
அகப்பு	ʔʌɡʌpːɯ
அகப்பை	ʔʌɡʌpːʌɪ̯
அகம்	ʔʌɡʌm
அகரமுதலி	ʔʌɡʌɾ̪ʌmɯd̪ʌl̪i
அகரம்	ʔʌɡʌɾ̪ʌm
அகரவரிசை	ʔʌɡʌɾ̪ʌʋʌɾ̪ɨsʌɪ̯
அகராதி	ʔʌɡʌɾ̪ɑːd̪i
அகற்சி	ʔʌɡʌrsi
அகற்று	ʔʌɡʌʈːɾɯ
அகலம்	ʔʌɡʌl̪ʌm
அகழி	ʔʌɡʌɻi
அகவன்மகள்	ʔʌɡʌʋʌnmʌɡʌɭ
அக்கச்சி	ʔʌkːʌsːi
அக்கா	ʔʌkːɑː
அக்காமார்	ʔʌkːɑːmɑːɾ̪
அக்காள்	ʔʌkːɑːɭ
அக்கி	ʔʌkːi
அக்கினி	ʔʌkːɨni
அக்கினிகர்ப்பம்	ʔʌkːɨnɨɡʌɾ̪pːʌm
அக்கினிகுண்டம்	ʔʌkːɨnɨɡɯɳɖʌm
அக்கினிகோத்திரம்	ʔʌkːɨnɨɡoːt̪ːɨɾ̪ʌm
அக்கினிச்சுவாலை	ʔʌkːɨnɨsːɯʋɑːl̪ʌɪ̯
அக்கினித்தம்பம்	ʔʌkːɨnɨt̪ːʌmbʌm
அக்கினியாஸ்திரம்	ʔʌkːɨnɨjɑːst̪ɨɾ̪ʌm
அக்கு	ʔʌkːɯ
அக்குள்	ʔʌkːɯɭ
அக்கை	ʔʌkːʌɪ̯
அக்கைச்சி	ʔʌkːʌɪ̯sːi
அங்கண்	ʔʌŋɡʌɳ
அங்கதம்	ʔʌŋɡʌd̪ʌm
அங்கம்	ʔʌŋɡʌm
அங்காலே	ʔʌŋɡɑːl̪eː
அங்கிட்டு	ʔʌŋɡɨʈːɯ
அங்கு	ʔʌŋɡɯ
அங்குத்தை	ʔʌŋɡɯt̪ːʌɪ̯
அங்குலி	ʔʌŋɡɯl̪i
அங்கே	ʔʌŋɡeː
அங்கோடிங்கோடு	ʔʌŋɡoːɖɨŋɡoːɖɯ
அங்ஙனம்	ʔʌŋːʌnʌm
அசர்	ʔʌsʌɾ̪
அசர்த்து	ʔʌsʌɾ̪t̪ːɯ
அசாம்	ʔʌsɑːm
அச்சுவினி	ʔʌsːɯʋɨni
அஞ்ஞை	ʔʌɲːʌɪ̯
அடக்கு	ʔʌɖʌkːɯ
அடங்கு	ʔʌɖʌŋɡɯ
அடர்த்தி	ʔʌɖʌɾ̪t̪ːi
அடவி	ʔʌɖʌʋi
அடி	ʔʌɖi
அடிகேயா	ʔʌɖɨɡeːjɑː
அடிக்கடி	ʔʌɖɨkːʌɖi
அடிக்கொருக்கால்	ʔʌɖɨkːoɾ̪ɯkːɑːl̪
அடித்தட்டு	ʔʌɖɨt̪ːʌʈːɯ
அடித்தளம்	ʔʌɖɨt̪ːʌɭʌm
அடிநிலை	ʔʌɖɨn̪ɨl̪ʌɪ̯
அடிப்பகுதி	ʔʌɖɨpːʌɡɯd̪i
அடிப்பாகம்	ʔʌɖɨpːɑːɡʌm
அடிமுடி	ʔʌɖɨmɯɖi
அடிமை	ʔʌɖɨmʌɪ̯
அடுத்த	ʔʌɖɯt̪ːa
அடுப்பு	ʔʌɖɯpːɯ
அடை	ʔʌɖʌɪ̯
அடைக்கலக்குருவி	ʔʌɖʌɪ̯kːʌl̪ʌkːɯɾ̪ɯʋi
அடைக்காய்	ʔʌɖʌɪ̯kːɑːj
அடைப்பு	ʔʌɖʌɪ̯pːɯ
அட்டம்	ʔʌʈːʌm
அட்டை	ʔʌʈːʌɪ̯
அணிகம்	ʔʌɳɨɡʌm
அணியம்	ʔʌɳɨjʌm
அணில்	ʔʌɳɨl̪
அணு	ʔʌɳɯ
அண்டை	ʔʌɳɖʌɪ̯
அண்ணன்	ʔʌɳːʌn
அண்ணா	ʔʌɳːɑː
அண்ணி	ʔʌɳːi
அதனால்	ʔʌd̪ʌnɑːl̪
அதிகாரம்	ʔʌd̪ɨɡɑːɾ̪ʌm
அதிர்ச்சி	ʔʌd̪ɨɾ̪sːi
அது	ʔʌd̪ɯ
அதோள்	ʔʌd̪oːɭ
அத்தனை	ʔʌt̪ːʌnʌɪ̯
அத்தியாபகன்	ʔʌt̪ːɨjɑːbʌɡʌn
அத்தை	ʔʌt̪ːʌɪ̯
அந்த	ʔʌn̪d̪a
அந்தண்டை	ʔʌn̪d̪ʌɳɖʌɪ̯
அந்தந்த	ʔʌn̪d̪ʌn̪d̪a
அந்நின்று	ʔʌn̪ːɨnrɯ
அந்நிலை	ʔʌn̪ːɨl̪ʌɪ̯
அனுபவம்	ʔʌnɯbʌʋʌm
அனுமன்	ʔʌnɯmʌn
அனை	ʔʌnʌɪ̯
அனைய	ʔʌnʌɪ̯ja
அன்னம்	ʔʌnːʌm
அன்பளிப்பு	ʔʌnpʌɭɨpːɯ
அன்பு	ʔʌnpɯ
அன்று	ʔʌnrɯ
அபிமானம்	ʔʌbɨmɑːnʌm
அபிஷேகம்	ʔʌbɨʂeːɡʌm
அப்படி	ʔʌpːʌɖi
அப்பம்	ʔʌpːʌm
அப்பா	ʔʌpːɑː
அப்பால்	ʔʌpːɑːl̪
அப்புறம்	ʔʌpːɯrʌm
அப்பொழுது	ʔʌpːoɻɯd̪ɯ
அமரம்	ʔʌmʌɾ̪ʌm
அமிர்தம்	ʔʌmɨɾ̪t̪ʌm
அமெரிக்கா	ʔʌmeɾ̪ɨkːɑː
அமைதி	ʔʌmʌɪ̯t̪i
அமையம்	ʔʌmʌɪ̯jʌm
அம்பரம்	ʔʌmbʌɾ̪ʌm
அம்பர்	ʔʌmbʌɾ̪
அம்பு	ʔʌmbɯ
அம்மா	ʔʌmːɑː
அம்மாய்	ʔʌmːɑːj
அயர்ச்சி	ʔʌjʌɾ̪sːi
அயோத்தி	ʔʌjoːt̪ːi
அரசன்	ʔʌɾ̪ʌsʌn
அரசாங்கம்	ʔʌɾ̪ʌsɑːŋɡʌm
அரசி	ʔʌɾ̪ʌsi
அரசு	ʔʌɾ̪ʌsɯ
அரண்மனை	ʔʌɾ̪ʌɳmʌnʌɪ̯
அரவிந்தம்	ʔʌɾ̪ʌʋɨn̪d̪ʌm
அராவாரம்	ʔʌɾ̪ɑːʋɑːɾ̪ʌm
அரிசி	ʔʌɾ̪ɨsi
அரிவாள்	ʔʌɾ̪ɨʋɑːɭ
அரிவாள்மணை	ʔʌɾ̪ɨʋɑːɭmʌɳʌɪ̯
அருகு	ʔʌɾ̪ɯɡɯ
அருக்கன்	ʔʌɾ̪ɯkːʌn
அருக்கன்வீதி	ʔʌɾ̪ɯkːʌnʋiːd̪i
அருப்பம்	ʔʌɾ̪ɯpːʌm
அருமை	ʔʌɾ̪ɯmʌɪ̯
அரைநெல்லி	ʔʌɾ̪ʌɪ̯n̪el̪ːi
அர்ஜுனன்	ʔʌɾ̪d͡ʑɯnʌn
அறக்கட்டளை	ʔʌrʌkːʌʈːʌɭʌɪ̯
அறம்	ʔʌrʌm
அறி	ʔʌri
அறிஞர்	ʔʌrɨɲʌɾ̪
அறிப்பு	ʔʌrɨpːɯ
அறிவாய்வியல்	ʔʌrɨʋɑːjʋɨjʌl̪
அறிவி	ʔʌrɨʋi
அறிவிப்பு	ʔʌrɨʋɨpːɯ
அறிவியல்	ʔʌrɨʋɨjʌl̪
அறிவு	ʔʌrɨʋɯ
அறு	ʔʌrɯ
அறுகோணம்	ʔʌrɯɡoːɳʌm
அறுதி	ʔʌrɯd̪i
அறுப்பு	ʔʌrɯpːɯ
அறுவடை	ʔʌrɯʋʌɖʌɪ̯
அறை	ʔʌrʌɪ̯
அற்பகதம்	ʔʌrpʌɡʌd̪ʌm
அலகு	ʔʌl̪ʌɡɯ
அலர்த்தி	ʔʌl̪ʌɾ̪t̪ːi
அலுவம்	ʔʌl̪ɯʋʌm
அலுவல்	ʔʌl̪ɯʋʌl̪
அலுவீகம்	alʉʋɨːɣəm
அலை	ʔʌl̪ʌɪ̯
அலைதாடி	ʔʌl̪ʌɪ̯t̪ɑːɖi
அலைப்	ʔʌl̪ʌɪ̯p
அலைப்பு	ʔʌl̪ʌɪ̯pːɯ
அலைப்பேசி	ʔʌl̪ʌɪ̯pːeːsi
அல்	ʔʌl̪
அளவு	ʔʌɭʌʋɯ
அளவுகோல்	ʔʌɭʌʋɯɡoːl̪
அளவை	ʔʌɭʌʋʌɪ̯
அளி	ʔʌɭi
அளேரியம்	ʔʌɭeːɾ̪ɨjʌm
அழகு	ʔʌɻʌɡɯ
அழி	ʔʌɻi
அழிபு	ʔʌɻɨbɯ
அழிப்பு	ʔʌɻɨpːɯ
அழிவாய்	ʔʌɻɨʋɑːj
அழிவு	ʔʌɻɨʋɯ
அழு	ʔʌɻɯ
அழைப்பு	ʔʌɻʌɪ̯pːɯ
அவசியம்	ʔʌʋʌsɨjʌm
அவண்	ʔʌʋʌɳ
அவதாரம்	ʔʌʋʌd̪ɑːɾ̪ʌm
அவதி	ʔʌʋʌd̪i
அவன்	ʔʌʋʌn
அவரை	ʔʌʋʌɾ̪ʌɪ̯
அவரோகணம்	ʔʌʋʌɾ̪oːɡʌɳʌm
அவர்	ʔʌʋʌɾ̪
அவர்கள்	ʔʌʋʌɾ̪kʌɭ
அவல்	ʔʌʋʌl̪
அவள்	ʔʌʋʌɭ
அவித்துருமம்	ʔʌʋɨt̪ːɯɾ̪ɯmʌm
அவுஸ்திரேலியா	ʔʌʋɯst̪ɨɾ̪eːl̪ɨjɑː
அவை	ʔʌʋʌɪ̯
அவ்	ʔʌʋ
அவ்வண்ணம்	ʔʌʋːʌɳːʌm
அவ்வது	ʔʌʋːʌd̪ɯ
அவ்வருகு	ʔʌʋːʌɾ̪ɯɡɯ
அவ்வழி	ʔʌʋːʌɻi
அவ்வாறு	ʔʌʋːɑːrɯ
அவ்விடம்	ʔʌʋːɨɖʌm
அவ்வோ	ʔʌʋːoː
அவ்வோன்	ʔʌʋːoːn
அஹம்	ʔʌhʌm
ஆ	ʔɑː
ஆகையால்	ʔɑːɡʌɪ̯jɑːl̪
ஆக்கம்	ʔɑːkːʌm
ஆங்கிலம்	ʔɑːŋɡɨl̪ʌm
ஆசினி	ʔɑːsɨni
ஆசிரியர்	ʔɑːsɨɾ̪ɨjʌɾ̪
ஆசிருந்தம்	ʔɑːsɨɾ̪ɯn̪d̪ʌm
ஆசீர்வதி	ʔɑːsiːɾ̪ʋʌd̪i
ஆசை	ʔɑːsʌɪ̯
ஆடம்பரம்	ʔɑːɖʌmbʌɾ̪ʌm
ஆடல்	ʔɑːɖʌl̪
ஆடு	ʔɑːɖɯ
ஆடுமாடு	ʔɑːɖɯmɑːɖɯ
ஆடை	ʔɑːɖʌɪ̯
ஆட்சி	ʔɑːʈsi
ஆட்டன்	ʔɑːʈːʌn
ஆட்டுப்பால்	ʔɑːʈːɯpːɑːl̪
ஆணவம்	ʔɑːɳʌʋʌm
ஆணை	ʔɑːɳʌɪ̯
ஆணையம்	ʔɑːɳʌɪ̯jʌm
ஆண்	ʔɑːɳ
ஆண்கள்	ʔɑːɳkʌɭ
ஆண்குறி	ʔɑːɳkɯri
ஆண்டவன்	ʔɑːɳɖʌʋʌn
ஆண்டு	ʔɑːɳɖɯ
ஆண்பால்	ʔɑːɳpɑːl̪
ஆண்மை	ʔɑːɳmʌɪ̯
ஆதாம்	ʔɑːd̪ɑːm
ஆதி	ʔɑːd̪i
ஆத்தி	aːt̪ːɨ
ஆந்தை	ʔɑːn̪d̪ʌɪ̯
ஆன்மீகம்	ʔɑːnmiːɡʌm
ஆபரணம்	ʔɑːbʌɾ̪ʌɳʌm
ஆபிச்	ʔɑːbɨs
ஆமை	ʔɑːmʌɪ̯
ஆம்பி	ʔɑːmbi
ஆயத்தம்	ʔɑːjʌt̪ːʌm
ஆயர்	ʔɑːjʌɾ̪
ஆயிட்டு	ʔɑːjɨʈːɯ
ஆயிரம்	ʔɑːjɨɾ̪ʌm
ஆயுதம்	ʔɑːjɯd̪ʌm
ஆயுள்	ʔɑːjɯɭ
ஆய்	ʔɑːj
ஆய்வு	ʔɑːjʋɯ
ஆரம்	ʔɑːɾ̪ʌm
ஆராய்ச்சி	ʔɑːɾ̪ɑːjsːi
ஆர்த்தி	ʔɑːɾ̪t̪ːi
ஆர்மீனியா	ʔɑːɾ̪miːnɨjɑː
ஆறு	ʔɑːrɯ
ஆலம்	ʔɑːl̪ʌm
ஆலயம்	ʔɑːl̪ʌjʌm
ஆளி	ʔɑːɭi
ஆளுவல்லி	ʔɑːɭɯʋʌl̪ːi
ஆள்	ʔɑːɭ
ஆழிப்பேரலை	ʔɑːɻɨpːeːɾ̪ʌl̪ʌɪ̯
ஆவல்	ʔɑːʋʌl̪
ஆவி	ʔɑːʋi
ஆஸ்திரேலியா	ʔɑːst̪ɨɾ̪eːl̪ɨjɑː
இகழ்ச்சி	ʔɨɡʌɻsːi
இக்கு	ʔɨkːɯ
இங்கண்	ʔɨŋɡʌɳ
இங்கிட்டு	ʔɨŋɡɨʈːɯ
இங்கு	ʔɨŋɡɯ
இங்குத்தை	ʔɨŋɡɯt̪ːʌɪ̯
இங்குஷேத்தியா	ʔɨŋɡɯʂeːt̪ːɨjɑː
இங்கே	ʔɨŋɡeː
இங்ஙனம்	ʔɨŋːʌnʌm
இசுலாம்	ʔɨsɯl̪ɑːm
இசை	ʔɨsʌɪ̯
இசைக்கருவி	ʔɨsʌɪ̯kːʌɾ̪ɯʋi
இசைப்பாட்டு	ʔɨsʌɪ̯pːɑːʈːɯ
இசைவு	ʔɨsʌɪ̯ʋɯ
இஞ்சி	ʔɨɲd͡ʑi
இடப்பு	ʔɨɖʌpːɯ
இடப்பெயர்	ʔɨɖʌpːejʌɾ̪
இடி	ʔɨɖi
இடியப்பம்	ʔɨɖɨjʌpːʌm
இடியாப்பம்	ʔɨɖɨjɑːpːʌm
இடு	ʔɨɖɯ
இடுப்பு	ʔɨɖɯpːɯ
இடையினம்	ʔɨɖʌɪ̯jɨnʌm
இட்டம்	ʔɨʈːʌm
இட்டு	ʔɨʈːɯ
இட்லி	ʔɨʈl̪i
இணக்கு	ʔɨɳʌkːɯ
இணை	ʔɨɳʌɪ̯
இதயம்	ʔɨd̪ʌjʌm
இது	ʔɨd̪ɯ
இத்தனை	ʔɨt̪ːʌnʌɪ̯
இத்தால்	ʔɨt̪ːɑːl̪
இந்த	ʔɨn̪d̪a
இந்தி	ʔɨn̪d̪i
இந்தியர்	ʔɨn̪d̪ɨjʌɾ̪
இந்தியா	ʔɨn̪d̪ɨjɑː
இந்து	ʔɨn̪d̪ɯ
இனப்படுகொலை	ʔɨnʌpːʌɖɯɡol̪ʌɪ̯
இனம்	ʔɨnʌm
இன்கண்	ʔɨnkʌɳ
இன்னும்	ʔɨnːɯm
இன்பம்	ʔɨnpʌm
இன்று	ʔɨnrɯ
இபங்கம்	ʔɨbʌŋɡʌm
இப்படி	ʔɨpːʌɖi
இப்பொழுது	ʔɨpːoɻɯd̪ɯ
இப்போது	ʔɨpːoːd̪ɯ
இமம்	ʔɨmʌm
இயக்கு	ʔɨjʌkːɯ
இயக்குரோதம்	ʔɨjʌkːɯɾ̪oːd̪ʌm
இயங்கு	ʔɨjʌŋɡɯ
இயங்குதளம்	ʔɨjʌŋɡɯd̪ʌɭʌm
இயம்	ʔɨjʌm
இயல்	ʔɨjʌl̪
இயல்பு	ʔɨjʌl̪pɯ
இயல்புகணம்	ʔɨjʌl̪pɯɡʌɳʌm
இயேசு	ʔɨjeːsɯ
இயைபு	ʔɨjʌɪ̯pɯ
இரசாயனம்	ʔɨɾ̪ʌsɑːjʌnʌm
இரசிதம்	ʔɨɾ̪ʌsɨd̪ʌm
இரணியம்	ʔɨɾ̪ʌɳɨjʌm
இரண்டு	rɛɳɖɯ
இரண்டு	ʔɨɾ̪ʌɳɖɯ
இரந்தை	ʔɨɾ̪ʌn̪d̪ʌɪ̯
இரவு	ʔɨɾ̪ʌʋɯ
இராகம்	ʔɨɾ̪ɑːɡʌm
இராசகுமாரி	ʔɨɾ̪ɑːsʌɡɯmɑːɾ̪i
இராசி	ʔɨɾ̪ɑːsi
இராஜாளி	ʔɨɾ̪ɑːd͡ʑɑːɭi
இராமாயணம்	ʔɨɾ̪ɑːmɑːjʌɳʌm
இரு	ʔɨɾ̪ɯ
இருபால்சேர்க்கை	ʔɨɾ̪ɯbɑːl̪seːɾ̪kːʌɪ̯
இருப்புப்பாதை	ʔɨɾ̪ɯpːɯpːɑːd̪ʌɪ̯
இருப்பை	iɾʉpːaɪ
இருமல்	ʔɨɾ̪ɯmʌl̪
இரும்பு	ʔɨɾ̪ɯmbɯ
இருளுவா	ʔɨɾ̪ɯɭɯʋɑː
இருளை	ʔɨɾ̪ɯɭʌɪ̯
இருள்	ʔɨɾ̪ɯɭ
இரை	ʔɨɾ̪ʌɪ̯
இரைப்பை	ʔɨɾ̪ʌɪ̯pːʌɪ̯
இறகு	ʔɨrʌɡɯ
இறக்கை	ʔɨrʌkːʌɪ̯
இறால்	ʔɨrɑːl̪
இறைச்சி	ʔɨrʌɪ̯sːi
இலக்கணம்	ʔɨl̪ʌkːʌɳʌm
இலக்கிய	ʔɨl̪ʌkːɨja
இலக்கியம்	ʔɨl̪ʌkːɨjʌm
இலக்கு	ʔɨl̪ʌkːɯ
இலங்கை	ʔɨl̪ʌŋɡʌɪ̯
இலட்சம்	ʔɨl̪ʌʈsʌm
இலட்சுமணன்	ʔɨl̪ʌʈsɯmʌɳʌn
இலத்தீன்	ʔɨl̪ʌt̪ːiːn
இலவசம்	ʔɨl̪ʌʋʌsʌm
இலுப்பை	ilʉpːaɪ
இலை	ʔɨl̪ʌɪ̯
இல்	ʔɨl̪
இல்லகம்	ʔɨl̪ːʌɡʌm
இல்லக்கிழத்தி	ʔɨl̪ːʌkːɨɻʌt̪ːi
இல்லத்தரசி	ʔɨl̪ːʌt̪ːʌɾ̪ʌsi
இல்லம்	ʔɨl̪ːʌm
இல்லாள்	ʔɨl̪ːɑːɭ
இல்லை	ʔɨl̪ːʌɪ̯
இள	ʔɨɭa
இளநீர்	ʔɨɭʌn̪iːɾ̪
இளம்பிறை	ʔɨɭʌmbɨrʌɪ̯
இளம்பிள்ளைவாதம்	ʔɨɭʌmbɨɭːʌɪ̯ʋɑːd̪ʌm
இளைப்பாறு	ʔɨɭʌɪ̯pːɑːrɯ
இளைப்பாறுதல்	ʔɨɭʌɪ̯pːɑːrɯd̪ʌl̪
இளைப்பாற்று	ʔɨɭʌɪ̯pːɑːʈːɾɯ
இளைப்பு	ʔɨɭʌɪ̯pːɯ
இழப்பீடு	ʔɨɻʌpːiːɖɯ
இழப்பு	ʔɨɻʌpːɯ
இழிப்பு	ʔɨɻɨpːɯ
இழிவு	ʔɨɻɨʋɯ
இழுக்கம்	ʔɨɻɯkːʌm
இழுக்கு	ʔɨɻɯkːɯ
இழுது	ʔɨɻɯd̪ɯ
இழுதை	ʔɨɻɯd̪ʌɪ̯
இழுப்பறை	ʔɨɻɯpːʌrʌɪ̯
இவள்	ʔɨʋʌɭ
இஸ்லாமாபாத்	ʔɨsl̪ɑːmɑːbɑːt̪
ஈகை	ʔiːɡʌɪ̯
ஈடு	ʔiːɖɯ
ஈட்டு	ʔiːʈːɯ
ஈனில்	ʔiːnɨl̪
ஈரல்	ʔiːɾ̪ʌl̪
ஈழம்	ʔiːɻʌm
உ	ʔɯ
உஃப	ʔɯfa
உகளம்	ʔɯɡʌɭʌm
உசுபெக்கிசுத்தான்	ʔɯsɯbekːɨsɯt̪ːɑːn
உச்சரிப்பு	ʔɯsːʌɾ̪ɨpːɯ
உச்சவம்	ʔɯsːʌʋʌm
உச்சி	ʔɯsːi
உடனே	ʔɯɖʌneː
உடம்பு	ʔɯɖʌmbɯ
உடல்	ʔɯɖʌl̪
உடுக்கை	ʔɯɖɯkːʌɪ̯
உட்கருத்து	ʔɯʈkʌɾ̪ɯt̪ːɯ
உட்பொருள்	ʔɯʈpoɾ̪ɯɭ
உணர்ச்சி	ʔɯɳʌɾ̪sːi
உணர்த்தி	ʔɯɳʌɾ̪t̪ːi
உணர்ப்பு	ʔɯɳʌɾ̪pːɯ
உணர்வு	ʔɯɳʌɾ̪ʋɯ
உணவு	ʔɯɳʌʋɯ
உண்	ʔɯɳ
உண்டா	ʔɯɳɖɑː
உண்டாக	ʔɯɳɖɑːɡa
உண்டாக்கு	ʔɯɳɖɑːkːɯ
உண்டுபடு	ʔɯɳɖɯbʌɖɯ
உண்டுபடுத்து	ʔɯɳɖɯbʌɖɯt̪ːɯ
உண்ணி	ʔɯɳːi
உண்மை	ʔɯɳmʌɪ̯
உதடு	ʔɯd̪ʌɖɯ
உதவி	ʔɯd̪ʌʋi
உதவு	ʔɯd̪ʌʋɯ
உத்தரி	ʔɯt̪ːʌɾ̪i
உன்	ʔɯn
உன்னம்	ʔɯnːʌm
உன்னல்	ʔɯnːʌl̪
உன்னு	ʔɯnːɯ
உபோதம்	ʔɯboːd̪ʌm
உப்பு	ʔɯpːɯ
உப்புமா	ʔɯpːɯmɑː
உப்புவாயு	ʔɯpːɯʋɑːjɯ
உம்	ʔɯm
உயரம்	ʔɯjʌɾ̪ʌm
உயர்ச்சி	ʔɯjʌɾ̪sːi
உயிரணு	ʔɯjɨɾ̪ʌɳɯ
உயிரியல்	ʔɯjɨɾ̪ɨjʌl̪
உயிரிழப்பு	ʔɯjɨɾ̪ɨɻʌpːɯ
உயிரெழுத்து	ʔɯjɨɾ̪eɻɯt̪ːɯ
உயிர்	ʔɯjɨɾ̪
உயிர்த்தெழு	ʔɯjɨɾ̪t̪ːeɻɯ
உயிர்வேதியியல்	ʔɯjɨɾ̪ʋeːd̪ɨjɨjʌl̪
உரிமை	ʔɯɾ̪ɨmʌɪ̯
உருசியா	ʔɯɾ̪ɯsɨjɑː
உருத்திரன்	ʔɯɾ̪ɯt̪ːɨɾ̪ʌn
உருப்பம்	ʔɯɾ̪ɯpːʌm
உருப்பு	ʔɯɾ̪ɯpːɯ
உருமேறு	ʔɯɾ̪ɯmeːrɯ
உரும்	ʔɯɾ̪ɯm
உருளைக்கிழங்கு	ʔɯɾ̪ɯɭʌɪ̯kːɨɻʌŋɡɯ
உரை	ʔɯɾ̪ʌɪ̯
உரோமம்	ʔɯɾ̪oːmʌm
உரோம்	ʔɯɾ̪oːm
உறக்கம்	ʔɯrʌkːʌm
உறப்பு	ʔɯrʌpːɯ
உறல்	ʔɯrʌl̪
உறழ்ச்சி	ʔɯrʌɻsːi
உறழ்வு	ʔɯrʌɻʋɯ
உறவு	ʔɯrʌʋɯ
உறுகண்	ʔɯrɯɡʌɳ
உறுகோள்	ʔɯrɯɡoːɭ
உறுதி	ʔɯrɯd̪i
உறுதிபூசுதல்	ʔɯrɯd̪ɨbuːsɯd̪ʌl̪
உறுப்பிசைக்குறி	ʔɯrɯpːɨsʌɪ̯kːɯri
உலகம்	ʔɯl̪ʌɡʌm
உலர்ச்சி	ʔɯl̪ʌɾ̪sːi
உலோகம்	ʔɯl̪oːɡʌm
உளவு	ʔɯɭʌʋɯ
உள்	ʔɯɭ
உள்ளங்கை	ʔɯɭːʌŋɡʌɪ̯
உள்ளுறை	ʔɯɭːɯrʌɪ̯
உழவர்	ʔɯɻʌʋʌɾ̪
உழவு	ʔɯɻʌʋɯ
உவமை	ʔɯʋʌmʌɪ̯
உவர்மம்	ʔɯʋʌɾ̪mʌm
ஊடகம்	ʔuːɖʌɡʌm
ஊடுகதிர்	ʔuːɖɯɡʌd̪ɨɾ̪
ஊதியம்	ʔuːd̪ɨjʌm
ஊது	ʔuːd̪ɯ
ஊத்தப்பம்	ʔuːt̪ːʌpːʌm
ஊனம்	ʔuːnʌm
ஊர்காவல்	ʔuːɾ̪kɑːʋʌl̪
ஊர்க்கதை	ʔuːɾ̪kːʌd̪ʌɪ̯
ஊர்வன	ʔuːɾ̪ʋʌna
ஊர்வலம்	ʔuːɾ̪ʋʌl̪ʌm
ஊறுகாய்	ʔuːrɯɡɑːj
ஊற்று	ʔuːʈːɾɯ
ஊழல்	ʔuːɻʌl̪
எஃகு	ʔeɡɯ
எகின்	ʔeɡɨn
எங்கண்	ʔeŋɡʌɳ
எங்கித்தை	ʔeŋɡɨt̪ːʌɪ̯
எங்கு	ʔeŋɡɯ
எங்கும்	ʔeŋɡɯm
எசுத்தோனியா	ʔesɯt̪ːoːnɨjɑː
எச்சம்	ʔesːʌm
எடு	ʔeɖɯ
எடுத்துக்காட்டு	ʔeɖɯt̪ːɯkːɑːʈːɯ
எட்டு	ʔeʈːɯ
எண்ணங்கள்	ʔeɳːʌŋɡʌɭ
எண்ணம்	ʔeɳːʌm
எண்ணிக்கை	ʔeɳːɨkːʌɪ̯
எதிர்ச்சி	ʔed̪ɨɾ̪sːi
எதிர்பால்சேர்க்கை	ʔed̪ɨɾ̪pɑːl̪seːɾ̪kːʌɪ̯
எத்தனை	ʔet̪ːʌnʌɪ̯
என்னர்	ʔenːʌɾ̪
என்னோரும்	ʔenːoːɾ̪ɯm
எப்படி	ʔepːʌɖi
எப்பேர்ப்பட்ட	ʔepːeːɾ̪pːʌʈːa
எமன்	ʔemʌn
எரிமலை	ʔeɾ̪ɨmʌl̪ʌɪ̯
எருது	ʔeɾ̪ɯd̪ɯ
எருமை	ʔeɾ̪ɯmʌɪ̯
எறும்பு	ʔerɯmbɯ
எற்பாடு	ʔerpɑːɖɯ
எலும்பு	ʔel̪ɯmbɯ
எல்லாரும்	ʔel̪ːɑːɾ̪ɯm
எல்லை	ʔel̪ːʌɪ̯
எழுச்சி	ʔeɻɯsːi
எழுது	ʔeɻɯd̪ɯ
எழுதுகோல்	ʔeɻɯd̪ɯɡoːl̪
எழுத்து	ʔeɻɯt̪ːɯ
எழுவாய்	ʔeɻɯʋɑːj
எஸ்பெராண்டோ	ʔespeɾ̪ɑːɳɖoː
ஏகாந்தம்	ʔeːɡɑːn̪d̪ʌm
ஏதடை	ʔeːd̪ʌɖʌɪ̯
ஏதின்மை	ʔeːd̪ɨnmʌɪ̯
ஏத்து	ʔeːt̪ːɯ
ஏனம்	ʔeːnʌm
ஏனென்றால்	ʔeːnenrɑːl̪
ஏப்ரல்	ʔeːpɾ̪ʌl̪
ஏரணம்	ʔeːɾ̪ʌɳʌm
ஏராளம்	ʔeːɾ̪ɑːɭʌm
ஏலக்காய்	ʔeːl̪ʌkːɑːj
ஏலம்	ʔeːl̪ʌm
ஏழு	ʔeːɻɯ
ஏவாள்	ʔeːʋɑːɭ
ஐ	ʔʌɪ̯
ஐதரசன்	ʔʌɪ̯t̪ʌɾ̪ʌsʌn
ஐநூறு	ʔʌɪ̯n̪uːrɯ
ஐந்து	ʔʌɪ̯n̪d̪ɯ
ஐந்து	ʔʌɲd͡ʑɯ
ஐம்பது	ʔʌɪ̯mbʌd̪ɯ
ஐம்பொன்	ʔʌɪ̯mbon
ஐயம்	ʔʌɪ̯jʌm
ஐரோப்பா	ʔʌɪ̯ɾ̪oːpːɑː
ஒகையோ	ʔoɡʌɪ̯joː
ஒக்கல்	ʔokːʌl̪
ஒட்டகம்	ʔoʈːʌɡʌm
ஒன்பது	ʔonpʌd̪ɯ
ஒன்பது	ʷombʌd̪ɯ
ஒன்று	ʔonrɯ
ஒன்று	ʷoɳɳɯ
ஒப்பம்	ʔopːʌm
ஒப்பு	ʔopːɯ
ஒப்புகை	ʔopːɯɡʌɪ̯
ஒப்புமை	ʔopːɯmʌɪ̯
ஒரு	ʔoɾ̪ɯ
ஒற்றுமை	ʔoʈːɾɯmʌɪ̯
ஒழுகு	ʔoɻɯɡɯ
ஒழுக்கம்	ʔoɻɯkːʌm
ஒழுங்கை	ʔoɻɯŋɡʌɪ̯
ஒவ்வாமை	ʔoʋːɑːmʌɪ̯
ஓடம்	ʔoːɖʌm
ஓடு	ʔoːɖɯ
ஓடை	ʔoːɖʌɪ̯
ஓட்டல்	ʔoːʈːʌl̪
ஓது	ʔoːd̪ɯ
ஓநாய்	ʔoːn̪ɑːj
ஓய்வூதியம்	ʔoːjʋuːd̪ɨjʌm
ஓவியம்	ʔoːʋɨjʌm
ஔ	ʔʌʊ̯
ஔடதம்	ʔʌʊ̯ʈʌd̪ʌm
ககனம்	kʌɡʌnʌm
கங்கு	kʌŋɡɯ
கஞ்சா	kʌɲd͡ʑɑː
கஞ்சாவை	kʌɲd͡ʑɑːʋʌɪ̯
கடனாளி	kʌɖʌnɑːɭi
கடன்	kʌɖʌn
கடம்பு	kaɖəmbʉ
கடற்கரை	kʌɖʌrkʌɾ̪ʌɪ̯
கடல்	kʌɖʌl̪
கடல்நீர்	kʌɖʌl̪n̪iːɾ̪
கடவுள்	kʌɖʌʋɯɭ
கடி	kʌɖi
கடிகாரம்	kʌɖɨɡɑːɾ̪ʌm
கடிதம்	kʌɖɨd̪ʌm
கடுங்கோபம்	kʌɖɯŋɡoːbʌm
கடுதாசி	kʌɖɯd̪ɑːsi
கடை	kʌɖʌɪ̯
கடைவாய்ப்பல்	kʌɖʌɪ̯ʋɑːjpːʌl̪
கட்கம்	kʌʈkʌm
கட்சி	kʌʈsi
கட்டடம்	kʌʈːʌɖʌm
கட்டல்	kʌʈːʌl̪
கட்டளை	kʌʈːʌɭʌɪ̯
கட்டி	kʌʈːi
கட்டிடக்கலை	kʌʈːɨɖʌkːʌl̪ʌɪ̯
கட்டிமை	kʌʈːɨmʌɪ̯
கட்டியடுப்பு	kʌʈːɨjʌɖɯpːɯ
கட்டில்	kʌʈːɨl̪
கட்டு	kʌʈːɯ
கணக்காளர்	kʌɳʌkːɑːɭʌɾ̪
கணக்கியல்	kʌɳʌkːɨjʌl̪
கணக்கு	kʌɳʌkːɯ
கணம்	kʌɳʌm
கணவன்	kʌɳʌʋʌn
கணிதம்	kʌɳɨd̪ʌm
கணினி	kʌɳɨni
கணினியியல்	kʌɳɨnɨjɨjʌl̪
கணு	kʌɳɯ
கணுமருது	kʌɳɯmʌɾ̪ɯd̪ɯ
கணையாழி	kʌɳʌɪ̯jɑːɻi
கண்	kʌɳ
கண்டக்கருவி	kʌɳɖʌkːʌɾ̪ɯʋi
கண்டங்கத்தரி	kaɳɖəŋɡət̪ːəɾɨ
கண்டரை	kʌɳɖʌɾ̪ʌɪ̯
கண்டு	kʌɳɖɯ
கண்ணன்	kʌɳːʌn
கண்ணாடி	kʌɳːɑːɖi
கண்ணீர்	kʌɳːiːɾ̪
கண்மாய்	kʌɳmɑːj
கதம்பகம்	kʌd̪ʌmbʌɡʌm
கதவு	kʌd̪ʌʋɯ
கதை	kʌd̪ʌɪ̯
கத்தரி	kʌt̪ːʌɾ̪i
கத்தரிக்காய்	kʌt̪ːʌɾ̪ɨkːɑːj
கத்தி	kʌt̪ːi
கத்திரி	kʌt̪ːɨɾ̪i
கத்திரிக்காய்	kʌt̪ːɨɾ̪ɨkːɑːj
கத்திரிணி	kʌt̪ːɨɾ̪ɨɳi
கந்தகம்	kʌn̪d̪ʌɡʌm
கனடா	kʌnʌɖɑː
கனமழை	kʌnʌmʌɻʌɪ̯
கனவு	kʌnʌʋɯ
கனிமம்	kʌnɨmʌm
கன்னடம்	kʌnːʌɖʌm
கன்னம்	kʌnːʌm
கன்று	kʌnrɯ
கபடம்	kʌbʌɖʌm
கபாலம்	kʌbɑːl̪ʌm
கபிலம்	kʌbɨl̪ʌm
கபுரம்	kʌbɯɾ̪ʌm
கபோதகம்	kʌboːd̪ʌɡʌm
கபோதம்	kʌboːd̪ʌm
கப்பல்	kʌpːʌl̪
கமலம்	kʌmʌl̪ʌm
கம்பம்	kʌmbʌm
கம்பி	kʌmbi
கயம்	kʌjʌm
கயவாய்	kʌjʌʋɑːj
கயிரவம்	kʌjɨɾ̪ʌʋʌm
கயிறு	kʌjɨrɯ
கரடகம்	kʌɾ̪ʌɖʌɡʌm
கரடி	kʌɾ̪ʌɖi
கரண்டி	kʌɾ̪ʌɳɖi
கரி	kʌɾ̪i
கரிமம்	kʌɾ̪ɨmʌm
கரியமிலவாயு	kʌɾ̪ɨjʌmɨl̪ʌʋɑːjɯ
கரு	kʌɾ̪ɯ
கருணை	kʌɾ̪ɯɳʌɪ̯
கருது	kʌɾ̪ɯd̪ɯ
கருத்துரு	kʌɾ̪ɯt̪ːɯɾ̪ɯ
கருப்பு	kʌɾ̪ɯpːɯ
கருப்பை	kʌɾ̪ɯpːʌɪ̯
கருமம்	kʌɾ̪ɯmʌm
கருமுட்டை	kʌɾ̪ɯmɯʈːʌɪ̯
கருமை	kʌɾ̪ɯmʌɪ̯
கருமையான	kʌɾ̪ɯmʌɪ̯jɑːna
கரும்பு	kʌɾ̪ɯmbɯ
கருவி	kʌɾ̪ɯʋi
கருவிளா	kaɾʉʋɨɭaː
கருவீரல்	kʌɾ̪ɯʋiːɾ̪ʌl̪
கரை	kʌɾ̪ʌɪ̯
கரைப்பு	kʌɾ̪ʌɪ̯pːɯ
கர்த்தர்	kʌɾ̪t̪ːʌɾ̪
கர்நாடகம்	kʌɾ̪n̪ɑːɖʌɡʌm
கறவு	kʌrʌʋɯ
கறவை	kʌrʌʋʌɪ̯
கறி	kʌri
கறுவா	kʌrɯʋɑː
கற்கம்	kʌrkʌm
கற்பாழி	kʌrpɑːɻi
கற்பூரம்	kʌrpuːɾ̪ʌm
கற்றாலை	kʌʈːɾɑːl̪ʌɪ̯
கலகம்	kʌl̪ʌɡʌm
கலந்தாய்வு	kʌl̪ʌn̪d̪ɑːjʋɯ
கலப்பை	kʌl̪ʌpːʌɪ̯
கலம்	kʌl̪ʌm
கலயம்	kʌl̪ʌjʌm
கலவி	kʌl̪ʌʋi
கலுழ்ச்சி	kʌl̪ɯɻsːi
கலை	kʌl̪ʌɪ̯
கலைக்களஞ்சியம்	kʌl̪ʌɪ̯kːʌɭʌɲd͡ʑɨjʌm
கலைச்சொல்	kʌl̪ʌɪ̯sːol̪
கலைஞர்	kʌl̪ʌɪ̯ɲʌɾ̪
கல்	kʌl̪
கல்யாணம்	kʌl̪jɑːɳʌm
கல்லீரல்	kʌl̪ːiːɾ̪ʌl̪
கல்வி	kʌl̪ʋi
கல்விக்கூடம்	kʌl̪ʋɨkːuːɖʌm
கல்விநிலையம்	kʌl̪ʋɨn̪ɨl̪ʌɪ̯jʌm
கல்வெட்டியல்	kʌl̪ʋeʈːɨjʌl̪
கல்வெட்டு	kʌl̪ʋeʈːɯ
களம்	kʌɭʌm
களவு	kʌɭʌʋɯ
களை	kʌɭʌɪ̯
கள்ளம்	kʌɭːʌm
கழித்தல்	kʌɻɨt̪ːʌl̪
கழுத்து	kʌɻɯt̪ːɯ
கழுவு	kʌɻɯʋɯ
கவர்வு	kʌʋʌɾ̪ʋɯ
கவற்சி	kʌʋʌrsi
கவல்	kʌʋʌl̪
கவிஞர்	kʌʋɨɲʌɾ̪
கவிதை	kʌʋɨd̪ʌɪ̯
கஸாயி	kʌsɑːji
காகம்	kɑːɡʌm
காகிதம்	kɑːɡɨd̪ʌm
காக்கை	kɑːkːʌɪ̯
காசு	kɑːsɯ
காடு	kɑːɖɯ
காடைக்கண்ணி	kɑːɖʌɪ̯kːʌɳːi
காட்டுப்பயிர்	kɑːʈːɯpːʌjɨɾ̪
காட்டெருமை	kɑːʈːeɾ̪ɯmʌɪ̯
காண்டம்	kɑːɳɖʌm
காண்டாமிருகம்	kɑːɳɖɑːmɨɾ̪ɯɡʌm
காண்டீவம்	kɑːɳɖiːʋʌm
காண்டு	kɑːɳɖɯ
காதணி	kɑːd̪ʌɳi
காதம்	kɑːd̪ʌm
காதரம்	kɑːd̪ʌɾ̪ʌm
காதல்	kɑːd̪ʌl̪
காது	kɑːd̪ɯ
காதை	kɑːd̪ʌɪ̯
காத்திரம்	kɑːt̪ːɨɾ̪ʌm
காந்தக்கல்	kɑːn̪d̪ʌkːʌl̪
காந்தம்	kɑːn̪d̪ʌm
காந்தவண்டி	kɑːn̪d̪ʌʋʌɳɖi
கானலி	kɑːnʌl̪i
காபி	kɑːbi
காபூல்	kɑːbuːl̪
காப்ச்சா	kɑːpsːɑː
காப்பியம்	kɑːpːɨjʌm
காப்பீடு	kɑːpːiːɖɯ
காமம்	kɑːmʌm
காய்	kɑːj
காய்கறி	kɑːjkʌri
காரணம்	kɑːɾ̪ʌɳʌm
காரம்	kɑːɾ̪ʌm
காராமணி	kɑːɾ̪ɑːmʌɳi
காரீயக்கல்	kɑːɾ̪iːjʌkːʌl̪
கார்	kɑːɾ̪
கார்த்திகை	kɑːɾ̪t̪ːɨɡʌɪ̯
கார்த்தூம்	kɑːɾ̪t̪ːuːm
கார்மம்	kɑːɾ̪mʌm
காறையெலும்பு	kɑːrʌɪ̯jel̪ɯmbɯ
காற்றழுத்தமானி	kɑːʈːɾʌɻɯt̪ːʌmɑːni
காற்றழுத்தம்	kɑːʈːɾʌɻɯt̪ːʌm
காற்று	kɑːʈːɾɯ
காலணி	kɑːl̪ʌɳi
காலம்	kɑːl̪ʌm
காலை	kɑːl̪ʌɪ̯
கால்	kɑːl̪
காளான்	kɑːɭɑːn
காளை	kɑːɭʌɪ̯
காவல்	kɑːʋʌl̪
காவு	kɑːʋɯ
கிடை	kɨɖʌɪ̯
கிட்ட	kɨʈːa
கிணறு	kɨɳʌrɯ
கித்தார்	kɨt̪ːɑːɾ̪
கின்னம்	kɨnːʌm
கிராம்பு	kɨɾ̪ɑːmbɯ
கிரி	kɨɾ̪i
கிருட்டிணன்	kɨɾ̪ɯʈːɨɳʌn
கிருத்திரம்	kɨɾ̪ɯt̪ːɨɾ̪ʌm
கிருபை	kɨɾ̪ɯbʌɪ̯
கிரேக்கம்	kɨɾ̪eːkːʌm
கிறாம்பு	kɨrɑːmbɯ
கிறி	kɨri
கிறிஸ்து	kɨrɨst̪ɯ
கிறிஸ்துமஸ்	kɨrɨst̪ɯmʌs
கிற்பு	kɨrpɯ
கிளம்பினவேலை	kɨɭʌmbɨnʌʋeːl̪ʌɪ̯
கிளம்பு	kɨɭʌmbɯ
கிளர்	kɨɭʌɾ̪
கிளர்ச்சி	kɨɭʌɾ̪sːi
கிளர்த்து	kɨɭʌɾ̪t̪ːɯ
கிளவி	kɨɭʌʋi
கிளி	kɨɭi
கிளிமெண்டி	kɨɭɨmeɳɖi
கிளை	kɨɭʌɪ̯
கிளைப்பு	kɨɭʌɪ̯pːɯ
கிழக்கு	kɨɻʌkːɯ
கிழங்கு	kɨɻʌŋɡɯ
கிழமை	kɨɻʌmʌɪ̯
கிழவன்	kɨɻʌʋʌn
கிழவி	kɨɻʌʋi
கிழவு	kɨɻʌʋɯ
கீரை	kiːɾ̪ʌɪ̯
கீழ்ப்பாகம்	kiːɻpːɑːɡʌm
கீழ்மை	kiːɻmʌɪ̯
குகை	kɯɡʌɪ̯
குங்கிலியம்	kɯŋɡɨl̪ɨjʌm
குங்குமப்பூ	kɯŋɡɯmʌpːuː
குங்குமம்	kɯŋɡɯmʌm
குசராத்	kɯsʌɾ̪ɑːt̪
குஞ்சி	kɯɲd͡ʑi
குடம்	kɯɖʌm
குடல்வால்	kɯɖʌl̪ʋɑːl̪
குடி	kɯɖi
குடிசை	kɯɖɨsʌɪ̯
குடிநீர்	kɯɖɨn̪iːɾ̪
குடில்	kɯɖɨl̪
குடும்பம்	kɯɖɯmbʌm
குடுவை	kɯɖɯʋʌɪ̯
குடை	kɯɖʌɪ̯
குட்டி	kɯʈːi
குணம்	kɯɳʌm
குணிப்பு	kɯɳɨpːɯ
குண்டம்	kɯɳɖʌm
குண்டி	kɯɳɖi
குதிரை	kɯd̪ɨɾ̪ʌɪ̯
குன்றின்	kɯnrɨn
குன்று	kɯnrɯ
குப்பம்	kɯpːʌm
குப்பி	kɯpːi
குமாரத்தி	kɯmɑːɾ̪ʌt̪ːi
குமாரன்	kɯmɑːɾ̪ʌn
குமார்	kɯmɑːɾ̪
குமிழி	kɯmɨɻi
கும்பிடு	kɯmbɨɖɯ
குயவன்	kɯjʌʋʌn
குயில்	kɯjɨl̪
குரங்கு	kɯɾ̪ʌŋɡɯ
குரல்	kɯɾ̪ʌl̪
குரல்வளை	kɯɾ̪ʌl̪ʋʌɭʌɪ̯
குரு	kɯɾ̪ɯ
குருகுலம்	kɯɾ̪ɯɡɯl̪ʌm
குருடன்	kɯɾ̪ɯɖʌn
குருடு	kɯɾ̪ɯɖɯ
குருதி	kɯɾ̪ɯd̪i
குருத்து	kɯɾ̪ɯt̪ːɯ
குறங்கு	kɯrʌŋɡɯ
குறி	kɯri
குறித்து	kɯrɨt̪ːɯ
குறிப்பு	kɯrɨpːɯ
குறுமை	kɯrɯmʌɪ̯
குலம்	kɯl̪ʌm
குலிகம்	kɯl̪ɨɡʌm
குலை	kɯl̪ʌɪ̯
குளம்	kɯɭʌm
குளி	kɯɭi
குளிப்பு	kɯɭɨpːɯ
குளியல்	kɯɭɨjʌl̪
குளிர்	kɯɭɨɾ̪
குளிர்ச்சி	kɯɭɨɾ̪sːi
குளிர்ப்பு	kɯɭɨɾ̪pːɯ
குளிர்மை	kɯɭɨɾ̪mʌɪ̯
குள்ளம்	kɯɭːʌm
குழப்பம்	kɯɻʌpːʌm
குழி	kɯɻi
குழிவு	kɯɻɨʋɯ
குவளை	kɯʋʌɭʌɪ̯
குவார்ட்சு	kɯʋɑːɾ̪ʈsɯ
குவியம்	kɯʋɨjʌm
குவியல்	kɯʋɨjʌl̪
கூகை	kuːɡʌɪ̯
கூடம்	kuːɖʌm
கூடாரத்தில்	kuːɖɑːɾ̪ʌt̪ːɨl̪
கூடாரம்	kuːɖɑːɾ̪ʌm
கூடு	kuːɖɯ
கூடை	kuːɖʌɪ̯
கூட்டம்	kuːʈːʌm
கூட்டல்	kuːʈːʌl̪
கூத்தாட	kuːt̪ːɑːɖa
கூத்து	kuːt̪ːɯ
கூனைப்பூ	kuːnʌɪ̯pːuː
கூரை	kuːɾ̪ʌɪ̯
கூரைவீடு	kuːɾ̪ʌɪ̯ʋiːɖɯ
கூறு	kuːrɯ
கூறை	kuːrʌɪ̯
கூற்று	kuːʈːɾɯ
கூலம்	kuːl̪ʌm
கூவிளம்	kuːʋɨɭəm
கெட்டம்	keʈːʌm
கெழு	keɻɯ
கேரளம்	keːɾ̪ʌɭʌm
கேரளா	keːɾ̪ʌɭɑː
கை	kʌɪ̯
கைது	kʌɪ̯t̪ɯ
கைப்பை	kʌɪ̯pːʌɪ̯
கொக்கு	kokːɯ
கொக்குமந்தாரை	kokːɯmʌn̪d̪ɑːɾ̪ʌɪ̯
கொசு	kosɯ
கொஞ்சம்	koɲd͡ʑʌm
கொடுவாள்	koɖɯʋɑːɭ
கொட்டகை	koʈːʌɡʌɪ̯
கொண்டாட்டம்	koɳɖɑːʈːʌm
கொம்பு	kombɯ
கொறுக்கை	korɯkːʌɪ̯
கொல்லறு	kol̪ːʌrɯ
கொல்லற்றுவேலை	kol̪ːʌʈːɾɯʋeːl̪ʌɪ̯
கொள்ளை	koɭːʌɪ̯
கொழுப்பு	koɻɯpːɯ
கொழும்பு	koɻɯmbɯ
கோடரி	koːɖʌɾ̪i
கோடர்	koːɖʌɾ̪
கோடாலி	koːɖɑːl̪i
கோடிமுனை	koːɖɨmɯnʌɪ̯
கோட்டம்	koːʈːʌm
கோட்டை	koːʈːʌɪ̯
கோட்பாடு	koːʈpɑːɖɯ
கோணவியல்	koːɳʌʋɨjʌl̪
கோபம்	koːbʌm
கோபுரம்	koːbɯɾ̪ʌm
கோப்பை	koːpːʌɪ̯
கோமான்	koːmɑːn
கோயம்புத்தூர்	koːjʌmbɯt̪ːuːɾ̪
கோயில்	koːjɨl̪
கோரிக்கை	koːɾ̪ɨkːʌɪ̯
கோலம்	koːl̪ʌm
கோளாறு	koːɭɑːrɯ
கோவைக்காய்	koːʋʌɪ̯kːɑːj
ச	sa
சகதி	sʌɡʌd̪i
சகோதரன்	sʌɡoːd̪ʌɾ̪ʌn
சகோதரி	sʌɡoːd̪ʌɾ̪i
சக்கரை	sʌkːʌɾ̪ʌɪ̯
சங்கம்	sʌŋɡʌm
சச்சம்	sʌsːʌm
சட்டமன்றம்	sʌʈːʌmʌnrʌm
சட்டம்	sʌʈːʌm
சட்டி	sʌʈːi
சட்டை	sʌʈːʌɪ̯
சட்னி	sʌʈni
சணல்	sʌɳʌl̪
சண்டை	sʌɳɖʌɪ̯
சதகுப்பி	sadəɣʉpːɨ
சதகுப்பை	sadəɣʉpːaɪ
சதுரங்கம்	sʌd̪ɯɾ̪ʌŋɡʌm
சதை	sʌd̪ʌɪ̯
சத்தியம்	sʌt̪ːɨjʌm
சத்திரம்	sʌt̪ːɨɾ̪ʌm
சத்து	sʌt̪ːɯ
சந்தனம்	sʌn̪d̪ʌnʌm
சந்தா	sʌn̪d̪ɑː
சந்திப்பு	sʌn̪d̪ɨpːɯ
சந்திரன்	sʌn̪d̪ɨɾ̪ʌn
சந்திரப்பிரபை	sʌn̪d̪ɨɾ̪ʌpːɨɾ̪ʌbʌɪ̯
சந்திராதபம்	sʌn̪d̪ɨɾ̪ɑːd̪ʌbʌm
சந்து	sʌn̪d̪ɯ
சந்தை	sʌn̪d̪ʌɪ̯
சனி	sʌni
சப்பாத்தி	sʌpːɑːt̪ːi
சப்போட்டா	sʌpːoːʈːɑː
சமசுகிருதம்	sʌmʌsɯɡɨɾ̪ɯd̪ʌm
சமம்	sʌmʌm
சமயம்	sʌmʌjʌm
சமவெளி	sʌmʌʋeɭi
சமாதானம்	sʌmɑːd̪ɑːnʌm
சமைவு	sʌmʌɪ̯ʋɯ
சமோசா	sʌmoːsɑː
சம்பளம்	sʌmbʌɭʌm
சம்புநாவல்	sʌmbɯn̪ɑːʋʌl̪
சம்மட்டி	sʌmːʌʈːi
சயிக்கம்	sʌjɨkːʌm
சயிந்தவம்	sʌjɨn̪d̪ʌʋʌm
சரி	sʌɾ̪i
சரித்திரம்	sʌɾ̪ɨt̪ːɨɾ̪ʌm
சரிவு	sʌɾ̪ɨʋɯ
சருமம்	sʌɾ̪ɯmʌm
சர்க்கரை	sʌɾ̪kːʌɾ̪ʌɪ̯
சர்ச்சை	sʌɾ̪sːʌɪ̯
சர்பராஜ்	sʌɾ̪pʌɾ̪ɑːd͡ʑ
சர்வத்திர	sʌɾ̪ʋʌt̪ːɨɾ̪a
சற்பிரசாதம்	sʌrpɨɾ̪ʌsɑːd̪ʌm
சலகம்	sʌl̪ʌɡʌm
சலவைக்காரர்	sʌl̪ʌʋʌɪ̯kːɑːɾ̪ʌɾ̪
சவால்	sʌʋɑːl̪
சாணைக்கல்	sɑːɳʌɪ̯kːʌl̪
சாதம்	sɑːd̪ʌm
சாதிக்காய்	sɑːd̪ɨkːɑːj
சாப்பாட்டுக்கடை	sɑːpːɑːʈːɯkːʌɖʌɪ̯
சாம்பல்	sɑːmbʌl̪
சாயங்காலம்	sɑːjʌŋɡɑːl̪ʌm
சாய்ப்பிடம்	sɑːjpːɨɖʌm
சார்வு	sɑːɾ̪ʋɯ
சாறு	sɑːrɯ
சாலி	sɑːl̪i
சாலை	sɑːl̪ʌɪ̯
சாளம்	sɑːɭʌm
சாளரம்	sɑːɭʌɾ̪ʌm
சாவல்	sɑːʋʌl̪
சாவி	sɑːʋi
சிகப்பு	sɨɡʌpːɯ
சிகரட்	sɨɡʌɾ̪ʌʈ
சிகரம்	sɨɡʌɾ̪ʌm
சிகிச்சை	sɨɡɨsːʌɪ̯
சிங்கப்பூர்	sɨŋɡʌpːuːɾ̪
சிங்கம்	sɨŋɡʌm
சிசு	sɨsɯ
சிதடு	sɨd̪ʌɖɯ
சிதமை	sɨd̪ʌmʌɪ̯
சிதர்	sɨd̪ʌɾ̪
சிதறியம்	sɨd̪ʌrɨjʌm
சிதல்	sɨd̪ʌl̪
சிதாரி	sɨd̪ɑːɾ̪i
சித்திரை	sɨt̪ːɨɾ̪ʌɪ̯
சிநேகிதன்	sɨn̪eːɡɨd̪ʌn
சிந்து	sɨn̪d̪ɯ
சினகரம்	sɨnʌɡʌɾ̪ʌm
சினகர்	sɨnʌɡʌɾ̪
சினம்	sɨnʌm
சினாடிகா	sɨnɑːɖɨɡɑː
சினேகம்	sɨneːɡʌm
சினை	sɨnʌɪ̯
சினைப்பை	sɨnʌɪ̯pːʌɪ̯
சின்டி	sɨnʈi
சின்ன	sɨnːa
சின்னக்கரடி	sɨnːʌkːʌɾ̪ʌɖi
சிரித்தை	sɨɾ̪ɨt̪ːʌɪ̯
சிரிப்பு	sɨɾ̪ɨpːɯ
சிருஷ்டி	sɨɾ̪ɯʂʈi
சிற	sɨra
சிறகு	sɨrʌɡɯ
சிறப்பு	sɨrʌpːɯ
சிறுகதை	sɨrɯɡʌd̪ʌɪ̯
சிறுநீரகம்	sɨrɯn̪iːɾ̪ʌɡʌm
சிறுமை	sɨrɯmʌɪ̯
சிறுவன்	sɨrɯʋʌn
சிற்பம்	sɨrpʌm
சிற்றுண்டி	sɨʈːɾɯɳɖi
சிற்றூர்	sɨʈːɾuːɾ̪
சிலந்தி	sɨl̪ʌn̪d̪i
சிவ	sɨʋa
சிவப்புக்கல்	sɨʋʌpːɯkːʌl̪
சிவளிகைக்கச்சு	sɨʋʌɭɨɡʌɪ̯kːʌsːɯ
சிஷ்டம்	sɨʂʈʌm
சிஷ்யன்	sɨʂjʌn
சீக்கிரம்	siːkːɨɾ̪ʌm
சீடை	siːɖʌɪ̯
சீனா	siːnɑː
சீபாதம்	siːbɑːd̪ʌm
சீமைச்சீரகம்	siːmʌɪ̯sːiːɾ̪ʌɡʌm
சீரகம்	siːɾ̪ʌɡʌm
சீழ்	siːɻ
சுக்கை	sɯkːʌɪ̯
சுட்டாமுட்டி	sɯʈːɑːmɯʈːi
சுட்டுவிரல்	sɯʈːɯʋɨɾ̪ʌl̪
சுண்டெலி	sɯɳɖel̪i
சுண்ணம்	sɯɳːʌm
சுதந்தரம்	sɯd̪ʌn̪d̪ʌɾ̪ʌm
சுந்தரம்	sɯn̪d̪ʌɾ̪ʌm
சுனாமி	sɯnɑːmi
சுனை	sɯnʌɪ̯
சுரம்	sɯɾ̪ʌm
சுருட்டு	sɯɾ̪ɯʈːɯ
சுருதி	sɯɾ̪ɯd̪i
சுரும்பு	sɯɾ̪ɯmbɯ
சுருளி	sɯɾ̪ɯɭi
சுரை	sɯɾ̪ʌɪ̯
சுறா	sɯrɑː
சுற்றம்	sɯʈːɾʌm
சுற்று	sɯʈːɾɯ
சுற்றுச்சூழல்	sɯʈːɾɯsːuːɻʌl̪
சுவடி	sɯʋʌɖi
சுவடு	sɯʋʌɖɯ
சுவாசம்	sɯʋɑːsʌm
சுவாசியா	sɯʋɑːsɨjɑː
சுவையான	sɯʋʌɪ̯jɑːna
சூரியன்	suːɾ̪ɨjʌn
சூறை	suːrʌɪ̯
சூழலியல்	suːɻʌl̪ɨjʌl̪
சூழல்	suːɻʌl̪
செங்	seŋ
செங்கந்தகம்	seŋɡʌn̪d̪ʌɡʌm
செங்கல்	seŋɡʌl̪
செங்கல்மால்	seŋɡʌl̪mɑːl̪
செங்கிழங்கு	seŋɡɨɻʌŋɡɯ
செங்கோல்	seŋɡoːl̪
செச்சினியா	sesːɨnɨjɑː
செடி	seɖi
செடிகொடி	seɖɨɡoɖi
செந்	sen̪
செந்தமிழ்	sen̪d̪ʌmɨɻ
செந்தாமரை	sen̪d̪ɑːmʌɾ̪ʌɪ̯
சென்னை	senːʌɪ̯
செபக்குடம்	sebʌkːɯɖʌm
செபம்	sebʌm
செப்பம்	sepːʌm
செப்பு	sepːɯ
செம்	sem
செம்பு	sembɯ
செயசூறை	sejʌsuːrʌɪ̯
செயலிழ	sejʌl̪ɨɻa
செய்	sej
செய்தல்	sejt̪ʌl̪
செய்தி	sejt̪i
செய்தித்தாள்	sejt̪ɨt̪ːɑːɭ
செய்யுள்	sejːɯɭ
செருப்பு	seɾ̪ɯpːɯ
செருமு	seɾ̪ɯmɯ
செல்வநூல்	sel̪ʋʌn̪uːl̪
செல்வம்	sel̪ʋʌm
செல்வாக்கு	sel̪ʋɑːkːɯ
செள்ளு	seɭːɯ
செழித்தகல்	seɻɨt̪ːʌɡʌl̪
செழிப்பு	seɻɨpːɯ
செழியன்	seɻɨjʌn
செவி	seʋi
செவியன்	seʋɨjʌn
செவ்வனம்	seʋːʌnʌm
செவ்வள்ளி	seʋːʌɭːi
செவ்வாய்	seʋːɑːj
செவ்வி	seʋːi
செவ்விரும்பு	seʋːɨɾ̪ɯmbɯ
சேதி	seːd̪i
சேப்பங்கிழங்கு	seːpːʌŋɡɨɻʌŋɡɯ
சேய்	seːj
சேய்மை	seːjmʌɪ̯
சேர்	seːɾ̪
சேர்க்கை	seːɾ̪kːʌɪ̯
சேர்த்தி	seːɾ̪t̪ːi
சேர்ந்தலை	seːɾ̪n̪d̪ʌl̪ʌɪ̯
சேர்ந்தார்	seːɾ̪n̪d̪ɑːɾ̪
சேர்ப்பு	seːɾ̪pːɯ
சேறு	seːrɯ
சேவல்	seːʋʌl̪
சைகதம்	sʌɪ̯kʌd̪ʌm
சொத்து	sot̪ːɯ
சொந்த	son̪d̪a
சொற்பிறப்பியல்	sorpɨrʌpːɨjʌl̪
சொற்பு	sorpɯ
சொற்புத்தி	sorpɯt̪ːi
சொற்பொழிவு	sorpoɻɨʋɯ
சொற்றொடர்	soʈːɾoɖʌɾ̪
சொல்	sol̪
சொல்லாட்சி	sol̪ːɑːʈsi
சொல்லியல்	sol̪ːɨjʌl̪
சொல்லெச்சம்	sol̪ːesːʌm
சொல்வளம்	sol̪ʋʌɭʌm
சோதிடம்	soːd̪ɨɖʌm
சோபானம்	soːbɑːnʌm
சோம்பு	soːmbɯ
சோறு	soːrɯ
சோலை	soːl̪ʌɪ̯
சோளம்	soːɭʌm
சௌக்கியமா	sʌʊ̯kːɨjʌmɑː
ஜகத்	d͡ʑʌɡʌt̪
ஜங்கிள்	d͡ʑʌŋɡɨɭ
ஜண்டா	d͡ʑʌɳɖɑː
ஜந்து	d͡ʑʌn̪d̪ɯ
ஜனகம்	d͡ʑʌnʌɡʌm
ஜனவரி	d͡ʑʌnʌʋʌɾ̪i
ஜனாபா	d͡ʑʌnɑːbɑː
ஜன்னல்	d͡ʑʌnːʌl̪
ஜப்பான்	d͡ʑʌpːɑːn
ஜலதி	d͡ʑʌl̪ʌd̪i
ஜலம்	d͡ʑʌl̪ʌm
ஜாஜ்வல்யம்	d͡ʑɑːd͡ʑʋʌl̪jʌm
ஜாநு	d͡ʑɑːn̪ɯ
ஜிந்தகி	d͡ʑɨn̪d̪ʌɡi
ஜிராயதி	d͡ʑɨɾ̪ɑːjʌd̪i
ஜீதம்	d͡ʑiːd̪ʌm
ஜீரகம்	d͡ʑiːɾ̪ʌɡʌm
ஜீவசரிதை	d͡ʑiːʋʌsʌɾ̪ɨd̪ʌɪ̯
ஜீவவிருட்சம்	d͡ʑiːʋʌʋɨɾ̪ɯʈsʌm
ஜெருசலேம்	d͡ʑeɾ̪ɯsʌl̪eːm
ஜ்வாலை	d͡ʑʋɑːl̪ʌɪ̯
ஞானம்	ɲɑːnʌm
ஞாயிறு	ɲɑːjɨrɯ
டிராகன்	ʈɨɾ̪ɑːɡʌn
தகடி	t̪ʌɡʌɖi
தக்காளி	t̪ʌkːɑːɭi
தங்கம்	t̪ʌŋɡʌm
தங்கை	t̪ʌŋɡʌɪ̯
தசை	t̪ʌsʌɪ̯
தடி	t̪ʌɖi
தட்டு	t̪ʌʈːɯ
தண்டனை	t̪ʌɳɖʌnʌɪ̯
தண்ணீர்	t̪ʌɳːiːɾ̪
தந்திரவாயன்	t̪ʌn̪d̪ɨɾ̪ʌʋɑːjʌn
தந்தை	t̪ʌn̪d̪ʌɪ̯
தனியா	t̪ʌnɨjɑː
தன்னுணர்வு	t̪ʌnːɯɳʌɾ̪ʋɯ
தன்மை	t̪ʌnmʌɪ̯
தப்பு	t̪ʌpːɯ
தமக்கை	t̪ʌmʌkːʌɪ̯
தமிழிலக்கணம்	t̪ʌmɨɻɨl̪ʌkːʌɳʌm
தமிழ்	t̪ʌmɨɻ
தமிழ்நாடு	t̪ʌmɨɻn̪ɑːɖɯ
தம்பம்	t̪ʌmbʌm
தம்பி	t̪ʌmbi
தம்புரா	t̪ʌmbɯɾ̪ɑː
தயிர்	t̪ʌjɨɾ̪
தரியலர்	t̪ʌɾ̪ɨjʌl̪ʌɾ̪
தரியாபத்து	t̪ʌɾ̪ɨjɑːbʌt̪ːɯ
தருக்கு	t̪ʌɾ̪ɯkːɯ
தருமன்	t̪ʌɾ̪ɯmʌn
தருமம்	t̪ʌɾ̪ɯmʌm
தரூடம்	t̪ʌɾ̪uːɖʌm
தர்ச்சனி	t̪ʌɾ̪sːʌni
தர்ஜமா	t̪ʌɾ̪d͡ʑʌmɑː
தறி	t̪ʌri
தற்சனி	t̪ʌrsʌni
தற்பால்சேர்க்கை	t̪ʌrpɑːl̪seːɾ̪kːʌɪ̯
தலை	t̪ʌl̪ʌɪ̯
தலைமாறு	t̪ʌl̪ʌɪ̯mɑːrɯ
தலைமுறை	t̪ʌl̪ʌɪ̯mɯrʌɪ̯
தலைமை	t̪ʌl̪ʌɪ̯mʌɪ̯
தலையல்	t̪ʌl̪ʌɪ̯jʌl̪
தலைவன்	t̪ʌl̪ʌɪ̯ʋʌn
தலைவர்	t̪ʌl̪ʌɪ̯ʋʌɾ̪
தளப்பு	t̪ʌɭʌpːɯ
தளம்	t̪ʌɭʌm
தளர்	t̪ʌɭʌɾ̪
தளர்ச்சி	t̪ʌɭʌɾ̪sːi
தளர்வு	t̪ʌɭʌɾ̪ʋɯ
தளை	t̪ʌɭʌɪ̯
தள்ளை	t̪ʌɭːʌɪ̯
தவம்	t̪ʌʋʌm
தவளை	t̪ʌʋʌɭʌɪ̯
தவிள்	t̪ʌʋɨɭ
தாகெஸ்தான்	t̪ɑːɡest̪ɑːn
தாடி	t̪ɑːɖi
தாட்கோல்	t̪ɑːʈkoːl̪
தாதை	t̪ɑːd̪ʌɪ̯
தானியம்	t̪ɑːnɨjʌm
தான்	t̪ɑːn
தாமரை	t̪ɑːmʌɾ̪ʌɪ̯
தாமிரபருணி	t̪ɑːmɨɾ̪ʌbʌɾ̪ɯɳi
தாயகம்	t̪ɑːjʌɡʌm
தாய்	t̪ɑːj
தாய்மொழி	t̪ɑːjmoɻi
தாய்லாந்து	t̪ɑːjl̪ɑːn̪d̪ɯ
தார்	t̪ɑːɾ̪
தாலாட்டு	t̪ɑːl̪ɑːʈːɯ
தாலி	t̪ɑːl̪i
தாளம்	t̪ɑːɭʌm
தாளித்தல்	t̪ɑːɭɨt̪ːʌl̪
தாவரம்	t̪ɑːʋʌɾ̪ʌm
தாவரவியல்	t̪ɑːʋʌɾ̪ʌʋɨjʌl̪
தாஸ்மானியா	t̪ɑːsmɑːnɨjɑː
திக்கு	t̪ɨkːɯ
திங்கள்	t̪ɨŋɡʌɭ
திதி	t̪ɨd̪i
திநாரம்	t̪ɨn̪ɑːɾ̪ʌm
தினந்தோறும்	t̪ɨnʌn̪d̪oːrɯm
தினம்	t̪ɨnʌm
தியானம்	t̪ɨjɑːnʌm
திரவம்	t̪ɨɾ̪ʌʋʌm
திரவிடம்	t̪ɨɾ̪ʌʋɨɖʌm
திராட்சை	t̪ɨɾ̪ɑːʈsʌɪ̯
திராவகம்	t̪ɨɾ̪ɑːʋʌɡʌm
திராவிட	t̪ɨɾ̪ɑːʋɨɖa
திரிதடையம்	t̪ɨɾ̪ɨd̪ʌɖʌɪ̯jʌm
திரிய	t̪ɨɾ̪ɨja
திரியும்	t̪ɨɾ̪ɨjɯm
திருகாணி	t̪ɨɾ̪ɯɡɑːɳi
திருக்கார்த்திகை	t̪ɨɾ̪ɯkːɑːɾ̪t̪ːɨɡʌɪ̯
திருட்டு	t̪ɨɾ̪ɯʈːɯ
திருப்பு	t̪ɨɾ̪ɯpːɯ
திருப்புகை	t̪ɨɾ̪ɯpːɯɡʌɪ̯
திருமணம்	t̪ɨɾ̪ɯmʌɳʌm
திருமண்	t̪ɨɾ̪ɯmʌɳ
திருவனந்தபுரம்	t̪ɨɾ̪ɯʋʌnʌn̪d̪ʌbɯɾ̪ʌm
திருவாத்தி	t̪iɾʉʋaːt̪ːɨ
திரைப்படம்	t̪ɨɾ̪ʌɪ̯pːʌɖʌm
திறமை	t̪ɨrʌmʌɪ̯
திறவுகோல்	t̪ɨrʌʋɯɡoːl̪
தில்லம்	t̪ɨl̪ːʌm
தீனம்	t̪iːnʌm
தீனிப்பை	t̪iːnɨpːʌɪ̯
தீமுறி	t̪iːmɯri
தீமை	t̪iːmʌɪ̯
தீவு	t̪iːʋɯ
துணி	t̪ɯɳi
துணைக்கருவி	t̪ɯɳʌɪ̯kːʌɾ̪ɯʋi
துண்டு	t̪ɯɳɖɯ
துத்தம்	t̪ɯt̪ːʌm
துப்பல்	t̪ɯpːʌl̪
தும்மல்	t̪ɯmːʌl̪
துயில்	t̪ɯjɨl̪
துரியான்	t̪ɯɾ̪ɨjɑːn
துருக்மெனிஸ்தான்	t̪ɯɾ̪ɯkmenɨst̪ɑːn
துறை	t̪ɯrʌɪ̯
துளசி	t̪ɯɭʌsi
துளுவம்	t̪ɯɭɯʋʌm
துவக்கு	t̪ɯʋʌkːɯ
துவக்கூசி	t̪ɯʋʌkːuːsi
துவாரம்	t̪ɯʋɑːɾ̪ʌm
தூக்கு	t̪uːkːɯ
தூண்டில்	t̪uːɳɖɨl̪
தூரம்	t̪uːɾ̪ʌm
தூவல்	t̪uːʋʌl̪
தெகுரான்	t̪eɡɯɾ̪ɑːn
தெரிவி	t̪eɾ̪ɨʋi
தெரு	t̪eɾ̪ɯ
தெற்கு	t̪erkɯ
தெலுங்கு	t̪el̪ɯŋɡɯ
தெள்ளு	t̪eɭːɯ
தெஹரான்	t̪ehʌɾ̪ɑːn
தேக்கர்	t̪eːkːʌɾ̪
தேக்கு	t̪eːkːɯ
தேங்காய்	t̪eːŋɡɑːj
தேசகன்	t̪eːsʌɡʌn
தேசபாஷை	t̪eːsʌbɑːʂʌɪ̯
தேசம்	t̪eːsʌm
தேசாசாரம்	t̪eːsɑːsɑːɾ̪ʌm
தேசாதிபதி	t̪eːsɑːd̪ɨbʌd̪i
தேசீயவியக்கம்	t̪eːsiːjʌʋɨjʌkːʌm
தேர்ச்சி	t̪eːɾ̪sːi
தேர்தல்	t̪eːɾ̪t̪ʌl̪
தேற்கு	t̪eːkkɯ
தேற்கு	t̪eːrkɯ
தேவதூதன்	t̪eːʋʌd̪uːd̪ʌn
தேவதை	t̪eːʋʌd̪ʌɪ̯
தேவன்	t̪eːʋʌn
தேவவசீகரம்	t̪eːʋʌʋʌsiːɡʌɾ̪ʌm
தேவாலயம்	t̪eːʋɑːl̪ʌjʌm
தேவை	t̪eːʋʌɪ̯
தேவையான	t̪eːʋʌɪ̯jɑːna
தொகுதி	t̪oɡɯd̪i
தொடருந்து	t̪oɖʌɾ̪ɯn̪d̪ɯ
தொடர்பு	t̪oɖʌɾ̪pɯ
தொடர்வண்டி	t̪oɖʌɾ̪ʋʌɳɖi
தொடு	t̪oɖɯ
தொடுப்பு	t̪oɖɯpːɯ
தொண்டு	t̪oɳɖɯ
தொன்னை	t̪onːʌɪ̯
தொன்மை	t̪onmʌɪ̯
தொன்று	t̪onrɯ
தொறுவு	t̪orɯʋɯ
தொற்று	t̪oʈːɾɯ
தொலைக்காட்சி	t̪ol̪ʌɪ̯kːɑːʈsi
தொலைபேசி	t̪ol̪ʌɪ̯peːsi
தொல்லியல்	t̪ol̪ːɨjʌl̪
தொழினுட்பம்	t̪oɻɨnɯʈpʌm
தொழிற்சாலை	t̪oɻɨrsɑːl̪ʌɪ̯
தொழிலாளி	t̪oɻɨl̪ɑːɭi
தொழில்	t̪oɻɨl̪
தொழும்பு	t̪oɻɯmbɯ
தொழுவன்	t̪oɻɯʋʌn
தொழுவம்	t̪oɻɯʋʌm
தொழுவர்	t̪oɻɯʋʌɾ̪
தொழுவு	t̪oɻɯʋɯ
தோகம்	t̪oːɡʌm
தோசம்	t̪oːsʌm
தோட்டம்	t̪oːʈːʌm
தோட்டிமை	t̪oːʈːɨmʌɪ̯
தோண்டான்	t̪oːɳɖɑːn
தோலியல்	t̪oːl̪ɨjʌl̪
நகம்	n̪ʌɡʌm
நகரப்பதி	n̪ʌɡʌɾ̪ʌpːʌd̪i
நகரமாந்தர்	n̪ʌɡʌɾ̪ʌmɑːn̪d̪ʌɾ̪
நகரம்	n̪ʌɡʌɾ̪ʌm
நகர்	n̪ʌɡʌɾ̪
நகை	n̪ʌɡʌɪ̯
நகைச்சுவை	n̪ʌɡʌɪ̯sːɯʋʌɪ̯
நக்கு	n̪ʌkːɯ
நட	n̪ʌɖa
நடனம்	n̪ʌɖʌnʌm
நடிகர்	n̪ʌɖɨɡʌɾ̪
நடு	n̪ʌɖɯ
நடுவடிக்கை	n̪ʌɖɯʋʌɖɨkːʌɪ̯
நடை	n̪ʌɖʌɪ̯
நட்சத்திரமண்டலம்	n̪ʌʈsʌt̪ːɨɾ̪ʌmʌɳɖʌl̪ʌm
நட்சத்திரம்	n̪ʌʈsʌt̪ːɨɾ̪ʌm
நட்டம்	n̪ʌʈːʌm
நதி	n̪ʌd̪i
நதிகேள்வன்	n̪ʌd̪ɨɡeːɭʋʌn
நத்தம்	n̪ʌt̪ːʌm
நந்தி	n̪ʌn̪d̪i
நன்மை	n̪ʌnmʌɪ̯
நன்றாக	n̪ʌnrɑːɡa
நன்றி	n̪ʌnri
நபம்	n̪ʌbʌm
நரகம்	n̪ʌɾ̪ʌɡʌm
நரம்பியல்	n̪ʌɾ̪ʌmbɨjʌl̪
நரம்பு	n̪ʌɾ̪ʌmbɯ
நரி	n̪ʌɾ̪i
நறுமணம்	n̪ʌrɯmʌɳʌm
நல்	n̪ʌl̪
நல்லவர்	n̪ʌl̪ːʌʋʌɾ̪
நல்லொழுக்கம்	n̪ʌl̪ːoɻɯkːʌm
நல்வாக்கு	n̪ʌl̪ʋɑːkːɯ
நவில்	n̪ʌʋɨl̪
நா	n̪ɑː
நாகம்	n̪ɑːɡʌm
நாகரிகம்	n̪ɑːɡʌɾ̪ɨɡʌm
நாக்கு	n̪ɑːkːɯ
நாங்கள்	n̪ɑːŋɡʌɭ
நாடகம்	n̪ɑːɖʌɡʌm
நாடா	n̪ɑːɖɑː
நாடு	n̪ɑːɖɯ
நாடோடி	n̪ɑːɖoːɖi
நாட்டம்	n̪ɑːʈːʌm
நாட்டாண்மை	n̪ɑːʈːɑːɳmʌɪ̯
நாணயம்	n̪ɑːɳʌjʌm
நாணல்	n̪ɑːɳʌl̪
நாத்திகம்	n̪ɑːt̪ːɨɡʌm
நான்	n̪ɑːn
நான்கு	n̪ɑːlɯ
நான்கு	n̪ɑːnkɯ
நாமம்	n̪ɑːmʌm
நாம்	n̪ɑːm
நாய்	n̪ɑːj
நாய்க்குட்டி	n̪ɑːjkːɯʈːi
நாரை	n̪ɑːɾ̪ʌɪ̯
நாற்காலி	n̪ɑːrkɑːl̪i
நாளுக்கு	n̪ɑːɭɯkːɯ
நாளும்	n̪ɑːɭɯm
நாளை	n̪ɑːɭʌɪ̯
நாள்	n̪ɑːɭ
நாழிகை	n̪ɑːɻɨɡʌɪ̯
நாவல்	n̪aːʋəl
நிகர்ப்பு	n̪ɨɡʌɾ̪pːɯ
நிகழ்ச்சி	n̪ɨɡʌɻsːi
நிகழ்வு	n̪ɨɡʌɻʋɯ
நித்திலம்	n̪ɨt̪ːɨl̪ʌm
நினை	n̪ɨnʌɪ̯
நினைவகம்	n̪ɨnʌɪ̯ʋʌɡʌm
நினைவு	n̪ɨnʌɪ̯ʋɯ
நின்று	n̪ɨnrɯ
நிமிஷம்	n̪ɨmɨʂʌm
நியாயம்	n̪ɨjɑːjʌm
நிரந்தர	n̪ɨɾ̪ʌn̪d̪ʌɾ̪a
நிர்ணயம்	n̪ɨɾ̪ɳʌjʌm
நிர்வாகம்	n̪ɨɾ̪ʋɑːɡʌm
நிறமாலையியல்	n̪ɨrʌmɑːl̪ʌɪ̯jɨjʌl̪
நிறம்	n̪ɨrʌm
நிலக்கடலை	n̪ɨl̪ʌkːʌɖʌl̪ʌɪ̯
நிலம்	n̪ɨl̪ʌm
நிலவு	n̪ɨl̪ʌʋɯ
நிலவொளி	n̪ɨl̪ʌʋoɭi
நிலா	n̪ɨl̪ɑː
நிலாவெளிச்சம்	n̪ɨl̪ɑːʋeɭɨsːʌm
நிலை	n̪ɨl̪ʌɪ̯
நிலைப்பு	n̪ɨl̪ʌɪ̯pːɯ
நிலையம்	n̪ɨl̪ʌɪ̯jʌm
நில்	n̪ɨl̪
நிழல்	n̪ɨɻʌl̪
நிவப்பு	n̪ɨʋʌpːɯ
நிஷானி	n̪ɨʂɑːni
நிஷ்டை	n̪ɨʂʈʌɪ̯
நீக்கம்	n̪iːkːʌm
நீக்கல்	n̪iːkːʌl̪
நீண்டாயம்	n̪iːɳɖɑːjʌm
நீண்மை	n̪iːɳmʌɪ̯
நீத்தம்	n̪iːt̪ːʌm
நீத்து	n̪iːt̪ːɯ
நீந்து	n̪iːn̪d̪ɯ
நீரகம்	n̪iːɾ̪ʌɡʌm
நீராவி	n̪iːɾ̪ɑːʋi
நீர்வளம்	n̪iːɾ̪ʋʌɭʌm
நீலக்கல்	n̪iːl̪ʌkːʌl̪
நீலம்	n̪iːl̪ʌm
நீலிரும்பு	n̪iːl̪ɨɾ̪ɯmbɯ
நீளம்	n̪iːɭʌm
நீளிப்பு	n̪iːɭɨpːɯ
நுகர்ச்சி	n̪ɯɡʌɾ̪sːi
நுதல்	n̪ɯd̪ʌl̪
நுரையீரல்	n̪ɯɾ̪ʌɪ̯jiːɾ̪ʌl̪
நுழைவாசல்	n̪ɯɻʌɪ̯ʋɑːsʌl̪
நூறு	n̪uːrɯ
நூலகம்	n̪uːl̪ʌɡʌm
நூலறிவு	n̪uːl̪ʌrɨʋɯ
நெகிழ்ச்சி	n̪eɡɨɻsːi
நெசவாளர்	n̪esʌʋɑːɭʌɾ̪
நெசவு	n̪esʌʋɯ
நெஞ்சு	n̪eɲd͡ʑɯ
நெம்புகோல்	n̪embɯɡoːl̪
நெய்ப்பு	n̪ejpːɯ
நெருஞ்சி	n̪eɾʉɲd͡ʒɨ
நெருப்பு	n̪eɾ̪ɯpːɯ
நேரப்பட	n̪eːɾ̪ʌpːʌɖa
நேரம்	n̪eːɾ̪ʌm
நேர்ச்சி	n̪eːɾ̪sːi
நேர்பாடு	n̪eːɾ̪pɑːɖɯ
நேர்மை	n̪eːɾ̪mʌɪ̯
நேர்விடை	n̪eːɾ̪ʋɨɖʌɪ̯
நேர்வு	n̪eːɾ̪ʋɯ
நேற்று	n̪eːʈːɾɯ
நைட்ரஜன்	n̪ʌɪ̯ʈɾ̪ʌd͡ʑʌn
நொடிப்பு	n̪oɖɨpːɯ
நோக்காடு	n̪oːkːɑːɖɯ
நோக்கு	n̪oːkːɯ
பகரம்	pʌɡʌɾ̪ʌm
பகர்	pʌɡʌɾ̪
பகர்ச்சி	pʌɡʌɾ̪sːi
பகர்த்து	pʌɡʌɾ̪t̪ːɯ
பகல்	pʌɡʌl̪
பக்கம்	pʌkːʌm
பக்குவம்	pʌkːɯʋʌm
பக்குவாசயம்	pʌkːɯʋɑːsʌjʌm
பக்தி	pʌkt̪i
பங்கம்	pʌŋɡʌm
பங்களா	pʌŋɡʌɭɑː
பங்களிப்பு	pʌŋɡʌɭɨpːɯ
பங்குரம்	pʌŋɡɯɾ̪ʌm
பசலிப்பழம்	pʌsʌl̪ɨpːʌɻʌm
பசளி	pʌsʌɭi
பசியம்	pʌsɨjʌm
பசு	pʌsɯ
பசுமை	pʌsɯmʌɪ̯
பச்சை	pʌsːʌɪ̯
பச்சைக்கல்	pʌsːʌɪ̯kːʌl̪
பஞ்சரம்	pʌɲd͡ʑʌɾ̪ʌm
பஞ்சாப்	pʌɲd͡ʑɑːp
பஞ்சை	pʌɲd͡ʑʌɪ̯
பட	pʌɖa
படகு	pʌɖʌɡɯ
படம்	pʌɖʌm
படி	pʌɖi
படிக்காரம்	pʌɖɨkːɑːɾ̪ʌm
படிப்பறிவு	pʌɖɨpːʌrɨʋɯ
படிப்பு	pʌɖɨpːɯ
படிவம்	pʌɖɨʋʌm
படைப்பு	pʌɖʌɪ̯pːɯ
பட்சி	pʌʈsi
பட்டாணி	pʌʈːɑːɳi
பட்டு	pʌʈːɯ
பட்டை	pʌʈːʌɪ̯
பணப்பை	pʌɳʌpːʌɪ̯
பணம்	pʌɳʌm
பணவன்	pʌɳʌʋʌn
பணவீக்கம்	pʌɳʌʋiːkːʌm
பணாகரம்	pʌɳɑːɡʌɾ̪ʌm
பணி	pʌɳi
பணிகோள்	pʌɳɨɡoːɭ
பணிக்கன்	pʌɳɨkːʌn
பணிதி	pʌɳɨd̪i
பணிமுட்டு	pʌɳɨmɯʈːɯ
பணிவு	pʌɳɨʋɯ
பண்டம்	pʌɳɖʌm
பண்டாரம்	pʌɳɖɑːɾ̪ʌm
பண்டாரவாய்க்கால்	pʌɳɖɑːɾ̪ʌʋɑːjkːɑːl̪
பண்டிகை	pʌɳɖɨɡʌɪ̯
பண்டிதன்	pʌɳɖɨd̪ʌn
பண்பாடு	pʌɳpɑːɖɯ
பண்பு	pʌɳpɯ
பதலை	pʌd̪ʌl̪ʌɪ̯
பதவி	pʌd̪ʌʋi
பதிப்பகம்	pʌd̪ɨpːʌɡʌm
பதிமுகம்	pʌd̪ɨmɯɡʌm
பதிவகம்	pʌd̪ɨʋʌɡʌm
பதுமம்	pʌd̪ɯmʌm
பத்து	pʌt̪ːɯ
பனாயிப்பு	pʌnɑːjɨpːɯ
பனி	pʌni
பனிமூட்டம்	pʌnɨmuːʈːʌm
பன்றி	pʌnri
பன்றிக்குட்டி	pʌnrɨkːɯʈːi
பம்பரம்	pʌmbʌɾ̪ʌm
பயணம்	pʌjʌɳʌm
பயணி	pʌjʌɳi
பயனர்	pʌjʌnʌɾ̪
பயன்	pʌjʌn
பயப்படு	pʌjʌpːʌɖɯ
பயம்	pʌjʌm
பயிர்	pʌjɨɾ̪
பயிற்சி	pʌjɨrsi
பயிற்சியாளர்	pʌjɨrsɨjɑːɭʌɾ̪
பய்யன்	pʌjːʌn
பரங்கி	pʌɾ̪ʌŋɡi
பரணி	pʌɾ̪ʌɳi
பராமரிப்பு	pʌɾ̪ɑːmʌɾ̪ɨpːɯ
பரிதி	pʌɾ̪ɨd̪i
பரிதியம்	pʌɾ̪ɨd̪ɨjʌm
பரிமாற்றம்	pʌɾ̪ɨmɑːʈːɾʌm
பரிவு	pʌɾ̪ɨʋɯ
பருப்பதம்	pʌɾ̪ɯpːʌd̪ʌm
பருப்பு	pʌɾ̪ɯpːɯ
பருவதம்	pʌɾ̪ɯʋʌd̪ʌm
பரோட்டா	pʌɾ̪oːʈːɑː
பர்ணம்	pʌɾ̪ɳʌm
பர்வதம்	pʌɾ̪ʋʌd̪ʌm
பறந்தலை	pʌrʌn̪d̪ʌl̪ʌɪ̯
பறப்பன்	pʌrʌpːʌn
பறவை	pʌrʌʋʌɪ̯
பறவையியல்	pʌrʌʋʌɪ̯jɨjʌl̪
பலம்	pʌl̪ʌm
பலவு	pʌl̪ʌʋɯ
பலாப்பழம்	pʌl̪ɑːpːʌɻʌm
பலுக்கல்	pʌl̪ɯkːʌl̪
பல்	pʌl̪
பல்வலம்	pʌl̪ʋʌl̪ʌm
பளு	pʌɭɯ
பள்ளி	pʌɭːi
பள்ளிக்கல்வி	pʌɭːɨkːʌl̪ʋi
பள்ளிக்கூடம்	pʌɭːɨkːuːɖʌm
பழக்கம்	pʌɻʌkːʌm
பழச்சாறு	pʌɻʌsːɑːrɯ
பழமை	pʌɻʌmʌɪ̯
பழமொழி	pʌɻʌmoɻi
பழம்	pʌɻʌm
பழம்பாடம்	pʌɻʌmbɑːɖʌm
பழிச்சு	pʌɻɨsːɯ
பழீயம்	pʌɻiːjʌm
பழுது	pʌɻɯd̪ɯ
பழுவம்	pʌɻɯʋʌm
பழைய	pʌɻʌɪ̯ja
பவழம்	pʌʋʌɻʌm
பவிகம்	pʌʋɨɡʌm
பவிஷு	pʌʋɨʂɯ
பவ்வம்	pʌʋːʌm
பாகம்	pɑːɡʌm
பாகற்காய்	pɑːɡʌrkɑːj
பாகு	pɑːɡɯ
பாசம்	pɑːsʌm
பாசுரம்	pɑːsɯɾ̪ʌm
பாசை	pɑːsʌɪ̯
பாடகர்	pɑːɖʌɡʌɾ̪
பாடசாலை	pɑːɖʌsɑːl̪ʌɪ̯
பாடம்	pɑːɖʌm
பாடல்	pɑːɖʌl̪
பாட்டி	pɑːʈːi
பாட்டு	pɑːʈːɯ
பாதம்	pɑːd̪ʌm
பாதலத்தாம்பி	pɑːd̪ʌl̪ʌt̪ːɑːmbi
பாதுகாப்பு	pɑːd̪ɯɡɑːpːɯ
பானை	pɑːnʌɪ̯
பாப்பா	pɑːpːɑː
பாம்பாட்டி	pɑːmbɑːʈːi
பாம்பு	pɑːmbɯ
பாயசம்	pɑːjʌsʌm
பாரதம்	pɑːɾ̪ʌd̪ʌm
பாராட்டு	pɑːɾ̪ɑːʈːɯ
பாரிசவாதம்	pɑːɾ̪ɨsʌʋɑːd̪ʌm
பாரிஸ்	pɑːɾ̪ɨs
பார்	pɑːɾ̪
பார்லி	pɑːɾ̪l̪i
பார்வை	pɑːɾ̪ʋʌɪ̯
பார்வையாளர்	pɑːɾ̪ʋʌɪ̯jɑːɭʌɾ̪
பாறை	pɑːrʌɪ̯
பாறையியல்	pɑːrʌɪ̯jɨjʌl̪
பாற்பசு	pɑːrpʌsɯ
பாலாறு	pɑːl̪ɑːrɯ
பாலுறவு	pɑːl̪ɯrʌʋɯ
பாலூட்டி	pɑːl̪uːʈːi
பாலைவனம்	pɑːl̪ʌɪ̯ʋʌnʌm
பால்	pɑːl̪
பாவம்	pɑːʋʌm
பாவிப்பு	pɑːʋɨpːɯ
பாஷ்கொர்டொஸ்தான்	pɑːʂkoɾ̪ʈost̪ɑːn
பாஷ்தூ	pɑːʂt̪uː
பிகு	pɨɡɯ
பிகுபண்ணுதல்	pɨɡɯbʌɳːɯd̪ʌl̪
பிகுப்பட்டை	pɨɡɯpːʌʈːʌɪ̯
பிகுவேற்றுதல்	pɨɡɯʋeːʈːɾɯd̪ʌl̪
பிங்கதிருட்டி	pɨŋɡʌd̪ɨɾ̪ɯʈːi
பிங்கம்	pɨŋɡʌm
பிங்கலகேசி	pɨŋɡʌl̪ʌɡeːsi
பிங்கலம்	pɨŋɡʌl̪ʌm
பிங்கலை	pɨŋɡʌl̪ʌɪ̯
பிசகுசொல்லுதல்	pɨsʌɡɯsol̪ːɯd̪ʌl̪
பிசகுதல்	pɨsʌɡɯd̪ʌl̪
பிசகுநாறுதல்	pɨsʌɡɯn̪ɑːrɯd̪ʌl̪
பிசக்குதல்	pɨsʌkːɯd̪ʌl̪
பிசங்கம்	pɨsʌŋɡʌm
பிசங்கற்சீலை	pɨsʌŋɡʌrsiːl̪ʌɪ̯
பிசங்குதல்	pɨsʌŋɡɯd̪ʌl̪
பிசண்டம்	pɨsʌɳɖʌm
பிசண்டிலன்	pɨsʌɳɖɨl̪ʌn
பிசனம்	pɨsʌnʌm
பிசம்	pɨsʌm
பிசறுதல்	pɨsʌrɯd̪ʌl̪
பிசாசக்கை	pɨsɑːsʌkːʌɪ̯
பிசாசடித்தல்	pɨsɑːsʌɖɨt̪ːʌl̪
பிசாசன்	pɨsɑːsʌn
பிசாசர்	pɨsɑːsʌɾ̪
பிசாசாடுதல்	pɨsɑːsɑːɖɯd̪ʌl̪
பிசாசுபிடித்தல்	pɨsɑːsɯbɨɖɨt̪ːʌl̪
பிசாத்து	pɨsɑːt̪ːɯ
பிசான்	pɨsɑːn
பிசி	pɨsi
பிசிதாசனர்	pɨsɨd̪ɑːsʌnʌɾ̪
பிசினரக்கு	pɨsɨnʌɾ̪ʌkːɯ
பிசினரிசி	pɨsɨnʌɾ̪ɨsi
பிசினி	pɨsɨni
பிசின்	pɨsɨn
பிசின்பட்டை	pɨsɨnpʌʈːʌɪ̯
பிசிர்தல்	pɨsɨɾ̪t̪ʌl̪
பிசிறுலாடு	pɨsɨrɯl̪ɑːɖɯ
பிசுகுதல்	pɨsɯɡɯd̪ʌl̪
பிசுக்கோத்து	pɨsɯkːoːt̪ːɯ
பிசுனம்	pɨsɯnʌm
பிசுபிசுத்தவன்	pɨsɯbɨsɯt̪ːʌʋʌn
பிசுபிசெனல்	pɨsɯbɨsenʌl̪
பிசுமந்தச்சூரணம்	pɨsɯmʌn̪d̪ʌsːuːɾ̪ʌɳʌm
பிச்சு	pɨsːɯ
பிச்சுப்பை	pɨsːɯpːʌɪ̯
பித்தப்பை	pɨt̪ːʌpːʌɪ̯
பித்தம்	pɨt̪ːʌm
பின்	pɨn
பின்னாலே	pɨnːɑːl̪eː
பின்னிரக்கம்	pɨnːɨɾ̪ʌkːʌm
பின்பு	pɨnpɯ
பின்மொழிநிலையல்	pɨnmoɻɨn̪ɨl̪ʌɪ̯jʌl̪
பின்லாந்து	pɨnl̪ɑːn̪d̪ɯ
பிரகாரம்	pɨɾ̪ʌɡɑːɾ̪ʌm
பிரசங்கம்	pɨɾ̪ʌsʌŋɡʌm
பிரபஞ்சம்	pɨɾ̪ʌbʌɲd͡ʑʌm
பிரபந்தம்	pɨɾ̪ʌbʌn̪d̪ʌm
பிரபை	pɨɾ̪ʌbʌɪ̯
பிரமாதமான	pɨɾ̪ʌmɑːd̪ʌmɑːna
பிராயம்	pɨɾ̪ɑːjʌm
பிரிவு	pɨɾ̪ɨʋɯ
பிருதிவி	pɨɾ̪ɯd̪ɨʋi
பிறந்தை	pɨrʌn̪d̪ʌɪ̯
பிறப்பு	pɨrʌpːɯ
பிறப்புவழி	pɨrʌpːɯʋʌɻi
பிறவி	pɨrʌʋi
பிறவிக்கடல்	pɨrʌʋɨkːʌɖʌl̪
பிறவிக்குணம்	pɨrʌʋɨkːɯɳʌm
பிறவிக்குருடன்	pɨrʌʋɨkːɯɾ̪ɯɖʌn
பிறவிப்பயன்	pɨrʌʋɨpːʌjʌn
பிறிதின்கிழமை	pɨrɨd̪ɨnkɨɻʌmʌɪ̯
பிறிதுசாபம்	pɨrɨd̪ɯsɑːbʌm
பிறை	pɨrʌɪ̯
பிற்பகல்	pɨrpʌɡʌl̪
பிற்பக்கம்	pɨrpʌkːʌm
பிற்பாடர்	pɨrpɑːɖʌɾ̪
பீர்க்கங்காய்	piːɾ̪kːʌŋɡɑːj
பீர்க்கம்	piːɾ̪kːʌm
புகை	pɯɡʌɪ̯
புசிப்பு	pɯsɨpːɯ
புடவை	pɯɖʌʋʌɪ̯
புட்டி	pɯʈːi
புட்பம்	pɯʈpʌm
புட்பாகம்	pɯʈpɑːɡʌm
புணர்ச்சி	pɯɳʌɾ̪sːi
புண்டை	pɯɳɖʌɪ̯
புதன்	pɯd̪ʌn
புதிய	pɯd̪ɨja
புது	pɯd̪ɯ
புதுச்சேரி	pɯd̪ɯsːeːɾ̪i
புதுமை	pɯd̪ɯmʌɪ̯
புத்தகம்	pɯt̪ːʌɡʌm
புத்தன்	pɯt̪ːʌn
புத்தாண்டு	pɯt̪ːɑːɳɖɯ
புயல்	pɯjʌl̪
புரவு	pɯɾ̪ʌʋɯ
புரியாத்தியா	pɯɾ̪ɨjɑːt̪ːɨjɑː
புரிவு	pɯɾ̪ɨʋɯ
புருவம்	pɯɾ̪ɯʋʌm
புறம்	pɯrʌm
புறவு	pɯrʌʋɯ
புறா	pɯrɑː
புற்றுநோய்	pɯʈːɾɯn̪oːj
புலமை	pɯl̪ʌmʌɪ̯
புலவர்	pɯl̪ʌʋʌɾ̪
புலி	pɯl̪i
புளி	pɯɭi
புள்ளி	pɯɭːi
புழு	pɯɻɯ
புஷபராகம்	pɯʂʌbʌɾ̪ɑːɡʌm
புஸ்தகம்	pɯst̪ʌɡʌm
பூகண்டம்	puːɡʌɳɖʌm
பூச்சி	puːsːi
பூண்டு	puːɳɖɯ
பூனை	puːnʌɪ̯
பூரணமி	puːɾ̪ʌɳʌmi
பெண்	poɳːɯ
பெண்கரு	peɳkʌɾ̪ɯ
பெண்கள்	peɳkʌɭ
பெண்குறி	peɳkɯri
பெண்சனம்	peɳsʌnʌm
பெண்டாட்டி	peɳɖɑːʈːi
பெண்பால்	peɳpɑːl̪
பெயரெச்சம்	pejʌɾ̪esːʌm
பெயர்	pejʌɾ̪
பெயர்க்கு	pejʌɾ̪kːɯ
பெயர்ச்சி	pejʌɾ̪sːi
பெயர்த்திரிசொல்	pejʌɾ̪t̪ːɨɾ̪ɨsol̪
பெயர்த்துரை	pejʌɾ̪t̪ːɯɾ̪ʌɪ̯
பெயர்புறம்	pejʌɾ̪pɯrʌm
பெயர்ப்படு	pejʌɾ̪pːʌɖɯ
பெயர்ப்பு	pejʌɾ̪pːɯ
பெயர்வழி	pejʌɾ̪ʋʌɻi
பெயர்வேற்றுமை	pejʌɾ̪ʋeːʈːɾɯmʌɪ̯
பெயலை	pejʌl̪ʌɪ̯
பெய்துரை	pejt̪ɯɾ̪ʌɪ̯
பெரிய	peɾ̪ɨja
பெரியவெள்ளிக்கிழமை	peɾ̪ɨjʌʋeɭːɨkːɨɻʌmʌɪ̯
பெரியார்	peɾ̪ɨjɑːɾ̪
பெரியோன்	peɾ̪ɨjoːn
பெருகு	peɾ̪ɯɡɯ
பெருக்கம்	peɾ̪ɯkːʌm
பெருக்கல்	peɾ̪ɯkːʌl̪
பெருக்கல்வாய்பாடு	peɾ̪ɯkːʌl̪ʋɑːjpɑːɖɯ
பெருக்கு	peɾ̪ɯkːɯ
பெருங்காயம்	peɾ̪ɯŋɡɑːjʌm
பெருச்சாளி	peɾ̪ɯsːɑːɭi
பெர்லின்	peɾ̪l̪ɨn
பெளதிகம்	peɭʌd̪ɨɡʌm
பேசு	peːsɯ
பேச்சாளர்	peːsːɑːɭʌɾ̪
பேச்சு	peːsːɯ
பேச்சுவார்த்தை	peːsːɯʋɑːɾ̪t̪ːʌɪ̯
பேதிமருந்து	peːd̪ɨmʌɾ̪ɯn̪d̪ɯ
பேனா	peːnɑː
பேரருவி	peːɾ̪ʌɾ̪ɯʋi
பேராசிரியர்	peːɾ̪ɑːsɨɾ̪ɨjʌɾ̪
பேராலயம்	peːɾ̪ɑːl̪ʌjʌm
பேரினம்	peːɾ̪ɨnʌm
பை	pʌɪ̯
பைவன்	pʌɪ̯ʋʌn
பொந்து	pon̪d̪ɯ
பொம்மை	pomːʌɪ̯
பொய்யன்	pojːʌn
பொருட்பெயர்	poɾ̪ɯʈpejʌɾ̪
பொருத்தம்	poɾ̪ɯt̪ːʌm
பொருளட்டவணை	poɾ̪ɯɭʌʈːʌʋʌɳʌɪ̯
பொருள்	poɾ̪ɯɭ
பொறியாளர்	porɨjɑːɭʌɾ̪
பொறுப்பு	porɯpːɯ
பொறுமை	porɯmʌɪ̯
பொலிவு	pol̪ɨʋɯ
பொழில்	poɻɨl̪
போக்குவரத்து	poːkːɯʋʌɾ̪ʌt̪ːɯ
போது	poːd̪ɯ
போதை	poːd̪ʌɪ̯
போதைப்பழக்கம்	poːd̪ʌɪ̯pːʌɻʌkːʌm
போதைப்பொருள்	poːd̪ʌɪ̯pːoɾ̪ɯɭ
போதைமருந்து	poːd̪ʌɪ̯mʌɾ̪ɯn̪d̪ɯ
போனகம்	poːnʌɡʌm
போன்றீயம்	poːnriːjʌm
போபால்	poːbɑːl̪
போராட்டம்	poːɾ̪ɑːʈːʌm
போறை	poːrʌɪ̯
போற்று	poːʈːɾɯ
போற்றுநர்	poːʈːɾɯn̪ʌɾ̪
போலிஷ்	poːl̪ɨʂ
மக	mʌɡa
மகன்	mʌɡʌn
மகரந்தம்	mʌɡʌɾ̪ʌn̪d̪ʌm
மகளிர்	mʌɡʌɭɨɾ̪
மகள்	mʌɡʌɭ
மகிமை	mʌɡɨmʌɪ̯
மகிழம்	mʌɡɨɻʌm
மகிழ்	mʌɡɨɻ
மகிழ்ச்சி	mʌɡɨɻsːi
மக்களாட்சி	mʌkːʌɭɑːʈsi
மங்குசுத்தான்	mʌŋɡɯsɯt̪ːɑːn
மஞ்சக்கடம்பு	maɲd͡ʒəkːəɖəmbʉ
மஞ்சன்	mʌɲd͡ʑʌn
மஞ்சள்	mʌɲd͡ʑʌɭ
மஞ்சள்முள்ளங்கி	mʌɲd͡ʑʌɭmɯɭːʌŋɡi
மஞ்ஞை	mʌɲːʌɪ̯
மடிக்கணினி	mʌɖɨkːʌɳɨni
மடுத்தல்	mʌɖɯt̪ːʌl̪
மட்டு	mʌʈːɯ
மணல்	mʌɳʌl̪
மணி	mʌɳi
மணிக்கட்டு	mʌɳɨkːʌʈːɯ
மணித்தக்காளி	mʌɳɨt̪ːʌkːɑːɭi
மண்	mʌɳ
மண்டபம்	mʌɳɖʌbʌm
மண்டலம்	mʌɳɖʌl̪ʌm
மண்வளம்	mʌɳʋʌɭʌm
மதம்	mʌd̪ʌm
மதறாஸ்	mʌd̪ʌrɑːs
மதி	mʌd̪i
மதிக்கத்தக்க	mʌd̪ɨkːʌt̪ːʌkːa
மதிநுட்பமிக்க	mʌd̪ɨn̪ɯʈpʌmɨkːa
மதிப்பு	mʌd̪ɨpːɯ
மதியம்	mʌd̪ɨjʌm
மதிராஸ்	mʌd̪ɨɾ̪ɑːs
மத்ரித்	mʌt̪ɾ̪ɨt̪
மந்தினி	mʌn̪d̪ɨni
மந்திரகூர்மை	mʌn̪d̪ɨɾ̪ʌɡuːɾ̪mʌɪ̯
மந்திரர்	mʌn̪d̪ɨɾ̪ʌɾ̪
மந்திரி	mʌn̪d̪ɨɾ̪i
மந்து	mʌn̪d̪ɯ
மந்துரை	mʌn̪d̪ɯɾ̪ʌɪ̯
மந்தை	mʌn̪d̪ʌɪ̯
மந்தைவெளி	mʌn̪d̪ʌɪ̯ʋeɭi
மனசு	mʌnʌsɯ
மனநலம்	mʌnʌn̪ʌl̪ʌm
மனப்பாங்கு	mʌnʌpːɑːŋɡɯ
மனப்போக்கு	mʌnʌpːoːkːɯ
மனம்	mʌnʌm
மனிதன்	mʌnɨd̪ʌn
மனிதவளம்	mʌnɨd̪ʌʋʌɭʌm
மனிதவியல்	mʌnɨd̪ʌʋɨjʌl̪
மனை	mʌnʌɪ̯
மனைவி	mʌnʌɪ̯ʋi
மனோபாவம்	mʌnoːbɑːʋʌm
மன்னிப்பு	mʌnːɨpːɯ
மன்றம்	mʌnrʌm
மம்மர்	mʌmːʌɾ̪
மம்மல்	mʌmːʌl̪
மயக்கடி	mʌjʌkːʌɖi
மயடம்	mʌjʌɖʌm
மயண்டை	mʌjʌɳɖʌɪ̯
மயர்வு	mʌjʌɾ̪ʋɯ
மயல்	mʌjʌl̪
மயிர்	mʌjɨɾ̪
மயில்	mʌjɨl̪
மரக்கட்டை	mʌɾ̪ʌkːʌʈːʌɪ̯
மரக்கலம்	mʌɾ̪ʌkːʌl̪ʌm
மரத்தக்காளி	mʌɾ̪ʌt̪ːʌkːɑːɭi
மரம்	mʌɾ̪ʌm
மரவள்ளி	mʌɾ̪ʌʋʌɭːi
மருட்டுதல்	mʌɾ̪ɯʈːɯd̪ʌl̪
மருத்துவம்	mʌɾ̪ɯt̪ːɯʋʌm
மருத்துவர்	mʌɾ̪ɯt̪ːɯʋʌɾ̪
மருந்தகம்	mʌɾ̪ɯn̪d̪ʌɡʌm
மருந்தாளர்	mʌɾ̪ɯn̪d̪ɑːɭʌɾ̪
மருந்து	mʌɾ̪ɯn̪d̪ɯ
மருந்துக்கடை	mʌɾ̪ɯn̪d̪ɯkːʌɖʌɪ̯
மர்தோவியா	mʌɾ̪t̪oːʋɨjɑː
மறுக்கம்	mʌrɯkːʌm
மறுசுழற்சி	mʌrɯsɯɻʌrsi
மறுபரிசீலனை	mʌrɯbʌɾ̪ɨsiːl̪ʌnʌɪ̯
மறை	mʌrʌɪ̯
மற்றும்	mʌʈːɾɯm
மலச்சிக்கல்	mʌl̪ʌsːɨkːʌl̪
மலம்	mʌl̪ʌm
மலர்	mʌl̪ʌɾ̪
மலர்க்கடை	mʌl̪ʌɾ̪kːʌɖʌɪ̯
மலர்ச்சி	mʌl̪ʌɾ̪sːi
மலேசியா	mʌl̪eːsɨjɑː
மலை	mʌl̪ʌɪ̯
மலையாளம்	mʌl̪ʌɪ̯jɑːɭʌm
மழை	mʌɻʌɪ̯
மழைக்காலம்	mʌɻʌɪ̯kːɑːl̪ʌm
மழைத்துளி	mʌɻʌɪ̯t̪ːɯɭi
மழைநீர்	mʌɻʌɪ̯n̪iːɾ̪
மஹால்	mʌhɑːl̪
மா	mɑː
மாங்காய்	mɑːŋɡɑːj
மாங்கிஸ்	mɑːŋɡɨs
மாசம்	mɑːsʌm
மாசவிடாய்	mɑːsʌʋɨɖɑːj
மாச்சல்	mɑːsːʌl̪
மாடம்	mɑːɖʌm
மாடு	mɑːɖɯ
மாட்டிடையன்	mɑːʈːɨɖʌɪ̯jʌn
மாட்டிறைச்சி	mɑːʈːɨrʌɪ̯sːi
மாட்டு	mɑːʈːɯ
மாட்டுக்கிடை	mɑːʈːɯkːɨɖʌɪ̯
மாணவன்	mɑːɳʌʋʌn
மாணாக்கி	mɑːɳɑːkːi
மாண்	mɑːɳ
மாண்டல்	mɑːɳɖʌl̪
மாண்பு	mɑːɳpɯ
மாதனம்	mɑːd̪ʌnʌm
மாதம்	mɑːd̪ʌm
மாதறி	mɑːd̪ʌri
மாதிரி	mɑːd̪ɨɾ̪i
மாதிரு	mɑːd̪ɨɾ̪ɯ
மாதுபாகம்	mɑːd̪ɯbɑːɡʌm
மாத்து	mɑːt̪ːɯ
மாநாடு	mɑːn̪ɑːɖɯ
மாநிலம்	mɑːn̪ɨl̪ʌm
மாந்தர்	mɑːn̪d̪ʌɾ̪
மான்	mɑːn
மாப்பிசின்	mɑːpːɨsɨn
மாப்பு	mɑːpːɯ
மாமரம்	mɑːmʌɾ̪ʌm
மாமிசம்	mɑːmɨsʌm
மாமியார்	mɑːmɨjɑːɾ̪
மாம்பழம்	mɑːmbʌɻʌm
மாய்ச்சி	mɑːjsːi
மாரடைப்பு	mɑːɾ̪ʌɖʌɪ̯pːɯ
மாரிகாலம்	mɑːɾ̪ɨɡɑːl̪ʌm
மார்	mɑːɾ̪
மார்பகம்	mɑːɾ̪pʌɡʌm
மாற்றுமருந்து	mɑːʈːɾɯmʌɾ̪ɯn̪d̪ɯ
மாலை	mɑːl̪ʌɪ̯
மாளிகை	mɑːɭɨɡʌɪ̯
மாவு	mɑːʋɯ
மிக	mɨɡa
மிகவும்	mɨɡʌʋɯm
மிகுதல்	mɨɡɯd̪ʌl̪
மிகுதியும்	mɨɡɯd̪ɨjɯm
மிகுந்த	mɨɡɯn̪d̪a
மிகை	mɨɡʌɪ̯
மிதழ்	mɨd̪ʌɻ
மிதவை	mɨd̪ʌʋʌɪ̯
மிதியடி	mɨd̪ɨjʌɖi
மின்சாரம்	mɨnsɑːɾ̪ʌm
மின்னணு	mɨnːʌɳɯ
மிருகம்	mɨɾ̪ɯɡʌm
மிருதங்கம்	mɨɾ̪ɯd̪ʌŋɡʌm
மிளகாய்	mɨɭʌɡɑːj
மிளகு	mɨɭʌɡɯ
மீக்கணினி	miːkːʌɳɨni
மீக்கூற்றம்	miːkːuːʈːɾʌm
மீண்டும்	miːɳɖɯm
மீனவர்	miːnʌʋʌɾ̪
மீப்பு	miːpːɯ
முகக்குறி	mɯɡʌkːɯri
முகம்	mɯɡʌm
முகை	mɯɡʌɪ̯
முச்சம்	mɯsːʌm
முடி	mɯɖi
முடியாட்சி	mɯɖɨjɑːʈsi
முட்டாள்	mɯʈːɑːɭ
முட்டு	mɯʈːɯ
முட்டுக்கால்	mɯʈːɯkːɑːl̪
முட்டை	mɯʈːʌɪ̯
முதன்மை	mɯd̪ʌnmʌɪ̯
முதலாளி	mɯd̪ʌl̪ɑːɭi
முதலீடு	mɯd̪ʌl̪iːɖɯ
முதலுதவி	mɯd̪ʌl̪ɯd̪ʌʋi
முதலை	mɯd̪ʌl̪ʌɪ̯
முதிர்ச்சி	mɯd̪ɨɾ̪sːi
முதுமை	mɯd̪ɯmʌɪ̯
முன்	mɯn
முன்னடியார்	mɯnːʌɖɨjɑːɾ̪
முன்னடியில்	mɯnːʌɖɨjɨl̪
முன்னதாக	mɯnːʌd̪ɑːɡa
முன்னர்	mɯnːʌɾ̪
முன்னாடி	mɯnːɑːɖi
முன்னுற	mɯnːɯra
முன்னே	mɯnːeː
முன்னேற்றம்	mɯnːeːʈːɾʌm
முன்னொட்டு	mɯnːoʈːɯ
முன்மாதிரி	mɯnmɑːd̪ɨɾ̪i
முன்முகனை	mɯnmɯɡʌnʌɪ̯
முன்றுறை	mɯnrɯrʌɪ̯
முப்பால்	mɯpːɑːl̪
முப்புள்ளி	mɯpːɯɭːi
முப்புவனம்	mɯpːɯʋʌnʌm
மும்பை	mɯmbʌɪ̯
முயல்	mɯjʌl̪
முரசு	mɯɾ̪ʌsɯ
முரி	mɯɾ̪i
முருங்கை	mɯɾ̪ɯŋɡʌɪ̯
முறுக்கு	mɯrɯkːɯ
முறையீடு	mɯrʌɪ̯jiːɖɯ
முற்றிலும்	mɯʈːɾɨl̪ɯm
முலை	mɯl̪ʌɪ̯
முலையூட்டி	mɯl̪ʌɪ̯juːʈːi
முளரி	mɯɭʌɾ̪i
முளைக்கீரை	mɯɭʌɪ̯kːiːɾ̪ʌɪ̯
முள்நாறிப்	mɯɭn̪ɑːrɨp
முள்ளங்கி	mɯɭːʌŋɡi
முள்ளங்கிழங்கு	mɯɭːʌŋɡɨɻʌŋɡɯ
முழங்கால்	mɯɻʌŋɡɑːl̪
முழுமை	mɯɻɯmʌɪ̯
முழுவதும்	mɯɻɯʋʌd̪ɯm
முழை	mɯɻʌɪ̯
முஸ்லிம்	mɯsl̪ɨm
முஸ்லீம்	mɯsl̪iːm
மூக்கண்ணாடி	muːkːʌɳːɑːɖi
மூக்கன்	muːkːʌn
மூக்கு	muːkːɯ
மூக்குத்தி	muːkːɯt̪ːi
மூங்கில்	muːŋɡɨl̪
மூச்சு	muːsːɯ
மூடு	muːɖɯ
மூடுபனி	muːɖɯbʌni
மூதாய்	muːd̪ɑːj
மூது	muːd̪ɯ
மூன்று	muːnrɯ
மூன்று	muːɳɯ
மூர்ச்சனை	muːɾ̪sːʌnʌɪ̯
மூலக்கூறு	muːl̪ʌkːuːrɯ
மூலதனம்	muːl̪ʌd̪ʌnʌm
மூலம்	muːl̪ʌm
மூளை	muːɭʌɪ̯
மெட்ராஸ்	meʈɾ̪ɑːs
மென்தங்கம்	ment̪ʌŋɡʌm
மென்பொருள்	menpoɾ̪ɯɭ
மென்மை	menmʌɪ̯
மெய்ப்பாட்டிசைக்குறி	mejpːɑːʈːɨsʌɪ̯kːɯri
மெய்யியல்	mejːɨjʌl̪
மெய்யெழுத்து	mejːeɻɯt̪ːɯ
மெல்லினம்	mel̪ːɨnʌm
மெல்லிய	mel̪ːɨja
மேகம்	meːɡʌm
மேசை	meːsʌɪ̯
மேஜை	meːd͡ʑʌɪ̯
மேம்பாடு	meːmbɑːɖɯ
மேம்பாலம்	meːmbɑːl̪ʌm
மேயல்	meːjʌl̪
மேய்ச்சல்	meːjsːʌl̪
மேய்ப்பன்	meːjpːʌn
மேய்ப்பு	meːjpːɯ
மேரை	meːɾ̪ʌɪ̯
மேற்கு	meːkkɯ
மேற்கு	meːrkɯ
மேற்கூரை	meːrkuːɾ̪ʌɪ̯
மேற்பார்வை	meːrpɑːɾ̪ʋʌɪ̯
மேற்றளம்	meːʈːɾʌɭʌm
மேலாண்மை	meːl̪ɑːɳmʌɪ̯
மேலும்	meːl̪ɯm
மை	mʌɪ̯
மைதா	mʌɪ̯t̪ɑː
மொட்டு	moʈːɯ
மொய்ம்பு	mojmbɯ
மொய்யற்சன்னி	mojːʌrsʌnːi
மொழிபெயர்ப்பு	moɻɨbejʌɾ̪pːɯ
மொழியியல்	moɻɨjɨjʌl̪
மோசம்	moːsʌm
மோடு	moːɖɯ
மோதிரம்	moːd̪ɨɾ̪ʌm
யமன்	jʌmʌn
யானை	jɑːnʌɪ̯
யாமம்	jɑːmʌm
யார்	jɑːɾ̪
யாழ்	jɑːɻ
யாவரும்	jɑːʋʌɾ̪ɯm
யுத்தம்	jɯt̪ːʌm
யூதம்	juːd̪ʌm
யோசனை	joːsʌnʌɪ̯
ரகசியம்	ɾ̪ʌɡʌsɨjʌm
ரசம்	ɾ̪ʌsʌm
ரத்தினம்	ɾ̪ʌt̪ːɨnʌm
ரப்பர்	ɾ̪ʌpːʌɾ̪
ரம்பம்	ɾ̪ʌmbʌm
ரவை	ɾ̪ʌʋʌɪ̯
ரஷ்யா	ɾ̪ʌʂjɑː
ராஜஸ்தான்	ɾ̪ɑːd͡ʑʌst̪ɑːn
ராஜீயவாதி	ɾ̪ɑːd͡ʑiːjʌʋɑːd̪i
ரிஷபம்	ɾ̪ɨʂʌbʌm
ரிஷி	ɾ̪ɨʂi
ருசரகம்	ɾ̪ɯsʌɾ̪ʌɡʌm
ருத்திரசடை	ɾ̪ɯt̪ːɨɾ̪ʌsʌɖʌɪ̯
ருப்புலக்கை	ɾ̪ɯpːɯl̪ʌkːʌɪ̯
ரும்மான்	ɾ̪ɯmːɑːn
ரூபாய்	ɾ̪uːbɑːj
ரேவு	ɾ̪eːʋɯ
ரொஷ்டு	ɾ̪oʂʈɯ
ரோகம்	ɾ̪oːɡʌm
ரோஜ்கார்	ɾ̪oːd͡ʑkɑːɾ̪
ரோதம்	ɾ̪oːd̪ʌm
ரோமம்	ɾ̪oːmʌm
லகரி	l̪ʌɡʌɾ̪i
லக்குவா	l̪ʌkːɯʋɑː
லக்ஷம்	l̪ʌkʂʌm
லங்கர்	l̪ʌŋɡʌɾ̪
லடாய்	l̪ʌɖɑːj
லட்சம்	l̪ʌʈsʌm
லட்டு	l̪ʌʈːɯ
லதி	l̪ʌd̪i
லதை	l̪ʌd̪ʌɪ̯
லத்தாடு	l̪ʌt̪ːɑːɖɯ
லாடம்	l̪ɑːɖʌm
லிஸ்பன்	l̪ɨspʌn
லீக்டன்ஸ்டைன்	l̪iːkʈʌnsʈʌɪ̯n
லுங்கி	l̪ɯŋɡi
லோகம்	l̪oːɡʌm
வகு	ʋʌɡɯ
வகுத்தல்	ʋʌɡɯt̪ːʌl̪
வகை	ʋʌɡʌɪ̯
வக்கணம்	ʋʌkːʌɳʌm
வக்கிரகட்கம்	ʋʌkːɨɾ̪ʌɡʌʈkʌm
வங்காளதேசம்	ʋʌŋɡɑːɭʌd̪eːsʌm
வங்காளம்	ʋʌŋɡɑːɭʌm
வங்கி	ʋʌŋɡi
வங்கிக்கடன்	ʋʌŋɡɨkːʌɖʌn
வங்கிக்கணக்கு	ʋʌŋɡɨkːʌɳʌkːɯ
வடக்கு	ʋʌɖʌkːɯ
வடிவம்	ʋʌɖɨʋʌm
வடிவியல்	ʋʌɖɨʋɨjʌl̪
வடை	ʋʌɖʌɪ̯
வடைப்பருப்பு	ʋʌɖʌɪ̯pːʌɾ̪ɯpːɯ
வணக்கம்	ʋʌɳʌkːʌm
வண்டி	ʋʌɳɖi
வண்டு	ʋʌɳɖɯ
வண்ணத்துப்பூச்சி	ʋʌɳːʌt̪ːɯpːuːsːi
வண்ணாத்திப்பூச்சி	ʋʌɳːɑːt̪ːɨpːuːsːi
வதி	ʋʌd̪i
வனம்	ʋʌnʌm
வன்தங்கம்	ʋʌnt̪ʌŋɡʌm
வன்பால்	ʋʌnpɑːl̪
வன்பொருள்	ʋʌnpoɾ̪ɯɭ
வன்முறை	ʋʌnmɯrʌɪ̯
வன்மை	ʋʌnmʌɪ̯
வன்வெள்ளி	ʋʌnʋeɭːi
வம்சம்	ʋʌmsʌm
வயல்	ʋʌjʌl̪
வரகு	ʋʌɾ̪ʌɡɯ
வரடம்	ʋʌɾ̪ʌɖʌm
வரணம்	ʋʌɾ̪ʌɳʌm
வரத்து	ʋʌɾ̪ʌt̪ːɯ
வரன்முறை	ʋʌɾ̪ʌnmɯrʌɪ̯
வரப்பு	ʋʌɾ̪ʌpːɯ
வரம்	ʋʌɾ̪ʌm
வரம்பு	ʋʌɾ̪ʌmbɯ
வரலாறு	ʋʌɾ̪ʌl̪ɑːrɯ
வரலாற்று	ʋʌɾ̪ʌl̪ɑːʈːɾɯ
வரவு	ʋʌɾ̪ʌʋɯ
வரவேற்கிறேன்	ʋʌɾ̪ʌʋeːrkɨreːn
வருகமஞ்சள்	ʋʌɾ̪ɯɡʌmʌɲd͡ʑʌɭ
வருக்கணம்	ʋʌɾ̪ɯkːʌɳʌm
வருடம்	ʋʌɾ̪ɯɖʌm
வருணன்	ʋʌɾ̪ɯɳʌn
வருஷம்	ʋʌɾ̪ɯʂʌm
வரை	ʋʌɾ̪ʌɪ̯
வறட்சி	ʋʌrʌʈsi
வறுமை	ʋʌrɯmʌɪ̯
வலங்கம்	ʋʌl̪ʌŋɡʌm
வலசை	ʋʌl̪ʌsʌɪ̯
வலம்	ʋʌl̪ʌm
வலாகம்	ʋʌl̪ɑːɡʌm
வலி	ʋʌl̪i
வலிப்பு	ʋʌl̪ɨpːɯ
வலிமை	ʋʌl̪ɨmʌɪ̯
வலுப்பு	ʋʌl̪ɯpːɯ
வலுமை	ʋʌl̪ɯmʌɪ̯
வலை	ʋʌl̪ʌɪ̯
வல்	ʋʌl̪
வல்ல	ʋʌl̪ːa
வல்லடி	ʋʌl̪ːʌɖi
வல்லபம்	ʋʌl̪ːʌbʌm
வல்லரி	ʋʌl̪ːʌɾ̪i
வல்லவன்	ʋʌl̪ːʌʋʌn
வல்லாமை	ʋʌl̪ːɑːmʌɪ̯
வல்லிதின்	ʋʌl̪ːɨd̪ɨn
வல்லினம்	ʋʌl̪ːɨnʌm
வல்லுநர்	ʋʌl̪ːɯn̪ʌɾ̪
வல்லுரம்	ʋʌl̪ːɯɾ̪ʌm
வல்லுளி	ʋʌl̪ːɯɭi
வல்லேறு	ʋʌl̪ːeːrɯ
வல்லை	ʋʌl̪ːʌɪ̯
வளப்பம்	ʋʌɭʌpːʌm
வளமை	ʋʌɭʌmʌɪ̯
வளம்	ʋʌɭʌm
வளர்ச்சி	ʋʌɭʌɾ̪sːi
வளையல்	ʋʌɭʌɪ̯jʌl̪
வழக்கம்	ʋʌɻʌkːʌm
வழக்கு	ʋʌɻʌkːɯ
வழலிக்கை	ʋʌɻʌl̪ɨkːʌɪ̯
வழி	ʋʌɻi
வழிச்செலவு	ʋʌɻɨsːel̪ʌʋɯ
வழிஞ்சி	ʋʌɻɨɲd͡ʑi
வழிநடை	ʋʌɻɨn̪ʌɖʌɪ̯
வழிப்பயணம்	ʋʌɻɨpːʌjʌɳʌm
வழிவகை	ʋʌɻɨʋʌɡʌɪ̯
வவ்வு	ʋʌʋːɯ
வா	ʋɑː
வாகடம்	ʋɑːɡʌɖʌm
வாகனம்	ʋɑːɡʌnʌm
வாகம்	ʋɑːɡʌm
வாகினி	ʋɑːɡɨni
வாகை	ʋaːɣaɪ
வாக்களிப்பு	ʋɑːkːʌɭɨpːɯ
வாக்காளர்	ʋɑːkːɑːɭʌɾ̪
வாக்கியம்	ʋɑːkːɨjʌm
வாக்கு	ʋɑːkːɯ
வாக்குவாதம்	ʋɑːkːɯʋɑːd̪ʌm
வாத்து	ʋɑːt̪ːɯ
வாந்தி	ʋɑːn̪d̪i
வானம்	ʋɑːnʌm
வானம்பாடி	ʋɑːnʌmbɑːɖi
வானவில்	ʋɑːnʌʋɨl̪
வானியல்	ʋɑːnɨjʌl̪
வான்	ʋɑːn
வாயன்	ʋɑːjʌn
வாயின்மாடம்	ʋɑːjɨnmɑːɖʌm
வாயில்	ʋɑːjɨl̪
வாயு	ʋɑːjɯ
வாய்	ʋɑːj
வாய்க்கால்	ʋɑːjkːɑːl̪
வாரம்	ʋɑːɾ̪ʌm
வாராவதி	ʋɑːɾ̪ɑːʋʌd̪i
வார்	ʋɑːɾ̪
வார்த்தை	ʋɑːɾ̪t̪ːʌɪ̯
வால்	ʋɑːl̪
வாள்	ʋɑːɭ
வாழை	ʋɑːɻʌɪ̯
வாழைப்பழம்	ʋɑːɻʌɪ̯pːʌɻʌm
வாழ்ச்சி	ʋɑːɻsːi
வாழ்வு	ʋɑːɻʋɯ
விசனம்	ʋɨsʌnʌm
விசைத்தறி	ʋɨsʌɪ̯t̪ːʌri
விடர்	ʋɨɖʌɾ̪
விடு	ʋɨɖɯ
விடுவி	ʋɨɖɯʋi
விடை	ʋɨɖʌɪ̯
விண்கலம்	ʋɨɳkʌl̪ʌm
விண்ணுளவி	ʋɨɳːɯɭʌʋi
விண்மீன்	ʋɨɳmiːn
விண்வெளி	ʋɨɳʋeɭi
விதவை	ʋɨd̪ʌʋʌɪ̯
விதி	ʋɨd̪i
விதை	ʋɨd̪ʌɪ̯
விதைப்பை	ʋɨd̪ʌɪ̯pːʌɪ̯
விநாடி	ʋɨn̪ɑːɖi
விந்து	ʋɨn̪d̪ɯ
வினவு	ʋɨnʌʋɯ
வினா	ʋɨnɑː
வினை	ʋɨnʌɪ̯
வினைச்சொல்	ʋɨnʌɪ̯sːol̪
வினைமுற்று	ʋɨnʌɪ̯mɯʈːɾɯ
வினைவியம்	ʋɨnʌɪ̯ʋɨjʌm
விமானம்	ʋɨmɑːnʌm
வியர்	ʋɨjʌɾ̪
வியர்வை	ʋɨjʌɾ̪ʋʌɪ̯
வியாபாரம்	ʋɨjɑːbɑːɾ̪ʌm
வியாபாரி	ʋɨjɑːbɑːɾ̪i
வியாழன்	ʋɨjɑːɻʌn
வியாழம்	ʋɨjɑːɻʌm
விரயம்	ʋɨɾ̪ʌjʌm
விரல்	ʋɨɾ̪ʌl̪
விரிகாசம்	ʋɨɾ̪ɨɡɑːsʌm
விரிகோணம்	ʋɨɾ̪ɨɡoːɳʌm
விருட்சம்	ʋɨɾ̪ɯʈsʌm
விருஷ்டி	ʋɨɾ̪ɯʂʈi
விரைவில்	ʋɨɾ̪ʌɪ̯ʋɨl̪
விரோதம்	ʋɨɾ̪oːd̪ʌm
விலங்கி	ʋɨl̪ʌŋɡi
விலங்கியல்	ʋɨl̪ʌŋɡɨjʌl̪
விலங்கு	ʋɨl̪ʌŋɡɯ
விலயம்	ʋɨl̪ʌjʌm
விலை	ʋɨl̪ʌɪ̯
வில்	ʋɨl̪
வில்வம்	ʋilʋəm
வில்வித்தை	ʋɨl̪ʋɨt̪ːʌɪ̯
விளக்கம்	ʋɨɭʌkːʌm
விளக்கு	ʋɨɭʌkːɯ
விளா	ʋiɭaː
விளைவு	ʋɨɭʌɪ̯ʋɯ
விழுக்காடு	ʋɨɻɯkːɑːɖɯ
விழுதி	ʋɨɻɯd̪i
விழைவு	ʋɨɻʌɪ̯ʋɯ
விவசாயம்	ʋɨʋʌsɑːjʌm
விவசாயி	ʋɨʋʌsɑːji
விஷாதம்	ʋɨʂɑːd̪ʌm
வீடு	ʋiːɖɯ
வீட்டுக்காரி	ʋiːʈːɯkːɑːɾ̪i
வீராங்கனை	ʋiːɾ̪ɑːŋɡʌnʌɪ̯
வெங்காயம்	ʋeŋɡɑːjʌm
வெடிமருந்து	ʋeɖɨmʌɾ̪ɯn̪d̪ɯ
வெட்டுக்கிளி	ʋeʈːɯkːɨɭi
வெண்டை	ʋeɳɖʌɪ̯
வெந்தயம்	ʋen̪d̪ʌjʌm
வெப்பநிலை	ʋepːʌn̪ɨl̪ʌɪ̯
வெப்புள்	ʋepːɯɭ
வெம்பகல்	ʋembʌɡʌl̪
வெறுங்காய்	ʋerɯŋɡɑːj
வெற்றிலை	ʋeʈːɾɨl̪ʌɪ̯
வெல்லம்	ʋel̪ːʌm
வெளிச்சம்	ʋeɭɨsːʌm
வெளியீடு	ʋeɭɨjiːɖɯ
வெள்ளரி	ʋeɭːʌɾ̪i
வேகம்	ʋeːɡʌm
வேண்டிய	ʋeːɳɖɨja
வேண்டியமட்டும்	ʋeːɳɖɨjʌmʌʈːɯm
வேண்டியவன்	ʋeːɳɖɨjʌʋʌn
வேண்டு	ʋeːɳɖɯ
வேண்டுகோள்	ʋeːɳɖɯɡoːɭ
வேதம்	ʋeːd̪ʌm
வேதவியல்	ʋeːd̪ʌʋɨjʌl̪
வேதியியல்	ʋeːd̪ɨjɨjʌl̪
வேப்பமரம்	ʋeːpːʌmʌɾ̪ʌm
வேம்பு	ʋeːmbɯ
வேர்வை	ʋeːɾ̪ʋʌɪ̯
வேறு	ʋeːrɯ
வேறுபாடு	ʋeːrɯbɑːɖɯ
வேற்றுமை	ʋeːʈːɾɯmʌɪ̯
வேலை	ʋeːl̪ʌɪ̯
வேலைக்காரன்	ʋeːl̪ʌɪ̯kːɑːɾ̪ʌn
வேலைக்கூலி	ʋeːl̪ʌɪ̯kːuːl̪i
வேலைநாணயம்	ʋeːl̪ʌɪ̯n̪ɑːɳʌjʌm
வேலைநேரம்	ʋeːl̪ʌɪ̯n̪eːɾ̪ʌm
வேலைமினக்கெட்டவன்	ʋeːl̪ʌɪ̯mɨnʌkːeʈːʌʋʌn
வேலையாள்	ʋeːl̪ʌɪ̯jɑːɭ
வேலைவளர்	ʋeːl̪ʌɪ̯ʋʌɭʌɾ̪
வேலைவாங்கு	ʋeːl̪ʌɪ̯ʋɑːŋɡɯ
வேளாண்மை	ʋeːɭɑːɳmʌɪ̯
வைணவி	ʋʌɪ̯ɳʌʋi
வைப்பு	ʋʌɪ̯pːɯ
வையை	ʋʌɪ̯jʌɪ̯
வௌவால்	ʋʌʊ̯ʋɑːl̪
ஶல்யம்	ɕʌl̪jʌm
ஶஸ்யம்	ɕʌsjʌm
ஸாயகம்	sɑːjʌɡʌm
ஸாரட்டு	sɑːɾ̪ʌʈːɯ
ஸாராம்ம்	sɑːɾ̪ɑːmː
ஸார்த்தகம்	sɑːɾ̪t̪ːʌɡʌm
ஸாலியானா	sɑːl̪ɨjɑːnɑː
ஸாவகாம்	sɑːʋʌɡɑːm
ஸாஹசர்யம்	sɑːhʌsʌɾ̪jʌm
ஸாஹுகார்	sɑːhɯɡɑːɾ̪
ஸீமை	siːmʌɪ̯
ஸ்தலம்	st̪ʌl̪ʌm
ஸ்வரம்	sʋʌɾ̪ʌm
ஹக்காசியா	hʌkːɑːsɨjɑː
