ۋە	wˈæ
بىر	bˈɪr
بۇ	bˈu
بىلەن	bˈɪlæn
ئۇ	ˈu
دەپ	dˈæp
بولغان	bˈolʁɑn
ياكى	jˈɑkɪ
ئۇنىڭ	ˈunɪŋ
ئۈچۈن	ˈyt͡ʃyn
ئۇيغۇر	ˈujʁur
ئەڭ	ˈæŋ
بولۇپ	bˈolup
بولىدۇ	bolˈɪdu
بار	bˈɑr
مەن	mˈæn
يەنە	jˈænæ
ھەر	hˈær
ئۆز	ˈœz
ئىككى	ˈɪkkɪ
قىلغان	qˈɪlʁɑn
شۇ	ʃˈu
باشقا	bˈɑʃqɑ
ئىدى	ˈɪdɪ
كېيىن	kˈejɪn
قىلىپ	qˈɪlɪp
دېگەن	dˈeɡæn
كۆپ	kˈœp
بولسا	bˈolsɑ
چوڭ	t͡ʃˈoŋ
يىلى	jˈɪlɪ
خىل	χˈɪl
قاتارلىق	qɑtˈɑrlɪq
قىلىش	qˈɪlɪʃ
ئېلىپ	ˈelɪp
بويىچە	bojˈɪt͡ʃæ
كەلگەن	kˈælɡæn
ئارقىلىق	ɑrqˈɪlɪq
ئۇلار	ˈulɑr
مىڭ	mˈɪŋ
قىلىدۇ	qɪlˈɪdu
بىز	bˈɪz
ئىچىدە	ɪt͡ʃˈɪdæ
ئىگە	ˈɪɡæ
ئۇنى	ˈunɪ
كېرەك	kˈeɾæk
خەلق	χˈælq
ياخشى	jˈɑχʃɪ
قانداق	qˈɑndɑq
قىلىنغان	qɪlˈɪnʁɑn
يەر	jˈær
ئوخشاش	ˈoχʃɑʃ
ئەمەس	ˈæmæs
ئۇلارنىڭ	ulˈɑrnɪŋ
ناھايىتى	nˌɑhɑjˈɪtɪ
ئادەم	ˈɑdæm
بىرى	bˈɪɾɪ
مۇھىم	mˈuhɪm
سىز	sˈɪz
ھەم	hˈæm
دۆلەت	dˈœlæt
يىل	jˈɪl
ئەگەر	ˈæɡær
قېتىم	qˈetɪm
يېڭى	jˈeŋɪ
پەقەت	pˈæqæt
ھازىر	hˈɑzɪr
كىشى	kˈɪʃɪ
قالغان	qˈɑlʁɑn
ئۆزىنىڭ	œzˈɪnɪŋ
ئەمما	ˈæmmɑ
پۈتۈن	pˈytyn
يۇقىرى	juqˈɪɾɪ
ھەمدە	hˈæmdæ
تەرىپىدىن	tˌæɾɪpˈɪdɪn
نۇرغۇن	nˈurʁun
ئۈچ	ˈyt͡ʃ
باش	bˈɑʃ
مۇشۇ	mˈuʃu
نىڭ	nˈɪŋ
كىشىلەر	kɪʃˈɪlær
ئىنتايىن	ɪntˈɑjɪn
ئوتتۇرا	ottˈuɾɑ
بولدى	bˈoldɪ
تىل	tˈɪl
تىلى	tˈɪlɪ
قىلدى	qˈɪldɪ
يوق	jˈoq
شۇنداق	ʃˈundɑq
ئىبنى	ˈɪbnɪ
ئىسلام	ˈɪslɑm
ئىش	ˈɪʃ
قارشى	qˈɑrʃɪ
شىنجاڭ	ʃˈɪnd͡ʒɑŋ
شۇنىڭ	ʃˈunɪŋ
بۇنداق	bˈundɑq
شەرقىي	ʃˈærqɪj
توغرا	tˈoʁrɑ
يىللىق	jˈɪllɪq
مەلۇم	mˈælum
دۇنيا	dˈunjɑ
شۇڭا	ʃˈuŋɑ
ھەققىدە	hæqqˈɪdæ
بەزى	bˈæzɪ
سۇ	sˈu
ئۇنىڭغا	unˈɪŋʁɑ
كۈن	kˈyn
كۈنى	kˈynɪ
ھازىرقى	hɑzˈɪrqɪ
مۇمكىن	mˈumkɪn
لېكىن	lˈekɪn
بۇنىڭ	bˈunɪŋ
نەچچە	nˈæt͡ʃt͡ʃæ
ئۆزى	ˈœzɪ
ئۇيغۇرلار	ujʁˈurlɑr
ئاز	ˈɑz
كىچىك	kˈɪt͡ʃɪk
يەردە	jˈærdæ
يەنى	jˈænɪ
مېنىڭ	mˈenɪŋ
ئىبارەت	ɪbˈɑɾæt
قاتارلىقلار	qˌɑtɑrlˈɪqlɑr
يول	jˈol
چۈنكى	t͡ʃˈynkɪ
ئالغان	ˈɑlʁɑn
ھالدا	hˈɑldɑ
تېخىمۇ	teχˈɪmu
كېلىدۇ	kelˈɪdu
مۇنداق	mˈundɑq
كېلىپ	kˈelɪp
مىللىي	mˈɪllɪj
ھەممە	hˈæmmæ
نى	nˈɪ
يۈز	jˈyz
ئېلان	ˈelɑn
چىققان	t͡ʃˈɪqqɑn
تۇنجى	tˈund͡ʒɪ
قاراپ	qˈɑɾɑp
زور	zˈor
ئۇيغۇرلارنىڭ	ˌujʁurlˈɑrnɪŋ
تۈرك	tˈyrk
قوبۇل	qˈobul
مەدەنىيەت	mˌædænˈɪjæt
ئاندىن	ˈɑndɪn
تەرەپ	tˈæɾæp
مىللەت	mˈɪllæt
بىزنىڭ	bˈɪznɪŋ
بەرگەن	bˈærɡæn
ئىجتىمائىي	ˌɪd͡ʒtɪmˈɑɪj
قىلىدىغان	qˌɪlɪdˈɪʁɑn
بولمايدۇ	bolmˈɑjdu
قاتتىق	qˈɑttɪq
قىلىشقا	qɪlˈɪʃqɑ
نوپۇس	nˈopus
ئانا	ˈɑnɑ
بۇرۇن	bˈuɾun
ئاساسەن	ɑsˈɑsæn
ئالاھىدە	ˌɑlɑhˈɪdæ
بارلىق	bˈɑrlɪq
دىن	dˈɪn
كەڭ	kˈæŋ
مىليون	mˈɪljon
سۆز	sˈœz
ئاق	ˈɑq
بولۇشى	bolˈuʃɪ
ئىلمىي	ˈɪlmɪj
تەتقىقات	tætqˈɪqɑt
قىلىنىدۇ	qˌɪlɪnˈɪdu
ئۇنىڭدىن	unˈɪŋdɪn
تولۇق	tˈoluq
ئىكەن	ˈɪkæn
شەھەر	ʃˈæhær
ئالدى	ˈɑldɪ
قانچە	qˈɑnt͡ʃæ
كەتكەن	kˈætkæn
ئىچىگە	ɪt͡ʃˈɪɡæ
تۇرىدۇ	tuɾˈɪdu
غەربىي	ʁˈærbɪj
قىسىم	qˈɪsɪm
ئوتتۇرىغا	ˌottuɾˈɪʁɑ
ئومۇمىي	omˈumɪj
ئۈستىگە	ystˈɪɡæ
بولۇش	bˈoluʃ
خىزمەت	χˈɪzmæt
ئۇزۇن	ˈuzun
ئاللاھ	ˈɑllɑh
چىقىپ	t͡ʃˈɪqɪp
تەلەپ	tˈælæp
كىلومېتىر	kˌɪlomˈetɪr
باشلاپ	bˈɑʃlɑp
كېيىنكى	kejˈɪnkɪ
ۋاقىت	wˈɑqɪt
ئاساس	ˈɑsɑs
مۇھەممەد	muhˈæmmæd
ئۆزىنى	œzˈɪnɪ
قايسى	qˈɑjsɪ
ئامېرىكا	ˌɑmeɾˈɪkɑ
قەدىمكى	qædˈɪmkɪ
ناملىق	nˈɑmlɪq
ۋاقىتتا	wɑqˈɪttɑ
ئۇلارنى	ulˈɑrnɪ
شۇنداقلا	ʃundˈɑqlɑ
ھەتتا	hˈættɑ
تۆت	tˈœt
ئىككىنچى	ɪkkˈɪnt͡ʃɪ
بېرىپ	bˈeɾɪp
جايلاشقان	d͡ʒɑjlˈɑʃqɑn
مەكتەپ	mˈæktæp
قەدەر	qˈædær
ئارىسىدا	ˌɑɾɪsˈɪdɑ
خىتاي	χˈɪtɑj
قىسمى	qˈɪsmɪ
ماڭا	mˈɑŋɑ
ھەممىسى	hæmmˈɪsɪ
ئادەتتە	ɑdˈættæ
بېرىدۇ	beɾˈɪdu
كىشىلەرنىڭ	kˌɪʃɪlˈærnɪŋ
ئالىي	ˈɑlɪj
سىياسىي	sɪjˈɑsɪj
ئىلگىرى	ɪlɡˈɪɾɪ
بەش	bˈæʃ
سىزنىڭ	sˈɪznɪŋ
ئون	ˈon
كەلدى	kˈældɪ
چاغدا	t͡ʃˈɑʁdɑ
ئوقۇش	ˈoquʃ
ئىكەنلىكىنى	ˌɪkænlɪkˈɪnɪ
يېزا	jˈezɑ
ئاشۇ	ˈɑʃu
دېڭىز	dˈeŋɪz
ئاساسىي	ɑsˈɑsɪj
بۇنى	bˈunɪ
يېرىم	jˈeɾɪm
تەرەققىي	tæɾˈæqqɪj
يېقىن	jˈeqɪn
ئوتتۇرىچە	ˌottuɾˈɪt͡ʃæ
دىنى	dˈɪnɪ
قەشقەر	qˈæʃqær
ئامېرىكىدا	ˌɑmeɾɪkˈɪdɑ
بەلكى	bˈælkɪ
ئۇيغۇرچە	ujʁˈurt͡ʃæ
نېمە	nˈemæ
كۈچلۈك	kˈyt͡ʃlyk
ئۆزىگە	œzˈɪɡæ
جۇڭگو	d͡ʒˈuŋɡo
مۇۋاپىق	muwˈɑpɪq
ئالدىنقى	ɑldˈɪnqɪ
بولۇپمۇ	bolˈupmu
پەيدا	pˈæjdɑ
ئۇرۇش	ˈuɾuʃ
ئەل	ˈæl
تارىخى	tɑɾˈɪχɪ
مۇناسىۋەتلىك	mˌunɑsɪwˈætlɪk
بەك	bˈæk
سۈپىتىدە	sˌypɪtˈɪdæ
قارا	qˈɑɾɑ
بولمىغان	bolmˈɪʁɑn
تۇرۇپ	tˈuɾup
مىقدارى	mɪqdˈɑɾɪ
سۇلالىسى	sˌulɑlˈɪsɪ
چىڭ	t͡ʃˈɪŋ
ئارتۇق	ˈɑrtuq
ئاساسلىق	ɑsˈɑslɪq
ئېلىش	ˈelɪʃ
ئەينى	ˈæjnɪ
جەھەتتىن	d͡ʒæhˈættɪn
بۇنىڭدىن	bunˈɪŋdɪn
ئىچكى	ˈɪt͡ʃkɪ
بايان	bˈɑjɑn
بېرىش	bˈeɾɪʃ
نوپۇسى	nopˈusɪ
ئەبۇ	ˈæbu
ئەرەب	ˈæɾæb
بىرىنچى	bɪɾˈɪnt͡ʃɪ
مۇسۇلمان	musˈulmɑn
مانا	mˈɑnɑ
تىلغا	tˈɪlʁɑ
شىمالىي	ʃɪmˈɑlɪj
ئاتىلىدۇ	ˌɑtɪlˈɪdu
بالا	bˈɑlɑ
بىرەر	bˈɪɾær
جەنۇبىي	d͡ʒænˈubɪj
قالدى	qˈɑldɪ
ئالىدۇ	ɑlˈɪdu
تەسىر	tˈæsɪr
ئاپتونوم	ɑptˈonom
تارىخىي	tɑɾˈɪχɪj
مەۋجۇت	mˈæwd͡ʒut
دىنىي	dˈɪnɪj
قولغا	qˈolʁɑ
ھېسابلىنىدۇ	hˌesɑblɪnˈɪdu
ئورتاق	ˈortɑq
ئىنسان	ˈɪnsɑn
داڭلىق	dˈɑŋlɪq
ئادەمنىڭ	ɑdˈæmnɪŋ
قايتىپ	qˈɑjtɪp
مەشھۇر	mˈæʃhur
بولسىمۇ	bolsˈɪmu
مائارىپ	mɑˈɑɾɪp
مۇشۇنداق	muʃˈundɑq
بولىدىغان	bˌolɪdˈɪʁɑn
ھەزرىتى	hæzrˈɪtɪ
ئېغىر	ˈeʁɪr
تۆۋەن	tˈœwæn
تەرجىمە	tærd͡ʒˈɪmæ
دەرىجىدە	dˌæɾɪd͡ʒˈɪdæ
دەۋرىدە	dæwrˈɪdæ
قىلىشى	qɪlˈɪʃɪ
كىتاب	kˈɪtɑb
يەرگە	jˈærɡæ
بىزگە	bˈɪzɡæ
تۈرلۈك	tˈyrlyk
قانۇن	qˈɑnun
قويغان	qˈojʁɑn
نامى	nˈɑmɪ
ياش	jˈɑʃ
ئىمام	ˈɪmɑm
ناھىيىسى	nˌɑhɪjˈɪsɪ
ئويۇن	ˈojun
ئىقتىسادىي	ˌɪqtɪsˈɑdɪj
جەھەتتە	d͡ʒæhˈættæ
دەل	dˈæl
قالىدۇ	qɑlˈɪdu
ئالدىدا	ɑldˈɪdɑ
ئىلىم	ˈɪlɪm
تارتىپ	tˈɑrtɪp
تۇرغان	tˈurʁɑn
تەخمىنەن	tæχmˈɪnæn
داۋاملىق	dɑwˈɑmlɪq
دۇنيادىكى	dˌunjɑdˈɪkɪ
مەزكۇر	mˈæzkur
توغرىسىدا	tˌoʁrɪsˈɪdɑ
دۇنياغا	dunjˈɑʁɑ
سانى	sˈɑnɪ
بۈگۈنكى	byɡˈynkɪ
پۇل	pˈul
ئىچىدىكى	ˌɪt͡ʃɪdˈɪkɪ
يازغان	jˈɑzʁɑn
ئۈستىدە	ystˈɪdæ
بالىلار	bɑlˈɪlɑr
بىللە	bˈɪllæ
تور	tˈor
چەت	t͡ʃˈæt
ئائىلە	ɑˈɪlæ
ئېنىق	ˈenɪq
تۇغۇلغان	tuʁˈulʁɑn
سەن	sˈæn
قول	qˈol
چوقۇم	t͡ʃˈoqum
ئوغلى	ˈoʁlɪ
زامان	zˈɑmɑn
ئۇنداق	ˈundɑq
ئىسمى	ˈɪsmɪ
ئەتراپىدا	ˌætrɑpˈɪdɑ
تەرىپى	tæɾˈɪpɪ
جەريانىدا	d͡ʒˌærjɑnˈɪdɑ
دەرىجىلىك	dˌæɾɪd͡ʒˈɪlɪk
قىلىندى	qɪlˈɪndɪ
ئاتا	ˈɑtɑ
باشقىلار	bɑʃqˈɪlɑr
قىلىشنى	qɪlˈɪʃnɪ
لازىم	lˈɑzɪm
يىلدىن	jˈɪldɪn
پەيغەمبەر	pæjʁˈæmbær
ھازىرغىچە	hˌɑzɪrʁˈɪt͡ʃæ
نەرسە	nˈærsæ
ياردەم	jˈɑrdæm
رول	rˈol
قۇرۇلغان	quɾˈulʁɑn
يولى	jˈolɪ
ئېرىشكەن	eɾˈɪʃkæn
دائىم	dˈɑɪm
دۇنيادا	dunjˈɑdɑ
دەيدۇ	dˈæjdu
كۆز	kˈœz
ھايات	hˈɑjɑt
ھەققىدىكى	hˌæqqɪdˈɪkɪ
تۈركىستان	tyrkˈɪstɑn
قىز	qˈɪz
كۋادرات	kwˈɑdrɑt
ۋاقتى	wˈɑqtɪ
بەردى	bˈærdɪ
تىلىدا	tɪlˈɪdɑ
تەبىئىي	tæbˈɪɪj
قان	qˈɑn
كېلىدىغان	kˌelɪdˈɪʁɑn
يېزىلغان	jezˈɪlʁɑn
ئاينىڭ	ˈɑjnɪŋ
ئورۇن	ˈoɾun
ئۇلارغا	ulˈɑrʁɑ
خۇددى	χˈuddɪ
كەتتى	kˈættɪ
ئىشلار	ˈɪʃlɑr
ئىشلارنى	ɪʃlˈɑrnɪ
سەنئەت	sˈænæt
شىركەت	ʃˈɪrkæt
ھاسىل	hˈɑsɪl
مۇستەقىل	mustˈæqɪl
چىقىدۇ	t͡ʃɪqˈɪdu
ئاسىيا	ɑsˈɪjɑ
قاتناش	qˈɑtnɑʃ
قايتا	qˈɑjtɑ
ياۋروپا	jɑwrˈopɑ
يولغا	jˈolʁɑ
ھەدىس	hˈædɪs
ئېدى	ˈedɪ
بىلىم	bˈɪlɪm
تەتقىق	tˈætqɪq
شەھىرى	ʃæhˈɪɾɪ
كۆرسىتىدۇ	kˌœrsɪtˈɪdu
كۆلىمى	kœlˈɪmɪ
كېتىدۇ	ketˈɪdu
مېتىر	mˈetɪr
ئۇزۇنلۇك	uzˈunluk
ئەدەبىي	ædˈæbɪj
جامائەت	d͡ʒɑmˈɑæt
خاس	χˈɑs
ئەسەر	ˈæsær
باشلىدى	bɑʃlˈɪdɪ
سوۋېت	sˈowet
مىللەتنىڭ	mɪllˈætnɪŋ
ھۆكۈمىتى	hˌœkymˈɪtɪ
ئائىت	ˈɑɪt
ئۆتكەن	ˈœtkæn
تاڭ	tˈɑŋ
دېدى	dˈedɪ
ئاتالغان	ɑtˈɑlʁɑn
باشلىغان	bɑʃlˈɪʁɑn
مەخسۇس	mˈæχsus
مەيلى	mˈæjlɪ
بەزىدە	bæzˈɪdæ
تېخى	tˈeχɪ
تەۋە	tˈæwæ
لىك	lˈɪk
مو	mˈo
ئاخىرقى	ɑχˈɪrqɪ
بۇرۇنقى	buɾˈunqɪ
تۈركىي	tˈyrkɪj
تەشكىل	tˈæʃkɪl
دەسلەپكى	dæslˈæpkɪ
سائەت	sˈɑæt
ناھىيە	nɑhˈɪjæ
يەرلىك	jˈærlɪk
ئاساسلىقى	ˌɑsɑslˈɪqɪ
ئايرىم	ˈɑjrɪm
ئىشقا	ˈɪʃqɑ
دەرياسى	dærjˈɑsɪ
ساقلاپ	sˈɑqlɑp
مىللەتلەر	mɪllˈætlær
يەنىلا	jænˈɪlɑ
پۈتۈنلەي	pytˈynlæj
ئىگىلىك	ɪɡˈɪlɪk
بارلىققا	bɑrlˈɪqqɑ
دۆلەتنىڭ	dœlˈætnɪŋ
مېنى	mˈenɪ
پارچە	pˈɑrt͡ʃæ
ئالدىغا	ɑldˈɪʁɑ
ئوقۇپ	ˈoqup
ئۆي	ˈœj
ئۇسۇلى	usˈulɪ
بېرىلگەن	beɾˈɪlɡæn
تاغ	tˈɑʁ
سودا	sˈodɑ
شەكلى	ʃˈæklɪ
قويۇپ	qˈojup
قۇرئان	qˈuɾɑn
كىشىنىڭ	kɪʃˈɪnɪŋ
ھۆكۈمەت	hœkˈymæt
تەسىس	tˈæsɪs
جازا	d͡ʒˈɑzɑ
جەمئىيەت	d͡ʒæmˈɪjæt
خارىكى	χɑɾˈɪkɪ
خوتەن	χˈotæn
خىمالىكاڭ	χˌɪmɑlˈɪkɑŋ
خەلقئارا	χælqˈɑɾɑ
سوت	sˈot
كۆرۈپ	kˈœɾyp
كۇۋادىرات	kˌuwɑdˈɪɾɑt
كۈچى	kˈyt͡ʃɪ
ئالتە	ˈɑltæ
بىرگە	bˈɪrɡæ
خېلى	χˈelɪ
خەۋەر	χˈæwær
دائىرائىقىدا	dˌɑɪɾˌɑɪqˈɪdɑ
چوڭقۇر	t͡ʃˈoŋqur
گەپ	ɡˈæp
ھەرىكەت	hæɾˈɪkæt
ئىشنى	ˈɪʃnɪ
ئىنسانلار	ɪnsˈɑnlɑr
ئوخشىمىغان	ˌoχʃɪmˈɪʁɑn
ئەسلى	ˈæslɪ
بېرىلىدۇ	bˌeɾɪlˈɪdu
تېمپېراتۇرىسى	tˌempeɾˌɑtuɾˈɪsɪ
دىكىبىخاھار	dˌɪkɪbɪχˈɑhɑr
رايونى	rɑjˈonɪ
ئاي	ˈɑj
ئايال	ˈɑjɑl
باشقۇرۇش	bɑʃqˈuɾuʃ
توي	tˈoj
يالغۇز	jˈɑlʁuz
گەرچە	ɡˈært͡ʃæ
ھەرقانداق	hærqˈɑndɑq
ھەقىقىي	hæqˈɪqɪj
ھەل	hˈæl
ئەمەلگە	æmˈælɡæ
بۈيۈك	bˈyjyk
دەپمۇ	dˈæpmu
قارىغاندا	qˌɑɾɪʁˈɑndɑ
كىيىن	kˈɪjɪn
مەيدانغا	mæjdˈɑnʁɑ
ئەمدى	ˈæmdɪ
ئەمەلىيەتتە	ˌæmælɪjˈættæ
تەرەپتىن	tæɾˈæptɪn
دۆلەتلەر	dœlˈætlær
شەكىلدە	ʃækˈɪldæ
قارار	qˈɑɾɑr
بولغاندىن	bolʁˈɑndɪn
تاپقان	tˈɑpqɑn
دېگەندەك	deɡˈændæk
كۆڭۈل	kˈœŋyl
مەركىزى	mærkˈɪzɪ
يىلنىڭ	jˈɪlnɪŋ
ۋاقتىدا	wɑqtˈɪdɑ
ئاخىرىدا	ˌɑχɪɾˈɪdɑ
ئورنى	ˈornɪ
ئوقۇغان	oqˈuʁɑn
ئەنە	ˈænæ
تۆمۈر	tˈœmyr
تەڭ	tˈæŋ
موڭغۇل	mˈoŋʁul
گۈزەل	ɡˈyzæl
بارغان	bˈɑrʁɑn
جاۋاب	d͡ʒˈɑwɑb
مەمۇرىي	mæmˈuɾɪj
ئاشۇنداق	ɑʃˈundɑq
بىزنى	bˈɪznɪ
كونا	kˈonɑ
كىرگەن	kˈɪrɡæn
ئۆزلىرىنىڭ	ˌœzlɪɾˈɪnɪŋ
ئۇلۇغ	ˈuluʁ
تۇرمۇش	tˈurmuʃ
خەلقى	χˈælqɪ
ھېچ	hˈet͡ʃ
ھەرخىل	hˈærχɪl
ئوت	ˈot
ئىجرا	ˈɪd͡ʒrɑ
باردۇر	bˈɑrdur
بولسۇن	bˈolsun
تەكلىپ	tˈæklɪp
خەت	χˈæt
شۇنىڭدىن	ʃunˈɪŋdɪn
كۈچ	kˈyt͡ʃ
نەشر	nˈæʃr
چۈشۈپ	t͡ʃˈyʃyp
ۋاپات	wˈɑpɑt
ئورنىغا	ornˈɪʁɑ
ئۇزاق	ˈuzɑq
ئۇيغۇرنىڭ	ujʁˈurnɪŋ
تۇز	tˈuz
تۈركىيە	tyrkˈɪjæ
دادىسى	dɑdˈɪsɪ
دىگەن	dˈɪɡæn
كۆپىنچە	kœpˈɪnt͡ʃæ
مەسىلەن	mæsˈɪlæn
يەتتە	jˈættæ
ھېس	hˈes
بۇنىڭغا	bunˈɪŋʁɑ
سانلىق	sˈɑnlɪq
غا	ʁˈɑ
مەيدانى	mæjdˈɑnɪ
ھەربىي	hˈærbɪj
ئاياللار	ɑjˈɑllɑr
ئەنئەنىۋى	ˌænænˈɪwɪ
ئەھۋال	ˈæhwɑl
تۇرىدىغان	tˌuɾɪdˈɪʁɑn
يېزىپ	jˈezɪp
باي	bˈɑj
توپ	tˈop
چىقارغان	t͡ʃɪqˈɑrʁɑn
ھۆكۈم	hˈœkym
سېلىپ	sˈelɪp
كەلتۈرۈپ	kæltˈyɾyp
كەلگەندە	kælɡˈændæ
ھەرقايسى	hærqˈɑjsɪ
ئانچە	ˈɑnt͡ʃæ
تىلىنى	tɪlˈɪnɪ
رەت	rˈæt
رەسمىي	rˈæsmɪj
قېتىملىق	qetˈɪmlɪq
كۆپلىگەن	kœplˈɪɡæn
يۈسۈپ	jˈysyp
چىقىش	t͡ʃˈɪqɪʃ
ئاللاھنىڭ	ɑllˈɑhnɪŋ
ئىلمى	ˈɪlmɪ
تۇتۇپ	tˈutup
تەسىرى	tæsˈɪɾɪ
غەرب	ʁˈærb
كىرىپ	kˈɪɾɪp
مەكتەپتە	mæktˈæptæ
چىقتى	t͡ʃˈɪqtɪ
گېكتار	ɡˈektɑr
ھىچ	hˈɪt͡ʃ
ھېچقانداق	het͡ʃqˈɑndɑq
ئىنسانلارنىڭ	ˌɪnsɑnlˈɑrnɪŋ
ئىنساننىڭ	ɪnsˈɑnnɪŋ
بىرىگە	bɪɾˈɪɡæ
بەزىلەر	bæzˈɪlær
خاتا	χˈɑtɑ
سۇلتان	sˈultɑn
مەسئۇل	mˈæsul
يۇقىرىقى	jˌuqɪɾˈɪqɪ
ئالىم	ˈɑlɪm
ئىلى	ˈɪlɪ
ئەركىن	ˈærkɪn
بەلگىلىمە	bˌælɡɪlˈɪmæ
تەرەپكە	tæɾˈæpkæ
دىققەت	dˈɪqqæt
قارايدۇ	qɑɾˈɑjdu
كىشىلىك	kɪʃˈɪlɪk
ئۇزۇنلۇقى	ˌuzunlˈuqɪ
بولغاندا	bolʁˈɑndɑ
تاش	tˈɑʃ
مەزگىل	mˈæzɡɪl
يۇمشاق	jˈumʃɑq
يېرى	jˈeɾɪ
يەردىكى	jærdˈɪkɪ
ھاۋا	hˈɑwɑ
ئارا	ˈɑɾɑ
ئاستىدا	ɑstˈɪdɑ
ئۈرۈمچى	yɾˈymt͡ʃɪ
ئەلەيھىسسالام	ˌælæjhɪssˈɑlɑm
تولىمۇ	tolˈɪmu
تېز	tˈez
دۇنيانىڭ	dunjˈɑnɪŋ
سىياسى	sɪjˈɑsɪ
قىزىل	qˈɪzɪl
كىم	kˈɪm
مەركىزىي	mærkˈɪzɪj
ئات	ˈɑt
ئەدەبىيات	ˌædæbˈɪjɑt
تاماق	tˈɑmɑq
تىلنى	tˈɪlnɪ
دىكى	dˈɪkɪ
قوشۇمچە	qoʃˈumt͡ʃæ
كەسپى	kˈæspɪ
نىسبەتەن	nɪsbˈætæn
چىن	t͡ʃˈɪn
ئايلىنىپ	ɑjlˈɪnɪp
بىراق	bˈɪɾɑq
تاشقى	tˈɑʃqɪ
خان	χˈɑn
قارىغان	qɑɾˈɪʁɑn
قانچىلىك	qɑnt͡ʃˈɪlɪk
ھوقۇق	hˈoquq
ئاساسى	ɑsˈɑsɪ
ئورۇندا	oɾˈundɑ
باشلايدۇ	bɑʃlˈɑjdu
بۇلار	bˈulɑr
بۇيان	bˈujɑn
بەت	bˈæt
تارىخ	tˈɑɾɪχ
تېرىلغۇ	teɾˈɪlʁu
دە	dˈæ
روھىي	rˈohɪj
شىركىتى	ʃɪrkˈɪtɪ
كۈندە	kˈyndæ
ياشىغان	jɑʃˈɪʁɑn
ئارىلىقى	ˌɑɾɪlˈɪqɪ
ئۆتۈپ	ˈœtyp
باشلانغۇچ	bɑʃlˈɑnʁut͡ʃ
بىرسى	bˈɪrsɪ
قىلسا	qˈɪlsɑ
مېدىيا	medˈɪjɑ
نام	nˈɑm
پەن	pˈæn
ئاخىرى	ɑχˈɪɾɪ
ئۈمىد	ˈymɪd
ئەزاسى	æzˈɑsɪ
ئەلى	ˈælɪ
ئەلەيھىسسالامنىڭ	ˌælæjhˌɪssɑlˈɑmnɪŋ
رايون	rˈɑjon
مۇئاۋىن	muˈɑwɪn
يېزىق	jˈezɪq
يېزىقى	jezˈɪqɪ
ھوقۇقى	hoqˈuqɪ
ئالاقىدار	ˌɑlɑqˈɪdɑr
ئالتۇن	ˈɑltun
خەلقىنىڭ	χælqˈɪnɪŋ
سانائەت	sɑnˈɑæt
شەكلىدە	ʃæklˈɪdæ
نۇر	nˈur
يېتىپ	jˈetɪp
ئامېرىكىدىكى	ˌɑmeɾˌɪkɪdˈɪkɪ
ئامېرىكىغا	ˌɑmeɾɪkˈɪʁɑ
ئىبن	ˈɪbn
ئۈچىنچى	yt͡ʃˈɪnt͡ʃɪ
بىرلىكتە	bɪrlˈɪktæ
بۇلارنىڭ	bulˈɑrnɪŋ
تۈركچە	tˈyrkt͡ʃæ
شىمال	ʃˈɪmɑl
شۇنچە	ʃˈunt͡ʃæ
شۇڭلاشقا	ʃuŋlˈɑʃqɑ
قويۇلغان	qojˈulʁɑn
كىشىلەرنى	kˌɪʃɪlˈærnɪ
مۇزىكا	muzˈɪkɑ
يا	jˈɑ
ھۇجۇم	hˈud͡ʒum
ھەق	hˈæq
ئىشلەپچىقىرىش	ˌɪʃlæpt͡ʃɪqˈɪɾɪʃ
ئۇنىڭدا	unˈɪŋdɑ
ئۇچۇر	ˈut͡ʃur
ئېلىنغان	elˈɪnʁɑn
بولغاچقا	bolʁˈɑt͡ʃqɑ
خەلقئارالىق	χˌælqɑɾˈɑlɪq
دېھقانچىلىق	dˌehqɑnt͡ʃˈɪlɪq
قۇرۇلۇش	quɾˈuluʃ
كەنت	kˈænt
ناخشا	nˈɑχʃɑ
يېقىنقى	jeqˈɪnqɪ
ھەيران	hˈæjrɑn
ئەر	ˈær
تەرەققىيات	tˌæɾæqqˈɪjɑt
كۆپرەك	kˈœpræk
كەم	kˈæm
ماس	mˈɑs
مەكتەپكە	mæktˈæpkæ
ئوڭ	ˈoŋ
ئەسەرلىرى	ˌæsærlˈɪɾɪ
باشقىلارغا	bˌɑʃqɪlˈɑrʁɑ
بالىلارنىڭ	bˌɑlɪlˈɑrnɪŋ
بولغانلىقى	bˌolʁɑnlˈɪqɪ
رىۋايەت	rɪwˈɑjæt
سان	sˈɑn
كۆرسىتىپ	kœrsˈɪtɪp
مەسىلە	mæsˈɪlæ
مەنىسى	mænˈɪsɪ
ھەرگىز	hˈærɡɪz
ھەرگىزمۇ	hærɡˈɪzmu
ئاستى	ˈɑstɪ
سەۋەبى	sæwˈæbɪ
قويىدۇ	qojˈɪdu
قىلىمەن	qɪlˈɪmæn
كەلمەكتە	kælmˈæktæ
يوشۇرۇن	joʃˈuɾun
ئارىسىدىكى	ˌɑɾɪsɪdˈɪkɪ
ئانىسى	ɑnˈɪsɪ
ئىشلەش	ˈɪʃlæʃ
ئىقتىسادى	ˌɪqtɪsˈɑdɪ
ئۆزلىرى	œzlˈɪɾɪ
ئېگىز	ˈeɡɪz
ئەمگەك	ˈæmɡæk
ئەگىشىپ	æɡˈɪʃɪp
بىۋاستە	bɪwˈɑstæ
بىۋاسىتە	bˌɪwɑsˈɪtæ
تىن	tˈɪn
تېخنىكا	teχnˈɪkɑ
دۇچ	dˈut͡ʃ
قىلىۋاتقان	qˌɪlɪwˈɑtqɑn
ماقالە	mɑqˈɑlæ
مەجبۇر	mˈæd͡ʒbur
ياشاش	jˈɑʃɑʃ
ياۋا	jˈɑwɑ
ئازراق	ˈɑzrɑq
ئۆگىنىش	œɡˈɪnɪʃ
ئەمەلىي	æmˈælɪj
توققۇز	tˈoqquz
جان	d͡ʒˈɑn
خەلقنىڭ	χˈælqnɪŋ
دەريا	dˈærjɑ
سېنىڭ	sˈenɪŋ
شىركەتنىڭ	ʃɪrkˈætnɪŋ
كۆك	kˈœk
مەھكىمىسى	mˌæhkɪmˈɪsɪ
يىراق	jˈɪɾɑq
يەتكەن	jˈætkæn
ھاياتى	hɑjˈɑtɪ
ھېلىقى	helˈɪqɪ
ھەرىكىتى	hˌæɾɪkˈɪtɪ
ئاسان	ˈɑsɑn
ئاھالە	ɑhˈɑlæ
ئىشلىگەن	ɪʃlˈɪɡæn
باشقىلارنىڭ	bˌɑʃqɪlˈɑrnɪŋ
توغرىسىدىكى	tˌoʁrɪsɪdˈɪkɪ
تىلىنىڭ	tɪlˈɪnɪŋ
جۇمھۇرىيىتى	d͡ʒˌumhuɾɪjˈɪtɪ
سەل	sˈæl
كۈرەش	kˈyɾæʃ
كۈندىن	kˈyndɪn
گە	ɡˈæ
ئاڭ	ˈɑŋ
ئوسمان	ˈosmɑn
ئىزچىل	ˈɪzt͡ʃɪl
ئەھمىيەت	æhmˈɪjæt
بېشىغا	beʃˈɪʁɑ
دا	dˈɑ
دەرھال	dˈærhɑl
قاراشلىق	qɑɾˈɑʃlɪq
قوشۇپ	qˈoʃup
مول	mˈol
مۇرەككەپ	muɾˈækkæp
مۇقەددەس	muqˈæddæs
مۇناسىۋىتى	mˌunɑsɪwˈɪtɪ
مەشرەپ	mˈæʃræp
نۇرغۇنلىغان	nˌurʁunlˈɪʁɑn
ئويلاپ	ˈojlɑp
ئۇرۇشى	uɾˈuʃɪ
ئەھمەد	ˈæhmæd
بىرلا	bˈɪrlɑ
بېرىدىغان	bˌeɾɪdˈɪʁɑn
خانلىقى	χɑnlˈɪqɪ
دىنىغا	dɪnˈɪʁɑ
رولى	rˈolɪ
شىمالى	ʃɪmˈɑlɪ
قۇربان	qˈurbɑn
كونترول	kˈontrol
كىلومەتىر	kˌɪlomˈætɪr
كۆرگەن	kˈœrɡæn
مۇئامىلە	mˌuɑmˈɪlæ
مۇتلەق	mˈutlæq
نەشىر	nˈæʃɪr
ھۆل	hˈœl
ۋەزىر	wˈæzɪr
ئادەتتىكى	ˌɑdættˈɪkɪ
ئارقا	ˈɑrqɑ
ئامېرىكىنىڭ	ˌɑmeɾɪkˈɪnɪŋ
ئۇن	ˈun
ئۇيغۇن	ˈujʁun
بولمايدىغان	bˌolmɑjdˈɪʁɑn
بۈگۈن	bˈyɡyn
تېگىشلىك	teɡˈɪʃlɪk
دەرس	dˈærs
سىزنى	sˈɪznɪ
سىزگە	sˈɪzɡæ
سەۋەبىدىن	sˌæwæbˈɪdɪn
قوي	qˈoj
كەلگەندىن	kælɡˈændɪn
ماشىنا	mɑʃˈɪnɑ
مۇسۇلمانلار	mˌusulmˈɑnlɑr
يار	jˈɑr
ياسالغان	jɑsˈɑlʁɑn
پادىشاھ	pɑdˈɪʃɑh
ئىلتىماس	ɪltˈɪmɑs
ئەپەندى	æpˈændɪ
باشلىقى	bɑʃlˈɪqɪ
باھا	bˈɑhɑ
جەمئىي	d͡ʒˈæmɪj
شۇنى	ʃˈunɪ
قىسقا	qˈɪsqɑ
قۇرغان	qˈurʁɑn
كومىتېتى	kˌomɪtˈetɪ
كۇب	kˈub
كەسىپ	kˈæsɪp
كەڭلىكى	kæŋlˈɪkɪ
مەبلەغ	mˈæblæʁ
مەزگىلىدە	mˌæzɡɪlˈɪdæ
ھەقتە	hˈæqtæ
ئوتتۇرىسىدىكى	ˌottuɾˌɪsɪdˈɪkɪ
ئوغۇل	ˈoʁul
ئوچۇق	ˈot͡ʃuq
ئىشلىرى	ɪʃlˈɪɾɪ
ئېتىراپ	etˈɪɾɑp
ئەسلىدە	æslˈɪdæ
تىلدا	tˈɪldɑ
خەنزۇچە	χænzˈut͡ʃæ
سەككىز	sˈækkɪz
سەۋەب	sˈæwæb
قىسمىنى	qɪsmˈɪnɪ
مۇكەممەل	mukˈæmmæl
يازما	jˈɑzmɑ
يېزىسى	jezˈɪsɪ
ئىنگلىزچە	ɪnɡlˈɪzt͡ʃæ
بولاتتى	bolˈɑttɪ
بولمىسا	bolmˈɪsɑ
بىلىدۇ	bɪlˈɪdu
بېرىشى	beɾˈɪʃɪ
بەلكىم	bˈælkɪm
بەلگىلەنگەن	bˌælɡɪlˈænɡæn
جەنۇبى	d͡ʒænˈubɪ
سۆزلەر	sˈœzlær
شەرقى	ʃˈærqɪ
قىزى	qˈɪzɪ
كەسپىي	kˈæspɪj
يۈرۈش	jˈyɾyʃ
چىقىرىش	t͡ʃɪqˈɪɾɪʃ
ئاخبارات	ɑχbˈɑɾɑt
ئايرىلىپ	ɑjrˈɪlɪp
ئۆلۈم	ˈœlym
ئەلۋەتتە	ælwˈættæ
بارىدۇ	bɑɾˈɪdu
باشلانغان	bɑʃlˈɑnʁɑn
تەسەۋۋۇر	tæsˈæwwur
تەكشۈرۈش	tækʃˈyɾyʃ
دورا	dˈoɾɑ
شەرت	ʃˈært
قارىتا	qɑɾˈɪtɑ
قىلدىم	qˈɪldɪm
قىيىن	qˈɪjɪn
كۆرسەتكەن	kœrsˈætkæn
مىللەتلەرنىڭ	mˌɪllætlˈærnɪŋ
مەقسەت	mˈæqsæt
مەنىدە	mænˈɪdæ
مەڭگۈ	mˈæŋɡy
نەتىجىدە	nˌætɪd͡ʒˈɪdæ
يامان	jˈɑmɑn
پارتىيە	pɑrtˈɪjæ
پەرقلىق	pˈærqlɪq
ئايرىپ	ˈɑjrɪp
ئىتتىپاقى	ˌɪttɪpˈɑqɪ
ئۆزئارا	œzˈɑɾɑ
باج	bˈɑd͡ʒ
تۇتىشىدۇ	tˌutɪʃˈɪdu
تۈركىيەدە	tˌyrkɪjˈædæ
تەشەببۇس	tæʃˈæbbus
جەمئىيىتىنىڭ	d͡ʒˌæmɪjɪtˈɪnɪŋ
فىلىم	fˈɪlɪm
قويۇلىدۇ	qˌojulˈɪdu
قىلاتتى	qɪlˈɑttɪ
قىلغۇچى	qɪlʁˈut͡ʃɪ
قەدىمىي	qædˈɪmɪj
مۇناسىۋەت	mˌunɑsˈɪwæt
ياشاۋاتقان	jˌɑʃɑwˈɑtqɑn
ياشلار	jˈɑʃlɑr
پىكىر	pˈɪkɪr
ۋەتەن	wˈætæn
ئادەمنى	ɑdˈæmnɪ
ئاقسۇ	ˈɑqsu
ئوغۇز	ˈoʁuz
ئۆسۈملۈك	œsˈymlyk
تىللار	tˈɪllɑr
جاۋاپ	d͡ʒˈɑwɑp
جەنۇب	d͡ʒˈænub
رولىنى	rolˈɪnɪ
سۆزى	sˈœzɪ
شۇنىڭغا	ʃunˈɪŋʁɑ
شەخسىي	ʃˈæχsɪj
كىشىنى	kɪʃˈɪnɪ
مايدانى	mɑjdˈɑnɪ
مىلادى	mɪlˈɑdɪ
مەنچە	mˈænt͡ʃæ
يولدا	jˈoldɑ
يۇقارقى	juqˈɑrqɪ
يۇقىرىدا	jˌuqɪɾˈɪdɑ
پۈتكۈل	pˈytkyl
ھىس	hˈɪs
ئادەملەر	ɑdˈæmlær
ئالى	ˈɑlɪ
ئاياللارنىڭ	ˌɑjɑllˈɑrnɪŋ
ئىسىملىك	ɪsˈɪmlɪk
ئېيتىپ	ˈejtɪp
بىكار	bˈɪkɑr
جەمئىيەتنىڭ	d͡ʒˌæmɪjˈætnɪŋ
دېيىلىدۇ	dˌejɪlˈɪdu
ساھەسىدە	sˌɑhæsˈɪdæ
سول	sˈol
قاتارىدا	qˌɑtɑɾˈɪdɑ
قويدى	qˈojdɪ
قىلغاندا	qɪlʁˈɑndɑ
قۇمۇل	qˈumul
كېيىنچە	kejˈɪnt͡ʃæ
پايدىلىق	pɑjdˈɪlɪq
ھەربىر	hˈærbɪr
ئالاقە	ɑlˈɑqæ
ئالدىنى	ɑldˈɪnɪ
ئاممىۋى	ɑmmˈɪwɪ
ئويۇنى	ojˈunɪ
ئىشلىتىش	ɪʃlˈɪtɪʃ
ئىشلەپ	ˈɪʃlæp
ئۆزگىرىش	œzɡˈɪɾɪʃ
ئېغىز	ˈeʁɪz
بېرى	bˈeɾɪ
بەزىلىرى	bˌæzɪlˈɪɾɪ
تىك	tˈɪk
سۈيى	sˈyjɪ
شائىر	ʃˈɑɪr
شەرق	ʃˈærq
قىلىنىپ	qɪlˈɪnɪp
قىممەت	qˈɪmmæt
قىممەتلىك	qɪmmˈætlɪk
كىرىدۇ	kɪɾˈɪdu
مال	mˈɑl
نورمال	nˈormɑl
نىشان	nˈɪʃɑn
نەرسىنى	nærsˈɪnɪ
ۋاز	wˈɑz
ئادا	ˈɑdɑ
ئوتتۇرىسىدا	ˌottuɾɪsˈɪdɑ
ئوخشاشلا	oχʃˈɑʃlɑ
ئورۇنغا	oɾˈunʁɑ
ئوينايدۇ	ojnˈɑjdu
ئىشلىتىلىدۇ	ˌɪʃlɪtɪlˈɪdu
ئېشىپ	ˈeʃɪp
ئەقىل	ˈæqɪl
بارلىقىنى	bˌɑrlɪqˈɪnɪ
تۇرۇش	tˈuɾuʃ
تۈزلەڭلىك	tyzlˈæŋlɪk
خوجا	χˈod͡ʒɑ
دوللار	dˈollɑr
سابىق	sˈɑbɪq
ساندىكى	sɑndˈɪkɪ
سىلەر	sˈɪlær
سۆزنى	sˈœznɪ
قوللانغان	qollˈɑnʁɑn
قەتئىي	qˈætɪj
كۆچۈپ	kˈœt͡ʃyp
مىلادىدىن	mˌɪlɑdˈɪdɪn
مەلۇمات	mælˈumɑt
نەشرىياتى	nˌæʃrɪjˈɑtɪ
يىلدا	jˈɪldɑ
يۈزىدىن	jyzˈɪdɪn
پۇلى	pˈulɪ
ئابدۇللاھ	ɑbdˈullɑh
ئاددىي	ˈɑddɪj
ئاساسىدا	ˌɑsɑsˈɪdɑ
ئايلانغان	ɑjlˈɑnʁɑn
ئوخشايدۇ	oχʃˈɑjdu
ئوقۇشقا	oqˈuʃqɑ
ئىسىم	ˈɪsɪm
ئىقتىدارى	ˌɪqtɪdˈɑɾɪ
ئۆتىدۇ	œtˈɪdu
ئۆزىڭىزنىڭ	ˌœzɪŋˈɪznɪŋ
ئۆمەر	ˈœmær
ئۇلاردىن	ulˈɑrdɪn
تارقالغان	tɑrqˈɑlʁɑn
تال	tˈɑl
تەلەپپۇز	tælˈæppuz
دائىر	dˈɑɪr
مىللىمېتىر	mˌɪllɪmˈetɪr
ناماز	nˈɑmɑz
يۈكسەك	jˈyksæk
يېڭىدىن	jeŋˈɪdɪn
پايتەختى	pɑjtˈæχtɪ
پىياز	pˈɪjɑz
ۋەكىللىك	wækˈɪllɪk
ئاشۇرۇش	ɑʃˈuɾuʃ
ئالتاي	ˈɑltɑj
ئاۋاز	ˈɑwɑz
ئىگىلەيدۇ	ˌɪɡɪlˈæjdu
ئۆينىڭ	ˈœjnɪŋ
ئۇسسۇل	ˈussul
ئەسكەر	ˈæskær
بازىرى	bɑzˈɪɾɪ
بىردىن	bˈɪrdɪn
تونۇلغان	tonˈulʁɑn
جۇڭخۇا	d͡ʒuŋχˈuɑ
دەۋرى	dˈæwrɪ
رايۇننومۇرى	rˌɑjunnomˈuɾɪ
رەزىيەللاھۇ	rˌæzɪjællˈɑhu
شەكىللەنگەن	ʃˌækɪllˈænɡæn
شەھىرىنىڭ	ʃˌæhɪɾˈɪnɪŋ
قاتارلىقلارنى	qˌɑtɑrlɪqlˈɑrnɪ
قايتىدىن	qɑjtˈɪdɪn
قولىغا	qolˈɪʁɑ
قېلىش	qˈelɪʃ
قەدەم	qˈædæm
كۈندىلىك	kyndˈɪlɪk
نېمىشقا	nemˈɪʃqɑ
يىگىت	jˈɪɡɪt
چاچ	t͡ʃˈɑt͡ʃ
ھوقۇقىنى	hˌoquqˈɪnɪ
ئادەت	ˈɑdæt
ئايدا	ˈɑjdɑ
ئوقۇغۇچى	ˌoquʁˈut͡ʃɪ
ئىكەنلىكى	ˌɪkænlˈɪkɪ
ئۈزلۈكسىز	yzlˈyksɪz
ئېتىقاد	etˈɪqɑd
بازار	bˈɑzɑr
بولۇشنى	bolˈuʃnɪ
خەنزۇ	χˈænzu
داۋام	dˈɑwɑm
دوكتور	dˈoktor
دۆلەتلەرنىڭ	dˌœlætlˈærnɪŋ
رەسۇلۇللاھ	rˌæsulˈullɑh
زۆرۈر	zˈœɾyr
سۇلالىسىنىڭ	sˌulɑlɪsˈɪnɪŋ
شەھىرىدە	ʃˌæhɪɾˈɪdæ
كىنو	kˈɪno
كۆزى	kˈœzɪ
مىللىتى	mɪllˈɪtɪ
مەيدان	mˈæjdɑn
نەتىجە	nætˈɪd͡ʒæ
ياراتقان	jɑɾˈɑtqɑn
يېغى	jˈeʁɪ
پەرق	pˈærq
چۈشكەن	t͡ʃˈyʃkæn
ھازىرمۇ	hɑzˈɪrmu
ئابدۇخالىق	ˌɑbduχˈɑlɪq
ئاۋۋال	ˈɑwwɑl
ئورنىنى	ornˈɪnɪ
باشقىچە	bɑʃqˈɪt͡ʃæ
بىرلىكى	bɪrlˈɪkɪ
بەلگىلىك	bælɡˈɪlɪk
تارىخىدا	tˌɑɾɪχˈɪdɑ
تۇراتتى	tuɾˈɑttɪ
تۈركلەر	tˈyrklær
تۈرى	tˈyɾɪ
جەھەتتىكى	d͡ʒˌæhættˈɪkɪ
دانە	dˈɑnæ
دەسلەپتە	dæslˈæptæ
رەئىسى	ræˈɪsɪ
سوغۇق	sˈoʁuq
سېرىق	sˈeɾɪq
سەۋەبلىك	sæwˈæblɪk
قوش	qˈoʃ
كىرەك	kˈɪɾæk
مۇسۇلمانلارنىڭ	mˌusulmɑnlˈɑrnɪŋ
مەسىلىسى	mˌæsɪlˈɪsɪ
مەھمۇد	mˈæhmud
ناھايتى	nɑhˈɑjtɪ
يات	jˈɑt
يولىدا	jolˈɪdɑ
پائالىيەت	pˌɑɑlˈɪjæt
پاي	pˈɑj
ئاجىز	ˈɑd͡ʒɪz
ئوبدان	ˈobdɑn
ئوردا	ˈordɑ
ئوقۇتۇش	oqˈutuʃ
ئوقۇغۇچىلار	ˌoquʁut͡ʃˈɪlɑr
ئى	ˈɪ
ئىچىدىن	ɪt͡ʃˈɪdɪn
ئۆلۈپ	ˈœlyp
ئۇيغۇرلاردا	ˌujʁurlˈɑrdɑ
ئېرىشتى	eɾˈɪʃtɪ
ئېسىل	ˈesɪl
بايلىقى	bɑjlˈɪqɪ
بىن	bˈɪn
بېرىشنى	beɾˈɪʃnɪ
بېشى	bˈeʃɪ
تەجرىبە	tæd͡ʒrˈɪbæ
تەربىيە	tærbˈɪjæ
تەۋەسىدە	tˌæwæsˈɪdæ
زامانىۋى	zˌɑmɑnˈɪwɪ
قوغداش	qˈoʁdɑʃ
قويۇش	qˈojuʃ
قىلىشىغا	qˌɪlɪʃˈɪʁɑ
قىممىتى	qɪmmˈɪtɪ
كۈچكە	kˈyt͡ʃkæ
كېسەل	kˈesæl
مەنبەسى	mænbˈæsɪ
نەرسىلەرنى	nˌærsɪlˈærnɪ
چاغلاردا	t͡ʃɑʁlˈɑrdɑ
چىرايلىق	t͡ʃɪɾˈɑjlɪq
چىقىرىپ	t͡ʃɪqˈɪɾɪp
ھاياتىنى	hˌɑjɑtˈɪnɪ
ھۆكۈمەتنىڭ	hˌœkymˈætnɪŋ
ۋىلايىتى	wˌɪlɑjˈɪtɪ
ئاستىغا	ɑstˈɪʁɑ
ئۇسۇل	ˈusul
ئۇنداقتا	undˈɑqtɑ
ئۇچرايدۇ	ut͡ʃrˈɑjdu
ئەسىرى	æsˈɪɾɪ
بىرلىككە	bɪrlˈɪkkæ
تارىختا	tɑɾˈɪχtɑ
تاغلىق	tˈɑʁlɪq
تامامەن	tɑmˈɑmæn
تىجارەت	tɪd͡ʒˈɑɾæt
تۇتقان	tˈutqɑn
جانلىق	d͡ʒˈɑnlɪq
دائىرىسى	dˌɑɪɾˈɪsɪ
دۈشمەن	dˈyʃmæn
رىم	rˈɪm
ساڭا	sˈɑŋɑ
سۆزلەپ	sˈœzlæp
سۇنىڭ	sˈunɪŋ
قانۇنى	qɑnˈunɪ
قولىدا	qolˈɪdɑ
قىزغىن	qˈɪzʁɪn
كىشىلەرگە	kˌɪʃɪlˈærɡæ
كۆزگە	kˈœzɡæ
مىليارد	mˈɪljɑrd
مۇۋەپپەقىيەت	mˌuwæppæqˈɪjæt
مەنىۋى	mænˈɪwɪ
نامايان	nɑmˈɑjɑn
ياشايدىغان	jˌɑʃɑjdˈɪʁɑn
پوقتانومۇرى	pˌoqtɑnomˈuɾɪ
ھۆددە	hˈœddæ
ئاتىغان	ɑtˈɪʁɑn
ئالما	ˈɑlmɑ
ئايلىنىش	ɑjlˈɪnɪʃ
ئىستېمال	ɪstˈemɑl
ئىشلارنىڭ	ɪʃlˈɑrnɪŋ
ئىلگىرىكى	ˌɪlɡɪɾˈɪkɪ
ئۆزىڭىز	œzˈɪŋɪz
ئۇنىۋېرسىتېتى	ˌunɪwˌersɪtˈetɪ
ئەدەبىياتى	ˌædæbɪjˈɑtɪ
ئەسىر	ˈæsɪr
ئەسەرلەرنى	ˌæsærlˈærnɪ
بۇلۇپ	bˈulup
بەرپا	bˈærpɑ
تاشلاپ	tˈɑʃlɑp
تۈردە	tˈyrdæ
تەشكىلاتى	tˌæʃkɪlˈɑtɪ
داۋالاش	dɑwˈɑlɑʃ
رەڭلىك	rˈæŋlɪk
سوراپ	sˈoɾɑp
سۈنئىي	sˈynɪj
سېلىش	sˈelɪʃ
قايىل	qˈɑjɪl
قىلغىلى	qɪlʁˈɪlɪ
قىلمايدۇ	qɪlmˈɑjdu
قۇرۇپ	qˈuɾup
قېچىپ	qˈet͡ʃɪp
كۆتۈرۈپ	kœtˈyɾyp
ماي	mˈɑj
ياشقا	jˈɑʃqɑ
ياغاچ	jˈɑʁɑt͡ʃ
ياپونىيە	jˌɑponˈɪjæ
يىللار	jˈɪllɑr
پايدىلىنىپ	pˌɑjdɪlˈɪnɪp
گۈل	ɡˈyl
ھاكىمىيەت	hˌɑkɪmˈɪjæt
ھىندىستان	hɪndˈɪstɑn
ھەقىقەتەن	hˌæqɪqˈætæn
ئالىملار	ɑlˈɪmlɑr
ئاڭلاپ	ˈɑŋlɑp
ئوقۇتقۇچى	ˌoqutqˈut͡ʃɪ
ئىجاد	ˈɪd͡ʒɑd
ئىچى	ˈɪt͡ʃɪ
ئۆيىگە	œjˈɪɡæ
ئەرەبچە	æɾˈæbt͡ʃæ
ئەزالىرى	ˌæzɑlˈɪɾɪ
باتۇر	bˈɑtur
بولۇشقا	bolˈuʃqɑ
بىلىدىغان	bˌɪlɪdˈɪʁɑn
بەگ	bˈæɡ
تاپىدۇ	tɑpˈɪdu
تۇخۇم	tˈuχum
تەتقىقاتى	tˌætqɪqˈɑtɪ
تەرەپنىڭ	tæɾˈæpnɪŋ
تەڭرى	tˈæŋrɪ
جايلاردا	d͡ʒɑjlˈɑrdɑ
جەنۇبتىن	d͡ʒænˈubtɪn
دۆلىتى	dœlˈɪtɪ
رازى	rˈɑzɪ
زات	zˈɑt
سىرتىدا	sɪrtˈɪdɑ
غەربكە	ʁˈærbkæ
قاتناشقان	qɑtnˈɑʃqɑn
قىرىق	qˈɪɾɪq
كومپيۇتېر	kompjˈuter
كېتىپ	kˈetɪp
كېلىۋاتقان	kˌelɪwˈɑtqɑn
مىقداردا	mɪqdˈɑrdɑ
مېۋە	mˈewæ
مەنسۇپ	mˈænsup
مەھكىمىسىگە	mˌæhkɪmɪsˈɪɡæ
نەزەر	nˈæzær
چېگرا	t͡ʃˈeɡrɑ
ئۆلچەم	ˈœlt͡ʃæm
ئۆيدە	ˈœjdæ
ئېلېكتر	ˈelektr
ئەتراپىدىكى	ˌætrɑpɪdˈɪkɪ
ئەزا	ˈæzɑ
ئەسلىگە	æslˈɪɡæ
بۇلارنى	bulˈɑrnɪ
بېرىشكە	beɾˈɪʃkæ
تاكى	tˈɑkɪ
توك	tˈok
تىلنىڭ	tˈɪlnɪŋ
تۇرپان	tˈurpɑn
تۈركلەرنىڭ	tyrklˈærnɪŋ
تەركىب	tˈærkɪb
تەپەككۇر	tæpˈækkur
جۈملىدىن	d͡ʒymlˈɪdɪn
جەڭ	d͡ʒˈæŋ
خىزمىتى	χɪzmˈɪtɪ
دىنىنىڭ	dɪnˈɪnɪŋ
دېگەنلىك	deɡˈænlɪk
روھى	rˈohɪ
ساياھەت	sɑjˈɑhæt
سۈپىتى	sypˈɪtɪ
شەرقتىن	ʃˈærqtɪn
شەھەرنىڭ	ʃæhˈærnɪŋ
قىسمىغا	qɪsmˈɪʁɑ
قۇرۇقلۇق	quɾˈuqluq
قۇياش	qˈujɑʃ
كاتتا	kˈɑttɑ
كېسىم	kˈesɪm
مۇھەببەت	muhˈæbbæt
مەملىكەت	mæmlˈɪkæt
مەملىكەتلىك	mˌæmlɪkˈætlɪk
پايدىلىنىش	pˌɑjdɪlˈɪnɪʃ
چىقىرىدۇ	t͡ʃˌɪqɪɾˈɪdu
گۆش	ɡˈœʃ
گېزىتى	ɡezˈɪtɪ
ۋاقىتلاردا	wˌɑqɪtlˈɑrdɑ
ۋەزىپە	wæzˈɪpæ
ۋەيران	wˈæjrɑn
ئىشلىرىغا	ˌɪʃlɪɾˈɪʁɑ
ئۆتكۈزۈپ	œtkˈyzyp
ئەسەرلەر	æsˈærlær
ئەھۋالنى	æhwˈɑlnɪ
باشتىن	bˈɑʃtɪn
بالىلارغا	bˌɑlɪlˈɑrʁɑ
بىلىپ	bˈɪlɪp
بىلەنلا	bɪlˈænlɑ
بۇلىدۇ	bulˈɪdu
بېسىپ	bˈesɪp
بەكمۇ	bˈækmu
تارىخقا	tɑɾˈɪχqɑ
تاۋۇش	tˈɑwuʃ
تۈزۈلگەن	tyzˈylɡæn
تېپىپ	tˈepɪp
تەرەققى	tæɾˈæqqɪ
تەرەققىياتى	tˌæɾæqqɪjˈɑtɪ
دېيىلگەن	dejˈɪlɡæn
رايونلۇق	rɑjˈonluq
سۆزنىڭ	sˈœznɪŋ
شەيخ	ʃˈæjχ
قىلغاندىن	qɪlʁˈɑndɪn
ماددىي	mˈɑddɪj
مۇۋەپپەقىيەتلىك	mˌuwæppˌæqɪjˈætlɪk
نەتىجىسىدە	nˌætɪd͡ʒɪsˈɪdæ
يولىنى	jolˈɪnɪ
پىششىقلاپ	pɪʃʃˈɪqlɑp
چۈشۈش	t͡ʃˈyʃyʃ
ھامان	hˈɑmɑn
ۋاڭ	wˈɑŋ
ئارزۇ	ˈɑrzu
ئازىركى	ɑzˈɪrkɪ
ئالىمى	ɑlˈɪmɪ
ئوينىغان	ojnˈɪʁɑn
ئىنكار	ˈɪnkɑr
ئۈستى	ˈystɪ
ئېگىزلىكى	ˌeɡɪzlˈɪkɪ
باراۋەر	bɑɾˈɑwær
بولدۇم	bˈoldum
تەھلىل	tˈæhlɪl
جەمئىيەتتە	d͡ʒˌæmɪjˈættæ
دۆلىتىنىڭ	dˌœlɪtˈɪnɪŋ
رايونىنىڭ	rˌɑjonˈɪnɪŋ
زاماندا	zɑmˈɑndɑ
سوڭىغا	soŋˈɪʁɑ
سىياسەت	sɪjˈɑsæt
فىزىكا	fɪzˈɪkɑ
قانۇنىي	qɑnˈunɪj
قوشقان	qˈoʃqɑn
قوشۇنى	qoʃˈunɪ
قىسقىچە	qɪsqˈɪt͡ʃæ
كەلتۈرگەن	kæltˈyrɡæn
مەركەز	mˈærkæz
مەزگىلى	mæzɡˈɪlɪ
مەغلۇپ	mˈæʁlup
نىمە	nˈɪmæ
نۇسخىسى	nusχˈɪsɪ
ياشايدۇ	jɑʃˈɑjdu
ياۋايى	jɑwˈɑjɪ
ھۆرمەت	hˈœrmæt
ئاتىلىدىغان	ˌɑtɪlɪdˈɪʁɑn
ئالاھىدىلىكى	ˌɑlɑhˌɪdɪlˈɪkɪ
ئوسمانلى	osmˈɑnlɪ
ئوق	ˈoq
ئىدىم	ˈɪdɪm
ئىشغال	ˈɪʃʁɑl
ئىلغار	ˈɪlʁɑr
ئۇيغۇرلارغا	ˌujʁurlˈɑrʁɑ
ئېچىش	ˈet͡ʃɪʃ
ئەخلاق	ˈæχlɑq
باغلاپ	bˈɑʁlɑp
بولىشى	bolˈɪʃɪ
بەكرەك	bˈækræk
جاي	d͡ʒˈɑj
جايدا	d͡ʒˈɑjdɑ
خانىم	χˈɑnɪm
خىتاينىڭ	χɪtˈɑjnɪŋ
خەلىپە	χælˈɪpæ
دەم	dˈæm
زىيان	zˈɪjɑn
سادىر	sˈɑdɪr
ساپ	sˈɑp
سۆزلەرنى	sœzlˈærnɪ
شەكىللىك	ʃækˈɪllɪk
قاتار	qˈɑtɑr
قارىشى	qɑɾˈɪʃɪ
قوللىنىلغان	qˌollɪnˈɪlʁɑn
كىتابنى	kɪtˈɑbnɪ
كېسىپ	kˈesɪp
ماتېماتىكا	mˌɑtemɑtˈɪkɑ
مۇئەييەن	muˈæjjæn
مۇھاكىمە	mˌuhɑkˈɪmæ
مەدەنىيىتى	mˌædænɪjˈɪtɪ
نومۇر	nˈomur
ياغ	jˈɑʁ
يالغان	jˈɑlʁɑn
يەردىن	jˈærdɪn
ھالەتتە	hɑlˈættæ
ھەسسە	hˈæssæ
ئاجايىپ	ɑd͡ʒˈɑjɪp
ئايالى	ɑjˈɑlɪ
ئورنىدا	ornˈɪdɑ
ئىقتىساد	ɪqtˈɪsɑd
ئۆزىمىزنىڭ	ˌœzɪmˈɪznɪŋ
ئۆزگىچە	œzɡˈɪt͡ʃæ
ئۇستاز	ˈustɑz
ئۇششاق	ˈuʃʃɑq
ئېلىشقا	elˈɪʃqɑ
بىرىنى	bɪɾˈɪnɪ
بۇددا	bˈuddɑ
تارماقتىكى	tˌɑrmɑqtˈɪkɪ
تىپتىكى	tɪptˈɪkɪ
تۇرۇشلۇق	tuɾˈuʃluq
جازاسى	d͡ʒɑzˈɑsɪ
دۇنيانى	dunjˈɑnɪ
رايونىغا	rˌɑjonˈɪʁɑ
شۇندىن	ʃˈundɪn
غايەت	ʁˈɑjæt
قائىدە	qɑˈɪdæ
قىلىشتا	qɪlˈɪʃtɑ
كۇنى	kˈunɪ
مېدىيانىڭ	mˌedɪjˈɑnɪŋ
ناچار	nˈɑt͡ʃɑr
ناھىيىسىنىڭ	nˌɑhɪjɪsˈɪnɪŋ
ياساپ	jˈɑsɑp
يۇقىرىدىكى	jˌuqɪɾɪdˈɪkɪ
يۈزى	jˈyzɪ
يېزىش	jˈezɪʃ
پەنلەر	pˈænlær
ئا	ˈɑ
ئائىلىسى	ˌɑɪlˈɪsɪ
ئوقۇۋاتقان	ˌoquwˈɑtqɑn
ئىستانبۇل	ɪstˈɑnbul
ئىككىسى	ɪkkˈɪsɪ
ئىنگلىز	ˈɪnɡlɪz
ئۇقۇم	ˈuqum
ئۇنىۋېرسىتېتىنىڭ	ˌunɪwˌersɪtetˈɪnɪŋ
ئۇيغۇرلارنى	ˌujʁurlˈɑrnɪ
ئۈنۈملۈك	ynˈymlyk
ئېچىپ	ˈet͡ʃɪp
ئەسلىدىكى	ˌæslɪdˈɪkɪ
ئەمەل	ˈæmæl
بايرىمى	bɑjrˈɪmɪ
بىرىنىڭ	bɪɾˈɪnɪŋ
بىزدە	bˈɪzdæ
بۇندىن	bˈundɪn
بېيجىڭ	bˈejd͡ʒɪŋ
بەئزى	bˈæzɪ
تائالا	tɑˈɑlɑ
تايىنىپ	tɑjˈɪnɪp
تولا	tˈolɑ
تىز	tˈɪz
تىللىق	tˈɪllɪq
تۆھپە	tˈœhpæ
جەرياندا	d͡ʒærjˈɑndɑ
رۇخسەت	rˈuχsæt
رۇسىيە	rusˈɪjæ
ساقلاش	sˈɑqlɑʃ
سىياسىتى	sˌɪjɑsˈɪtɪ
شىركىتىنىڭ	ʃˌɪrkɪtˈɪnɪŋ
قىلمىغان	qɪlmˈɪʁɑn
قېلىپ	qˈelɪp
كىتابى	kɪtˈɑbɪ
كۆپىنچىسى	kˌœpɪnt͡ʃˈɪsɪ
كۈننىڭ	kˈynnɪŋ
كۈچىنى	kyt͡ʃˈɪnɪ
مىلادىيە	mˌɪlɑdˈɪjæ
مەزگىلدە	mæzɡˈɪldæ
نەتىجىسى	nˌætɪd͡ʒˈɪsɪ
يازغۇچىلار	jˌɑzʁut͡ʃˈɪlɑr
يۈەن	jˈyæn
يېغىن	jˈeʁɪn
چىقىدىغان	t͡ʃˌɪqɪdˈɪʁɑn
ھوقۇقىغا	hˌoquqˈɪʁɑ
ھەممىسىنى	hˌæmmɪsˈɪnɪ
ۋارىسلىق	wɑɾˈɪslɪq
ۋاقىتلىق	wɑqˈɪtlɪq
ئائىلىسىدە	ˌɑɪlɪsˈɪdæ
ئادىتى	ɑdˈɪtɪ
ئازادلىق	ɑzˈɑdlɪq
ئالدىن	ˈɑldɪn
ئالغا	ˈɑlʁɑ
ئايلىنىدۇ	ˌɑjlɪnˈɪdu
ئىشلىرىنى	ˌɪʃlɪɾˈɪnɪ
ئۆزگەرتىش	œzɡˈærtɪʃ
ئۆزۈم	ˈœzym
ئۆمۈر	ˈœmyr
ئەسىرىدە	ˌæsɪɾˈɪdæ
ئەھۋالى	æhwˈɑlɪ
بالىنىڭ	bɑlˈɪnɪŋ
بايرام	bˈɑjrɑm
بايقالغان	bɑjqˈɑlʁɑn
بىرلىك	bˈɪrlɪk
بەلگىلەيدۇ	bˌælɡɪlˈæjdu
تۆۋەندىكى	tˌœwændˈɪkɪ
تەبىئەت	tæbˈɪæt
تەشۋىقات	tæʃwˈɪqɑt
خاتىرە	χɑtˈɪɾæ
ساغلام	sˈɑʁlɑm
سەۋەبىنى	sˌæwæbˈɪnɪ
قازاق	qˈɑzɑq
قالدۇرغان	qɑldˈurʁɑn
كىردى	kˈɪrdɪ
مۇددىتى	muddˈɪtɪ
مۇز	mˈuz
مۇھىت	mˈuhɪt
نورۇز	nˈoɾuz
ياشاپ	jˈɑʃɑp
يىللاردا	jɪllˈɑrdɑ
يۇرت	jˈurt
چاي	t͡ʃˈɑj
چۈشىنىش	t͡ʃyʃˈɪnɪʃ
گرام	ɡrˈɑm
ھاجى	hˈɑd͡ʒɪ
ئاسىيادىكى	ˌɑsɪjɑdˈɪkɪ
ئاشلىق	ˈɑʃlɪq
ئامېرىكىلىق	ˌɑmeɾɪkˈɪlɪq
ئايلاندى	ɑjlˈɑndɪ
ئاڭلىغان	ɑŋlˈɪʁɑn
ئىسسىق	ˈɪssɪq
تارىم	tˈɑɾɪm
تاۋار	tˈɑwɑr
تىلىدىكى	tˌɪlɪdˈɪkɪ
تېلېۋىزىيە	tˌelewɪzˈɪjæ
خاراكتېرلىك	χˌɑɾɑktˈerlɪk
خاقان	χˈɑqɑn
خۇسۇسىي	χusˈusɪj
دۇلات	dˈulɑt
دېگۈدەك	deɡˈydæk
رايونىدا	rˌɑjonˈɪdɑ
زىيارەت	zɪjˈɑɾæt
سوڭرە	sˈoŋræ
سىستېمىسى	sˌɪstemˈɪsɪ
سۆزلەرنىڭ	sœzlˈærnɪŋ
قالسا	qˈɑlsɑ
قاپتۇ	qˈɑptu
قىسمەن	qˈɪsmæn
قىلىنىشى	qˌɪlɪnˈɪʃɪ
قۇرۇق	qˈuɾuq
كىرگۈزۈلگەن	kˌɪrɡyzˈylɡæn
كۆرسىتىش	kœrsˈɪtɪʃ
مۇددەتلىك	muddˈætlɪk
مۇقىم	mˈuqɪm
مەسىلىلەرنى	mˌæsɪlɪlˈærnɪ
نوپۇزلۇق	nopˈuzluq
نىسبىتى	nɪsbˈɪtɪ
ياشلىق	jˈɑʃlɪq
يىپەك	jˈɪpæk
يەھۇدى	jæhˈudɪ
پارغا	pˈɑrʁɑ
پايدا	pˈɑjdɑ
گېرمانىيە	ɡˌermɑnˈɪjæ
ھارام	hˈɑɾɑm
ۋەزىپىسىنى	wˌæzɪpɪsˈɪnɪ
ئارقىدىن	ɑrqˈɪdɪn
ئورگىنى	orɡˈɪnɪ
ئومۇملاشقان	ˌomumlˈɑʃqɑn
ئىسرائىلىيە	ˌɪsrɑɪlˈɪjæ
ئىشى	ˈɪʃɪ
ئىلھام	ˈɪlhɑm
ئىنسانىي	ɪnsˈɑnɪj
ئۈرۈمچىدە	ˌyɾymt͡ʃˈɪdæ
ئەخلاقىي	æχlˈɑqɪj
ئەسىرنىڭ	æsˈɪrnɪŋ
ئەلا	ˈælɑ
ئەھلى	ˈæhlɪ
ئەھۋالدا	æhwˈɑldɑ
باقمىغان	bɑqmˈɪʁɑn
بالىلارنى	bˌɑlɪlˈɑrnɪ
بىخەتەرلىك	bˌɪχætˈærlɪk
تاتار	tˈɑtɑr
تارىختىن	tɑɾˈɪχtɪn
تېپىش	tˈepɪʃ
جىق	d͡ʒˈɪq
خەلقلەر	χˈælqlær
دىۋانى	dɪwˈɑnɪ
دەۋر	dˈæwr
سىرتقى	sˈɪrtqɪ
سۇغا	sˈuʁɑ
سېنى	sˈenɪ
قازان	qˈɑzɑn
قوشۇن	qˈoʃun
قوڭ	qˈoŋ
قۇرغاق	qˈurʁɑq
كوللېكتىپ	kollˈektɪp
كىلىپ	kˈɪlɪp
كۆرە	kˈœɾæ
مىللىتىنىڭ	mˌɪllɪtˈɪnɪŋ
مۆتىدىل	mœtˈɪdɪl
مۇكاپاتى	mˌukɑpˈɑtɪ
مۇھىتى	muhˈɪtɪ
مەزمۇن	mˈæzmun
مەكتەپنىڭ	mæktˈæpnɪŋ
نۆۋەتتە	nœwˈættæ
پىكرى	pˈɪkrɪ
پۇختا	pˈuχtɑ
ھادىسە	hɑdˈɪsæ
ھۆكۈمرانلىق	hˌœkymrˈɑnlɪq
ھەممىدىن	hæmmˈɪdɪn
ھەپتە	hˈæptæ
ۋاكالىتەن	wˌɑkɑlˈɪtæn
ئائىلىنىڭ	ˌɑɪlˈɪnɪŋ
ئاخىرىغىچە	ˌɑχɪɾɪʁˈɪt͡ʃæ
ئادەمگە	ɑdˈæmɡæ
ئاران	ˈɑɾɑn
ئالدىدىكى	ˌɑldɪdˈɪkɪ
ئوقۇغۇچىلارنىڭ	ˌoquʁˌut͡ʃɪlˈɑrnɪŋ
ئىزدەپ	ˈɪzdæp
ئىچ	ˈɪt͡ʃ
ئۆيگە	ˈœjɡæ
ئەركىنلىك	ærkˈɪnlɪk
ئەرلەر	ˈærlær
باشلىنىدۇ	bˌɑʃlɪnˈɪdu
بايلىقىدىن	bˌɑjlɪqˈɪdɪn
بوغۇم	bˈoʁum
بولۇشىنى	bˌoluʃˈɪnɪ
بىلدۈرىدۇ	bˌɪldyɾˈɪdu
بۇلاردىن	bulˈɑrdɪn
بۇنىڭدا	bunˈɪŋdɑ
بەدەن	bˈædæn
تا	tˈɑ
تارمىقى	tɑrmˈɪqɪ
تۈپ	tˈyp
تەدرىجىي	tædrˈɪd͡ʒɪj
تەييار	tˈæjjɑr
جۇڭگونىڭ	d͡ʒuŋɡˈonɪŋ
خاھرى	χˈɑhrɪ
خىزمەتكە	χɪzmˈætkæ
دېگەندە	deɡˈændæ
دەرياسىنىڭ	dˌærjɑsˈɪnɪŋ
دەيدىغان	dæjdˈɪʁɑn
زىچ	zˈɪt͡ʃ
ساقلىنىپ	sɑqlˈɪnɪp
ساھەدە	sɑhˈædæ
ساھەسىدىكى	sˌɑhæsɪdˈɪkɪ
سوزۇق	sˈozuq
قارىلىدۇ	qˌɑɾɪlˈɪdu
قازاقىستان	qˌɑzɑqˈɪstɑn
قالدىم	qˈɑldɪm
قىلىمىز	qɪlˈɪmɪz
قۇرۇلغاندىن	qˌuɾulʁˈɑndɪn
قەرز	qˈærz
قەشقەردە	qæʃqˈærdæ
قەشقەرگە	qæʃqˈærɡæ
كىشىگە	kɪʃˈɪɡæ
كەلتۈرۈش	kæltˈyɾyʃ
لاتىن	lˈɑtɪn
مىللەتنى	mɪllˈætnɪ
مىنگونىڭ	mɪnɡˈonɪŋ
مۇستەقىللىق	mˌustæqˈɪllɪq
مۇلازىمەت	mˌulɑzˈɪmæt
مەندىن	mˈændɪn
يېشىدا	jeʃˈɪdɑ
چارۋىچىلىق	t͡ʃˌɑrwɪt͡ʃˈɪlɪq
گېزىت	ɡˈezɪt
ھاياتىدا	hˌɑjɑtˈɪdɑ
ۋاقىتنىڭ	wɑqˈɪtnɪŋ
ئابدۇللا	ɑbdˈullɑ
ئاتايدۇ	ɑtˈɑjdu
ئاستا	ˈɑstɑ
ئالەمدىن	ɑlˈæmdɪn
ئامېرىكىلىقلار	ˌɑmeɾˌɪkɪlˈɪqlɑr
ئامېرىكىلىقلارنىڭ	ˌɑmeɾˌɪkɪlɪqlˈɑrnɪŋ
ئوخشاپ	ˈoχʃɑp
ئىز	ˈɪz
ئىسمىنى	ɪsmˈɪnɪ
ئىشلىتىلگەن	ˌɪʃlɪtˈɪlɡæn
ئىمان	ˈɪmɑn
ئىنچىكە	ɪnt͡ʃˈɪkæ
ئىپتىدائىي	ˌɪptɪdˈɑɪj
ئىگىسى	ɪɡˈɪsɪ
ئۆتكۈر	ˈœtkyr
ئۇيغۇرنى	ujʁˈurnɪ
ئۇچرىغان	ut͡ʃrˈɪʁɑn
ئۈنۈم	ˈynym
باشقىلارنى	bˌɑʃqɪlˈɑrnɪ
باغلانغان	bɑʁlˈɑnʁɑn
بويى	bˈojɪ
بىردەك	bˈɪrdæk
توختىماي	toχtˈɪmɑj
تىلىدىن	tɪlˈɪdɪn
تىلىغا	tɪlˈɪʁɑ
تۇردى	tˈurdɪ
تەركىبىدە	tˌærkɪbˈɪdæ
تەشكىلات	tæʃkˈɪlɑt
تەلىم	tˈælɪm
خىزمىتىنى	χˌɪzmɪtˈɪnɪ
خىمىيە	χɪmˈɪjæ
خەن	χˈæn
روشەن	rˈoʃæn
رەھمەت	rˈæhmæt
سالغان	sˈɑlʁɑn
قارايدىغان	qˌɑɾɑjdˈɪʁɑn
قولىدىن	qolˈɪdɪn
قىش	qˈɪʃ
قىلغانلىقى	qˌɪlʁɑnlˈɪqɪ
قىلىشتىن	qɪlˈɪʃtɪn
كۈنلىرى	kynlˈɪɾɪ
مىراس	mˈɪɾɑs
مۇددەت	mˈuddæt
مۇكاپاتىغا	mˌukɑpɑtˈɪʁɑ
نۆۋەتلىك	nœwˈætlɪk
نەرسىلەر	nærsˈɪlær
ياغلىق	jˈɑʁlɪq
يېنىدا	jenˈɪdɑ
پۇرسەت	pˈursæt
چاغدىكى	t͡ʃɑʁdˈɪkɪ
گەپنى	ɡˈæpnɪ
ھىجرىيە	hɪd͡ʒrˈɪjæ
ھۆكۈمىتىنىڭ	hˌœkymɪtˈɪnɪŋ
ھەممىمىز	hæmmˈɪmɪz
ئاشىدۇ	ɑʃˈɪdu
ئاكتىپ	ˈɑktɪp
ئالەم	ˈɑlæm
ئايروپىلان	ˌɑjropˈɪlɑn
ئايرىلغان	ɑjrˈɪlʁɑn
ئوتتۇرغا	ottˈurʁɑ
ئولتۇرغان	oltˈurʁɑn
ئىبراھىم	ɪbrˈɑhɪm
ئىدارە	ɪdˈɑɾæ
ئىشتا	ˈɪʃtɑ
ئىمزا	ˈɪmzɑ
ئىنسانىيەت	ˌɪnsɑnˈɪjæt
ئۇرۇقى	uɾˈuqɪ
ئۈستىدىكى	ˌystɪdˈɪkɪ
ئەكسىچە	æksˈɪt͡ʃæ
بىرىدۇر	bɪɾˈɪdur
بىلىش	bˈɪlɪʃ
بەلگىلەش	bælɡˈɪlæʃ
تار	tˈɑr
تارتىش	tˈɑrtɪʃ
تارقىتىش	tɑrqˈɪtɪʃ
تارىخىدىكى	tˌɑɾɪχɪdˈɪkɪ
تاللاش	tˈɑllɑʃ
توم	tˈom
تۈپەيلىدىن	tˌypæjlˈɪdɪn
جۇمھۇرىيىتىنىڭ	d͡ʒˌumhuɾˌɪjɪtˈɪnɪŋ
جەمئىيىتى	d͡ʒˌæmɪjˈɪtɪ
دېمەك	dˈemæk
دەۋا	dˈæwɑ
روزا	rˈozɑ
سىيىت	sˈɪjɪt
سۈت	sˈyt
سەرپ	sˈærp
غايە	ʁˈɑjæ
قازانغان	qɑzˈɑnʁɑn
قانات	qˈɑnɑt
قىزىق	qˈɪzɪq
كەتسە	kˈætsæ
ماتورلۇق	mɑtˈorluq
مىسىر	mˈɪsɪr
مۇسا	mˈusɑ
مەدەنىي	mædˈænɪj
مەنپەئەت	mænpˈææt
نادىر	nˈɑdɪr
نۇرى	nˈuɾɪ
يارىتىش	jɑɾˈɪtɪʃ
ياپون	jˈɑpon
پايتاھتى	pɑjtˈɑhtɪ
پەقەتلا	pæqˈætlɑ
چەكلىك	t͡ʃˈæklɪk
گۆشى	ɡˈœʃɪ
ھاكىم	hˈɑkɪm
ھوقۇقلۇق	hoqˈuqluq
ئاكا	ˈɑkɑ
ئالىدىغان	ˌɑlɪdˈɪʁɑn
ئىشەنچ	ˈɪʃænt͡ʃ
ئۆزبېك	ˈœzbek
ئۆگەنگەن	œɡˈænɡæn
ئۇممۇ	ˈummu
ئېتىش	ˈetɪʃ
ئەھۋالىنى	ˌæhwɑlˈɪnɪ
ئەۋلاد	ˈæwlɑd
باققان	bˈɑqqɑn
بولىدىغانلىقىنى	bˌolɪdˌɪʁɑnlɪqˈɪnɪ
بىرىدۇ	bɪɾˈɪdu
بېشىنى	beʃˈɪnɪ
تىللىرى	tɪllˈɪɾɪ
تەسىرىگە	tˌæsɪɾˈɪɡæ
تەييارلىق	tæjjˈɑrlɪq
جارى	d͡ʒˈɑɾɪ
جۈپ	d͡ʒˈyp
خىلاپلىق	χɪlˈɑplɪq
خەنسۇ	χˈænsu
دېھقانلار	dehqˈɑnlɑr
سامسۇڭ	sˈɑmsuŋ
سانتىمېتىر	sˌɑntɪmˈetɪr
غەلىبە	ʁælˈɪbæ
قاراش	qˈɑɾɑʃ
قوغلاپ	qˈoʁlɑp
كىتاپ	kˈɪtɑp
كۆزدە	kˈœzdæ
كۆكتات	kˈœktɑt
كۈندۇر	kˈyndur
كۈنلەردە	kynlˈærdæ
كېتىدىغان	kˌetɪdˈɪʁɑn
كەلگۈسىدە	kˌælɡysˈɪdæ
موڭغۇللار	moŋʁˈullɑr
مىسال	mˈɪsɑl
مەسچىت	mˈæst͡ʃɪt
مەكتىپى	mæktˈɪpɪ
مەكتەپنى	mæktˈæpnɪ
نەزىرىدە	nˌæzɪɾˈɪdæ
يېتەرلىك	jetˈærlɪk
يېقىندا	jeqˈɪndɑ
پۇلىنى	pulˈɪnɪ
پەرقى	pˈærqɪ
چەتئەل	t͡ʃˈætæl
گىرىپتار	ɡɪɾˈɪptɑr
ھالاك	hˈɑlɑk
ھاۋالە	hɑwˈɑlæ
ھېكايە	hekˈɑjæ
ۋىلايەت	wɪlˈɑjæt
ۋۇجۇدقا	wud͡ʒˈudqɑ
ئاتاقلىق	ɑtˈɑqlɪq
ئاخىر	ˈɑχɪr
ئارمىيىسى	ˌɑrmɪjˈɪsɪ
ئارمىيەسى	ˌɑrmɪjˈæsɪ
ئارىسىغا	ˌɑɾɪsˈɪʁɑ
ئافرىقا	ɑfrˈɪqɑ
ئاللاھقا	ɑllˈɑhqɑ
ئاچقان	ˈɑt͡ʃqɑn
ئىبارەتتۇر	ˌɪbɑɾˈættur
ئىستراتېگىيەلىك	ˌɪstrɑtˌeɡɪjˈælɪk
ئىستىخبارات	ˌɪstɪχbˈɑɾɑt
ئىشلىتىلىدىغان	ˌɪʃlɪtˌɪlɪdˈɪʁɑn
ئىشلەتكەن	ɪʃlˈætkæn
ئىنقىلابى	ˌɪnqɪlˈɑbɪ
ئۈچۈنمۇ	yt͡ʃˈynmu
ئېيتقاندا	ejtqˈɑndɑ
ئەسەرنىڭ	æsˈærnɪŋ
بالىسى	bɑlˈɪsɪ
بىرنى	bˈɪrnɪ
تاتلىق	tˈɑtlɪq
تونۇپ	tˈonup
تېببىي	tˈebbɪj
تېغىنىڭ	teʁˈɪnɪŋ
تەرىپىگە	tˌæɾɪpˈɪɡæ
تەقدىرىنى	tˌæqdɪɾˈɪnɪ
جىسىمنىڭ	d͡ʒɪsˈɪmnɪŋ
جەريانى	d͡ʒærjˈɑnɪ
خۇش	χˈuʃ
خەتەرلىك	χætˈærlɪk
دەپنە	dˈæpnæ
رۇس	rˈus
رەڭ	rˈæŋ
شىنجاڭدىكى	ʃˌɪnd͡ʒɑŋdˈɪkɪ
شەخسنىڭ	ʃˈæχsnɪŋ
شەكىل	ʃˈækɪl
شەھەرلىك	ʃæhˈærlɪk
قورال	qˈoɾɑl
قىزنىڭ	qˈɪznɪŋ
قىسمىدا	qɪsmˈɪdɑ
قىلىنىدىغان	qˌɪlɪnɪdˈɪʁɑn
قۇم	qˈum
كاپالەتلىك	kˌɑpɑlˈætlɪk
كىرىم	kˈɪɾɪm
كىرىمى	kɪɾˈɪmɪ
كۆرىدۇ	kœɾˈɪdu
كۆرۈش	kˈœɾyʃ
كەپتۇ	kˈæptu
مىنۇت	mˈɪnut
مۇنازىرە	mˌunɑzˈɪɾæ
مۇناسىپ	munˈɑsɪp
مەدەنىيىتىنى	mˌædænˌɪjɪtˈɪnɪ
مەنئى	mˈænɪ
مەھسۇلاتى	mˌæhsulˈɑtɪ
نازارەت	nɑzˈɑɾæt
نىشانى	nɪʃˈɑnɪ
نەپەر	nˈæpær
ى	ˈɪ
يىڭى	jˈɪŋɪ
يېشىل	jˈeʃɪl
يەھۇدىلارنىڭ	jˌæhudɪlˈɑrnɪŋ
پاكىز	pˈɑkɪz
پەلسەپە	pælsˈæpæ
چاغاتاي	t͡ʃɑʁˈɑtɑj
ھاياتنىڭ	hɑjˈɑtnɪŋ
ھەقسىز	hˈæqsɪz
ھەمراھ	hˈæmrɑh
ۋالىي	wˈɑlɪj
ۋەكىلى	wækˈɪlɪ
ئايالنىڭ	ɑjˈɑlnɪŋ
ئومۇمەن	omˈumæn
ئويناش	ˈojnɑʃ
ئىجادىيەت	ˌɪd͡ʒɑdˈɪjæt
ئىجتىمائى	ˌɪd͡ʒtɪmˈɑɪ
ئۆزىدىن	œzˈɪdɪn
ئۆزۈمنىڭ	œzˈymnɪŋ
ئۆلكە	ˈœlkæ
ئۈزۈپ	ˈyzyp
ئۈستىدىن	ystˈɪdɪn
ئېلىشى	elˈɪʃɪ
ئېچىلغان	et͡ʃˈɪlʁɑn
ئەسەرلىرىنى	ˌæsærlɪɾˈɪnɪ
ئەمەلدىن	æmˈældɪn
بارىدىغان	bˌɑɾɪdˈɪʁɑn
بازىرىنىڭ	bˌɑzɪɾˈɪnɪŋ
باشلىق	bˈɑʃlɪq
بالىلىق	bɑlˈɪlɪq
بىزدىن	bˈɪzdɪn
بۆلۈنىدۇ	bˌœlynˈɪdu
بېشىدا	beʃˈɪdɑ
بەيئەت	bˈæjæt
تارماق	tˈɑrmɑq
تولغان	tˈolʁɑn
تۈرلىرى	tyrlˈɪɾɪ
تەرتىپ	tˈærtɪp
تەرىپىدە	tˌæɾɪpˈɪdæ
تەس	tˈæs
خالىغان	χɑlˈɪʁɑn
خىرىستىيان	χˌɪɾɪstˈɪjɑn
دىنىنى	dɪnˈɪnɪ
دۆلەتلىك	dœlˈætlɪk
دەۋردە	dˈæwrdæ
زادى	zˈɑdɪ
سوئال	sˈoɑl
سىڭىپ	sˈɪŋɪp
شەھەرگە	ʃæhˈærɡæ
قادىر	qˈɑdɪr
قار	qˈɑr
قارىماي	qɑɾˈɪmɑj
قاغان	qˈɑʁɑn
قاماق	qˈɑmɑq
قانۇننىڭ	qɑnˈunnɪŋ
قايتۇرۇپ	qɑjtˈuɾup
قوشۇلۇپ	qoʃˈulup
قىروسىز	qɪɾˈosɪz
قىلالايدىغان	qˌɪlɑlɑjdˈɪʁɑn
قىلغىن	qˈɪlʁɪn
قىلماقتا	qɪlmˈɑqtɑ
قىلىشنىڭ	qɪlˈɪʃnɪŋ
قېتىمدا	qetˈɪmdɑ
قەبىلە	qæbˈɪlæ
قەبۇل	qˈæbul
قەغەز	qˈæʁæz
كۆردۈم	kˈœrdym
كۆرۈنەرلىك	kˌœɾynˈærlɪk
كېتىشى	ketˈɪʃɪ
كېتىپتۇ	ketˈɪptu
كەلدىم	kˈældɪm
كەلگۈسى	kælɡˈysɪ
لايىق	lˈɑjɪq
موللا	mˈollɑ
مۇسابىقە	mˌusɑbˈɪqæ
مۇستاككىل	mustˈɑkkɪl
مۇكاپات	mukˈɑpɑt
مېڭە	mˈeŋæ
مەجبۇرى	mæd͡ʒbˈuɾɪ
مەھسۇلاتلىرىدىن	mˌæhsulˌɑtlɪɾˈɪdɪn
نۇپۇسى	nupˈusɪ
يىگىرمە	jɪɡˈɪrmæ
يۇقىرىقىدەك	jˌuqɪɾɪqˈɪdæk
يۈزىگە	jyzˈɪɡæ
يەھۇدىي	jæhˈudɪj
پارس	pˈɑrs
پارلامېنت	pɑrlˈɑment
ژۇرنال	ʒˈurnɑl
گوۋۇيۈەننىڭ	ɡˌowujyˈænnɪŋ
ھالەتكە	hɑlˈætkæ
ھېيت	hˈejt
ۋاسىتىسى	wˌɑsɪtˈɪsɪ
ئاتىسى	ɑtˈɪsɪ
ئاساستا	ɑsˈɑstɑ
ئاستىدىكى	ˌɑstɪdˈɪkɪ
ئاللاھتىن	ɑllˈɑhtɪn
ئانالىز	ɑnˈɑlɪz
ئاپتونۇم	ɑptˈonum
ئوردىسى	ordˈɪsɪ
ئولتۇرۇپ	oltˈuɾup
ئىجارە	ɪd͡ʒˈɑɾæ
ئىران	ˈɪɾɑn
ئىشتىن	ˈɪʃtɪn
ئىشلاردا	ɪʃlˈɑrdɑ
ئىشلىتىدۇ	ˌɪʃlɪtˈɪdu
ئۆتكۈزۈلگەن	ˌœtkyzˈylɡæn
ئۆيىدە	œjˈɪdæ
ئۇرۇشتا	uɾˈuʃtɑ
ئۇسۇلىنى	ˌusulˈɪnɪ
ئۇچار	ˈut͡ʃɑr
ئۇچراپ	ˈut͡ʃrɑp
ئەنھۇ	ˈænhu
ئەي	ˈæj
باب	bˈɑb
باغلىق	bˈɑʁlɪq
بالىلىرى	bˌɑlɪlˈɪɾɪ
بىرلىشىپ	bɪrlˈɪʃɪp
بىلگەن	bˈɪlɡæn
بېرىلغان	beɾˈɪlʁɑn
تارىخىنى	tˌɑɾɪχˈɪnɪ
تاللاپ	tˈɑllɑp
تورى	tˈoɾɪ
تۆۋەندە	tœwˈændæ
تۈزۈپ	tˈyzyp
تېرە	tˈeɾæ
تېلېفون	telˈefon
تېما	tˈemɑ
تەييارلىنىدۇ	tˌæjjɑrlɪnˈɪdu
تەپسىلىي	tæpsˈɪlɪj
جايدىكى	d͡ʒɑjdˈɪkɪ
خانلىقىنىڭ	χˌɑnlɪqˈɪnɪŋ
خېلىلا	χelˈɪlɑ
خەلقىمىز	χælqˈɪmɪz
دوكتورلۇق	doktˈorluq
دۇر	dˈur
سىلەرگە	sɪlˈærɡæ
سىنانىڭ	sɪnˈɑnɪŋ
شافىئىي	ʃɑfˈɪɪj
شىمالغا	ʃɪmˈɑlʁɑ
شىمالغىچە	ʃˌɪmɑlʁˈɪt͡ʃæ
شەھىرىگە	ʃˌæhɪɾˈɪɡæ
غۇلجا	ʁˈuld͡ʒɑ
قا	qˈɑ
قارىتىلغان	qˌɑɾɪtˈɪlʁɑn
قاسىم	qˈɑsɪm
قولى	qˈolɪ
قوڭۇر	qˈoŋur
قىزىم	qˈɪzɪm
قۇرۇش	qˈuɾuʃ
قۇملۇق	qˈumluq
قېتىمقى	qetˈɪmqɪ
كىتابنىڭ	kɪtˈɑbnɪŋ
كۆرگىلى	kœrɡˈɪlɪ
كۆرۈنگەن	kœɾˈynɡæn
كۈنگە	kˈynɡæ
كېلىش	kˈelɪʃ
كېلىۋاتىدۇ	kˌelɪwɑtˈɪdu
لىكىن	lˈɪkɪn
مىللى	mˈɪllɪ
مىللىئون	mɪllˈɪon
مۇ	mˈu
مۇدىرى	mudˈɪɾɪ
مۇنەۋۋەر	munˈæwwær
مەزمۇنى	mæzmˈunɪ
مەسىلىنى	mˌæsɪlˈɪnɪ
مەپكۇرە	mæpkˈuɾæ
مەھرۇم	mˈæhrum
نامىنى	nɑmˈɪnɪ
نان	nˈɑn
نە	nˈæ
نەق	nˈæq
نەۋائىي	næwˈɑɪj
يارىتىپ	jɑɾˈɪtɪp
ياۋرۇپا	jɑwrˈupɑ
يىللاردىن	jɪllˈɑrdɪn
يىلىدىن	jɪlˈɪdɪn
يۈرگەن	jˈyrɡæn
يۈرەك	jˈyɾæk
يەپ	jˈæp
پەرەز	pˈæɾæz
چىقىشى	t͡ʃɪqˈɪʃɪ
چۈشەنچە	t͡ʃyʃˈænt͡ʃæ
ھايۋان	hˈɑjwɑn
ھۆكۈمران	hœkˈymrɑn
ھېساب	hˈesɑb
ھەركەت	hˈærkæt
ۋاقىتتىكى	wˌɑqɪttˈɪkɪ
ۋەتەنگە	wætˈænɡæ
ۋەدە	wˈædæ
ئاتلىق	ˈɑtlɪq
ئىشلىتىشكە	ˌɪʃlɪtˈɪʃkæ
ئىككىگە	ɪkkˈɪɡæ
ئىنكاس	ˈɪnkɑs
ئىپادە	ɪpˈɑdæ
ئۆتتى	ˈœttɪ
ئۆتكۈزگەن	œtkˈyzɡæn
ئۇرۇق	ˈuɾuq
ئۇسۇلدا	usˈuldɑ
ئۈستۈن	ˈystyn
ئۈلگە	ˈylɡæ
ئېتىپ	ˈetɪp
ئەھۋالغا	æhwˈɑlʁɑ
باردى	bˈɑrdɪ
بولماي	bˈolmɑj
بىردىنبىر	bɪrdˈɪnbɪr
بىرلەشمە	bɪrlˈæʃmæ
بۇيرۇق	bˈujruq
بەلۋاغ	bˈælwɑʁ
تارىخىغا	tˌɑɾɪχˈɪʁɑ
تاللىغان	tɑllˈɪʁɑn
تۇتۇش	tˈutuʃ
تۈركىستاننىڭ	tˌyrkɪstˈɑnnɪŋ
تۈزۈمى	tyzˈymɪ
تېشى	tˈeʃɪ
تەشۋىق	tˈæʃwɪq
جايلارغا	d͡ʒɑjlˈɑrʁɑ
جەمئىيىتىدە	d͡ʒˌæmɪjɪtˈɪdæ
خام	χˈɑm
خەنسۇچە	χænsˈut͡ʃæ
دىققىتىنى	dˌɪqqɪtˈɪnɪ
دېيىشكە	dejˈɪʃkæ
دەسلەپ	dˈæslæp
ساقچى	sˈɑqt͡ʃɪ
سۈرگەن	sˈyrɡæn
شەخس	ʃˈæχs
قاراقاش	qɑɾˈɑqɑʃ
قالدۇرۇپ	qɑldˈuɾup
قاچان	qˈɑt͡ʃɑn
قولدىن	qˈoldɪn
قوللىنىلىدۇ	qˌollɪnɪlˈɪdu
قۇرۇلمىسى	qˌuɾulmˈɪsɪ
قۇل	qˈul
قەيت	qˈæjt
كىشلەر	kˈɪʃlær
كىشىلەردىن	kˌɪʃɪlˈærdɪn
كۆل	kˈœl
كېلەتتى	kelˈættɪ
لۇغەت	lˈuʁæt
مۇستەملىكە	mˌustæmlˈɪkæ
مەزگىللەردە	mˌæzɡɪllˈærdæ
مەسلىھەت	mæslˈɪhæt
مەنبە	mˈænbæ
مەنمۇ	mˈænmu
مەھسۇلات	mæhsˈulɑt
نامايەن	nɑmˈɑjæn
نېفىت	nˈefɪt
ياخشىراق	jɑχʃˈɪɾɑq
يېمەكلىك	jemˈæklɪk
پائالىيىتى	pˌɑɑlɪjˈɪtɪ
پوچتا	pˈot͡ʃtɑ
پەرز	pˈærz
چىقىرىلغان	t͡ʃˌɪqɪɾˈɪlʁɑn
چەكسىز	t͡ʃˈæksɪz
گويا	ɡˈojɑ
ھەققى	hˈæqqɪ
ھەممىنى	hæmmˈɪnɪ
ۋەزىپىسى	wˌæzɪpˈɪsɪ
ئارىلاشتۇرۇپ	ˌɑɾɪlɑʃtˈuɾup
ئاش	ˈɑʃ
ئالىملىرى	ˌɑlɪmlˈɪɾɪ
ئومۇميۈزلۈك	ˌomumjˈyzlyk
ئىبادەت	ɪbˈɑdæt
ئىدارىسى	ˌɪdɑɾˈɪsɪ
ئىدىيە	ɪdˈɪjæ
ئىسمائىل	ɪsmˈɑɪl
ئىلىپ	ˈɪlɪp
ئۆتۈش	ˈœtyʃ
ئۆگىنىپ	œɡˈɪnɪp
ئۇنۋانى	unwˈɑnɪ
ئېشەك	ˈeʃæk
ئەتراپىغا	ˌætrɑpˈɪʁɑ
ئەسەرلەرنىڭ	ˌæsærlˈærnɪŋ
ئەقلىي	ˈæqlɪj
ئەمىر	ˈæmɪr
ئەپەندىنىڭ	ˌæpændˈɪnɪŋ
اللە	ˈɑllæ
بارغانسېرى	bˌɑrʁɑnsˈeɾɪ
بارى	bˈɑɾɪ
بېشىدىن	beʃˈɪdɪn
بەلگىسى	bælɡˈɪsɪ
تارتقان	tˈɑrtqɑn
توشقان	tˈoʃqɑn
تىنچ	tˈɪnt͡ʃ
تۈپەيلى	typˈæjlɪ
تېخنىكىسى	tˌeχnɪkˈɪsɪ
تەربىيىسى	tˌærbɪjˈɪsɪ
تەسلىم	tˈæslɪm
تەنلىك	tˈænlɪk
جۇمھۇرىيەت	d͡ʒˌumhuɾˈɪjæt
خرىستىئان	χrɪstˈɪɑn
خىلاپ	χˈɪlɑp
خەلقنى	χˈælqnɪ
دوست	dˈost
دىننى	dˈɪnnɪ
دەۋەت	dˈæwæt
رايونغا	rɑjˈonʁɑ
رەڭگى	rˈæŋɡɪ
زاپاس	zˈɑpɑs
سەۋەپتىن	sæwˈæptɪn
شارائىت	ʃɑɾˈɑɪt
شۇنىڭدەك	ʃunˈɪŋdæk
شېئىر	ʃˈeɪr
شەرقتە	ʃˈærqtæ
قازا	qˈɑzɑ
قالمايدۇ	qɑlmˈɑjdu
قوشنا	qˈoʃnɑ
قويۇلمايدۇ	qˌojulmˈɑjdu
قىزلار	qˈɪzlɑr
قىزىقارلىق	qˌɪzɪqˈɑrlɪq
قىلالايدۇ	qˌɪlɑlˈɑjdu
قىلماقچى	qɪlmˈɑqt͡ʃɪ
قىلماي	qˈɪlmɑj
قىلىدىكەن	qˌɪlɪdˈɪkæn
قېزىلما	qezˈɪlmɑ
قېشىغا	qeʃˈɪʁɑ
كالا	kˈɑlɑ
كومىتېتىنىڭ	kˌomɪtetˈɪnɪŋ
كىيىنكى	kɪjˈɪnkɪ
كېتىش	kˈetɪʃ
ماقالىسى	mˌɑqɑlˈɪsɪ
مىللەتكە	mɪllˈætkæ
مەجبۇرىي	mæd͡ʒbˈuɾɪj
مەرھۇم	mˈærhum
مەقسىتىدە	mˌæqsɪtˈɪdæ
نامىدا	nɑmˈɪdɑ
نۆۋەت	nˈœwæt
نۇقتىسىدىن	nˌuqtɪsˈɪdɪn
نەرسىلەرنىڭ	nˌærsɪlˈærnɪŋ
يىغىنى	jɪʁˈɪnɪ
يېزىسىدا	jˌezɪsˈɪdɑ
يېزىلىدۇ	jˌezɪlˈɪdu
يەھۇدىلار	jˌæhudˈɪlɑr
پەس	pˈæs
چەتكە	t͡ʃˈætkæ
ھالغا	hˈɑlʁɑ
ۋۇجۇتقا	wud͡ʒˈutqɑ
ئابدۇرېھىم	ˌɑbduɾˈehɪm
ئاتالغۇ	ɑtˈɑlʁu
ئارمىيە	ɑrmˈɪjæ
ئالغۇچى	ɑlʁˈut͡ʃɪ
ئاللىقاچان	ˌɑllɪqˈɑt͡ʃɑn
ئامىل	ˈɑmɪl
ئاياللارغا	ˌɑjɑllˈɑrʁɑ
ئايدىن	ˈɑjdɪn
ئايرىش	ˈɑjrɪʃ
ئايەت	ˈɑjæt
ئوتتۇرىسىغا	ˌottuɾɪsˈɪʁɑ
ئورگان	ˈorɡɑn
ئوقۇشنى	oqˈuʃnɪ
ئىجابىي	ɪd͡ʒˈɑbɪj
ئىجادىي	ɪd͡ʒˈɑdɪj
ئىشلەنگەن	ɪʃlˈænɡæn
ئىشىنى	ɪʃˈɪnɪ
ئىكەنلىكىگە	ˌɪkænlɪkˈɪɡæ
ئىمپېرىيىسى	ˌɪmpeɾɪjˈɪsɪ
ئىگىلىگەن	ˌɪɡɪlˈɪɡæn
ئۆتمەي	ˈœtmæj
ئۆزگىرىپ	œzɡˈɪɾɪp
ئۆسۈپ	ˈœsyp
ئۇرۇشىدا	ˌuɾuʃˈɪdɑ
ئۇچرايدىغان	ˌut͡ʃrɑjdˈɪʁɑn
ئۇچۇرلارنى	ˌut͡ʃurlˈɑrnɪ
ئېرىشىش	eɾˈɪʃɪʃ
ئەتىسى	ætˈɪsɪ
ئەدەبىياتىنىڭ	ˌædæbˌɪjɑtˈɪnɪŋ
ئەقىللىق	æqˈɪllɪq
ئەكىس	ˈækɪs
ئەھمىيەتكە	ˌæhmɪjˈætkæ
ئەۋج	ˈæwd͡ʒ
بارغاندا	bɑrʁˈɑndɑ
بالدۇر	bˈɑldur
بىرمۇ	bˈɪrmu
بىرىدىن	bɪɾˈɪdɪn
بىرىنجى	bɪɾˈɪnd͡ʒɪ
بۇغداي	bˈuʁdɑj
بېقىش	bˈeqɪʃ
بەھرىمەن	bæhrˈɪmæn
تاشنى	tˈɑʃnɪ
توختاپ	tˈoχtɑp
تىرىشچانلىق	tˌɪɾɪʃt͡ʃˈɑnlɪq
تۆرت	tˈœrt
تۇرۇۋاتقان	tˌuɾuwˈɑtqɑn
تۇيغۇ	tˈujʁu
تۈر	tˈyr
تېخنىكىلىق	tˌeχnɪkˈɪlɪq
تەرەپتە	tæɾˈæptæ
تەشكىلاتلار	tˌæʃkɪlˈɑtlɑr
تەكشى	tˈækʃɪ
تەييارلاش	tæjjˈɑrlɑʃ
تەھرىر	tˈæhrɪr
جايغا	d͡ʒˈɑjʁɑ
جۇڭغار	d͡ʒˈuŋʁɑr
خالاس	χˈɑlɑs
خانلىق	χˈɑnlɪq
خىزمىتىگە	χˌɪzmɪtˈɪɡæ
خىيال	χˈɪjɑl
دائىمىي	dɑˈɪmɪj
دادىسىنىڭ	dˌɑdɪsˈɪnɪŋ
داموللام	dɑmˈollɑm
دولان	dˈolɑn
دۆلەتتە	dœlˈættæ
دۆلەتنى	dœlˈætnɪ
دەرىجىسى	dˌæɾɪd͡ʒˈɪsɪ
دەرىجىسىنى	dˌæɾɪd͡ʒɪsˈɪnɪ
دەۋرىدىكى	dˌæwrɪdˈɪkɪ
راست	rˈɑst
رىئايە	rɪˈɑjæ
زىرە	zˈɪɾæ
زىيادە	zɪjˈɑdæ
سۆزلىشىدىغان	sˌœzlɪʃɪdˈɪʁɑn
شىمالىدىكى	ʃˌɪmɑlɪdˈɪkɪ
شۇغۇللانغان	ʃˌuʁullˈɑnʁɑn
شەھەردە	ʃæhˈærdæ
غازى	ʁˈɑzɪ
قاراشقا	qɑɾˈɑʃqɑ
قانۇندا	qɑnˈundɑ
قويۇق	qˈojuq
كىتابلار	kɪtˈɑblɑr
كىتابىدا	kˌɪtɑbˈɪdɑ
كىچىكىدىن	kˌɪt͡ʃɪkˈɪdɪn
كېسەللىك	kesˈællɪk
كەرىم	kˈæɾɪm
كەسكىن	kˈæskɪn
كەينىگە	kæjnˈɪɡæ
كەچۈرۈم	kæt͡ʃˈyɾym
ماقالىنىڭ	mˌɑqɑlˈɪnɪŋ
مىڭدىن	mˈɪŋdɪn
مۇستەھكەم	mustˈæhkæm
مەخپىي	mˈæχpɪj
مەزمۇنلار	mæzmˈunlɑr
مەشرىپى	mæʃrˈɪpɪ
ناھىيەسى	nˌɑhɪjˈæsɪ
نېمىگە	nemˈɪɡæ
نەسىھەت	næsˈɪhæt
نەشرى	nˈæʃrɪ
ياخشىلىق	jɑχʃˈɪlɪq
يولدىن	jˈoldɪn
يولىغا	jolˈɪʁɑ
يىغىن	jˈɪʁɪn
يىلتىزى	jɪltˈɪzɪ
يىلىغا	jɪlˈɪʁɑ
يۇلتۇز	jˈultuz
يېتىدۇ	jetˈɪdu
يېزىقىنى	jˌezɪqˈɪnɪ
يېنىغا	jenˈɪʁɑ
چىققاندىن	t͡ʃɪqqˈɑndɪn
چىقىشقا	t͡ʃɪqˈɪʃqɑ
گەپلەرنى	ɡæplˈærnɪ
گەۋدىلىك	ɡæwdˈɪlɪk
ھاياتلىق	hɑjˈɑtlɪq
ھەممىسىدە	hˌæmmɪsˈɪdæ
ۋىتامىن	wɪtˈɑmɪn
ئالاقىدارلار	ˌɑlɑqɪdˈɑrlɑr
ئالىملارنىڭ	ˌɑlɪmlˈɑrnɪŋ
ئاۋات	ˈɑwɑt
ئاۋام	ˈɑwɑm
ئوقۇغۇچىلارغا	ˌoquʁˌut͡ʃɪlˈɑrʁɑ
ئوقۇيدىغان	ˌoqujdˈɪʁɑn
ئوينىدى	ojnˈɪdɪ
ئىتتىپاقىنىڭ	ˌɪttɪpɑqˈɪnɪŋ
ئىسلامغا	ɪslˈɑmʁɑ
ئىشلارغا	ɪʃlˈɑrʁɑ
ئىشلىتىدىغان	ˌɪʃlɪtɪdˈɪʁɑn
ئىشلەيدىغان	ˌɪʃlæjdˈɪʁɑn
ئىشنىڭ	ˈɪʃnɪŋ
ئىقلىم	ˈɪqlɪm
ئىنسانلارنى	ˌɪnsɑnlˈɑrnɪ
ئۆچ	ˈœt͡ʃ
ئۈچۈنلا	yt͡ʃˈynlɑ
ئېيتقان	ˈejtqɑn
ئەينەن	ˈæjnæn
باشلاش	bˈɑʃlɑʃ
بولالايدۇ	bˌolɑlˈɑjdu
بولىدىكەن	bˌolɪdˈɪkæn
بوۋاي	bˈowɑj
بىنا	bˈɪnɑ
بۇرۇنلا	buɾˈunlɑ
بېگى	bˈeɡɪ
بەنى	bˈænɪ
تاشقىرى	tɑʃqˈɪɾɪ
تاماكا	tɑmˈɑkɑ
توختام	tˈoχtɑm
تۇتىدۇ	tutˈɪdu
تۈركى	tˈyrkɪ
تۈركۈم	tˈyrkym
تەرەپتىكى	tˌæɾæptˈɪkɪ
جىددىي	d͡ʒˈɪddɪj
جىنايەت	d͡ʒɪnˈɑjæt
جىنسىي	d͡ʒˈɪnsɪj
جۈملە	d͡ʒˈymlæ
خوش	χˈoʃ
داستىخانغا	dˌɑstɪχˈɑnʁɑ
دوكلات	dˈoklɑt
دېتال	dˈetɑl
روھ	rˈoh
رېئاللىققا	rˌeɑllˈɪqqɑ
رېمونت	rˈemont
زۇڭتۇڭ	zˈuŋtuŋ
زېمىن	zˈemɪn
سورۇن	sˈoɾun
سەھىھ	sˈæhɪh
شىمالدا	ʃɪmˈɑldɑ
شىنجاڭنىڭ	ʃɪnd͡ʒˈɑŋnɪŋ
شېكەر	ʃˈekær
شەھرىدە	ʃæhrˈɪdæ
غەيرى	ʁˈæjrɪ
قاتارلىقلارنىڭ	qˌɑtɑrlɪqlˈɑrnɪŋ
قاراخانىيلار	qˌɑɾɑχɑnˈɪjlɑr
قارشىلىق	qɑrʃˈɪlɪq
قانۇنسىز	qɑnˈunsɪz
قانۇنغا	qɑnˈunʁɑ
قىسمىدىكى	qˌɪsmɪdˈɪkɪ
قۇرئاندا	quɾˈɑndɑ
قېرىنداش	qeɾˈɪndɑʃ
قېلىشى	qelˈɪʃɪ
كارخانا	kɑrχˈɑnɑ
كاۋاۋىچىن	kˌɑwɑwˈɪt͡ʃɪn
كوچا	kˈot͡ʃɑ
كىيىم	kˈɪjɪm
كېسىلىگە	kˌesɪlˈɪɡæ
كېلىشى	kelˈɪʃɪ
كە	kˈæ
لىنىيىسى	lˌɪnɪjˈɪsɪ
ماكانى	mɑkˈɑnɪ
مالىيە	mɑlˈɪjæ
مانجۇ	mˈɑnd͡ʒu
مودا	mˈodɑ
مۇداپىئە	mˌudɑpˈɪæ
مۇسۇلمانلارغا	mˌusulmɑnlˈɑrʁɑ
مەشغۇلات	mæʃʁˈulɑt
مەكتەپلەردە	mˌæktæplˈærdæ
مەھەللە	mæhˈællæ
نازىل	nˈɑzɪl
نەتىجىلىرى	nˌætɪd͡ʒɪlˈɪɾɪ
نەرسىنىڭ	nærsˈɪnɪŋ
يازغۇچى	jɑzʁˈut͡ʃɪ
ياشاشقا	jɑʃˈɑʃqɑ
يان	jˈɑn
ياڭاق	jˈɑŋɑq
يوللار	jˈollɑr
يىغىپ	jˈɪʁɪp
يىللىرى	jɪllˈɪɾɪ
پات	pˈɑt
پىششىق	pˈɪʃʃɪq
پىشقان	pˈɪʃqɑn
پۇت	pˈut
پەرزەنت	pˈærzænt
چوڭراق	t͡ʃˈoŋrɑq
گۇرۇپپىسى	ɡˌuɾuppˈɪsɪ
ھاراق	hˈɑɾɑq
ھال	hˈɑl
ھىندىستاننىڭ	hˌɪndɪstˈɑnnɪŋ
ھېچكىم	hˈet͡ʃkɪm
ھەقىقەت	hæqˈɪqæt
ۋىلايىتىگە	wˌɪlɑjɪtˈɪɡæ
ۋەتەندىكى	wˌætændˈɪkɪ
ۋەقە	wˈæqæ
ئاتالمىش	ɑtˈɑlmɪʃ
ئاتىلىشى	ˌɑtɪlˈɪʃɪ
ئارىلى	ɑɾˈɪlɪ
ئاسانلا	ɑsˈɑnlɑ
ئاسىيانىڭ	ˌɑsɪjˈɑnɪŋ
ئامىللار	ɑmˈɪllɑr
ئانىنىڭ	ɑnˈɪnɪŋ
ئاپتوماتىك	ˌɑptomˈɑtɪk
ئاچچىق	ˈɑt͡ʃt͡ʃɪq
ئوخشىمايدۇ	ˌoχʃɪmˈɑjdu
ئوقۇتقۇچىلىق	ˌoqutqut͡ʃˈɪlɪq
ئوكيان	ˈokjɑn
ئىتالىيە	ˌɪtɑlˈɪjæ
ئىسلامنىڭ	ɪslˈɑmnɪŋ
ئىشەنچلىك	ɪʃˈænt͡ʃlɪk
ئىلان	ˈɪlɑn
ئىمكانىيىتى	ˌɪmkɑnɪjˈɪtɪ
ئۆزىدە	œzˈɪdæ
ئۆلگەن	ˈœlɡæn
ئۇقتۇرۇش	uqtˈuɾuʃ
ئۇل	ˈul
ئۇلاردا	ulˈɑrdɑ
ئۇچۇرلار	ut͡ʃˈurlɑr
ئۈزۈم	ˈyzym
ئېتنىك	ˈetnɪk
ئېھتىياجلىق	ˌehtɪjˈɑd͡ʒlɪq
ئەسىردىن	æsˈɪrdɪn
ئەكس	ˈæks
ئەنگىلىيە	ˌænɡɪlˈɪjæ
ئەيسا	ˈæjsɑ
ئەييۇب	ˈæjjub
بالىلىرىنى	bˌɑlɪlɪɾˈɪnɪ
باھاسى	bɑhˈɑsɪ
بوز	bˈoz
بولىدىغانلىقى	bˌolɪdˌɪʁɑnlˈɪqɪ
بولۇشىغا	bˌoluʃˈɪʁɑ
بولۇپلا	bolˈuplɑ
بىرخىل	bˈɪrχɪl
بەدىئىي	bædˈɪɪj
تاراتقۇلاردا	tˌɑɾɑtqulˈɑrdɑ
تاماملىغان	tˌɑmɑmlˈɪʁɑn
توپى	tˈopɪ
تۇتاش	tˈutɑʃ
تۇرمۇشىنى	tˌurmuʃˈɪnɪ
تۇيۇقسىز	tujˈuqsɪz
تۈرگە	tˈyrɡæ
تۈزۈلۈشى	tˌyzylˈyʃɪ
تېزلا	tˈezlɑ
تەرغىپ	tˈærʁɪp
تەركىپ	tˈærkɪp
تەرەققىياتىغا	tˌæɾæqqˌɪjɑtˈɪʁɑ
تەشكىلاتنىڭ	tˌæʃkɪlˈɑtnɪŋ
تەمىنلەيدۇ	tˌæmɪnlˈæjdu
تەن	tˈæn
تەنتەربىيە	tˌæntærbˈɪjæ
تەڭرىتاغ	tæŋrˈɪtɑʁ
جاھان	d͡ʒˈɑhɑn
جەرىمانە	d͡ʒˌæɾɪmˈɑnæ
خوتەنىينىڭ	χˌotænˈɪjnɪŋ
خىلدىكى	χɪldˈɪkɪ
خۇشاللىق	χuʃˈɑllɪq
خېرىدار	χeɾˈɪdɑr
خەۋەرلىشىش	χˌæwærlˈɪʃɪʃ
داۋاملاشقان	dˌɑwɑmlˈɑʃqɑn
دىۋان	dˈɪwɑn
دېموكراتىك	dˌemokrˈɑtɪk
روزى	rˈozɪ
رەسىم	rˈæsɪm
زىيا	zˈɪjɑ
زەھەرلىك	zæhˈærlɪk
ساھابىلەر	sˌɑhɑbˈɪlær
سۇدا	sˈudɑ
سۇلايمان	sulˈɑjmɑn
سۈرئىتى	syɾˈɪtɪ
سەپەر	sˈæpær
شۆھرەت	ʃˈœhræt
شېئىرلار	ʃeˈɪrlɑr
شېئىرى	ʃeˈɪɾɪ
شەخسى	ʃˈæχsɪ
شەرتى	ʃˈærtɪ
غەربكىچە	ʁærbkˈɪt͡ʃæ
قاراشلىرىنى	qˌɑɾɑʃlɪɾˈɪnɪ
قاقاس	qˈɑqɑs
قوناق	qˈonɑq
قىزىمنىڭ	qɪzˈɪmnɪŋ
قىلىشىنى	qˌɪlɪʃˈɪnɪ
قۇدرەتلىك	qudrˈætlɪk
قۇرۇلتىيى	qˌuɾultˈɪjɪ
كورىيە	koɾˈɪjæ
كىلىدۇ	kɪlˈɪdu
كۈنلۈك	kˈynlyk
كۈنىگە	kynˈɪɡæ
كېچىسى	ket͡ʃˈɪsɪ
كېچە	kˈet͡ʃæ
كېڭەش	kˈeŋæʃ
كەلتۈرۈلىدۇ	kˌæltyɾylˈɪdu
كەلمەيدۇ	kælmˈæjdu
كەينىدىن	kæjnˈɪdɪn
ماتېرىيال	mˌɑteɾˈɪjɑl
ماددا	mˈɑddɑ
مۇقام	mˈuqɑm
مۇيەسسەر	mujˈæssær
مۇھتاج	mˈuhtɑd͡ʒ
مۇھەممەت	muhˈæmmæt
مەسىلىلەر	mˌæsɪlˈɪlær
مەنىنى	mænˈɪnɪ
مەۋجۇد	mˈæwd͡ʒud
ناۋادا	nɑwˈɑdɑ
ياتقان	jˈɑtqɑn
ياردىمى	jɑrdˈɪmɪ
ياساش	jˈɑsɑʃ
ياپونلۇقلار	jˌɑponlˈuqlɑr
ياۋروپادا	jˌɑwropˈɑdɑ
يەرلەردە	jærlˈærdæ
پائالىيەتلىرى	pˌɑɑlˌɪjætlˈɪɾɪ
پارسچە	pˈɑrst͡ʃæ
پروفېسسور	profˈessor
پۇرچاق	pˈurt͡ʃɑq
پۈتتۈرگەندىن	pˌyttyrɡˈændɪn
چارۋا	t͡ʃˈɑrwɑ
چالغۇ	t͡ʃˈɑlʁu
چىقاردى	t͡ʃɪqˈɑrdɪ
چىقىم	t͡ʃˈɪqɪm
چۈشىدۇ	t͡ʃyʃˈɪdu
چەك	t͡ʃˈæk
ژۇرنىلى	ʒurnˈɪlɪ
ھالال	hˈɑlɑl
ھايۋانلار	hɑjwˈɑnlɑr
ھىجرەت	hˈɪd͡ʒræt
ھىندى	hˈɪndɪ
ھېساپلىنىدۇ	hˌesɑplɪnˈɪdu
ھېكمەت	hˈekmæt
ھەرىكەتكە	hˌæɾɪkˈætkæ
ھەقىقى	hæqˈɪqɪ
ۋەتەندە	wætˈændæ
ئادەملەرنىڭ	ˌɑdæmlˈærnɪŋ
ئارىلىشىپ	ˌɑɾɪlˈɪʃɪp
ئارىلىقتا	ˌɑɾɪlˈɪqtɑ
ئاشكارا	ɑʃkˈɑɾɑ
ئالاقىسى	ˌɑlɑqˈɪsɪ
ئامراق	ˈɑmrɑq
ئايرىلىدۇ	ˌɑjrɪlˈɪdu
ئاھالىسى	ˌɑhɑlˈɪsɪ
ئاۋازى	ɑwˈɑzɪ
ئوتلاق	ˈotlɑq
ئوخشىشىپ	oχʃˈɪʃɪp
ئولتۇراقلاشقان	ˌoltuɾɑqlˈɑʃqɑn
ئويۇنغا	ojˈunʁɑ
ئىدارىسىنىڭ	ˌɪdɑɾɪsˈɪnɪŋ
ئىزدەش	ˈɪzdæʃ
ئىسپاتلاپ	ɪspˈɑtlɑp
ئۆتكەندىن	œtkˈændɪn
ئۆزلىرىنى	ˌœzlɪɾˈɪnɪ
ئۆلچىمى	œlt͡ʃˈɪmɪ
ئۇچۇپ	ˈut͡ʃup
ئېرىشىدۇ	ˌeɾɪʃˈɪdu
ئېقىپ	ˈeqɪp
ئەزالىرىنىڭ	ˌæzɑlɪɾˈɪnɪŋ
ئەسلىي	ˈæslɪj
ئەللىرىدە	ˌællɪɾˈɪdæ
ئەلىشىر	ælˈɪʃɪr
ئەينەك	ˈæjnæk
ئەھۋالىغا	ˌæhwɑlˈɪʁɑ
ئەۋلادى	æwlˈɑdɪ
بالىنى	bɑlˈɪnɪ
بولغانلىقىنى	bˌolʁɑnlɪqˈɪnɪ
بولماسلىقى	bˌolmɑslˈɪqɪ
بولمىدى	bolmˈɪdɪ
بولۇشتىن	bolˈuʃtɪn
بوپتۇ	bˈoptu
بىرقەدەر	bɪrqˈædær
بىرىدە	bɪɾˈɪdæ
بىلگە	bˈɪlɡæ
بۇقا	bˈuqɑ
بۇلاق	bˈulɑq
تاشيولى	tɑʃjˈolɪ
تاقابىل	tɑqˈɑbɪl
تالاش	tˈɑlɑʃ
توپلىمى	toplˈɪmɪ
تىزىمغا	tɪzˈɪmʁɑ
تۇيغۇسى	tujʁˈusɪ
تېمپېراتۇرا	tˌempeɾɑtˈuɾɑ
تەتقىقاتچى	tˌætqɪqˈɑtt͡ʃɪ
تەختكە	tˈæχtkæ
تەقدىم	tˈæqdɪm
تەكرار	tˈækrɑr
تەۋسىيە	tæwsˈɪjæ
جايلىرىدا	d͡ʒˌɑjlɪɾˈɪdɑ
جىسمانىي	d͡ʒɪsmˈɑnɪj
جۇغراپىيىلىك	d͡ʒˌuʁrɑpɪjˈɪlɪk
جۈمە	d͡ʒˈymæ
خاننىڭ	χˈɑnnɪŋ
خەلقلەرنىڭ	χælqlˈærnɪŋ
خەۋەرلەر	χæwˈærlær
داستان	dˈɑstɑn
دوستى	dˈostɪ
دىنغا	dˈɪnʁɑ
دىگەندەك	dɪɡˈændæk
دېھقان	dˈehqɑn
دەپتۇ	dˈæptu
رادىئو	rɑdˈɪo
رادىيو	rɑdˈɪjo
رومان	rˈomɑn
زىيالىي	zɪjˈɑlɪj
زەيدىن	zˈæjdɪn
ساھە	sˈɑhæ
سوزۇلغان	sozˈulʁɑn
سىتاتىسكىگا	sˌɪtɑtɪskˈɪɡɑ
سىرتقا	sˈɪrtqɑ
سىرتىدىكى	sˌɪrtɪdˈɪkɪ
سىناق	sˈɪnɑq
سېتىش	sˈetɪʃ
سېپىل	sˈepɪl
سەۋەبتىن	sæwˈæbtɪn
سەۋەپ	sˈæwæp
شارائىتتا	ʃˌɑɾɑˈɪttɑ
شەخسلەر	ʃˈæχslær
غول	ʁˈol
فاتىمە	fɑtˈɪmæ
قاتناشتى	qɑtnˈɑʃtɪ
قارايتتى	qɑɾˈɑjttɪ
قارىتىپ	qɑɾˈɪtɪp
قارىمۇچ	qɑɾˈɪmut͡ʃ
قانلىق	qˈɑnlɪq
قانۇنىيىتى	qˌɑnunɪjˈɪtɪ
قوللىنىش	qollˈɪnɪʃ
قولىنى	qolˈɪnɪ
قويدۇم	qˈojdum
قىرغىز	qˈɪrʁɪz
قىسىمى	qɪsˈɪmɪ
قىلدۇرۇش	qɪldˈuɾuʃ
قىلغۇچ	qˈɪlʁut͡ʃ
قۇتلۇق	qˈutluq
قۇلاق	qˈulɑq
قۇياشنىڭ	qujˈɑʃnɪŋ
قەشقەرنىڭ	qæʃqˈærnɪŋ
كاتولىك	kɑtˈolɪk
كۆرسىتىلگەن	kˌœrsɪtˈɪlɡæn
كېسىلى	kesˈɪlɪ
كەسپىگە	kæspˈɪɡæ
كەلتۈردى	kæltˈyrdɪ
كەمسىتىش	kæmsˈɪtɪʃ
كەڭلىك	kˈæŋlɪk
مالىك	mˈɑlɪk
ماڭغان	mˈɑŋʁɑn
مۇخبىر	mˈuχbɪr
مۇنچە	mˈunt͡ʃæ
نۇقتا	nˈuqtɑ
يادرو	jˈɑdro
يوقىرى	joqˈɪɾɪ
يولنى	jˈolnɪ
يۇرتى	jˈurtɪ
يۈرۈپ	jˈyɾyp
يېتىش	jˈetɪʃ
پاكىت	pˈɑkɪt
پۇلنى	pˈulnɪ
چىنە	t͡ʃˈɪnæ
گۇرۇپپا	ɡuɾˈuppɑ
ھازىرغا	hɑzˈɪrʁɑ
ھالىتىدە	hˌɑlɪtˈɪdæ
ھەسەن	hˈæsæn
ۋاقىتتىن	wɑqˈɪttɪn
ئابدۇشۈكۈر	ˌɑbduʃˈykyr
ئاسمان	ˈɑsmɑn
ئاسىيادا	ˌɑsɪjˈɑdɑ
ئانىسىنىڭ	ˌɑnɪsˈɪnɪŋ
ئاپتوموبىل	ˌɑptomˈobɪl
ئو	ˈo
ئورخۇن	ˈorχun
ئوغلىنىڭ	oʁlˈɪnɪŋ
ئومۇمى	omˈumɪ
ئويۇننى	ojˈunnɪ
ئىككىنجى	ɪkkˈɪnd͡ʒɪ
ئىمتىھان	ɪmtˈɪhɑn
ئىنتېرنېت	ɪntˈernet
ئىنسانىيەتنىڭ	ˌɪnsɑnɪjˈætnɪŋ
ئىنگىلىزچە	ˌɪnɡɪlˈɪzt͡ʃæ
ئىگىلىكى	ˌɪɡɪlˈɪkɪ
ئۆتۈنۈپ	œtˈynyp
ئۆزلىرىگە	ˌœzlɪɾˈɪɡæ
ئۆزگەرتىلگەن	ˌœzɡærtˈɪlɡæn
ئۆستۈرۈش	œstˈyɾyʃ
ئۆيدىن	ˈœjdɪn
ئۇيغۇرچىغا	ˌujʁurt͡ʃˈɪʁɑ
ئۈزۈك	ˈyzyk
ئېلىشنى	elˈɪʃnɪ
ئېلىنىدۇ	ˌelɪnˈɪdu
ئەرەپ	ˈæɾæp
ئەسەرلىرىدە	ˌæsærlɪɾˈɪdæ
ئەلگە	ˈælɡæ
ئەنگلىيە	ænɡlˈɪjæ
باشقىلاردىن	bˌɑʃqɪlˈɑrdɪn
بالام	bˈɑlɑm
بايقىغان	bɑjqˈɪʁɑn
بايلىق	bˈɑjlɪq
بوش	bˈoʃ
بولماقتا	bolmˈɑqtɑ
بىراقلا	bɪɾˈɑqlɑ
بىرنەچچە	bɪrnˈæt͡ʃt͡ʃæ
بېرىلدى	beɾˈɪldɪ
بېرىلىدىغان	bˌeɾɪlɪdˈɪʁɑn
بېرىپتۇ	beɾˈɪptu
بېرەتتى	beɾˈættɪ
بېسىلغان	besˈɪlʁɑn
بېكىتىپ	bekˈɪtɪp
بەخت	bˈæχt
بەل	bˈæl
تام	tˈɑm
توختىتىپ	toχtˈɪtɪp
تونۇشتۇرۇپ	tˌonuʃtˈuɾup
توپلىغان	toplˈɪʁɑn
تىلدىكى	tɪldˈɪkɪ
تىنچلىق	tˈɪnt͡ʃlɪq
تۆگە	tˈœɡæ
تۆۋەنگە	tœwˈænɡæ
تۇرسۇن	tˈursun
تۇرغۇن	tˈurʁun
تۇپراق	tˈuprɑq
تېپىلغان	tepˈɪlʁɑn
تەبىئى	tæbˈɪɪ
تەتقىقاتچىلار	tˌætqɪqɑtt͡ʃˈɪlɑr
تەركىبى	tærkˈɪbɪ
تەلىپى	tælˈɪpɪ
جاپالىق	d͡ʒɑpˈɑlɪq
جاۋابكار	d͡ʒɑwˈɑbkɑr
جەلپ	d͡ʒˈælp
جەمئىيەتتىكى	d͡ʒˌæmɪjættˈɪkɪ
جەمئىيەتكە	d͡ʒˌæmɪjˈætkæ
خېمىر	χˈemɪr
داۋاملىشىپ	dˌɑwɑmlˈɪʃɪp
دېيىش	dˈejɪʃ
دەرسلىك	dˈærslɪk
دەۋردىكى	dæwrdˈɪkɪ
رەسۇلۇللاھنىڭ	rˌæsulullˈɑhnɪŋ
زىيانلىق	zɪjˈɑnlɪq
سامساق	sˈɑmsɑq
ساھەلەردە	sˌɑhælˈærdæ
سوققان	sˈoqqɑn
سىرت	sˈɪrt
سۆزلىرى	sœzlˈɪɾɪ
سۆيگۈ	sˈœjɡy
سېسىق	sˈesɪq
سېلىنغان	selˈɪnʁɑn
سەمىمىي	sæmˈɪmɪj
سەپ	sˈæp
شەكىلدىكى	ʃˌækɪldˈɪkɪ
شەھەرنى	ʃæhˈærnɪ
غەلىتە	ʁælˈɪtæ
قاتلام	qˈɑtlɑm
قاتنىشىپ	qɑtnˈɪʃɪp
قاراشلىرى	qˌɑɾɑʃlˈɪɾɪ
قارمىقىدا	qˌɑrmɪqˈɪdɑ
قويىدىغان	qˌojɪdˈɪʁɑn
قويۇشقا	qojˈuʃqɑ
قىلىنىش	qɪlˈɪnɪʃ
قەبىلىسىنىڭ	qˌæbɪlɪsˈɪnɪŋ
قەدىمقى	qædˈɪmqɪ
قەلئە	qˈælæ
كىتابلارنى	kˌɪtɑblˈɑrnɪ
كىرىش	kˈɪɾɪʃ
كىشىدىن	kɪʃˈɪdɪn
كىمنىڭ	kˈɪmnɪŋ
كۆرىدىغان	kˌœɾɪdˈɪʁɑn
كۆچمەن	kˈœt͡ʃmæn
كېيىنمۇ	kejˈɪnmu
كەنتى	kˈæntɪ
ماقالىنى	mˌɑqɑlˈɪnɪ
مۇئەللىم	muˈællɪm
مۇبارەك	mubˈɑɾæk
مەشغۇل	mˈæʃʁul
مەكتەپتىكى	mˌæktæptˈɪkɪ
مەنبەسىنى	mˌænbæsˈɪnɪ
مەنىۋىي	mænˈɪwɪj
نوبېل	nˈobel
ياردەمچى	jɑrdˈæmt͡ʃɪ
ياز	jˈɑz
يازىدۇ	jɑzˈɪdu
ياسىغان	jɑsˈɪʁɑn
ياشلارنىڭ	jɑʃlˈɑrnɪŋ
ياشلىرى	jɑʃlˈɪɾɪ
ياغاچتىن	jɑʁˈɑt͡ʃtɪn
يوقاپ	jˈoqɑp
يوپۇرمىقى	jˌopurmˈɪqɪ
يىغىندا	jɪʁˈɪndɑ
يىپ	jˈɪp
يۇقۇرى	juqˈuɾɪ
يۇڭ	jˈuŋ
يۈزىسىدىن	jˌyzɪsˈɪdɪn
يېرىدە	jeɾˈɪdæ
يەككە	jˈækkæ
پائال	pˈɑɑl
پادىشاھى	pˌɑdɪʃˈɑhɪ
پايدىسى	pɑjdˈɪsɪ
پۇرسىتىگە	pˌursɪtˈɪɡæ
چىقىرىشقا	t͡ʃˌɪqɪɾˈɪʃqɑ
چەكلەنگەن	t͡ʃæklˈænɡæn
گۇمان	ɡˈumɑn
گەۋدە	ɡˈæwdæ
ھەرىپى	hæɾˈɪpɪ
ھەمىشە	hæmˈɪʃæ
ئارىدىن	ɑɾˈɪdɪn
ئاشقان	ˈɑʃqɑn
ئالماشتۇرۇش	ˌɑlmɑʃtˈuɾuʃ
ئاۋال	ˈɑwɑl
ئوزۇقلۇق	ozˈuqluq
ئوقۇتقۇچىسى	ˌoqutqut͡ʃˈɪsɪ
ئوقۇرمەنلەرنىڭ	ˌoqurmænlˈærnɪŋ
ئويناپ	ˈojnɑp
ئوۋ	ˈow
ئىجازەت	ɪd͡ʒˈɑzæt
ئىسلامنى	ɪslˈɑmnɪ
ئىسپانىيە	ˌɪspɑnˈɪjæ
ئىشچىلار	ɪʃt͡ʃˈɪlɑr
ئىقتىدارىغا	ˌɪqtɪdɑɾˈɪʁɑ
ئىلاھ	ˈɪlɑh
ئىنسانلارغا	ˌɪnsɑnlˈɑrʁɑ
ئىپادىلىنىدۇ	ˌɪpɑdˌɪlɪnˈɪdu
ئۆگىنىشكە	ˌœɡɪnˈɪʃkæ
ئۇرۇشقا	uɾˈuʃqɑ
ئۇستازى	ustˈɑzɪ
ئۇشبۇ	ˈuʃbu
ئۇقۇمى	uqˈumɪ
ئۇمۇ	ˈumu
ئۇيغۇرغا	ujʁˈurʁɑ
ئۈرۈمچىگە	ˌyɾymt͡ʃˈɪɡæ
ئەزەلدىن	æzˈældɪn
ئەسكەرلىرى	ˌæskærlˈɪɾɪ
ئەسەردە	æsˈærdæ
بارىن	bˈɑɾɪn
باشلاپلا	bɑʃlˈɑplɑ
بولسام	bˈolsɑm
بولمىش	bˈolmɪʃ
بىرلەشكەن	bɪrlˈæʃkæn
بىرىش	bˈɪɾɪʃ
بىلەنمۇ	bɪlˈænmu
بۆلۈنگەن	bœlˈynɡæn
بېلىق	bˈelɪq
توپنى	tˈopnɪ
تىرىشىپ	tɪɾˈɪʃɪp
تۇرماقتا	turmˈɑqtɑ
تۈركىيەدىكى	tˌyrkɪjædˈɪkɪ
تۈرمىگە	tyrmˈɪɡæ
تۈز	tˈyz
تۈزۈش	tˈyzyʃ
تۈزۈم	tˈyzym
تەبلىغ	tˈæblɪʁ
تەرەپنى	tæɾˈæpnɪ
تەقۋىم	tˈæqwɪm
تەڭگە	tˈæŋɡæ
جايلاخكان	d͡ʒɑjlˈɑχkɑn
جايلار	d͡ʒˈɑjlɑr
جىنايەتنى	d͡ʒˌɪnɑjˈætnɪ
جەم	d͡ʒˈæm
خوتۇن	χˈotun
خەلقىمىزنىڭ	χˌælqɪmˈɪznɪŋ
دادىسىغا	dˌɑdɪsˈɪʁɑ
داستىخان	dɑstˈɪχɑn
داۋامىدا	dˌɑwɑmˈɪdɑ
دوستۇم	dˈostum
دۆلىتىنى	dˌœlɪtˈɪnɪ
دۆلىتىگە	dˌœlɪtˈɪɡæ
دۇئا	dˈuɑ
دۇنياسى	dunjˈɑsɪ
دەۋرىنىڭ	dæwrˈɪnɪŋ
زاماندىكى	zˌɑmɑndˈɪkɪ
زامانلاردا	zˌɑmɑnlˈɑrdɑ
سالدى	sˈɑldɪ
سالىدۇ	sɑlˈɪdu
ساھابە	sɑhˈɑbæ
سىر	sˈɪr
سىلەرنىڭ	sɪlˈærnɪŋ
سۆزلەيدىغان	sˌœzlæjdˈɪʁɑn
سۈپەتلىك	sypˈætlɪk
سېتىپ	sˈetɪp
شىركەتلەر	ʃɪrkˈætlær
شېھىت	ʃˈehɪt
شەھىرىدىكى	ʃˌæhɪɾɪdˈɪkɪ
غەلبە	ʁˈælbæ
قاتارلىقلاردىن	qˌɑtɑrlɪqlˈɑrdɪn
قاراڭغۇ	qɑɾˈɑŋʁu
قالىدىغان	qˌɑlɪdˈɪʁɑn
قوراللىق	qoɾˈɑllɪq
قىلدۇرغان	qɪldˈurʁɑn
قىلغانلىقىنى	qˌɪlʁɑnlɪqˈɪnɪ
قىلغانىدى	qˌɪlʁɑnˈɪdɪ
قىلىنماقتا	qˌɪlɪnmˈɑqtɑ
قىلىۋاتىدۇ	qˌɪlɪwɑtˈɪdu
قىلچە	qˈɪlt͡ʃæ
قىيما	qˈɪjmɑ
قۇتۇلۇش	qutˈuluʃ
قۇردى	qˈurdɪ
قۇرۇلدى	quɾˈuldɪ
قۇرۇلما	quɾˈulmɑ
قەدىمدىن	qædˈɪmdɪn
كومىتېت	komˈɪtet
كىلومەتەر	kˌɪlomˈætær
كىملىكىنى	kˌɪmlɪkˈɪnɪ
كۆرسەتتى	kœrsˈættɪ
كۆلەمدە	kœlˈæmdæ
كۆپلەپ	kˈœplæp
كۆپچىلىك	kœpt͡ʃˈɪlɪk
كېرەكلىكىنى	kˌeɾæklɪkˈɪnɪ
كەلتۈرۈلگەن	kˌæltyɾˈylɡæn
ماددىلارنى	mˌɑddɪlˈɑrnɪ
ماكان	mˈɑkɑn
مايسا	mˈɑjsɑ
مايىل	mˈɑjɪl
موڭغۇللارنىڭ	mˌoŋʁullˈɑrnɪŋ
مىس	mˈɪs
مىكرو	mˈɪkro
مىللەتچىلىك	mˌɪllætt͡ʃˈɪlɪk
مۇدىر	mˈudɪr
مۇرات	mˈuɾɑt
مېھمان	mˈehmɑn
مەدىنىگە	mˌædɪnˈɪɡæ
مەدىنە	mædˈɪnæ
مەزمۇنلارنى	mˌæzmunlˈɑrnɪ
مەسئۇلىيەت	mˌæsulˈɪjæt
مەقسىتى	mæqsˈɪtɪ
مەكتەپلەر	mæktˈæplær
مەككە	mˈækkæ
مەھسۇلى	mæhsˈulɪ
نامىزى	nɑmˈɪzɪ
ناھىيىگە	nˌɑhɪjˈɪɡæ
نومۇرى	nomˈuɾɪ
نەرسىگە	nærsˈɪɡæ
نەزەرىيە	nˌæzæɾˈɪjæ
ياشلارغا	jɑʃlˈɑrʁɑ
يولىدىكى	jˌolɪdˈɪkɪ
يولىنىڭ	jolˈɪnɪŋ
يېتىشىپ	jetˈɪʃɪp
يېرىگە	jeɾˈɪɡæ
يېزىقنى	jezˈɪqnɪ
يېزىلىق	jezˈɪlɪq
يەكەن	jˈækæn
يەھۇدىيلار	jˌæhudˈɪjlɑr
پائالىيەتلىرىنى	pˌɑɑlˌɪjætlɪɾˈɪnɪ
پاختا	pˈɑχtɑ
پارىژ	pˈɑɾɪʒ
پېتى	pˈetɪ
چاقچاق	t͡ʃˈɑqt͡ʃɑq
چامغۇر	t͡ʃˈɑmʁur
چۈشەندۈرۈپ	t͡ʃˌyʃændˈyɾyp
چېكى	t͡ʃˈekɪ
گوۋۇيۈەن	ɡˌowujˈyæn
گۈرۈچ	ɡˈyɾyt͡ʃ
ھاكىمىيىتى	hˌɑkɪmɪjˈɪtɪ
ھايۋانلارنىڭ	hˌɑjwɑnlˈɑrnɪŋ
ھىساپلىنىدۇ	hˌɪsɑplɪnˈɪdu
ھېسابلاش	hesˈɑblɑʃ
ھەددىدىن	hæddˈɪdɪn
ھەرىكىتىنى	hˌæɾɪkɪtˈɪnɪ
ھەقىقەتنى	hˌæqɪqˈætnɪ
ۋاقتىنى	wɑqtˈɪnɪ
ۋاقىتنى	wɑqˈɪtnɪ
ئائىلىدە	ˌɑɪlˈɪdæ
ئائىلىگە	ˌɑɪlˈɪɡæ
ئاتوم	ˈɑtom
ئاجرىتىپ	ɑd͡ʒrˈɪtɪp
ئادەملەرنى	ˌɑdæmlˈærnɪ
ئارام	ˈɑɾɑm
ئايالىم	ɑjˈɑlɪm
ئوتاق	ˈotɑq
ئوخشىمايدىغان	ˌoχʃɪmɑjdˈɪʁɑn
ئويمانلىقىنىڭ	ˌojmɑnlɪqˈɪnɪŋ
ئىتتىپاق	ɪttˈɪpɑq
ئىستىمال	ɪstˈɪmɑl
ئىسلامىي	ɪslˈɑmɪj
ئىشلەتكۈچى	ˌɪʃlætkˈyt͡ʃɪ
ئىپادىلەش	ˌɪpɑdˈɪlæʃ
ئۆزىمىزنى	ˌœzɪmˈɪznɪ
ئۆزىمىزگە	ˌœzɪmˈɪzɡæ
ئۆلچەملىك	œlt͡ʃˈæmlɪk
ئۇرۇشتىن	uɾˈuʃtɪn
ئۇيغۇرلاردىن	ˌujʁurlˈɑrdɪn
ئېلخەت	ˈelχæt
ئېلىنىپ	elˈɪnɪp
ئېنگىلىزچە	ˌenɡɪlˈɪzt͡ʃæ
ئېھتىياجى	ˌehtɪjˈɑd͡ʒɪ
ئە	ˈæ
ئەتراپلىق	ætrˈɑplɪq
ئەخلاقى	æχlˈɑqɪ
ئەلچى	ˈælt͡ʃɪ
ئەمدىلا	æmdˈɪlɑ
ئەمەسلىكىنى	ˌæmæslɪkˈɪnɪ
ئەنئەنىسى	ˌænænˈɪsɪ
ئەپ	ˈæp
باشتا	bˈɑʃtɑ
باشقۇرغۇچى	bˌɑʃqurʁˈut͡ʃɪ
بايراق	bˈɑjrɑq
بولالمايدۇ	bˌolɑlmˈɑjdu
بولساق	bˈolsɑq
بولغىنى	bolʁˈɪnɪ
بولىمىز	bolˈɪmɪz
بولۇپتۇ	bolˈuptu
بىرقانچە	bɪrqˈɑnt͡ʃæ
بىزدىكى	bɪzdˈɪkɪ
بىناكارلىق	bˌɪnɑkˈɑrlɪq
بىڭتۇەنى	bˌɪŋtuˈænɪ
بۆلۈنۈپ	bœlˈynyp
بۇيىچە	bujˈɪt͡ʃæ
بېرىۋاتقان	bˌeɾɪwˈɑtqɑn
بەدىنى	bædˈɪnɪ
بەلگە	bˈælɡæ
تامغا	tˈɑmʁɑ
توختىلىپ	toχtˈɪlɪp
توغرۇلۇق	toʁrˈuluq
تۈركىيەنىڭ	tˌyrkɪjˈænɪŋ
تېمىسى	temˈɪsɪ
تەرجىمىسى	tˌærd͡ʒɪmˈɪsɪ
تەزكىرىسى	tˌæzkɪɾˈɪsɪ
تەقلىد	tˈæqlɪd
تەكشۈرۈپ	tækʃˈyɾyp
تەلىپىنى	tˌælɪpˈɪnɪ
تەييارلانغان	tˌæjjɑrlˈɑnʁɑn
تەييارلاپ	tæjjˈɑrlɑp
تەھدىت	tˈæhdɪt
جايلاردىكى	d͡ʒˌɑjlɑrdˈɪkɪ
جوڭگۇ	d͡ʒˈoŋɡu
جۇغراپىيە	d͡ʒˌuʁrɑpˈɪjæ
خاتالىق	χɑtˈɑlɪq
خاتىرىلەنگەن	χˌɑtɪɾɪlˈænɡæn
خانى	χˈɑnɪ
خەلقىگە	χælqˈɪɡæ
خەلىق	χˈælɪq
دائىرىدە	dˌɑɪɾˈɪdæ
دولقۇنى	dolqˈunɪ
دىئابېت	dɪˈɑbet
دۆلەتكە	dœlˈætkæ
دۆلەتلىرى	dˌœlætlˈɪɾɪ
دۆلەتلەردە	dˌœlætlˈærdæ
دېمەكتۇر	demˈæktur
دېگەنگە	deɡˈænɡæ
رايوندا	rɑjˈondɑ
رايونلاردا	rˌɑjonlˈɑrdɑ
رايوننىڭ	rɑjˈonnɪŋ
راۋان	rˈɑwɑn
روھىنى	rohˈɪnɪ
رەھبىرى	ræhbˈɪɾɪ
زىيالىيلار	zˌɪjɑlˈɪjlɑr
ساقلانغان	sɑqlˈɑnʁɑn
سالىھ	sˈɑlɪh
سامان	sˈɑmɑn
سۆزلىگەن	sœzlˈɪɡæn
سۈرە	sˈyɾæ
سۈننەت	sˈynnæt
سەندىن	sˈændɪn
شارائىتى	ʃˌɑɾɑˈɪtɪ
شارى	ʃˈɑɾɪ
شام	ʃˈɑm
شىنجاڭغا	ʃɪnd͡ʒˈɑŋʁɑ
شەخىس	ʃˈæχɪs
غەيرىي	ʁˈæjrɪj
فرانسىيە	frɑnsˈɪjæ
ق	q
قارالغان	qɑɾˈɑlʁɑn
قارلىق	qˈɑrlɪq
قارىشىنى	qˌɑɾɪʃˈɪnɪ
قالدۇردى	qɑldˈurdɪ
قالمىدى	qɑlmˈɪdɪ
قورقۇپ	qˈorqup
قوشۇلغان	qoʃˈulʁɑn
قىلالمايدۇ	qˌɪlɑlmˈɑjdu
قىلدۇق	qˈɪlduq
قىلىسىز	qɪlˈɪsɪz
قىلىشتىكى	qˌɪlɪʃtˈɪkɪ
قىلىنغاندىن	qˌɪlɪnʁˈɑndɪn
قۇرامىغا	qˌuɾɑmˈɪʁɑ
قەبىلىسى	qˌæbɪlˈɪsɪ
قەلەم	qˈælæm
كونكرېت	kˈonkret
كىتابىنى	kˌɪtɑbˈɪnɪ
كىملىك	kˈɪmlɪk
كۆتۈرۈلگەن	kˌœtyɾˈylɡæn
كۆرسىتىدىغان	kˌœrsɪtɪdˈɪʁɑn
كۆزىتىش	kœzˈɪtɪʃ
كۆلى	kˈœlɪ
كۆچمە	kˈœt͡ʃmæ
كۆڭلى	kˈœŋlɪ
كېسەك	kˈesæk
كەتمەيدۇ	kætmˈæjdu
كەلتۈرىدۇ	kˌæltyɾˈɪdu
كەلگەنلىكىنى	kˌælɡænlɪkˈɪnɪ
ماقالىدە	mˌɑqɑlˈɪdæ
مۈمكىن	mˈymkɪn
مەكتەپتىن	mæktˈæptɪn
مەنىلىك	mænˈɪlɪk
مەپتۇن	mˈæptun
مەھمۇت	mˈæhmut
نوچى	nˈot͡ʃɪ
نىياز	nˈɪjɑz
يارىتىلغان	jˌɑɾɪtˈɪlʁɑn
ياشتىن	jˈɑʃtɪn
يوپۇرماق	jopˈurmɑq
يىغىنىدا	jˌɪʁɪnˈɪdɑ
يىلغا	jˈɪlʁɑ
يىلىغىچە	jˌɪlɪʁˈɪt͡ʃæ
يېزىلىشى	jˌezɪlˈɪʃɪ
يەتتى	jˈættɪ
يەتكۈزۈش	jætkˈyzyʃ
پروگرامما	proɡrˈɑmmɑ
پىسخىك	pˈɪsχɪk
پىلان	pˈɪlɑn
پەيغەمبەرنىڭ	pˌæjʁæmbˈærnɪŋ
چارە	t͡ʃˈɑɾæ
ھايۋانات	hɑjwˈɑnɑt
ھۆكۈمەتكە	hˌœkymˈætkæ
ھەدىسلەرنى	hˌædɪslˈærnɪ
ھەرپ	hˈærp
ھەقىقەتەنمۇ	hˌæqɪqætˈænmu
ھەمكارلىق	hæmkˈɑrlɪq
ۋىلايىتىنىڭ	wˌɪlɑjɪtˈɪnɪŋ
ۋىلايەتلىك	wˌɪlɑjˈætlɪk
ئاتۇش	ˈɑtuʃ
ئاخىرلىشىدۇ	ˌɑχɪrlɪʃˈɪdu
ئادالەت	ɑdˈɑlæt
ئاددى	ˈɑddɪ
ئارىسىدىن	ˌɑɾɪsˈɪdɪn
ئازاد	ˈɑzɑd
ئاساسىنى	ˌɑsɑsˈɪnɪ
ئاشىق	ˈɑʃɪq
ئاشۇرۇپ	ɑʃˈuɾup
ئالدىراش	ɑldˈɪɾɑʃ
ئايروپىلانى	ˌɑjropɪlˈɑnɪ
ئايكۆل	ˈɑjkœl
ئايلىق	ˈɑjlɪq
ئاپتونومىيىلىك	ˌɑptonˌomɪjˈɪlɪk
ئوتتۇز	ˈottuz
ئورمان	ˈormɑn
ئورۇنلىرى	ˌoɾunlˈɪɾɪ
ئوقۇشى	oqˈuʃɪ
ئويلايمەن	ojlˈɑjmæn
ئىسا	ˈɪsɑ
ئىسرائىل	ɪsrˈɑɪl
ئىسلاھ	ˈɪslɑh
ئىسلاھات	ɪslˈɑhɑt
ئىشلىدى	ɪʃlˈɪdɪ
ئىشىك	ˈɪʃɪk
ئىمىن	ˈɪmɪn
ئىنساننى	ɪnsˈɑnnɪ
ئىنقىلاب	ɪnqˈɪlɑb
ئۆزلۈكىدىن	ˌœzlykˈɪdɪn
ئۆزىمىز	œzˈɪmɪz
ئۆلكىلىك	œlkˈɪlɪk
ئۇدا	ˈudɑ
ئۇنتۇپ	ˈuntup
ئۇچىغا	ut͡ʃˈɪʁɑ
ئۈزىنى	yzˈɪnɪ
ئۈنۈمى	ynˈymɪ
ئېرىشىپ	eɾˈɪʃɪp
ئېنېرگىيە	ˌenerɡˈɪjæ
ئېيتىلغان	ejtˈɪlʁɑn
ئەجدادلىرىمىز	ˌæd͡ʒdɑdlɪɾˈɪmɪz
ئەزالىرىنى	ˌæzɑlɪɾˈɪnɪ
ئەستايىدىل	ˌæstɑjˈɪdɪl
ئەسىردە	æsˈɪrdæ
ئەھۋاللار	æhwˈɑllɑr
ئەۋلادلىرى	ˌæwlɑdlˈɪɾɪ
بارغاندىن	bɑrʁˈɑndɪn
باشچىلىقىدىكى	bˌɑʃt͡ʃɪlˌɪqɪdˈɪkɪ
بانكا	bˈɑnkɑ
باھالاش	bɑhˈɑlɑʃ
بولغۇچى	bolʁˈut͡ʃɪ
بويىغا	bojˈɪʁɑ
بىلمەيدىغان	bˌɪlmæjdˈɪʁɑn
بۆلۈم	bˈœlym
بېكىتىلگەن	bˌekɪtˈɪlɡæn
بەردىم	bˈærdɪm
بەرگۈچى	bærɡˈyt͡ʃɪ
تارماقتا	tɑrmˈɑqtɑ
تاشكەنت	tˈɑʃkænt
تايانغان	tɑjˈɑnʁɑn
توغۇلغان	toʁˈulʁɑn
تىببىي	tˈɪbbɪj
تىپى	tˈɪpɪ
تۇل	tˈul
تۈرتكە	tˈyrtkæ
تۈردىكى	tyrdˈɪkɪ
تۈزگەن	tˈyzɡæn
تېرىسى	teɾˈɪsɪ
تەبئىي	tˈæbɪj
تەدبىر	tˈædbɪr
تەكلىماكان	tˌæklɪmˈɑkɑn
تەمى	tˈæmɪ
تەمىنلىگەن	tˌæmɪnlˈɪɡæn
تەيىنلەنگەن	tˌæjɪnlˈænɡæn
تەييارلىغان	tˌæjjɑrlˈɪʁɑn
جايلارنىڭ	d͡ʒɑjlˈɑrnɪŋ
جۇڭگودىكى	d͡ʒˌuŋɡodˈɪkɪ
جەمەت	d͡ʒˈæmæt
جەھەتلەردە	d͡ʒˌæhætlˈærdæ
خادىم	χˈɑdɪm
خادىملىرى	χˌɑdɪmlˈɪɾɪ
خاراكتېرى	χˌɑɾɑktˈeɾɪ
خىزمەتلەرنى	χˌɪzmætlˈærnɪ
خەلقىنى	χælqˈɪnɪ
خەۋپسىزلىكى	χˌæwpsɪzlˈɪkɪ
دوستلۇق	dˈostluq
دېرەك	dˈeɾæk
دېسە	dˈesæ
دېگەننى	deɡˈænnɪ
دەۋرنىڭ	dˈæwrnɪŋ
دەۋرىگە	dæwrˈɪɡæ
روھىغا	rohˈɪʁɑ
رېئال	rˈeɑl
رەئىس	rˈæɪs
زىيالىلار	zˌɪjɑlˈɪlɑr
زۇلۇم	zˈulum
زەنجىۋىل	zænd͡ʒˈɪwɪl
ساقلانماقتا	sˌɑqlɑnmˈɑqtɑ
ساقلىنىش	sɑqlˈɪnɪʃ
سالام	sˈɑlɑm
سوئالغا	soˈɑlʁɑ
سوتسىيالىستىك	sˌotsɪjɑlˈɪstɪk
سىزىلغان	sɪzˈɪlʁɑn
سىستېما	sɪstˈemɑ
سىڭدۈرمە	sɪŋdˈyrmæ
سۆزىنى	sœzˈɪnɪ
سۆزىنىڭ	sœzˈɪnɪŋ
سۆڭەك	sˈœŋæk
سۇڭ	sˈuŋ
سۈرگۈن	sˈyrɡyn
سۈپەت	sˈypæt
سېستىمىسى	sˌestɪmˈɪsɪ
سېلىشتۇرۇپ	sˌelɪʃtˈuɾup
سەنئىتى	sænˈɪtɪ
شائىرنىڭ	ʃɑˈɪrnɪŋ
شائىرى	ʃɑˈɪɾɪ
شامال	ʃˈɑmɑl
شۇنداقتىمۇ	ʃˌundɑqtˈɪmu
غەربتە	ʁˈærbtæ
غەربى	ʁˈærbɪ
فوندى	fˈondɪ
قوزغىغان	qozʁˈɪʁɑn
قوشاق	qˈoʃɑq
قوغۇن	qˈoʁun
قولايلىق	qolˈɑjlɪq
قوللىنىپ	qollˈɪnɪp
قىزلارنىڭ	qɪzlˈɑrnɪŋ
قىلدۇردى	qɪldˈurdɪ
قىممىتىنى	qˌɪmmɪtˈɪnɪ
قۇرۇلۇشى	qˌuɾulˈuʃɪ
قەدەمدە	qædˈæmdæ
قەھرىمان	qæhrˈɪmɑn
كوماندا	komˈɑndɑ
كى	kˈɪ
كىتابلىرى	kˌɪtɑblˈɪɾɪ
كۈچلەر	kˈyt͡ʃlær
كۈچىگە	kyt͡ʃˈɪɡæ
كەسپىنى	kæspˈɪnɪ
كەچ	kˈæt͡ʃ
لار	lˈɑr
لىق	lˈɪq
ما	mˈɑ
مائارىپنىڭ	mˌɑɑɾˈɪpnɪŋ
ماددىنىڭ	mɑddˈɪnɪŋ
مىرزا	mˈɪrzɑ
مىلادىيىدىن	mˌɪlɑdɪjˈɪdɪn
مىنىڭ	mˈɪnɪŋ
مۇتەللىپ	mutˈællɪp
مۇتەللىپنىڭ	mˌutællˈɪpnɪŋ
مۇرەسسە	muɾˈæssæ
مۇھىتتا	muhˈɪttɑ
مۈلكى	mˈylkɪ
مەسچىتنىڭ	mæst͡ʃˈɪtnɪŋ
مەنە	mˈænæ
مەيداندا	mæjdˈɑndɑ
مەيداننىڭ	mæjdˈɑnnɪŋ
مەھسۇلاتلىرى	mˌæhsulɑtlˈɪɾɪ
نوپۇسىنىڭ	nˌopusˈɪnɪŋ
نۇسخىسىنى	nˌusχɪsˈɪnɪ
نۇقتىدىن	nuqtˈɪdɪn
نۇقتىسى	nuqtˈɪsɪ
نۇقتىلىق	nuqtˈɪlɪq
نەتىجىلەرنى	nˌætɪd͡ʒɪlˈærnɪ
ياتلىق	jˈɑtlɪq
ياخشىلانماقتا	jˌɑχʃɪlɑnmˈɑqtɑ
ياسىلىدۇ	jˌɑsɪlˈɪdu
ياڭ	jˈɑŋ
ياۋروپانىڭ	jˌɑwropˈɑnɪŋ
يورۇقلۇق	joɾˈuqluq
يوغان	jˈoʁɑn
يىلغىچە	jɪlʁˈɪt͡ʃæ
يۇرتىغا	jurtˈɪʁɑ
يېزىنىڭ	jezˈɪnɪŋ
يەرشارى	jærʃˈɑɾɪ
يەرنى	jˈærnɪ
يەرنىڭ	jˈærnɪŋ
پاتېنت	pˈɑtent
پادىشاھلىق	pˌɑdɪʃˈɑhlɪq
پارتىيىسى	pˌɑrtɪjˈɪsɪ
پۈتتۈرگەن	pyttˈyrɡæn
چارۋىچىلىقتا	t͡ʃˌɑrwɪt͡ʃɪlˈɪqtɑ
چىقتىم	t͡ʃˈɪqtɪm
چۈشىنىپ	t͡ʃyʃˈɪnɪp
چېگرىلىنىدۇ	t͡ʃˌeɡrɪlɪnˈɪdu
گۈزەللىك	ɡyzˈællɪk
گەپلەر	ɡˈæplær
ھازىرچە	hɑzˈɪrt͡ʃæ
ھاللاردا	hɑllˈɑrdɑ
ھاياتقا	hɑjˈɑtqɑ
ھاياتىنىڭ	hˌɑjɑtˈɪnɪŋ
ھۆكۈمەتلىرى	hˌœkymætlˈɪɾɪ
ھېكىم	hˈekɪm
ھەممىگە	hæmmˈɪɡæ
ۋاسىتىسىنى	wˌɑsɪtɪsˈɪnɪ
GPS	ɡps
ئائىشە	ɑˈɪʃæ
ئابباس	ˈɑbbɑs
ئابدۇراخمان	ˌɑbduɾˈɑχmɑn
ئاتاپ	ˈɑtɑp
ئادەملەرگە	ˌɑdæmlˈærɡæ
ئاسمانغا	ɑsmˈɑnʁɑ
ئاشقازان	ɑʃqˈɑzɑn
ئاكام	ˈɑkɑm
ئاكىسى	ɑkˈɪsɪ
ئالىمنىڭ	ɑlˈɪmnɪŋ
ئامانەت	ɑmˈɑnæt
ئانام	ˈɑnɑm
ئايلاندۇرۇش	ˌɑjlɑndˈuɾuʃ
ئاپتونومىيە	ˌɑptonomˈɪjæ
ئاھالىلەر	ˌɑhɑlˈɪlær
ئوبلاستى	oblˈɑstɪ
ئوراپ	ˈoɾɑp
ئورگانلىرى	ˌorɡɑnlˈɪɾɪ
ئورۇننى	oɾˈunnɪ
ئوقۇغۇچىسى	ˌoquʁut͡ʃˈɪsɪ
ئوقۇغۇچىلارنى	ˌoquʁˌut͡ʃɪlˈɑrnɪ
ئوقۇيدۇ	oqˈujdu
ئويۇندا	ojˈundɑ
ئوپتىكا	optˈɪkɑ
ئىرادىسىنى	ˌɪɾɑdɪsˈɪnɪ
ئىرادە	ɪɾˈɑdæ
ئىشچى	ˈɪʃt͡ʃɪ
ئىقبال	ˈɪqbɑl
ئىقتىدار	ɪqtˈɪdɑr
ئىنسانىيەتكە	ˌɪnsɑnɪjˈætkæ
ئىپادىلەيدۇ	ˌɪpɑdɪlˈæjdu
ئىھتىياجى	ˌɪhtɪjˈɑd͡ʒɪ
ئۆتۈشكە	œtˈyʃkæ
ئۆزگىرىشى	ˌœzɡɪɾˈɪʃɪ
ئۆزەم	ˈœzæm
ئۆلدى	ˈœldɪ
ئۆيى	ˈœjɪ
ئۇرۇپ	ˈuɾup
ئۇلۇس	ˈulus
ئۇچۇش	ˈut͡ʃuʃ
ئېرى	ˈeɾɪ
ئېسىمدە	esˈɪmdæ
ئېغىزى	eʁˈɪzɪ
ئېقىم	ˈeqɪm
ئېلىمىزنىڭ	ˌelɪmˈɪznɪŋ
ئېلېكتىر	elˈektɪr
ئېڭى	ˈeŋɪ
ئەرتۇغرۇل	ærtˈuʁrul
ئەزىز	ˈæzɪz
ئەسكەرتىپ	æskˈærtɪp
ئەشمە	ˈæʃmæ
ئەقىدە	æqˈɪdæ
ئەللەر	ˈællær
ئەمەلدار	æmˈældɑr
باجنى	bˈɑd͡ʒnɪ
بارلىقى	bɑrlˈɪqɪ
باشلىرىدا	bˌɑʃlɪɾˈɪdɑ
باغ	bˈɑʁ
باغلىغان	bɑʁlˈɪʁɑn
بالىڭىز	bɑlˈɪŋɪz
بولغاچ	bˈolʁɑt͡ʃ
بولمايتتى	bolmˈɑjttɪ
بولىۋېرىدۇ	bˌolɪweɾˈɪdu
بىرلە	bˈɪrlæ
بىرلەشمىسى	bˌɪrlæʃmˈɪsɪ
بىزمۇ	bˈɪzmu
بىلدۈرگەن	bɪldˈyrɡæn
بۆلۈپ	bˈœlyp
بۆلەك	bˈœlæk
بۇيانقى	bujˈɑnqɪ
بېرىشىنى	bˌeɾɪʃˈɪnɪ
بېسىم	bˈesɪm
بېسىمى	besˈɪmɪ
بېقىپ	bˈeqɪp
بەرمەيدۇ	bærmˈæjdu
تارتىدۇ	tɑrtˈɪdu
تارقىتىلغان	tˌɑrqɪtˈɪlʁɑn
تارىخنى	tɑɾˈɪχnɪ
تارىخنىڭ	tɑɾˈɪχnɪŋ
تازىلاش	tɑzˈɪlɑʃ
تاق	tˈɑq
تاقىم	tˈɑqɪm
تولۇقسىز	tolˈuqsɪz
تونۇش	tˈonuʃ
تونۇشتۇرۇلغان	tˌonuʃtuɾˈulʁɑn
تىياتىر	tɪjˈɑtɪr
تۇتۇشقا	tutˈuʃqɑ
تۇرمۇشتا	turmˈuʃtɑ
تۇغقان	tˈuʁqɑn
تۇغما	tˈuʁmɑ
تۈركىستاندا	tˌyrkɪstˈɑndɑ
تېخىچە	teχˈɪt͡ʃæ
تە	tˈæ
تەربىيىلەش	tˌærbɪjˈɪlæʃ
تەسىرىنى	tˌæsɪɾˈɪnɪ
تەشكىلاتىنىڭ	tˌæʃkɪlɑtˈɪnɪŋ
تەپتىش	tˈæptɪʃ
تەھسىل	tˈæhsɪl
جىسىم	d͡ʒˈɪsɪm
جىن	d͡ʒˈɪn
جۇڭگوغا	d͡ʒuŋɡˈoʁɑ
جۇڭگۇ	d͡ʒˈuŋɡu
جەنۇبتا	d͡ʒænˈubtɑ
جەنۇبقا	d͡ʒænˈubqɑ
جەھەتتىمۇ	d͡ʒˌæhættˈɪmu
خاتىرىسى	χˌɑtɪɾˈɪsɪ
خۇشال	χˈuʃɑl
خۇلاسە	χulˈɑsæ
خېمىرتۇرۇچ	χˌemɪrtˈuɾut͡ʃ
خەلققە	χˈælqqæ
خەنچە	χˈænt͡ʃæ
دائىرىسىنى	dˌɑɪɾɪsˈɪnɪ
دادام	dˈɑdɑm
دوكتۇرلۇق	doktˈurluq
دىننىڭ	dˈɪnnɪŋ
دۆلەتلىرىنىڭ	dˌœlætlɪɾˈɪnɪŋ
دۇنياۋى	dunjˈɑwɪ
دەرىجىگە	dˌæɾɪd͡ʒˈɪɡæ
دەرىجە	dæɾˈɪd͡ʒæ
دەلىل	dˈælɪl
رايونلار	rɑjˈonlɑr
رەسمى	rˈæsmɪ
رەھبەرلىك	ræhbˈærlɪk
زىكىر	zˈɪkɪr
زىياننى	zɪjˈɑnnɪ
سازاۋەر	sɑzˈɑwær
سورىغان	soɾˈɪʁɑn
سوممىسى	sommˈɪsɪ
سى	sˈɪ
سىرلىق	sˈɪrlɪq
سىزدە	sˈɪzdæ
سۆيۈملۈك	sœjˈymlyk
سۆھبەت	sˈœhbæt
سۇس	sˈus
سۈرىدۇ	syɾˈɪdu
سەئۇدى	sæˈudɪ
سەۋەبلەر	sæwˈæblær
شىسى	ʃˈɪsɪ
شىنجاڭدا	ʃɪnd͡ʒˈɑŋdɑ
شۆبە	ʃˈœbæ
شېئىرلىرى	ʃˌeɪrlˈɪɾɪ
شەرىئەت	ʃæɾˈɪæt
فرانسۇز	frˈɑnsuz
قارايمەن	qɑɾˈɑjmæn
قارمىقىدىكى	qˌɑrmɪqɪdˈɪkɪ
قارىمۇ	qɑɾˈɪmu
قالمىغان	qɑlmˈɪʁɑn
قايتقاندىن	qɑjtqˈɑndɪn
قوزغىلاڭ	qozʁˈɪlɑŋ
قوشۇلىدۇ	qˌoʃulˈɪdu
قوشۇنلىرى	qˌoʃunlˈɪɾɪ
قوغداپ	qˈoʁdɑp
قويۇشى	qojˈuʃɪ
قىرغىنچىلىق	qˌɪrʁɪnt͡ʃˈɪlɪq
قىلسۇن	qˈɪlsun
قىلماسلىق	qɪlmˈɑslɪq
قىلمايدىغان	qˌɪlmɑjdˈɪʁɑn
قۇش	qˈuʃ
قەشقەردىكى	qˌæʃqærdˈɪkɪ
قەلبىدە	qælbˈɪdæ
كىرىشكە	kɪɾˈɪʃkæ
كۆتۈرۈش	kœtˈyɾyʃ
كۆرۈشكە	kœɾˈyʃkæ
كۆرۈنۈش	kœɾˈynyʃ
كۆزىگە	kœzˈɪɡæ
كۈلتۈر	kˈyltyr
كېتىشكە	ketˈɪʃkæ
لازا	lˈɑzɑ
لەشكەر	lˈæʃkær
مابەينىدە	mˌɑbæjnˈɪdæ
ماتېرىياللارنى	mˌɑteɾˌɪjɑllˈɑrnɪ
ماگىستىرلىق	mˌɑɡɪstˈɪrlɪq
ماھىر	mˈɑhɪr
موھىم	mˈohɪm
مىللەتلەرنى	mˌɪllætlˈærnɪ
مىللەتلەرگە	mˌɪllætlˈærɡæ
مىنگو	mˈɪnɡo
مۇئەسسەسەلىرى	mˌuæssˌæsælˈɪɾɪ
مۇكاپاتقا	mˌukɑpˈɑtqɑ
مۇناسىۋىتىنى	mˌunɑsˌɪwɪtˈɪnɪ
مېنىڭچە	menˈɪŋt͡ʃæ
مەدەنىيىتىنىڭ	mˌædænˌɪjɪtˈɪnɪŋ
مەشىق	mˈæʃɪq
مەمتېلى	mæmtˈelɪ
مەنىسىدە	mˌænɪsˈɪdæ
مەنىسىنى	mˌænɪsˈɪnɪ
مەنپەئەتى	mˌænpæˈætɪ
مەھكىمىسىنىڭ	mˌæhkɪmɪsˈɪnɪŋ
ناخشىسى	nɑχʃˈɪsɪ
ناھىيىسىگە	nˌɑhɪjɪsˈɪɡæ
نۆۋەتتىكى	nˌœwættˈɪkɪ
نۇزۇكۇمنىڭ	nˌuzukˈumnɪŋ
نەزەرىيىسى	nˌæzæɾɪjˈɪsɪ
نەشرىيات	næʃrˈɪjɑt
يوقىتىپ	joqˈɪtɪp
يۈسۈپنىڭ	jysˈypnɪŋ
يېتەكچىلىك	jˌetækt͡ʃˈɪlɪk
يېقىندىن	jeqˈɪndɪn
يەكشەنبە	jækʃˈænbæ
يەنىمۇ	jænˈɪmu
پادىشاھلىقى	pˌɑdɪʃɑhlˈɪqɪ
پولات	pˈolɑt
پۇرسىتى	pursˈɪtɪ
پېداگوگىكا	pˌedɑɡoɡˈɪkɑ
چۈشۈرۈپ	t͡ʃyʃˈyɾyp
چەرچەن	t͡ʃˈært͡ʃæn
گېن	ɡˈen
گېپىنى	ɡepˈɪnɪ
ھ	h
ھاجىم	hˈɑd͡ʒɪm
ھالىتى	hɑlˈɪtɪ
ھون	hˈon
ھويلا	hˈojlɑ
ھىچكىم	hˈɪt͡ʃkɪm
ھېلىمۇ	helˈɪmu
ھېيىت	hˈejɪt
ھەدىسلەر	hædˈɪslær
ۋاستىسى	wɑstˈɪsɪ
of	ˈof
ئابدۇقادىر	ˌɑbduqˈɑdɪr
ئابدۇلئەزىز	ˌɑbdulˈæzɪz
ئارسلان	ˈɑrslɑn
ئارىق	ˈɑɾɪq
ئاساسلانغاندا	ˌɑsɑslɑnʁˈɑndɑ
ئالاقىلىشىش	ˌɑlɑqɪlˈɪʃɪʃ
ئالاھىدىلىك	ˌɑlɑhɪdˈɪlɪk
ئامالسىز	ɑmˈɑlsɪz
ئامىرىكا	ˌɑmɪɾˈɪkɑ
ئانىسىغا	ˌɑnɪsˈɪʁɑ
ئانىلارنىڭ	ˌɑnɪlˈɑrnɪŋ
ئاياغ	ˈɑjɑʁ
ئاياللىرى	ˌɑjɑllˈɪɾɪ
ئاپئاق	ˈɑpɑq
ئاپپاراتى	ˌɑppɑɾˈɑtɪ
ئورنىدىن	ornˈɪdɪn
ئورگانىك	orɡˈɑnɪk
ئورگىنىنىڭ	ˌorɡɪnˈɪnɪŋ
ئورۇنلاردىن	ˌoɾunlˈɑrdɪn
ئوغلىنى	oʁlˈɪnɪ
ئوقۇتقۇچىلار	ˌoqutqut͡ʃˈɪlɑr
ئوقۇرمەنلەرگە	ˌoqurmænlˈærɡæ
ئوقۇشىنى	ˌoquʃˈɪnɪ
ئوڭدىن	ˈoŋdɪn
ئوڭۇشلۇق	oŋˈuʃluq
ئىت	ˈɪt
ئىتىراپ	ɪtˈɪɾɑp
ئىراق	ˈɪɾɑq
ئىستانسىسىنىڭ	ˌɪstɑnsɪsˈɪnɪŋ
ئىستەك	ˈɪstæk
ئىقتىدارىنى	ˌɪqtɪdɑɾˈɪnɪ
ئىككىمىز	ɪkkˈɪmɪz
ئىككىنچىسى	ˌɪkkɪnt͡ʃˈɪsɪ
ئىمپېرىيە	ˌɪmpeɾˈɪjæ
ئىچكىرىدىكى	ˌɪt͡ʃkɪɾɪdˈɪkɪ
ئىگىز	ˈɪɡɪz
ئۆرپ	ˈœrp
ئۆزبېكىستان	ˌœzbekˈɪstɑn
ئۆزىڭىزنى	ˌœzɪŋˈɪznɪ
ئۆزىڭىزگە	ˌœzɪŋˈɪzɡæ
ئۆلكىسىنىڭ	ˌœlkɪsˈɪnɪŋ
ئۆلگەندىن	œlɡˈændɪn
ئۆينى	ˈœjnɪ
ئۇرۇشىدىن	ˌuɾuʃˈɪdɪn
ئۇسسۇلى	ussˈulɪ
ئۇقۇملار	uqˈumlɑr
ئۇندىن	ˈundɪn
ئۇنىۋېرسىتېتىدا	ˌunɪwˌersɪtetˈɪdɑ
ئۇنۋان	ˈunwɑn
ئېتىبار	etˈɪbɑr
ئېرىق	ˈeɾɪq
ئەبۇبەكرى	ˌæbubˈækrɪ
ئەجدادلىرىمىزنىڭ	ˌæd͡ʒdɑdlˌɪɾɪmˈɪznɪŋ
ئەركەك	ˈærkæk
ئەرەبلەرنىڭ	ˌæɾæblˈærnɪŋ
ئەسەرلىرىنىڭ	ˌæsærlɪɾˈɪnɪŋ
ئەسەرنى	æsˈærnɪ
ئەكىلىپ	ækˈɪlɪp
ئەلدە	ˈældæ
ئەلچىسى	ælt͡ʃˈɪsɪ
ئەنئەنە	ænˈænæ
ئەپۇ	ˈæpu
ب	b
بارا	bˈɑɾɑ
باراۋەرلىك	bˌɑɾɑwˈærlɪk
باسقان	bˈɑsqɑn
باسقۇچقا	bɑsqˈut͡ʃqɑ
باقتىم	bˈɑqtɪm
بالىسىنى	bˌɑlɪsˈɪnɪ
بالىلىرىغا	bˌɑlɪlɪɾˈɪʁɑ
بانان	bˈɑnɑn
باھانە	bɑhˈɑnæ
بوشلۇقى	boʃlˈuqɪ
بولدۇق	bˈolduq
بولغانىدى	bˌolʁɑnˈɪdɪ
بولۇشنىڭ	bolˈuʃnɪŋ
بولۇشىمۇ	bˌoluʃˈɪmu
بولۇۋاتىدۇ	bˌoluwɑtˈɪdu
بوي	bˈoj
بوۋاينىڭ	bowˈɑjnɪŋ
بىلدۈرىدىغان	bˌɪldyɾɪdˈɪʁɑn
بۇزۇلۇپ	buzˈulup
بېرىلىشى	bˌeɾɪlˈɪʃɪ
بېرىلىپ	beɾˈɪlɪp
بەدەننى	bædˈænnɪ
بەدەننىڭ	bædˈænnɪŋ
تارىخچى	tɑɾˈɪχt͡ʃɪ
تاشلاش	tˈɑʃlɑʃ
تالانت	tˈɑlɑnt
تالىشىش	tɑlˈɪʃɪʃ
تاپتى	tˈɑptɪ
توختىتىش	toχtˈɪtɪʃ
توماس	tˈomɑs
تومۇر	tˈomur
تىخىمۇ	tɪχˈɪmu
تىزىپ	tˈɪzɪp
تىكلەپ	tˈɪklæp
تىياتىرى	tˌɪjɑtˈɪɾɪ
تۆلەپ	tˈœlæp
تۆھپىسى	tœhpˈɪsɪ
تۇرۇشقا	tuɾˈuʃqɑ
تۇغلۇق	tˈuʁluq
تۇغۇت	tˈuʁut
تۇەن	tˈuæn
تۈركلىرى	tyrklˈɪɾɪ
تۈرلىرىنىڭ	tˌyrlɪɾˈɪnɪŋ
تەرتىپى	tærtˈɪpɪ
تەرەققىياتىنى	tˌæɾæqqˌɪjɑtˈɪnɪ
تەشكىلاتلارنىڭ	tˌæʃkɪlɑtlˈɑrnɪŋ
تەقدىردىمۇ	tˌæqdɪrdˈɪmu
تەقسىم	tˈæqsɪm
تەنقىد	tˈænqɪd
تەنھەرىكەت	tˌænhæɾˈɪkæt
جايلارنى	d͡ʒɑjlˈɑrnɪ
جاۋابكارلىقىنى	d͡ʒˌɑwɑbkˌɑrlɪqˈɪnɪ
جۇ	d͡ʒˈu
جۇڭگودا	d͡ʒuŋɡˈodɑ
جەمئىيەتشۇناسلىق	d͡ʒˌæmɪjˌætʃunˈɑslɪq
جەمئىيەتنى	d͡ʒˌæmɪjˈætnɪ
جەمەتى	d͡ʒæmˈætɪ
جەننەت	d͡ʒˈænnæt
جەنۇبىدىكى	d͡ʒˌænubɪdˈɪkɪ
خارابىسى	χˌɑɾɑbˈɪsɪ
خاننى	χˈɑnnɪ
خىتايلار	χɪtˈɑjlɑr
خۇدا	χˈudɑ
خەۋىرى	χæwˈɪɾɪ
دائىرىسىدە	dˌɑɪɾɪsˈɪdæ
دادا	dˈɑdɑ
دورىلارنى	dˌoɾɪlˈɑrnɪ
دوستلار	dˈostlɑr
دوكتۇر	dˈoktur
دىئامېتىرى	dˌɪɑmetˈɪɾɪ
دىيارىدىكى	dˌɪjɑɾɪdˈɪkɪ
دۇنياسىدىكى	dˌunjɑsɪdˈɪkɪ
دېسەم	dˈesæm
دېگەندىن	deɡˈændɪn
دەيمەن	dˈæjmæn
رەڭدە	rˈæŋdæ
زىيىنى	zɪjˈɪnɪ
سادىق	sˈɑdɪq
ساز	sˈɑz
ساقىت	sˈɑqɪt
ساما	sˈɑmɑ
سانائىتى	sˌɑnɑˈɪtɪ
ساھەسىگە	sˌɑhæsˈɪɡæ
سودىگەر	sodˈɪɡær
سورايدۇ	soɾˈɑjdu
سورۇندا	soɾˈundɑ
سىزىق	sˈɪzɪq
سىمسىز	sˈɪmsɪz
سىناپ	sˈɪnɑp
سۇرە	sˈuɾæ
سەئىد	sˈæɪd
شانلىق	ʃˈɑnlɪq
شۇغۇللىنىدىغان	ʃˌuʁullˌɪnɪdˈɪʁɑn
شۇنچىلىك	ʃunt͡ʃˈɪlɪk
غوللۇق	ʁˈolluq
فارابى	fɑɾˈɑbɪ
فىقھىي	fˈɪqhɪj
قاتارىغا	qˌɑtɑɾˈɪʁɑ
قالدۇق	qˈɑlduq
قالماي	qˈɑlmɑj
قانداقلا	qɑndˈɑqlɑ
قانۇندىكى	qˌɑnundˈɪkɪ
قايتۇرۇش	qɑjtˈuɾuʃ
قوللىشىغا	qˌollɪʃˈɪʁɑ
قولىدىكى	qˌolɪdˈɪkɪ
قويسا	qˈojsɑ
قوينىڭ	qˈojnɪŋ
قىزنى	qˈɪznɪ
قىسمىنىڭ	qɪsmˈɪnɪŋ
قىسىملىق	qɪsˈɪmlɪq
قىلىنغۇچى	qˌɪlɪnʁˈut͡ʃɪ
قىلىنمايدۇ	qˌɪlɪnmˈɑjdu
قۇبۇل	qˈubul
قېرىنداشلار	qˌeɾɪndˈɑʃlɑr
قەبىلىلەر	qˌæbɪlˈɪlær
قەدىمى	qædˈɪmɪ
قەھۋە	qˈæhwæ
كالىنىڭ	kɑlˈɪnɪŋ
كلاسسىك	klˈɑssɪk
كىتابتا	kɪtˈɑbtɑ
كىرگۈزگەن	kɪrɡˈyzɡæn
كىرگەندىن	kɪrɡˈændɪn
كىرگەندە	kɪrɡˈændæ
كىملىكى	kɪmlˈɪkɪ
كۆرۈلىدۇ	kˌœɾylˈɪdu
كۆكتۈرك	kˈœktyrk
كۆپۈنچە	kœpˈynt͡ʃæ
كۆچۈرۈپ	kœt͡ʃˈyɾyp
كۆڭلىگە	kœŋlˈɪɡæ
كۈمۈش	kˈymyʃ
كۈنلەرنىڭ	kynlˈærnɪŋ
كۈنگىچە	kynɡˈɪt͡ʃæ
كەشىپ	kˈæʃɪp
كەلگەنلىكى	kˌælɡænlˈɪkɪ
مائارىپى	mˌɑɑɾˈɪpɪ
ماتېرىيالى	mˌɑteɾɪjˈɑlɪ
ماڭدى	mˈɑŋdɪ
ماڭىدۇ	mɑŋˈɪdu
مۇراسىمى	mˌuɾɑsˈɪmɪ
مۇسۇلمانلارنى	mˌusulmɑnlˈɑrnɪ
مۇناسىۋەتنى	mˌunɑsɪwˈætnɪ
مۈشۈك	mˈyʃyk
مۈلۈك	mˈylyk
مەزمۇنىنى	mˌæzmunˈɪnɪ
مەسىلىسىنى	mˌæsɪlɪsˈɪnɪ
مەسىلىلەرگە	mˌæsɪlɪlˈærɡæ
مەسىلىگە	mˌæsɪlˈɪɡæ
مەكتەپلەرنىڭ	mˌæktæplˈærnɪŋ
مەلۇماتلار	mˌælumˈɑtlɑr
مەنىگە	mænˈɪɡæ
مەھسۇلاتلىرىنى	mˌæhsulˌɑtlɪɾˈɪnɪ
نىسپىيلىك	nɪspˈɪjlɪk
نىمىشقا	nɪmˈɪʃqɑ
نەدىن	nˈædɪn
ياسىر	jˈɑsɪr
يايلاق	jˈɑjlɑq
يىغلاپ	jˈɪʁlɑp
يىغىلىپ	jɪʁˈɪlɪp
يىلتىز	jˈɪltɪz
يۇمىلاق	jumˈɪlɑq
يېزىشنى	jezˈɪʃnɪ
يېزىقچىلىق	jˌezɪqt͡ʃˈɪlɪq
يېشىغا	jeʃˈɪʁɑ
يەتكۈزۈپ	jætkˈyzyp
يەڭگەن	jˈæŋɡæn
يەھۇدىلارنى	jˌæhudɪlˈɑrnɪ
پارچىدىن	pɑrt͡ʃˈɪdɪn
پالۋان	pˈɑlwɑn
پرىنسىپى	prɪnsˈɪpɪ
پىشۇرۇلىدۇ	pˌɪʃuɾulˈɪdu
پىلانى	pɪlˈɑnɪ
پەلەستىن	pælˈæstɪn
پەيلاسوپ	pæjlˈɑsop
پەۋقۇلئاددە	pˌæwqulˈɑddæ
چوڭلار	t͡ʃˈoŋlɑr
چىشى	t͡ʃˈɪʃɪ
چىقىرىشى	t͡ʃˌɪqɪɾˈɪʃɪ
چۆل	t͡ʃˈœl
چۈشتى	t͡ʃˈyʃtɪ
چۈشەنچىسى	t͡ʃˌyʃænt͡ʃˈɪsɪ
چېتىگە	t͡ʃetˈɪɡæ
گۈلى	ɡˈylɪ
گېزىتنىڭ	ɡezˈɪtnɪŋ
ھالقىغان	hɑlqˈɪʁɑn
ھالىتىنى	hˌɑlɪtˈɪnɪ
ھوقۇقىدىن	hˌoquqˈɪdɪn
ھۈنەر	hˈynær
ھېچبىر	hˈet͡ʃbɪr
ھەدىسنىڭ	hædˈɪsnɪŋ
ھەرقانچە	hærqˈɑnt͡ʃæ
ھەسرەت	hˈæsræt
ھەممىسىگە	hˌæmmɪsˈɪɡæ
ھەيئىتى	hæjˈɪtɪ
ۋاڭنىڭ	wˈɑŋnɪŋ
ۋەكىل	wˈækɪl
ئائىلىسىگە	ˌɑɪlɪsˈɪɡæ
ئابدۇرراھمان	ˌɑbdurrˈɑhmɑn
ئاخىرىغا	ˌɑχɪɾˈɪʁɑ
ئادىل	ˈɑdɪl
ئارىدا	ɑɾˈɪdɑ
ئازات	ˈɑzɑt
ئازادلىقتىن	ˌɑzɑdlˈɪqtɪn
ئاشتى	ˈɑʃtɪ
ئالاھىدىلىككە	ˌɑlɑhˌɪdɪlˈɪkkæ
ئالقىشىغا	ˌɑlqɪʃˈɪʁɑ
ئامما	ˈɑmmɑ
ئاپتور	ˈɑptor
ئاپپاراتلىرى	ˌɑppɑɾɑtlˈɪɾɪ
ئاۋازىنى	ˌɑwɑzˈɪnɪ
ئوتتا	ˈottɑ
ئورنىنىڭ	ornˈɪnɪŋ
ئورۇنلاشتۇرۇلغان	ˌoɾunlˌɑʃtuɾˈulʁɑn
ئورۇننىڭ	oɾˈunnɪŋ
ئوقۇرمەنلەر	ˌoqurmˈænlær
ئوينايدىغان	ˌojnɑjdˈɪʁɑn
ئىجادىيىتى	ˌɪd͡ʒɑdɪjˈɪtɪ
ئىدۇق	ˈɪduq
ئىرادىسى	ˌɪɾɑdˈɪsɪ
ئىراننىڭ	ɪɾˈɑnnɪŋ
ئىرىشكەن	ɪɾˈɪʃkæn
ئىستېمالچىلار	ˌɪstemɑlt͡ʃˈɪlɑr
ئىسھاق	ˈɪshɑq
ئىشلەيدۇ	ɪʃlˈæjdu
ئىللەت	ˈɪllæt
ئىنجىل	ˈɪnd͡ʒɪl
ئىنقىلابىنىڭ	ˌɪnqɪlɑbˈɪnɪŋ
ئىگىلەپ	ɪɡˈɪlæp
ئۆتىدىغان	ˌœtɪdˈɪʁɑn
ئۆگىتىش	œɡˈɪtɪʃ
ئۇستا	ˈustɑ
ئۇسۇللار	usˈullɑr
ئۇنىۋېرسال	ˌunɪwˈersɑl
ئۇيغۇرچىدا	ˌujʁurt͡ʃˈɪdɑ
ئۇچى	ˈut͡ʃɪ
ئۇچۇن	ˈut͡ʃun
ئۈزىنىڭ	yzˈɪnɪŋ
ئېغىرلىقى	ˌeʁɪrlˈɪqɪ
ئېيتىدۇ	ejtˈɪdu
ئېھتىياجىغا	ˌehtɪjɑd͡ʒˈɪʁɑ
ئەتراپى	ætrˈɑpɪ
ئەسىرىنى	ˌæsɪɾˈɪnɪ
ئەسىرگە	æsˈɪrɡæ
ئەقىلگە	æqˈɪlɡæ
ئەللىرى	ællˈɪɾɪ
ئەلىنىڭ	ælˈɪnɪŋ
ئەۋەتكەن	æwˈætkæn
بارماق	bˈɑrmɑq
بازارغا	bɑzˈɑrʁɑ
باغلىنىپ	bɑʁlˈɪnɪp
بالىغا	bɑlˈɪʁɑ
بايلىقلىرىدىن	bˌɑjlɪqlɪɾˈɪdɪn
باھار	bˈɑhɑr
بوشلۇق	bˈoʃluq
بوغۇز	bˈoʁuz
بولغانلىقتىن	bˌolʁɑnlˈɪqtɪn
بولمىسۇن	bolmˈɪsun
بولۇشتەك	bolˈuʃtæk
بولۇشىدىن	bˌoluʃˈɪdɪn
بولۇۋاتقان	bˌoluwˈɑtqɑn
بوۋاق	bˈowɑq
بىخەتەر	bɪχˈætær
بىرىپ	bˈɪɾɪp
بىلمەي	bˈɪlmæj
بىلىملىرىنى	bˌɪlɪmlɪɾˈɪnɪ
بىلىملىك	bɪlˈɪmlɪk
بۇخارا	buχˈɑɾɑ
بۇمۇ	bˈumu
بۇگۈنكى	buɡˈynkɪ
بېتى	bˈetɪ
بېجىرىش	bed͡ʒˈɪɾɪʃ
بەرداشلىق	bærdˈɑʃlɪq
بەكرى	bˈækrɪ
بەلگىلىنىدۇ	bˌælɡɪlɪnˈɪdu
بەلگىلىگەن	bˌælɡɪlˈɪɡæn
بەلگىلەپ	bælɡˈɪlæp
تاراتقۇ	tɑɾˈɑtqu
تارقىلىش	tɑrqˈɪlɪʃ
تاشلانغان	tɑʃlˈɑnʁɑn
تاپشۇرۇپ	tɑpʃˈuɾup
تاۋۇشى	tɑwˈuʃɪ
توختى	tˈoχtɪ
توردا	tˈordɑ
توسقۇنلۇق	tosqˈunluq
توغرالغان	toʁrˈɑlʁɑn
توننا	tˈonnɑ
تىللاردا	tɪllˈɑrdɑ
تىللارنىڭ	tɪllˈɑrnɪŋ
تىپىك	tˈɪpɪk
تۆرە	tˈœɾæ
تۇتقۇن	tˈutqun
تۇتىشىپ	tutˈɪʃɪp
تۇرمۇشقا	turmˈuʃqɑ
تۇرمۇشى	turmˈuʃɪ
تۇرۇشى	tuɾˈuʃɪ
تۇرۇپلا	tuɾˈuplɑ
تۇغۇلۇپ	tuʁˈulup
تېغى	tˈeʁɪ
تېمىغا	temˈɪʁɑ
تەتقىقاتلار	tˌætqɪqˈɑtlɑr
تەرجىمان	tærd͡ʒˈɪmɑn
تەركىبىدىكى	tˌærkɪbɪdˈɪkɪ
تەرپىدىن	tærpˈɪdɪn
تەسىرىدە	tˌæsɪɾˈɪdæ
تەك	tˈæk
تەمىنلەيدىغان	tˌæmɪnlæjdˈɪʁɑn
تەپەككۈر	tæpˈækkyr
تەۋەسىدىكى	tˌæwæsɪdˈɪkɪ
جازاسىغا	d͡ʒˌɑzɑsˈɪʁɑ
جالالىدىن	d͡ʒˌɑlɑlˈɪdɪn
جايلىرىدىكى	d͡ʒˌɑjlɪɾɪdˈɪkɪ
جاپا	d͡ʒˈɑpɑ
جىنايى	d͡ʒɪnˈɑjɪ
جىڭ	d͡ʒˈɪŋ
جىگدە	d͡ʒˈɪɡdæ
جەنۇبىغا	d͡ʒˌænubˈɪʁɑ
خاتىرىلەر	χˌɑtɪɾˈɪlær
خاتىمە	χɑtˈɪmæ
خالىي	χˈɑlɪj
خۇسۇسىيىتى	χˌususɪjˈɪtɪ
خەق	χˈæq
خەقنىڭ	χˈæqnɪŋ
خەنزۇلار	χænzˈulɑr
خەۋەرنى	χæwˈærnɪ
دائىرىسىدىكى	dˌɑɪɾˌɪsɪdˈɪkɪ
داموللا	dɑmˈollɑ
دوختۇر	dˈoχtur
دولقۇن	dˈolqun
دۆلەتتىكى	dˌœlættˈɪkɪ
دۇنيادىن	dunjˈɑdɪn
دۇنياسىدا	dˌunjɑsˈɪdɑ
دۇنياسىنىڭ	dˌunjɑsˈɪnɪŋ
دۈشمەنگە	dyʃmˈænɡæ
دېگىنى	deɡˈɪnɪ
دەرىجىسىگە	dˌæɾɪd͡ʒɪsˈɪɡæ
دەرىخى	dæɾˈɪχɪ
دەپلا	dˈæplɑ
دەۋىردە	dæwˈɪrdæ
رامىزان	rɑmˈɪzɑn
زادىلا	zɑdˈɪlɑ
زىيانغا	zɪjˈɑnʁɑ
زەھەر	zˈæhær
سابىت	sˈɑbɪt
ساق	sˈɑq
ساقلايدۇ	sɑqlˈɑjdu
سايلام	sˈɑjlɑm
ساھەسى	sɑhˈæsɪ
سورىدى	soɾˈɪdɪ
سىنىپى	sɪnˈɪpɪ
سىياسەتنىڭ	sˌɪjɑsˈætnɪŋ
سۆزلەرگە	sœzlˈærɡæ
سۆزلەنگەن	sœzlˈænɡæn
سېتىۋېلىش	sˌetɪwˈelɪʃ
سەپتە	sˈæptæ
سەھنە	sˈæhnæ
سەھىيە	sæhˈɪjæ
شاڭخەي	ʃˈɑŋχæj
شى	ʃˈɪ
شىسىنىڭ	ʃɪsˈɪnɪŋ
شېئىرىي	ʃeˈɪɾɪj
شەكلىنى	ʃæklˈɪnɪ
شەكىللەندۈرگەن	ʃˌækɪllændˈyrɡæn
غولى	ʁˈolɪ
غۇلجىدا	ʁuld͡ʒˈɪdɑ
قات	qˈɑt
قاتارىدىن	qˌɑtɑɾˈɪdɪn
قالماستىن	qɑlmˈɑstɪn
قانۇنىيەت	qˌɑnunˈɪjæt
قوشۇنىنىڭ	qˌoʃunˈɪnɪŋ
قويۇشنى	qojˈuʃnɪ
قىزغا	qˈɪzʁɑ
قىزىنى	qɪzˈɪnɪ
قىلىشىمىز	qˌɪlɪʃˈɪmɪz
قىلىنمىغان	qˌɪlɪnmˈɪʁɑn
قىلىنىشقا	qˌɪlɪnˈɪʃqɑ
قىلىپتۇ	qɪlˈɪptu
قىپتۇ	qˈɪptu
قۇتادغۇبىلىك	qˌutɑdʁubˈɪlɪk
قۇر	qˈur
قۇرغۇچىسى	qˌurʁut͡ʃˈɪsɪ
قۇرۇلمىسىنى	qˌuɾulmɪsˈɪnɪ
قۇللۇق	qˈulluq
قۇيىدۇ	qujˈɪdu
قەبرە	qˈæbræ
كالىفورنىيە	kˌɑlɪfornˈɪjæ
كامال	kˈɑmɑl
كامالەتكە	kˌɑmɑlˈætkæ
كىرگۈزۈپ	kɪrɡˈyzyp
كىلاسسىك	kɪlˈɑssɪk
كىلوگرام	kɪlˈoɡrɑm
كىچىككىنە	kˌɪt͡ʃɪkkˈɪnæ
كىگىز	kˈɪɡɪz
كۆتۈرىدۇ	kˌœtyɾˈɪdu
كۆرۈنىدۇ	kˌœɾynˈɪdu
كۆزىنى	kœzˈɪnɪ
كۆلەملىك	kœlˈæmlɪk
كۈتۈپ	kˈytyp
كۈز	kˈyz
كۈلۈپ	kˈylyp
كۈچىنىڭ	kyt͡ʃˈɪnɪŋ
كېرىيە	keɾˈɪjæ
كېسىلىنى	kˌesɪlˈɪnɪ
كەسىپنى	kæsˈɪpnɪ
كەلسە	kˈælsæ
لوپ	lˈop
لىپەك	lˈɪpæk
لېكسىيە	leksˈɪjæ
م	m
ماددىلار	mɑddˈɪlɑr
مارشى	mˈɑrʃɪ
ماھىيەتتە	mˌɑhɪjˈættæ
موڭغۇلىيە	mˌoŋʁulˈɪjæ
مىنىستىرى	mˌɪnɪstˈɪɾɪ
مىڭلىغان	mɪŋlˈɪʁɑn
مەجبۇرىيىتى	mˌæd͡ʒbuɾɪjˈɪtɪ
مەجبۇرىيىتىنى	mˌæd͡ʒbuɾˌɪjɪtˈɪnɪ
مەرىپەت	mæɾˈɪpæt
مەسخىرە	mæsχˈɪɾæ
مەسىلىسىدە	mˌæsɪlɪsˈɪdæ
مەسىلىنىڭ	mˌæsɪlˈɪnɪŋ
مەشرەپكە	mæʃrˈæpkæ
مەقسىدى	mæqsˈɪdɪ
مەكتەپلەرنى	mˌæktæplˈærnɪ
مەمۇرى	mæmˈuɾɪ
مەنىدىن	mænˈɪdɪn
مەنىسىدىكى	mˌænɪsɪdˈɪkɪ
مەڭگۈلۈك	mæŋɡˈylyk
مەھكىمە	mæhkˈɪmæ
مەھكۇم	mˈæhkum
ناھىيىسىدە	nˌɑhɪjɪsˈɪdæ
ناھىيىنىڭ	nˌɑhɪjˈɪnɪŋ
نىشانغا	nɪʃˈɑnʁɑ
نۇسخا	nˈusχɑ
نەزىر	nˈæzɪr
نەقىل	nˈæqɪl
ياد	jˈɑd
ياردەمچىسى	jˌɑrdæmt͡ʃˈɪsɪ
يازدى	jˈɑzdɪ
ياسايدۇ	jɑsˈɑjdu
يالىڭاچ	jɑlˈɪŋɑt͡ʃ
يىغىنغا	jɪʁˈɪnʁɑ
يىلنى	jˈɪlnɪ
يۇسۇف	jˈusuf
يۇقۇملۇق	juqˈumluq
يۈزىدىكى	jˌyzɪdˈɪkɪ
يۈزىدە	jyzˈɪdæ
يۈزىنى	jyzˈɪnɪ
يېتىم	jˈetɪm
يېرىمىنى	jˌeɾɪmˈɪnɪ
يېزىشقا	jezˈɪʃqɑ
يېشى	jˈeʃɪ
يېقىملىق	jeqˈɪmlɪq
يەتكۈزىدىغان	jˌætkyzɪdˈɪʁɑn
يەل	jˈæl
پارلاق	pˈɑrlɑq
پورتى	pˈortɪ
پۇلغا	pˈulʁɑ
پۇلنىڭ	pˈulnɪŋ
پەتىۋا	pætˈɪwɑ
پەرقلىنىپ	pærqlˈɪnɪp
پەنلىرى	pænlˈɪɾɪ
چاشقان	t͡ʃˈɑʃqɑn
چاقىرىق	t͡ʃɑqˈɪɾɪq
چوشقا	t͡ʃˈoʃqɑ
چەمبەر	t͡ʃˈæmbær
گېپى	ɡˈepɪ
ھادىسىسى	hˌɑdɪsˈɪsɪ
ھالبۇكى	hɑlbˈukɪ
ھالىتىگە	hˌɑlɪtˈɪɡæ
ھونلارنىڭ	honlˈɑrnɪŋ
ھىجرى	hˈɪd͡ʒrɪ
ھۆكۈمىتىگە	hˌœkymɪtˈɪɡæ
ھۈجەيرە	hyd͡ʒˈæjræ
ھەدىسنى	hædˈɪsnɪ
ھەرىكىتىنىڭ	hˌæɾɪkɪtˈɪnɪŋ
ھەقتىكى	hæqtˈɪkɪ
ھەققىنى	hæqqˈɪnɪ
ھەمكارلىشىپ	hˌæmkɑrlˈɪʃɪp
ھەممىسىنىڭ	hˌæmmɪsˈɪnɪŋ
ھەيۋەتلىك	hæjwˈætlɪk
ھەپتىدە	hæptˈɪdæ
ۋاستە	wˈɑstæ
ۋايىغا	wɑjˈɪʁɑ
ۋەزىيەت	wæzˈɪjæt
ۋەزىپىلەرنى	wˌæzɪpɪlˈærnɪ
ئابلاجان	ɑblˈɑd͡ʒɑn
ئاخىرلاشتى	ˌɑχɪrlˈɑʃtɪ
ئاراللىرى	ˌɑɾɑllˈɪɾɪ
ئارقىسىدا	ˌɑrqɪsˈɪdɑ
ئارىلىقىدا	ˌɑɾɪlɪqˈɪdɑ
ئاسسىمىلياتسىيە	ˌɑssɪmˌɪljɑtsˈɪjæ
ئالامەتلەر	ˌɑlɑmˈætlær
ئاللىبۇرۇن	ˌɑllɪbˈuɾun
ئامبال	ˈɑmbɑl
ئاياللىرىنىڭ	ˌɑjɑllɪɾˈɪnɪŋ
ئاچتى	ˈɑt͡ʃtɪ
ئاڭلىق	ˈɑŋlɪq
ئوبرازىنى	ˌobrɑzˈɪnɪ
ئورتا	ˈortɑ
ئورگىنىغا	ˌorɡɪnˈɪʁɑ
ئوقۇغۇچىنىڭ	ˌoquʁut͡ʃˈɪnɪŋ
ئوينىلىدۇ	ˌojnɪlˈɪdu
ئوۋچىلىق	owt͡ʃˈɪlɪq
ئىتتىپاقداش	ˌɪttɪpˈɑqdɑʃ
ئىجارىگە	ˌɪd͡ʒɑɾˈɪɡæ
ئىدىقۇت	ɪdˈɪqut
ئىزدىنىش	ɪzdˈɪnɪʃ
ئىسىمنى	ɪsˈɪmnɪ
ئىشلاردىن	ɪʃlˈɑrdɪn
ئىشلىتىپ	ɪʃlˈɪtɪp
ئىشلەشكە	ɪʃlˈæʃkæ
ئىشىنىدۇ	ˌɪʃɪnˈɪdu
ئىنقىلابىي	ˌɪnqɪlˈɑbɪj
ئىنىمىز	ɪnˈɪmɪz
ئىپادىسى	ˌɪpɑdˈɪsɪ
ئىچكىرىدە	ˌɪt͡ʃkɪɾˈɪdæ
ئىگىسىنىڭ	ˌɪɡɪsˈɪnɪŋ
ئۆتكەندە	œtkˈændæ
ئۆتىمەن	œtˈɪmæn
ئۆزگەرتىپ	œzɡˈærtɪp
ئۆزگەرگەن	œzɡˈærɡæn
ئۆستەڭ	ˈœstæŋ
ئۆسۈملۈكنىڭ	ˌœsymlˈyknɪŋ
ئۆلكىسى	œlkˈɪsɪ
ئۆيىنى	œjˈɪnɪ
ئۇرخۇن	ˈurχun
ئۇرۇشنى	uɾˈuʃnɪ
ئۇزۇنلۇق	uzˈunluq
ئۇيغۇردىن	ujʁˈurdɪn
ئۇيغۇرلاردىكى	ˌujʁurlɑrdˈɪkɪ
ئۇيغۇرلارمۇ	ˌujʁurlˈɑrmu
ئۇچ	ˈut͡ʃ
ئۈزى	ˈyzɪ
ئېتىبارەن	ˌetɪbˈɑɾæn
ئېرۇر	ˈeɾur
ئېلىندى	elˈɪndɪ
ئېلېكترونلۇق	ˌelektrˈonluq
ئېيتتى	ˈejttɪ
ئېيتىش	ˈejtɪʃ
ئەخمەق	ˈæχmæq
ئەدلىيە	ædlˈɪjæ
ئەرلەرنىڭ	ærlˈærnɪŋ
ئەرلەرگە	ærlˈærɡæ
ئەرەبلەر	æɾˈæblær
ئەسكەرتىش	æskˈærtɪʃ
ئەمەلىيەتكە	ˌæmælɪjˈætkæ
ئەنقەرە	ænqˈæɾæ
ئەھۋاللارنى	ˌæhwɑllˈɑrnɪ
باستۇرۇپ	bɑstˈuɾup
باشقارمىسى	bˌɑʃqɑrmˈɪsɪ
باشقۇرۇشىدا	bˌɑʃquɾuʃˈɪdɑ
باشلاندى	bɑʃlˈɑndɪ
باقايلى	bɑqˈɑjlɪ
بولىسىز	bolˈɪsɪz
بىرۇنى	bɪɾˈunɪ
بىلىشكە	bɪlˈɪʃkæ
بىلەتتى	bɪlˈættɪ
بۆرە	bˈœɾæ
بۆلىكى	bœlˈɪkɪ
بۈگۈنگىچە	bˌyɡynɡˈɪt͡ʃæ
بېشىدىكى	bˌeʃɪdˈɪkɪ
بېيجىڭدا	bejd͡ʒˈɪŋdɑ
بېيجىڭغا	bejd͡ʒˈɪŋʁɑ
بەدەل	bˈædæl
بەرمىگەن	bærmˈɪɡæn
بەكلا	bˈæklɑ
بەلباغ	bˈælbɑʁ
تارتىپلا	tɑrtˈɪplɑ
تارماقلىرى	tˌɑrmɑqlˈɪɾɪ
تارىختىكى	tˌɑɾɪχtˈɪkɪ
تارىخىنىڭ	tˌɑɾɪχˈɪnɪŋ
تازا	tˈɑzɑ
تاشيوللىرى	tˌɑʃjollˈɪɾɪ
تاشيولىنىڭ	tˌɑʃjolˈɪnɪŋ
تالانتى	tɑlˈɑntɪ
تاپالماي	tɑpˈɑlmɑj
توختامنى	toχtˈɑmnɪ
توپا	tˈopɑ
توپلاش	tˈoplɑʃ
توپلانغان	toplˈɑnʁɑn
توپىغا	topˈɪʁɑ
تىجارىتى	tˌɪd͡ʒɑɾˈɪtɪ
تىرىشقان	tɪɾˈɪʃqɑn
تىللارغا	tɪllˈɑrʁɑ
تىپلىق	tˈɪplɪq
تۆتىنچى	tœtˈɪnt͡ʃɪ
تۈركىيەگە	tˌyrkɪjˈæɡæ
تۈمەن	tˈymæn
تۈگەپ	tˈyɡæp
تېلېۋىزور	tˌelewˈɪzor
تەتقىقاتىغا	tˌætqɪqɑtˈɪʁɑ
تەرىقىسىدە	tˌæɾɪqɪsˈɪdæ
تەۋەسىدىن	tˌæwæsˈɪdɪn
جانلىقلار	d͡ʒɑnlˈɪqlɑr
جىلد	d͡ʒˈɪld
خاسىيەتلىك	χˌɑsɪjˈætlɪk
خالىغانچە	χˌɑlɪʁˈɑnt͡ʃæ
خاڭگۇڭ	χˈɑŋɡuŋ
خىتايغا	χɪtˈɑjʁɑ
خىراجىتى	χˌɪɾɑd͡ʒˈɪtɪ
خىزمەتچى	χɪzmˈætt͡ʃɪ
خىلدىن	χˈɪldɪn
خىلى	χˈɪlɪ
خەتنى	χˈætnɪ
خەلقئارادا	χˌælqɑɾˈɑdɑ
خەلىقنىڭ	χælˈɪqnɪŋ
خەنسۇلار	χænsˈulɑr
خەۋپ	χˈæwp
دادىسىدىن	dˌɑdɪsˈɪdɪn
دانا	dˈɑnɑ
دوتەي	dˈotæj
دىلمۇرات	dɪlmˈuɾɑt
دىپلوماتىيە	dˌɪplomɑtˈɪjæ
دېمەكچى	demˈækt͡ʃɪ
دېگىنىمىز	dˌeɡɪnˈɪmɪz
دەرىجىدىكى	dˌæɾɪd͡ʒɪdˈɪkɪ
رايونىدىكى	rˌɑjonɪdˈɪkɪ
راھەت	rˈɑhæt
روياپقا	rojˈɑpqɑ
رىقابەت	rɪqˈɑbæt
رۇمى	rˈumɪ
زامانىدا	zˌɑmɑnˈɪdɑ
زوراۋانلىق	zˌoɾɑwˈɑnlɪq
زىت	zˈɪt
زېمىنى	zemˈɪnɪ
سالاھىيىتىگە	sˌɑlɑhˌɪjɪtˈɪɡæ
سالماقنى	sɑlmˈɑqnɪ
سانائىتىدىن	sˌɑnɑɪtˈɪdɪn
ساندا	sˈɑndɑ
سانىنى	sɑnˈɪnɪ
سورايمەن	soɾˈɑjmæn
سىرتتىن	sˈɪrttɪn
سىزدىن	sˈɪzdɪn
سىنا	sˈɪnɑ
سىناش	sˈɪnɑʃ
سىنىڭ	sˈɪnɪŋ
سىياسىتىنى	sˌɪjɑsɪtˈɪnɪ
سىياسىتىنىڭ	sˌɪjɑsɪtˈɪnɪŋ
سۆزلۈك	sˈœzlyk
سۇغۇرتا	suʁˈurtɑ
سۇڭپىياز	suŋpˈɪjɑz
سۈرئەتتە	syɾˈættæ
سۈرۈك	sˈyɾyk
سەلبىي	sˈælbɪj
سەۋەپلىك	sæwˈæplɪk
شاگىرتى	ʃɑɡˈɪrtɪ
شاھى	ʃˈɑhɪ
شىركەتلىرى	ʃˌɪrkætlˈɪɾɪ
شىمالدىكى	ʃˌɪmɑldˈɪkɪ
شىمالدىن	ʃɪmˈɑldɪn
شىمالىغا	ʃˌɪmɑlˈɪʁɑ
شۇغۇللىنىدۇ	ʃˌuʁullɪnˈɪdu
شۇلارنىڭ	ʃulˈɑrnɪŋ
شېڭ	ʃˈeŋ
شەھرىنىڭ	ʃæhrˈɪnɪŋ
غايىسى	ʁɑjˈɪsɪ
غۇلجىدىكى	ʁˌuld͡ʒɪdˈɪkɪ
فونېتىكىلىق	fˌonetɪkˈɪlɪq
فىرانسىيە	fˌɪɾɑnsˈɪjæ
قابىلىيىتى	qˌɑbɪlɪjˈɪtɪ
قاتكۆك	qˈɑtkœk
قارارىغا	qˌɑɾɑɾˈɪʁɑ
قاراشەھەر	qˌɑɾɑʃˈæhær
قالاتتى	qɑlˈɑttɪ
قالايمىقان	qˌɑlɑjmˈɪqɑn
قالغاندا	qɑlʁˈɑndɑ
قايتىش	qˈɑjtɪʃ
قاھىرە	qɑhˈɪɾæ
قولدا	qˈoldɑ
قوللىنىدىغان	qˌollɪnɪdˈɪʁɑn
قوماندانلىق	qˌomɑndˈɑnlɪq
قىل	qˈɪl
قىلسىڭىز	qɪlsˈɪŋɪz
قىلغانلار	qɪlʁˈɑnlɑr
قىلمىشى	qɪlmˈɪʃɪ
قىلىشىدۇ	qˌɪlɪʃˈɪdu
قىممەتكە	qɪmmˈætkæ
قۇتقۇزۇش	qutqˈuzuʃ
قۇرئاننى	quɾˈɑnnɪ
قېرىنداشلارنىڭ	qˌeɾɪndɑʃlˈɑrnɪŋ
قېنى	qˈenɪ
قەيسەر	qˈæjsær
كان	kˈɑn
كاپالەتكە	kˌɑpɑlˈætkæ
كورلا	kˈorlɑ
كوممۇنىستىك	kˌommunˈɪstɪk
كىتابتىكى	kˌɪtɑbtˈɪkɪ
كۆرىسىز	kœɾˈɪsɪz
كۆزلىگەن	kœzlˈɪɡæn
كۇچا	kˈut͡ʃɑ
كۈنلەر	kˈynlær
كېتىۋاتقان	kˌetɪwˈɑtqɑn
كېتەتتى	ketˈættɪ
كېرەكلىك	keɾˈæklɪk
كېرەكلىكى	kˌeɾæklˈɪkɪ
كېلىشىم	kelˈɪʃɪm
كېيىنلا	kejˈɪnlɑ
كەبىسە	kæbˈɪsæ
كەلىمىسى	kˌælɪmˈɪsɪ
كەلگۈسىگە	kˌælɡysˈɪɡæ
كەچلىك	kˈæt͡ʃlɪk
كەچۈرگەن	kæt͡ʃˈyrɡæn
لوپنۇر	lˈopnur
لۇت	lˈut
ماتېماتىكىلىق	mˌɑtemˌɑtɪkˈɪlɪq
ماددى	mˈɑddɪ
ماددىسىدىكى	mˌɑddɪsɪdˈɪkɪ
ماقالىدا	mˌɑqɑlˈɪdɑ
ماقۇل	mˈɑqul
مانى	mˈɑnɪ
ماڭغاندا	mɑŋʁˈɑndɑ
ماگنىت	mˈɑɡnɪt
مىقداردىكى	mˌɪqdɑrdˈɪkɪ
مىلادىنىڭ	mˌɪlɑdˈɪnɪŋ
مىڭغا	mˈɪŋʁɑ
مۇستەقىللىقىنى	mˌustæqˌɪllɪqˈɪnɪ
مۇنار	mˈunɑr
مۇنبەت	mˈunbæt
مۇنتىزىم	muntˈɪzɪm
مۇھاپىزەت	mˌuhɑpˈɪzæt
مېتر	mˈetr
مېيىپلەر	mejˈɪplær
مېھرى	mˈehrɪ
مېۋىسى	mewˈɪsɪ
مەدىنىدە	mˌædɪnˈɪdæ
مەركىزىدە	mˌærkɪzˈɪdæ
مەركىزىگە	mˌærkɪzˈɪɡæ
مەسئۇلىيىتى	mˌæsulɪjˈɪtɪ
مەقسەتلىك	mæqsˈætlɪk
مەلۇماتقا	mˌælumˈɑtqɑ
مەندەك	mˈændæk
مەنىدىكى	mˌænɪdˈɪkɪ
مەيدانىدا	mˌæjdɑnˈɪdɑ
مەۋجۇتلۇقىنى	mˌæwd͡ʒutluqˈɪnɪ
مەۋھۇم	mˈæwhum
نامرات	nˈɑmrɑt
ناملىرى	nɑmlˈɪɾɪ
نېمىنى	nemˈɪnɪ
نەزەردىن	næzˈærdɪn
نەسلىدىن	næslˈɪdɪn
نەقىش	nˈæqɪʃ
نەقەدەر	næqˈædær
نەپىس	nˈæpɪs
نەۋائىينىڭ	nˌæwɑˈɪjnɪŋ
نەۋرىسى	næwrˈɪsɪ
يارقىن	jˈɑrqɪn
يازغۇچىلىرى	jˌɑzʁut͡ʃɪlˈɪɾɪ
يازلىق	jˈɑzlɪq
ياشانغان	jɑʃˈɑnʁɑn
ياشنىڭ	jˈɑʃnɪŋ
يولباشلاش	jolbˈɑʃlɑʃ
يوللىرىنى	jˌollɪɾˈɪnɪ
يوللۇق	jˈolluq
يۇنان	jˈunɑn
يۈزلەنگەن	jyzlˈænɡæn
يۈك	jˈyk
يۈەندىن	jyˈændɪn
يېتىشتۈرۈش	jˌetɪʃtˈyɾyʃ
يېتەكچى	jetˈækt͡ʃɪ
يېزىقتا	jezˈɪqtɑ
يەكۈن	jˈækyn
پائالىيەتلەر	pˌɑɑlɪjˈætlær
پارىسچە	pɑɾˈɪst͡ʃæ
پاك	pˈɑk
پايتەخت	pˈɑjtæχt
پروگراممىلىق	prˌoɡrɑmmˈɪlɪq
پىكرىنى	pɪkrˈɪnɪ
پىلانىنى	pˌɪlɑnˈɪnɪ
پىچاق	pˈɪt͡ʃɑq
پۇتىن	pˈutɪn
پۇرسەتتىن	pursˈættɪn
پەرقلىنىدۇ	pˌærqlɪnˈɪdu
چاناق	t͡ʃˈɑnɑq
چىداملىق	t͡ʃɪdˈɑmlɪq
چىرا	t͡ʃˈɪɾɑ
چىراغ	t͡ʃˈɪɾɑʁ
چىقىرىدىغان	t͡ʃˌɪqɪɾɪdˈɪʁɑn
چىقىشىغا	t͡ʃˌɪqɪʃˈɪʁɑ
چىڭگىزخان	t͡ʃɪŋɡˈɪzχɑn
چۆچەك	t͡ʃˈœt͡ʃæk
چېپىپ	t͡ʃˈepɪp
چەتئەلگە	t͡ʃætˈælɡæ
گومىنداڭ	ɡomˈɪndɑŋ
گىلەم	ɡˈɪlæm
گۈلخان	ɡˈylχɑn
گۈللىنىش	ɡyllˈɪnɪʃ
گەندى	ɡˈændɪ
گەنسۇ	ɡˈænsu
ھاجىتى	hɑd͡ʒˈɪtɪ
ھالقىلىق	hɑlqˈɪlɪq
ھاياتنى	hɑjˈɑtnɪ
ھورمۇن	hˈormun
ھوقۇقنى	hoqˈuqnɪ
ھىندىستاندا	hˌɪndɪstˈɑndɑ
ھۇجۇمغا	hud͡ʒˈumʁɑ
ھېسابات	hesˈɑbɑt
ھە	hˈæ
ھەجىملىك	hæd͡ʒˈɪmlɪk
ھەمراھى	hæmrˈɑhɪ
ھەممىمىزگە	hˌæmmɪmˈɪzɡæ
ھەيدەش	hˈæjdæʃ
ۋاپاتىدىن	wˌɑpɑtˈɪdɪn
ۋىرۇس	wˈɪɾus
ۋەزىپىگە	wˌæzɪpˈɪɡæ
II	ˈɪɪ
ئاتالغۇسى	ˌɑtɑlʁˈusɪ
ئاتىلىپ	ɑtˈɪlɪp
ئادەتكە	ɑdˈætkæ
ئارزۇسىنى	ˌɑrzusˈɪnɪ
ئارۇز	ˈɑɾuz
ئاساسىدىكى	ˌɑsɑsɪdˈɪkɪ
ئاساسىغا	ˌɑsɑsˈɪʁɑ
ئافرىقىدىكى	ˌɑfrɪqɪdˈɪkɪ
ئالدىم	ˈɑldɪm
ئالماشتۇرۇپ	ˌɑlmɑʃtˈuɾup
ئالەمشۇمۇل	ˌɑlæmʃˈumul
ئاممىۋىي	ɑmmˈɪwɪj
ئامىللارنى	ˌɑmɪllˈɑrnɪ
ئانىلار	ɑnˈɪlɑr
ئاياق	ˈɑjɑq
ئايەتلەر	ɑjˈætlær
ئاپىرىپ	ɑpˈɪɾɪp
ئاڭلايدىغان	ˌɑŋlɑjdˈɪʁɑn
ئاھالىسىنىڭ	ˌɑhɑlɪsˈɪnɪŋ
ئاھالىنىڭ	ˌɑhɑlˈɪnɪŋ
ئوخشاشمىغان	ˌoχʃɑʃmˈɪʁɑn
ئورۇنلار	oɾˈunlɑr
ئورۇنلاشقان	ˌoɾunlˈɑʃqɑn
ئوغۇللار	oʁˈullɑr
ئوقۇغۇچىلاردىن	ˌoquʁˌut͡ʃɪlˈɑrdɪn
ئوقۇغۇچىلىرى	ˌoquʁˌut͡ʃɪlˈɪɾɪ
ئويلىنىپ	ojlˈɪnɪp
ئىتتىپاقىغا	ˌɪttɪpɑqˈɪʁɑ
ئىزدەڭ	ˈɪzdæŋ
ئىسىملار	ɪsˈɪmlɑr
ئىشخانىسى	ˌɪʃχɑnˈɪsɪ
ئىشلەۋاتقان	ˌɪʃlæwˈɑtqɑn
ئىشىغا	ɪʃˈɪʁɑ
ئىككىدىن	ɪkkˈɪdɪn
ئىمكانىيەت	ˌɪmkɑnˈɪjæt
ئىنسانغا	ɪnsˈɑnʁɑ
ئىنىسى	ɪnˈɪsɪ
ئىپادىلەنگەن	ˌɪpɑdɪlˈænɡæn
ئىپادىلەپ	ˌɪpɑdˈɪlæp
ئىچكىرى	ɪt͡ʃkˈɪɾɪ
ئىچىنى	ɪt͡ʃˈɪnɪ
ئىگىلىكىنى	ˌɪɡɪlɪkˈɪnɪ
ئىگەللەيدۇ	ˌɪɡællˈæjdu
ئۆتكۈزىدۇ	ˌœtkyzˈɪdu
ئۆتمەيلا	œtmˈæjlɑ
ئۆردەك	ˈœrdæk
ئۆردەكنىڭ	œrdˈæknɪŋ
ئۆزگىرىشلەر	ˌœzɡɪɾˈɪʃlær
ئۆزگەرتىشكە	ˌœzɡærtˈɪʃkæ
ئۆزۈمنى	œzˈymnɪ
ئۆستۈرۈلىدۇ	ˌœstyɾylˈɪdu
ئۆسكەن	ˈœskæn
ئۆسىدۇ	œsˈɪdu
ئۆلتۈرىۋېلىش	ˌœltyɾɪwˈelɪʃ
ئۆچمەنلىك	œt͡ʃmˈænlɪk
ئۆگىنىدۇ	ˌœɡɪnˈɪdu
ئۇتۇق	ˈutuq
ئۇسۇللىرى	ˌusullˈɪɾɪ
ئۇلاردىكى	ˌulɑrdˈɪkɪ
ئۇلۇغۋار	ulˈuʁwɑr
ئۇنىڭدىكى	ˌunɪŋdˈɪkɪ
ئۇنۋانىغا	ˌunwɑnˈɪʁɑ
ئۇنۋانىنى	ˌunwɑnˈɪnɪ
ئۇيغۇرلۇق	ujʁˈurluq
ئۇچۇرلارنىڭ	ˌut͡ʃurlˈɑrnɪŋ
ئۈندەيدۇ	yndˈæjdu
ئېسىمگە	esˈɪmɡæ
ئېشىش	ˈeʃɪʃ
ئېلى	ˈelɪ
ئېنىقلاش	enˈɪqlɑʃ
ئېينىشتىيىن	ˌejnɪʃtˈɪjɪn
ئېيى	ˈejɪ
ئېھتىمال	ehtˈɪmɑl
ئېھتىماللىقى	ˌehtɪmɑllˈɪqɪ
ئەبى	ˈæbɪ
ئەتكەن	ˈætkæn
ئەخلەت	ˈæχlæt
ئەسكى	ˈæskɪ
ئەسكىرى	æskˈɪɾɪ
ئەقلى	ˈæqlɪ
ئەقىدىسى	ˌæqɪdˈɪsɪ
ئەلدىكى	ældˈɪkɪ
ئەمەستۇر	æmˈæstur
ئەندىشە	ændˈɪʃæ
ئەھمىيەتلىك	ˌæhmɪjˈætlɪk
ئەۋلىيا	æwlˈɪjɑ
بارات	bˈɑɾɑt
بازارلىق	bɑzˈɑrlɪq
باشلىنىپ	bɑʃlˈɪnɪp
باغۋەنچىلىك	bˌɑʁwænt͡ʃˈɪlɪk
بالىڭىزغا	bˌɑlɪŋˈɪzʁɑ
بايرىقى	bɑjrˈɪqɪ
بوسنىيە	bosnˈɪjæ
بولغانلار	bolʁˈɑnlɑr
بولغانلارغا	bˌolʁɑnlˈɑrʁɑ
بولغانىكەن	bˌolʁɑnˈɪkæn
بولغىلى	bolʁˈɪlɪ
بولغىنىغا	bˌolʁɪnˈɪʁɑ
بولمايدىغانلىقىنى	bˌolmɑjdˌɪʁɑnlɪqˈɪnɪ
بولمىغاندا	bˌolmɪʁˈɑndɑ
بويلاپ	bˈojlɑp
بوۋىسى	bowˈɪsɪ
بىخەۋەر	bɪχˈæwær
بۇخىل	bˈuχɪl
بېرىشتىن	beɾˈɪʃtɪn
بېسىش	bˈesɪʃ
بېقىڭ	bˈeqɪŋ
بەختلىك	bˈæχtlɪk
بەدىلىگە	bˌædɪlˈɪɡæ
بەرگەندە	bærɡˈændæ
بەس	bˈæs
بەشىنچى	bæʃˈɪnt͡ʃɪ
تائالانىڭ	tˌɑɑlˈɑnɪŋ
تارقاتقان	tɑrqˈɑtqɑn
تارمىقىغا	tˌɑrmɪqˈɪʁɑ
تاغقا	tˈɑʁqɑ
تاپشۇرغان	tɑpʃˈurʁɑn
تاۋۇز	tˈɑwuz
تاۋۇشلار	tɑwˈuʃlɑr
توختالغان	toχtˈɑlʁɑn
توردىن	tˈordɪn
توملۇق	tˈomluq
تونۇرغا	tonˈurʁɑ
تىبەت	tˈɪbæt
تىرازىي	tɪɾˈɑzɪj
تىللىرىنى	tˌɪllɪɾˈɪnɪ
تۆلەم	tˈœlæm
تۇرسا	tˈursɑ
تۇرۇپتۇ	tuɾˈuptu
تۇپراققا	tuprˈɑqqɑ
تۇڭگان	tˈuŋɡɑn
تۈرتكىلىك	tyrtkˈɪlɪk
تۈركىستاننى	tˌyrkɪstˈɑnnɪ
تۈسىنى	tysˈɪnɪ
تۈنۈگۈن	tynˈyɡyn
تېرىقچىلىق	tˌeɾɪqt͡ʃˈɪlɪq
تېلىفون	telˈɪfon
تەجەللىنىڭ	tˌæd͡ʒællˈɪnɪŋ
تەخسە	tˈæχsæ
تەرىقىدە	tˌæɾɪqˈɪdæ
تەرىپىدىكى	tˌæɾɪpɪdˈɪkɪ
تەشكىلىي	tæʃkˈɪlɪj
تەشنا	tˈæʃnɑ
تەكلىپى	tæklˈɪpɪ
تەمىنلەش	tæmˈɪnlæʃ
تەنلىكلەر	tænlˈɪklær
تەپسىلى	tæpsˈɪlɪ
تەڭلا	tˈæŋlɑ
جايى	d͡ʒˈɑjɪ
جون	d͡ʒˈon
جەريان	d͡ʒˈærjɑn
جەلىپ	d͡ʒˈælɪp
جەننەتكە	d͡ʒænnˈætkæ
خاتىرجەم	χɑtˈɪrd͡ʒæm
خانغا	χˈɑnʁɑ
خانىمنىڭ	χɑnˈɪmnɪŋ
خوتۇنى	χotˈunɪ
خىتايچە	χɪtˈɑjt͡ʃæ
خىش	χˈɪʃ
خىمىيىلىك	χˌɪmɪjˈɪlɪk
خۇسۇسى	χusˈusɪ
خۇسۇسىيىتىگە	χˌususˌɪjɪtˈɪɡæ
خۇسۇسەن	χusˈusæn
خۇيزۇ	χˈujzu
خېنىم	χˈenɪm
د	d
دالا	dˈɑlɑ
داڭق	dˈɑŋq
داۋاملاشتۇرىدۇ	dˌɑwɑmlˌɑʃtuɾˈɪdu
داۋاملىشىدۇ	dˌɑwɑmlɪʃˈɪdu
دورىغا	doɾˈɪʁɑ
دوستۇمنىڭ	dostˈumnɪŋ
دۆلەتتىن	dœlˈættɪn
دۇنياسىغا	dˌunjɑsˈɪʁɑ
دېگەنلىكتۇر	dˌeɡænlˈɪktur
دەخلى	dˈæχlɪ
دەھشەتلىك	dæhʃˈætlɪk
دەۋرلەردە	dæwrlˈærdæ
دەۋرىدىن	dæwrˈɪdɪn
رادىئاكتىپلىق	rˌɑdɪɑktˈɪplɪq
رايوندىكى	rˌɑjondˈɪkɪ
رايونلىرىنى	rˌɑjonlɪɾˈɪnɪ
روسىيە	rosˈɪjæ
رېئاللىق	reˈɑllɪq
رەتلىك	rˈætlɪk
رەڭگارەڭ	ræŋɡˈɑɾæŋ
رەھبەرلىرى	rˌæhbærlˈɪɾɪ
زامانىسىدا	zˌɑmɑnɪsˈɪdɑ
زامانىۋىي	zˌɑmɑnˈɪwɪj
زاپىسى	zɑpˈɪsɪ
زىمىنى	zɪmˈɪnɪ
زەربە	zˈærbæ
سائەتتىن	sɑˈættɪn
ساتقۇچى	sɑtqˈut͡ʃɪ
ساھەدىكى	sˌɑhædˈɪkɪ
ساھەگە	sɑhˈæɡæ
ستالىن	stˈɑlɪn
سوقۇپ	sˈoqup
سولغا	sˈolʁɑ
سىدىق	sˈɪdɪq
سىرتىغا	sɪrtˈɪʁɑ
سىنىپ	sˈɪnɪp
سۇدىن	sˈudɪn
سۇلالىسىنى	sˌulɑlɪsˈɪnɪ
سۇمېر	sˈumer
سېلىشتۇرغاندا	sˌelɪʃturʁˈɑndɑ
سەر	sˈær
شايار	ʃˈɑjɑr
شىسەي	ʃˈɪsæj
شەرققە	ʃˈærqqæ
شەرىقى	ʃæɾˈɪqɪ
شەكىللەندى	ʃˌækɪllˈændɪ
شەنبە	ʃˈænbæ
غالىپ	ʁˈɑlɪp
غىچە	ʁˈɪt͡ʃæ
فوند	fˈond
قاتناشقۇچىلار	qˌɑtnɑʃqut͡ʃˈɪlɑr
قارارغا	qɑɾˈɑrʁɑ
قارى	qˈɑɾɪ
قارىشىچە	qˌɑɾɪʃˈɪt͡ʃæ
قارىغۇلارچە	qˌɑɾɪʁulˈɑrt͡ʃæ
قاش	qˈɑʃ
قامۇسى	qɑmˈusɪ
قايرىپ	qˈɑjrɪp
قاچا	qˈɑt͡ʃɑ
قورالى	qoɾˈɑlɪ
قورقۇش	qˈorquʃ
قومۇل	qˈomul
قويۇپتۇ	qojˈuptu
قىلغىنى	qɪlʁˈɪnɪ
قىلغۇچىلارنىڭ	qˌɪlʁut͡ʃɪlˈɑrnɪŋ
قىلماق	qˈɪlmɑq
قىلىشتۇر	qɪlˈɪʃtur
قۇدرەت	qˈudræt
قۇرۇشقا	quɾˈuʃqɑ
قۇيرۇق	qˈujruq
قەبرىسى	qæbrˈɪsɪ
كوممۇنىست	kommˈunɪst
كومپىيوتىر	kˌompɪjˈotɪr
كىرىشى	kɪɾˈɪʃɪ
كىشىدۇر	kɪʃˈɪdur
كىلىماتى	kˌɪlɪmˈɑtɪ
كۆتۈرگەن	kœtˈyrɡæn
كۆرەتتى	kœɾˈættɪ
كۆپىيىپ	kœpˈɪjɪp
كۆڭلىڭىزدە	kˌœŋlɪŋˈɪzdæ
كۈلكىلىك	kylkˈɪlɪk
كۈنجۈت	kˈynd͡ʒyt
كۈنىنى	kynˈɪnɪ
كېسەللىكلەر	kˌesællˈɪklær
كېسەلگە	kesˈælɡæ
كېلىشىمى	kˌelɪʃˈɪmɪ
كېچىدە	ket͡ʃˈɪdæ
كېڭىشى	keŋˈɪʃɪ
كەبى	kˈæbɪ
كەسپ	kˈæsp
كەسپىدە	kæspˈɪdæ
كەچتە	kˈæt͡ʃtæ
مارت	mˈɑrt
ماقال	mˈɑqɑl
ماقالىلىرى	mˌɑqɑlɪlˈɪɾɪ
ماگىستىر	mɑɡˈɪstɪr
ماۋ	mˈɑw
مىقياسىدا	mˌɪqjɑsˈɪdɑ
مىللەتتە	mɪllˈættæ
مىلىيون	mɪlˈɪjon
مىليوندىن	mɪljˈondɪn
مىنى	mˈɪnɪ
مۆھلەت	mˈœhlæt
مۇتەخەسسىس	mˌutæχˈæssɪs
مۇراسىم	muɾˈɑsɪm
مۇسابىقىسى	mˌusɑbɪqˈɪsɪ
مۇنارى	munˈɑɾɪ
مۇۋەپپەقىيەتكە	mˌuwæppˌæqɪjˈætkæ
مېڭىش	mˈeŋɪʃ
مېھرىبانۇ	mˌehrɪbˈɑnu
مەدەت	mˈædæt
مەزمۇندىكى	mˌæzmundˈɪkɪ
مەسئۇلىيىتىنى	mˌæsulˌɪjɪtˈɪnɪ
مەكتىپىگە	mˌæktɪpˈɪɡæ
مەككىگە	mækkˈɪɡæ
مەنبەلەردە	mˌænbælˈærdæ
مەھكەم	mˈæhkæm
ناتايىن	nɑtˈɑjɪn
نامەلۇم	nɑmˈælum
ناننىڭ	nˈɑnnɪŋ
ناپولىيون	nˌɑpolˈɪjon
ناھايىتىمۇ	nˌɑhɑjɪtˈɪmu
نومۇس	nˈomus
نۆۋىتى	nœwˈɪtɪ
نۇقتىغا	nuqtˈɪʁɑ
نەتىجىگە	nˌætɪd͡ʒˈɪɡæ
ياراتتى	jɑɾˈɑttɪ
يارىدەم	jɑɾˈɪdæm
يازغۇچىسى	jˌɑzʁut͡ʃˈɪsɪ
يامغۇر	jˈɑmʁur
ياپونلۇق	jɑpˈonluq
ياپونىيىدە	jˌɑponɪjˈɪdæ
ياۋروپادىكى	jˌɑwropɑdˈɪkɪ
يوقىتىش	joqˈɪtɪʃ
يوللاپ	jˈollɑp
يولۇچىلار	jˌolut͡ʃˈɪlɑr
يىرىك	jˈɪɾɪk
يۆتكەپ	jˈœtkæp
يۇرتقا	jˈurtqɑ
يۇيۇش	jˈujuʃ
يۇيۇپ	jˈujup
يۈزىنىڭ	jyzˈɪnɪŋ
يېرىنى	jeɾˈɪnɪ
يېزىدا	jezˈɪdɑ
يېزىسىنىڭ	jˌezɪsˈɪnɪŋ
يېزىلاردا	jˌezɪlˈɑrdɑ
يېمەكلىكلەرنى	jˌemæklɪklˈærnɪ
يېيىش	jˈejɪʃ
يېپىق	jˈepɪq
يېڭىسار	jeŋˈɪsɑr
يېڭىشەھەر	jˌeŋɪʃˈæhær
يەرلەرنى	jærlˈærnɪ
يەسەۋىي	jæsˈæwɪj
پارچىسى	pɑrt͡ʃˈɪsɪ
پاسپورت	pˈɑsport
پاش	pˈɑʃ
پىرسەنتىنى	pˌɪrsæntˈɪnɪ
پىشىپ	pˈɪʃɪp
پىكرىگە	pɪkrˈɪɡæ
پۇتىنى	putˈɪnɪ
پۇراپ	pˈuɾɑp
پۈتتۈرۈپ	pyttˈyɾyp
پېئىل	pˈeɪl
پەسىل	pˈæsɪl
چاقىردى	t͡ʃɑqˈɪrdɪ
چىققاندا	t͡ʃɪqqˈɑndɑ
چىقىشنى	t͡ʃɪqˈɪʃnɪ
چۈش	t͡ʃˈyʃ
چۈشتىن	t͡ʃˈyʃtɪn
چۈشەندۈرىدۇ	t͡ʃˌyʃændyɾˈɪdu
چۈشەندۈرۈش	t͡ʃˌyʃændˈyɾyʃ
چېكىنىپ	t͡ʃekˈɪnɪp
چېچىنى	t͡ʃet͡ʃˈɪnɪ
گۇناھ	ɡˈunɑh
ھازىرقىدەك	hˌɑzɪrqˈɪdæk
ھاشىم	hˈɑʃɪm
ھاكىمىيەتنى	hˌɑkɪmɪjˈætnɪ
ھاياتىدىكى	hˌɑjɑtɪdˈɪkɪ
ھاياتىغا	hˌɑjɑtˈɪʁɑ
ھاۋاسى	hɑwˈɑsɪ
ھىندىستانغا	hˌɪndɪstˈɑnʁɑ
ھۆر	hˈœr
ھۈسەين	hˈysæjn
ھۈسەيىن	hysˈæjɪn
ھەربى	hˈærbɪ
ھەركۈنى	hærkˈynɪ
ھەرىكەتلىرى	hˌæɾɪkætlˈɪɾɪ
ھەسسىلەپ	hæssˈɪlæp
ھەممەيلەن	hæmmˈæjlæn
ۋاستىلىرى	wˌɑstɪlˈɪɾɪ
ۋاقىتلىرىدا	wˌɑqɪtlɪɾˈɪdɑ
ۋاكالەت	wɑkˈɑlæt
ۋاپاتى	wɑpˈɑtɪ
ۋىرۇسى	wɪɾˈusɪ
ۋەقەلەرنى	wˌæqælˈærnɪ
DNA	dnˈɑ
X	χ
ئابدۇسالام	ˌɑbdusˈɑlɑm
ئاتالدى	ɑtˈɑldɪ
ئاتقا	ˈɑtqɑ
ئاجراتقان	ɑd͡ʒrˈɑtqɑn
ئاد	ˈɑd
ئادەملىرى	ˌɑdæmlˈɪɾɪ
ئارالنىڭ	ɑɾˈɑlnɪŋ
ئارغامچا	ɑrʁˈɑmt͡ʃɑ
ئارقىغا	ɑrqˈɪʁɑ
ئارقىلىقلا	ˌɑrqɪlˈɪqlɑ
ئارىلىق	ɑɾˈɪlɪq
ئارىلىقىدىكى	ˌɑɾɪlˌɪqɪdˈɪkɪ
ئارىلىنىڭ	ˌɑɾɪlˈɪnɪŋ
ئازسانلىق	ɑzsˈɑnlɪq
ئاستىدىن	ɑstˈɪdɪn
ئافغانىستان	ˌɑfʁɑnˈɪstɑn
ئالاتتى	ɑlˈɑttɪ
ئالغاندا	ɑlʁˈɑndɑ
ئالغىلى	ɑlʁˈɪlɪ
ئالەمنىڭ	ɑlˈæmnɪŋ
ئاممىنىڭ	ɑmmˈɪnɪŋ
ئامىر	ˈɑmɪr
ئايغىچە	ɑjʁˈɪt͡ʃæ
ئايلاندۇرۇپ	ˌɑjlɑndˈuɾup
ئاپتورنىڭ	ɑptˈornɪŋ
ئاڭلىدىم	ɑŋlˈɪdɪm
ئاڭلىشىمچە	ˌɑŋlɪʃˈɪmt͡ʃæ
ئاۋارە	ɑwˈɑɾæ
ئاۋۇت	ˈɑwut
ئوبيېكتىپ	objˈektɪp
ئوتتۇرىدىن	ˌottuɾˈɪdɪn
ئوتنى	ˈotnɪ
ئوخشايدىغان	ˌoχʃɑjdˈɪʁɑn
ئوردىسىدا	ˌordɪsˈɪdɑ
ئوقيا	ˈoqjɑ
ئوقۇدى	oqˈudɪ
ئوقۇغانلىقى	ˌoquʁɑnlˈɪqɪ
ئوقۇلىدۇ	ˌoqulˈɪdu
ئويلىغان	ojlˈɪʁɑn
ئىدىيىسى	ˌɪdɪjˈɪsɪ
ئىرقى	ˈɪrqɪ
ئىزدەيدۇ	ɪzdˈæjdu
ئىزى	ˈɪzɪ
ئىزھار	ˈɪzhɑr
ئىستانبۇلدا	ˌɪstɑnbˈuldɑ
ئىستانبۇلغا	ˌɪstɑnbˈulʁɑ
ئىستىكى	ɪstˈɪkɪ
ئىسىملىرى	ˌɪsɪmlˈɪɾɪ
ئىسپات	ˈɪspɑt
ئىشخانىسىغا	ˌɪʃχɑnɪsˈɪʁɑ
ئىشلىتىۋاتقان	ˌɪʃlɪtɪwˈɑtqɑn
ئىشىكى	ɪʃˈɪkɪ
ئىلاھى	ɪlˈɑhɪ
ئىلاۋە	ɪlˈɑwæ
ئىلىش	ˈɪlɪʃ
ئىماننىڭ	ɪmˈɑnnɪŋ
ئىمكانىيىتىگە	ˌɪmkɑnˌɪjɪtˈɪɡæ
ئىمپېرىيىسىنىڭ	ˌɪmpeɾˌɪjɪsˈɪnɪŋ
ئىنىق	ˈɪnɪq
ئىپادىلەيدىغان	ˌɪpɑdˌɪlæjdˈɪʁɑn
ئىچىدىلا	ˌɪt͡ʃɪdˈɪlɑ
ئۆتىشى	œtˈɪʃɪ
ئۆتىگەن	œtˈɪɡæn
ئۆتۈشى	œtˈyʃɪ
ئۆرۈلۈپ	œɾˈylyp
ئۆزبېكلەر	œzbˈeklær
ئۆزىدىكى	ˌœzɪdˈɪkɪ
ئۆزەمنىڭ	œzˈæmnɪŋ
ئۆلتۈرۈلگەن	ˌœltyɾˈylɡæn
ئۆلچەش	ˈœlt͡ʃæʃ
ئۆلۈمى	œlˈymɪ
ئۆمەرنىڭ	œmˈærnɪŋ
ئۆيلەرنىڭ	œjlˈærnɪŋ
ئۆگەتكەن	œɡˈætkæn
ئۇدۇن	ˈudun
ئۇرۇشنىڭ	uɾˈuʃnɪŋ
ئۇزۇقلۇق	uzˈuqluq
ئۇزۇنراق	uzˈunrɑq
ئۇنىۋېرستېتى	ˌunɪwerstˈetɪ
ئۇيغۇردا	ujʁˈurdɑ
ئۇيغۇرلىرىنىڭ	ˌujʁurlɪɾˈɪnɪŋ
ئۇچراتقان	ut͡ʃrˈɑtqɑn
ئۇچرىمايدۇ	ˌut͡ʃrɪmˈɑjdu
ئۈجمە	ˈyd͡ʒmæ
ئۈستۈنكى	ystˈynkɪ
ئېسىپ	ˈesɪp
ئېغىرلىق	eʁˈɪrlɪq
ئېقىمى	eqˈɪmɪ
ئېيتىشىچە	ˌejtɪʃˈɪt͡ʃæ
ئېيىق	ˈejɪq
ئېيىنىڭ	ejˈɪnɪŋ
ئەتراپتىكى	ˌætrɑptˈɪkɪ
ئەدەبىياتىغا	ˌædæbˌɪjɑtˈɪʁɑ
ئەسلەپ	ˈæslæp
ئەشۇ	ˈæʃu
ئەلئەنسارىي	ˌælænsˈɑɾɪj
ئەللىك	ˈællɪk
ئەمر	ˈæmr
ئەمگەكچىلەر	ˌæmɡækt͡ʃˈɪlær
ئەنئەنىۋىي	ˌænænˈɪwɪj
ئەنگە	ˈænɡæ
ئەۋزەل	ˈæwzæl
ئەۋەتىپ	æwˈætɪp
بارلار	bˈɑrlɑr
بازىرىدا	bˌɑzɪɾˈɪdɑ
باسقۇچ	bˈɑsqut͡ʃ
باسىدۇ	bɑsˈɪdu
باغلىنىشلىق	bˌɑʁlɪnˈɪʃlɪq
باياشات	bɑjˈɑʃɑt
بايقايمىز	bɑjqˈɑjmɪz
باينىڭ	bˈɑjnɪŋ
بوستانلىق	bostˈɑnlɪq
بولسىلا	bolsˈɪlɑ
بولغاندەك	bolʁˈɑndæk
بويۇن	bˈojun
بوۋاقلار	bowˈɑqlɑr
بوۋاقنىڭ	bowˈɑqnɪŋ
بىئولوگىيە	bˌɪoloɡˈɪjæ
بىردەم	bˈɪrdæm
بىرلىكىنى	bˌɪrlɪkˈɪnɪ
بىرلەشتۈرۈپ	bˌɪrlæʃtˈyɾyp
بىرىنچىسى	bˌɪɾɪnt͡ʃˈɪsɪ
بىرۇنىنىڭ	bˌɪɾunˈɪnɪŋ
بىلمەيدۇ	bɪlmˈæjdu
بىلىشى	bɪlˈɪʃɪ
بىلىمگە	bɪlˈɪmɡæ
بۆلۈمى	bœlˈymɪ
بۇخارىي	buχˈɑɾɪj
بۇزۇلۇش	buzˈuluʃ
بۇزۇپ	bˈuzup
بۇغراخان	buʁrˈɑχɑn
بۇلارغا	bulˈɑrʁɑ
بۇلۇت	bˈulut
بۇلۇش	bˈuluʃ
بېجى	bˈed͡ʒɪ
بېرەي	bˈeɾæj
بېقىشنى	beqˈɪʃnɪ
بېكىتكەن	bekˈɪtkæn
بېكىتىش	bekˈɪtɪʃ
بەدىنىدە	bˌædɪnˈɪdæ
بەدەندىكى	bˌædændˈɪkɪ
بەرسە	bˈærsæ
بەزىلەرنىڭ	bˌæzɪlˈærnɪŋ
بەلگىلىمىلەر	bˌælɡɪlɪmˈɪlær
بەلگىلىمىگە	bˌælɡɪlɪmˈɪɡæ
تاتارلار	tɑtˈɑrlɑr
تارتىشش	tˈɑrtɪʃʃ
تارقىتىشقا	tˌɑrqɪtˈɪʃqɑ
تارقىلىشى	tˌɑrqɪlˈɪʃɪ
تارقىلىپ	tɑrqˈɪlɪp
تارمار	tˈɑrmɑr
تاشلايدۇ	tɑʃlˈɑjdu
تاشيول	tˈɑʃjol
ترامپ	trˈɑmp
توختامى	toχtˈɑmɪ
توسالغۇ	tosˈɑlʁu
توغرىسىغا	tˌoʁrɪsˈɪʁɑ
توغرىلىق	toʁrˈɪlɪq
توپلام	tˈoplɑm
تىخى	tˈɪχɪ
تىزىلغان	tɪzˈɪlʁɑn
تىلەيمىز	tɪlˈæjmɪz
تىپىدىكى	tˌɪpɪdˈɪkɪ
تۆۋەندىكىدەك	tˌœwændɪkˈɪdæk
تۆۋەندىكىچە	tˌœwændɪkˈɪt͡ʃæ
تۇرمۇشتىكى	tˌurmuʃtˈɪkɪ
تۇرمۇشنى	turmˈuʃnɪ
تۇرىمەن	tuɾˈɪmæn
تۇغقانلىرى	tˌuʁqɑnlˈɪɾɪ
تۈركىستاندىكى	tˌyrkɪstɑndˈɪkɪ
تۈزۈمنىڭ	tyzˈymnɪŋ
تېكىن	tˈekɪn
تېمىنى	temˈɪnɪ
تېنچلىق	tˈent͡ʃlɪq
تەرتىپكە	tærtˈɪpkæ
تەسىرىدىن	tˌæsɪɾˈɪdɪn
تەقدىر	tˈæqdɪr
تەلەپنى	tælˈæpnɪ
تەڭكەش	tˈæŋkæʃ
تەھرىرلەش	tæhrˈɪrlæʃ
تەۋەلىك	tæwˈælɪk
تەۋەلىكىدە	tˌæwælɪkˈɪdæ
جاراڭلىق	d͡ʒɑɾˈɑŋlɪq
جايلىرىغا	d͡ʒˌɑjlɪɾˈɪʁɑ
جەمئىيەتتىن	d͡ʒˌæmɪjˈættɪn
جەڭدە	d͡ʒˈæŋdæ
خاتىرىلەش	χˌɑtɪɾˈɪlæʃ
خاراكتېر	χɑɾˈɑkter
خاقانى	χɑqˈɑnɪ
خىتاب	χˈɪtɑb
خېلە	χˈelæ
خەلقئارادىكى	χˌælqɑɾɑdˈɪkɪ
خەلقلىرى	χælqlˈɪɾɪ
خەۋىرىنى	χˌæwɪɾˈɪnɪ
دان	dˈɑn
داۋا	dˈɑwɑ
داۋاملاشتۇرۇش	dˌɑwɑmlɑʃtˈuɾuʃ
دىمەك	dˈɪmæk
دىيارىدا	dˌɪjɑɾˈɪdɑ
دۆلەتلىرىدە	dˌœlætlɪɾˈɪdæ
دۆلەتلەردىكى	dˌœlætlærdˈɪkɪ
دۆلەتلەرنى	dˌœlætlˈærnɪ
دېيىلىدىغان	dˌejɪlɪdˈɪʁɑn
دېڭىزنىڭ	deŋˈɪznɪŋ
دەرسى	dˈærsɪ
دەرەخ	dˈæɾæχ
دەۋالاشقۇچى	dˌæwɑlɑʃqˈut͡ʃɪ
دەۋرىنى	dæwrˈɪnɪ
ر	r
رايونلىرىدا	rˌɑjonlɪɾˈɪdɑ
روھنى	rˈohnɪ
رىشات	rˈɪʃɑt
رىياسەتچىلىك	rˌɪjɑsætt͡ʃˈɪlɪk
رەسىمى	ræsˈɪmɪ
رەھبەرلىكىدىكى	rˌæhbærlˌɪkɪdˈɪkɪ
رەھمەتۇللا	rˌæhmætˈullɑ
رەھىمەھۇللاھ	rˌæhɪmæhˈullɑh
زامانغا	zɑmˈɑnʁɑ
زاۋۇت	zˈɑwut
س	s
ساختا	sˈɑχtɑ
سارىيى	sɑɾˈɪjɪ
ساقلاشقا	sɑqlˈɑʃqɑ
سالىدىغان	sˌɑlɪdˈɪʁɑn
ساھابىلەردىن	sˌɑhɑbɪlˈærdɪn
ساۋاتسىز	sɑwˈɑtsɪz
سوۋغا	sˈowʁɑ
سىلىق	sˈɪlɪq
سۆزدىن	sˈœzdɪn
سۇتۇق	sˈutuq
سۇپىسى	supˈɪsɪ
سۈيىدىن	syjˈɪdɪn
سېلىشتۇرما	sˌelɪʃtˈurmɑ
سېپىپ	sˈepɪp
سەلبى	sˈælbɪ
سەپەرگە	sæpˈærɡæ
سەۋىيىسى	sˌæwɪjˈɪsɪ
ش	ʃ
شارىدىكى	ʃˌɑɾɪdˈɪkɪ
شىتابى	ʃɪtˈɑbɪ
شىركەتتىن	ʃɪrkˈættɪn
شىركەتنى	ʃɪrkˈætnɪ
شىمالىدا	ʃˌɪmɑlˈɪdɑ
شىڭ	ʃˈɪŋ
شەخسلەردىن	ʃæχslˈærdɪn
شەرقتىكى	ʃærqtˈɪkɪ
شەرەپ	ʃˈæɾæp
شەكلىدىكى	ʃˌæklɪdˈɪkɪ
شەكلىگە	ʃæklˈɪɡæ
شەكىللىرى	ʃˌækɪllˈɪɾɪ
شەكىللىنىدۇ	ʃˌækɪllɪnˈɪdu
شەھىرىنى	ʃˌæhɪɾˈɪnɪ
غايىنى	ʁɑjˈɪnɪ
غەرپكە	ʁˈærpkæ
غەم	ʁˈæm
فىزىكىسى	fˌɪzɪkˈɪsɪ
قاتاردا	qɑtˈɑrdɑ
قاتارلىقلارغا	qˌɑtɑrlɪqlˈɑrʁɑ
قاتنىشى	qɑtnˈɪʃɪ
قاراشلار	qɑɾˈɑʃlɑr
قارىماققا	qˌɑɾɪmˈɑqqɑ
قازى	qˈɑzɪ
قالتىس	qˈɑltɪs
قالدۇرىدۇ	qˌɑlduɾˈɪdu
قالغانلار	qɑlʁˈɑnlɑr
قالغانلىرى	qˌɑlʁɑnlˈɪɾɪ
قالماسلىقى	qˌɑlmɑslˈɪqɪ
قالىسىز	qɑlˈɪsɪz
قالىمىز	qɑlˈɪmɪz
قالىمەن	qɑlˈɪmæn
قانداقمۇ	qɑndˈɑqmu
قانۇننى	qɑnˈunnɪ
قايناق	qˈɑjnɑq
قاينىتىپ	qɑjnˈɪtɪp
قورۇقچىبەگ	qˌoɾuqt͡ʃˈɪbæɡ
قوشتى	qˈoʃtɪ
قوللىنىدۇ	qˌollɪnˈɪdu
قوماندانى	qˌomɑndˈɑnɪ
قوياتتى	qojˈɑttɪ
قىتئەسى	qɪtˈæsɪ
قىرىم	qˈɪɾɪm
قىسسە	qˈɪssæ
قىسمىدىن	qɪsmˈɪdɪn
قىشلىق	qˈɪʃlɪq
قىلسىمۇ	qɪlsˈɪmu
قىلغۇچىلار	qˌɪlʁut͡ʃˈɪlɑr
قىلىندۇ	qɪlˈɪndu
قىلىنسا	qɪlˈɪnsɑ
قىلىپلا	qɪlˈɪplɑ
قىيامەت	qɪjˈɑmæt
قۇتۇپ	qˈutup
قۇرۇلۇشلىرى	qˌuɾuluʃlˈɪɾɪ
قۇمۇلغا	qumˈulʁɑ
قۇيۇلغان	qujˈulʁɑn
قېتىمدىن	qetˈɪmdɪn
قېرى	qˈeɾɪ
قېرىندىشى	qˌeɾɪndˈɪʃɪ
قېلىشتىن	qelˈɪʃtɪn
قېيىن	qˈejɪn
قەد	qˈæd
قەيەردە	qæjˈærdæ
كادىر	kˈɑdɪr
كاربون	kˈɑrbon
كاشغەرىي	kɑʃʁˈæɾɪj
كاڭشىنىڭ	kɑŋʃˈɪnɪŋ
كومپيوتېر	kompjˈoter
كوپ	kˈop
كىشىلىرى	kˌɪʃɪlˈɪɾɪ
كۆرسىتىشى	kˌœrsɪtˈɪʃɪ
كۆرسەتكۈچى	kˌœrsætkˈyt͡ʃɪ
كۆرۈلگەن	kœɾˈylɡæn
كۆرۈۋالغىلى	kˌœɾywɑlʁˈɪlɪ
كۆمەچ	kˈœmæt͡ʃ
كۆنۈپ	kˈœnyp
كۆچۈرۈلگەن	kˌœt͡ʃyɾˈylɡæn
كۆڭلىنى	kœŋlˈɪnɪ
كۈنىمىزدە	kˌynɪmˈɪzdæ
كۈچەپ	kˈyt͡ʃæp
كېلەر	kˈelær
كەسىپكە	kæsˈɪpkæ
كەلگەنىدى	kˌælɡænˈɪdɪ
كەمچىل	kˈæmt͡ʃɪl
كەنجى	kˈænd͡ʒɪ
كەينى	kˈæjnɪ
لى	lˈɪ
لىبېرالىزم	lˌɪbeɾˈɑlɪzm
لىنىيىسىنىڭ	lˌɪnɪjɪsˈɪnɪŋ
لۇغاتىت	luʁˈɑtɪt
ماخمۇت	mˈɑχmut
ماقالىلەرنى	mˌɑqɑlɪlˈærnɪ
مالىكنىڭ	mɑlˈɪknɪŋ
ماھارىتى	mˌɑhɑɾˈɪtɪ
ماھارەت	mɑhˈɑɾæt
موسكۋا	mˈoskwɑ
موڭغۇلچە	moŋʁˈult͡ʃæ
موگۇ	mˈoɡu
مىسلى	mˈɪslɪ
مىسىرلىق	mɪsˈɪrlɪq
مىسىرنىڭ	mɪsˈɪrnɪŋ
مىقدارىنى	mˌɪqdɑɾˈɪnɪ
مىللەتتىن	mɪllˈættɪn
مىللەتلەردىن	mˌɪllætlˈærdɪn
مىنىستىرلىكى	mˌɪnɪstɪrlˈɪkɪ
مۇستەملىكىسى	mˌustæmlɪkˈɪsɪ
مۇڭلۇق	mˈuŋluq
مۇھىمى	muhˈɪmɪ
مۇھەببىتى	mˌuhæbbˈɪtɪ
مۇھەممەدنىڭ	mˌuhæmmˈædnɪŋ
مېڭىنىڭ	meŋˈɪnɪŋ
مەخسۇت	mˈæχsut
مەدەنىيىتىگە	mˌædænˌɪjɪtˈɪɡæ
مەزمۇننى	mæzmˈunnɪ
مەزگىلدىن	mæzɡˈɪldɪn
مەزگىللىك	mæzɡˈɪllɪk
مەزھىپى	mæzhˈɪpɪ
مەغلۇبىيەتكە	mˌæʁlubɪjˈætkæ
مەككىدە	mækkˈɪdæ
مەمتىلى	mæmtˈɪlɪ
مەندە	mˈændæ
مەنزىرىسى	mˌænzɪɾˈɪsɪ
مەنپەئەتىنى	mˌænpæætˈɪnɪ
مەپكۇرىنىڭ	mˌæpkuɾˈɪnɪŋ
نائىل	nˈɑɪl
نادان	nˈɑdɑn
نارازى	nɑɾˈɑzɪ
نامدا	nˈɑmdɑ
نامىدىن	nɑmˈɪdɪn
نوقتىسىدىن	nˌoqtɪsˈɪdɪn
نوقۇل	nˈoqul
نوپۇسنىڭ	nopˈusnɪŋ
نىشاننى	nɪʃˈɑnnɪ
نىكاھ	nˈɪkɑh
نۆۋىتىدە	nˌœwɪtˈɪdæ
نۇتۇق	nˈutuq
نۇسخىلىرى	nˌusχɪlˈɪɾɪ
نەتىجىسىنى	nˌætɪd͡ʒɪsˈɪnɪ
نەسلى	nˈæslɪ
نەقىشلەر	næqˈɪʃlær
نەگە	nˈæɡæ
يوقتۇر	jˈoqtur
يىللارغا	jɪllˈɑrʁɑ
يىلىنىڭ	jɪlˈɪnɪŋ
يىگانە	jɪɡˈɑnæ
يۆتكەلگەن	jœtkˈælɡæn
يۆنىلىشى	jˌœnɪlˈɪʃɪ
يېتىدىغان	jˌetɪdˈɪʁɑn
يېتىلگەن	jetˈɪlɡæn
يېرىدىن	jeɾˈɪdɪn
يېزىقىدا	jˌezɪqˈɪdɑ
يېنىپ	jˈenɪp
يەتكۈزگەن	jætkˈyzɡæn
يەرلەرگە	jærlˈærɡæ
پاتقاق	pˈɑtqɑq
پاراڭلىشىپ	pˌɑɾɑŋlˈɪʃɪp
پوزىتسىيە	pˌozɪtsˈɪjæ
پولو	pˈolo
پىروگرامما	pˌɪɾoɡrˈɑmmɑ
پىشۇرۇش	pɪʃˈuɾuʃ
پىلانلىق	pɪlˈɑnlɪq
پۇتبول	pˈutbol
پۇقرالىق	puqrˈɑlɪq
پۈتۈشكىنى	pˌytyʃkˈɪnɪ
پەرزەنتى	pærzˈæntɪ
پەرھات	pˈærhɑt
پەسلىدە	pæslˈɪdæ
پەش	pˈæʃ
چارىسىنى	t͡ʃˌɑɾɪsˈɪnɪ
چالا	t͡ʃˈɑlɑ
چىش	t͡ʃˈɪʃ
چىقاتتى	t͡ʃɪqˈɑttɪ
چىققانلىقىنى	t͡ʃˌɪqqɑnlɪqˈɪnɪ
چىقىۋاتقان	t͡ʃˌɪqɪwˈɑtqɑn
چىڭگىزخاننىڭ	t͡ʃˌɪŋɡɪzχˈɑnnɪŋ
چۆللۈك	t͡ʃˈœllyk
چۈشكەندىن	t͡ʃyʃkˈændɪn
چۈشەنچىسىنى	t͡ʃˌyʃænt͡ʃɪsˈɪnɪ
چۈشەنگەن	t͡ʃyʃˈænɡæn
چېدىر	t͡ʃˈedɪr
چەتئەللىك	t͡ʃætˈællɪk
چەكلىنىپ	t͡ʃæklˈɪnɪp
ژۇرنىلىنىڭ	ʒˌurnɪlˈɪnɪŋ
گۇاڭشۈ	ɡuˈɑŋʃy
گۇما	ɡˈumɑ
گۈللەر	ɡˈyllær
گېرمان	ɡˈermɑn
گېنېرال	ɡenˈeɾɑl
ھالقا	hˈɑlqɑ
ھالەت	hˈɑlæt
ھامىلدار	hɑmˈɪldɑr
ھايۋانلارنى	hˌɑjwɑnlˈɑrnɪ
ھوقۇقىنىڭ	hˌoquqˈɪnɪŋ
ھىكايە	hɪkˈɑjæ
ھېسابلاپ	hesˈɑblɑp
ھېسسىيات	hessˈɪjɑt
ھېكايىسى	hˌekɑjˈɪsɪ
ھەدىسلەرنىڭ	hˌædɪslˈærnɪŋ
ھەدىيە	hædˈɪjæ
ھەرىكىتىگە	hˌæɾɪkɪtˈɪɡæ
ھەرىكەتچان	hˌæɾɪkˈætt͡ʃɑn
ھەقىقەتكە	hˌæqɪqˈætkæ
ھەلىق	hˈælɪq
ھەنەفىي	hænˈæfɪj
ۋادىسى	wɑdˈɪsɪ
ۋەقەسى	wæqˈæsɪ
ۋەقەنى	wæqˈænɪ
